UserId,Recency,Frequency,Monetary,R_Score,F_Score,M_Score,RFM_Score,UserSegment
148,121,6,35,4,1,3,8,Promising
463,141,13,62,4,3,3,10,Loyal Users
471,111,61,116,4,5,4,13,Champions
496,111,56,258,4,5,5,14,Champions
833,278,12,21,3,3,2,8,Loyal Users
1088,746,8,16,2,2,2,6,Lost
1238,479,15,73,2,3,4,9,Casual Users
1342,97,5,7,4,1,1,6,Promising
1580,231,93,179,3,5,5,13,Loyal Users
1591,1276,34,76,1,4,4,9,At Risk
1645,1232,18,74,2,3,4,9,Casual Users
1829,118,13,44,4,3,3,10,Loyal Users
1959,9,22,34,5,4,3,12,Loyal Users
2122,868,33,76,2,4,4,10,At Risk
2142,69,141,399,5,5,5,15,Champions
2366,2431,14,17,1,3,2,6,Casual Users
2659,5,18,151,5,3,5,13,Loyal Users
2866,714,26,46,2,4,3,9,At Risk
3175,67,31,153,5,4,5,14,Champions
3749,3127,21,38,1,3,3,7,Casual Users
3794,118,28,85,4,4,4,12,Champions
3918,281,18,27,3,3,2,8,Loyal Users
3997,280,37,142,3,4,4,11,Loyal Users
4101,784,7,9,2,2,1,5,Lost
4519,266,48,159,3,5,5,13,Loyal Users
4818,380,25,66,3,4,4,11,Loyal Users
4900,808,5,8,2,1,1,4,Lost
4935,28,9,32,5,2,3,10,Promising
5156,232,40,173,3,4,5,12,Loyal Users
5300,840,15,20,2,3,2,7,Casual Users
5518,107,20,101,4,3,4,11,Loyal Users
5803,302,20,66,3,3,4,10,Loyal Users
6336,61,53,208,5,5,5,15,Champions
6357,424,31,58,3,4,3,10,Loyal Users
6397,177,42,94,3,4,4,11,Loyal Users
6466,12,22,63,5,4,4,13,Champions
6620,83,59,133,4,5,4,13,Champions
6654,509,14,23,2,3,2,7,Casual Users
6658,3100,10,36,1,2,3,6,Lost
7240,75,5,10,4,1,1,6,Promising
7253,132,26,111,4,4,4,12,Champions
7340,6,64,98,5,5,4,14,Champions
7554,2084,6,16,1,1,2,4,Lost
7754,639,16,44,2,3,3,8,Casual Users
7833,226,66,357,3,5,5,13,Loyal Users
7880,30,37,200,5,4,5,14,Champions
7982,1423,7,39,1,2,3,6,Lost
7993,123,43,84,4,4,4,12,Champions
8086,185,12,27,3,3,2,8,Loyal Users
8389,4841,5,7,1,1,1,3,Lost
8592,670,67,318,2,5,5,12,At Risk
8638,840,15,35,2,3,3,8,Casual Users
9376,124,21,36,4,3,3,10,Loyal Users
9427,377,6,9,3,1,1,5,Casual Users
9465,16,76,258,5,5,5,15,Champions
9852,12,19,64,5,3,4,12,Loyal Users
9900,824,7,10,2,2,1,5,Lost
10206,121,13,25,4,3,2,9,Loyal Users
10362,894,6,19,2,1,2,5,Lost
10623,439,7,16,3,2,2,7,Casual Users
10817,1439,9,9,1,2,1,4,Lost
11033,170,45,279,3,4,5,12,Loyal Users
11141,3615,6,13,1,1,1,3,Lost
11317,120,57,73,4,5,4,13,Champions
11458,128,18,40,4,3,3,10,Loyal Users
11748,82,36,142,4,4,4,12,Champions
11858,1950,16,27,1,3,2,6,Casual Users
12027,1769,16,46,1,3,3,7,Casual Users
12046,1905,8,22,1,2,2,5,Lost
12799,1168,10,18,2,2,2,6,Lost
12940,168,41,67,3,4,4,11,Loyal Users
13285,1170,15,57,2,3,3,8,Casual Users
13289,104,48,105,4,5,4,13,Champions
243,1140,12,20,2,3,2,7,Casual Users
392,21,58,141,5,5,4,14,Champions
540,807,6,11,2,1,1,4,Lost
623,108,19,159,4,3,5,12,Loyal Users
737,127,57,248,4,5,5,14,Champions
858,722,12,23,2,3,2,7,Casual Users
897,114,77,233,4,5,5,14,Champions
1025,300,13,73,3,3,4,10,Loyal Users
1084,835,20,115,2,3,4,9,Casual Users
1127,177,9,24,3,2,2,7,Casual Users
1395,286,68,203,3,5,5,13,Loyal Users
1460,361,7,28,3,2,2,7,Casual Users
1483,110,11,60,4,2,3,9,Promising
1507,177,39,67,3,4,4,11,Loyal Users
1522,1833,6,13,1,1,1,3,Lost
1721,2807,31,52,1,4,3,8,At Risk
1896,1447,10,58,1,2,3,6,Lost
1990,35,11,23,5,2,2,9,Promising
2235,28,19,87,5,3,4,12,Loyal Users
2387,146,51,178,4,5,5,14,Champions
2563,115,20,41,4,3,3,10,Loyal Users
2580,564,14,19,2,3,2,7,Casual Users
2811,79,29,63,4,4,4,12,Champions
2999,1405,11,42,1,2,3,6,Lost
3179,26,5,12,5,1,1,7,Promising
3226,421,6,11,3,1,1,5,Casual Users
3475,276,9,15,3,2,1,6,Casual Users
3698,1212,14,28,2,3,2,7,Casual Users
4158,186,15,65,3,3,4,10,Loyal Users
4161,1344,5,11,1,1,1,3,Lost
4190,2474,15,81,1,3,4,8,Casual Users
4219,158,11,30,4,2,2,8,Promising
4929,35,12,14,5,3,1,9,Loyal Users
5614,673,13,18,2,3,2,7,Casual Users
6393,303,34,70,3,4,4,11,Loyal Users
6623,32,80,481,5,5,5,15,Champions
6773,2310,20,88,1,3,4,8,Casual Users
7168,1819,15,94,1,3,4,8,Casual Users
7417,335,5,6,3,1,1,5,Casual Users
8105,9,142,507,5,5,5,15,Champions
8803,1122,32,102,2,4,4,10,At Risk
8928,349,51,65,3,5,4,12,Loyal Users
8932,32,74,337,5,5,5,15,Champions
9182,116,19,70,4,3,4,11,Loyal Users
9564,5,9,15,5,2,1,8,Promising
9879,61,127,781,5,5,5,15,Champions
10081,2488,34,255,1,4,5,10,At Risk
10121,1688,8,23,1,2,2,5,Lost
10230,429,5,5,3,1,1,5,Casual Users
10462,3148,18,37,1,3,3,7,Casual Users
10703,260,8,25,3,2,2,7,Casual Users
10914,1,66,129,5,5,4,14,Champions
11280,886,9,32,2,2,3,7,Lost
11316,1434,9,20,1,2,2,5,Lost
11500,849,5,15,2,1,1,4,Lost
11710,118,20,31,4,3,2,9,Loyal Users
12006,368,13,16,3,3,2,8,Loyal Users
12367,1230,5,7,2,1,1,4,Lost
12471,12,38,49,5,4,3,12,Loyal Users
12611,23,5,23,5,1,2,8,Promising
12626,277,7,8,3,2,1,6,Casual Users
12715,1363,8,12,1,2,1,4,Lost
13261,92,112,327,4,5,5,14,Champions
31,1052,19,29,2,3,2,7,Casual Users
516,105,16,17,4,3,2,9,Loyal Users
1139,264,54,249,3,5,5,13,Loyal Users
1143,8,5,10,5,1,1,7,Promising
1270,1734,12,13,1,3,1,5,Casual Users
1303,6,30,57,5,4,3,12,Loyal Users
1322,119,34,169,4,4,5,13,Champions
1339,6,18,94,5,3,4,12,Loyal Users
1352,1522,13,17,1,3,2,6,Casual Users
1618,74,92,170,4,5,5,14,Champions
1650,237,22,34,3,4,3,10,Loyal Users
1699,59,40,77,5,4,4,13,Champions
1903,278,19,58,3,3,3,9,Loyal Users
2393,3720,5,6,1,1,1,3,Lost
2572,1381,8,15,1,2,1,4,Lost
2711,4,103,607,5,5,5,15,Champions
2776,176,124,189,3,5,5,13,Loyal Users
2821,403,43,83,3,4,4,11,Loyal Users
2996,55,58,238,5,5,5,15,Champions
3000,713,8,14,2,2,1,5,Lost
3213,117,12,109,4,3,4,11,Loyal Users
3352,107,10,17,4,2,2,8,Promising
3488,450,17,58,3,3,3,9,Loyal Users
3704,535,5,13,2,1,1,4,Lost
3761,1165,9,17,2,2,2,6,Lost
4391,15,7,25,5,2,2,9,Promising
4489,1678,7,31,1,2,2,5,Lost
5071,304,16,45,3,3,3,9,Loyal Users
5117,5,40,115,5,4,4,13,Champions
5173,121,53,147,4,5,5,14,Champions
5287,312,6,10,3,1,1,5,Casual Users
5345,1030,9,10,2,2,1,5,Lost
5984,308,63,301,3,5,5,13,Loyal Users
6266,128,27,38,4,4,3,11,Loyal Users
6482,3165,36,45,1,4,3,8,At Risk
6559,415,30,211,3,4,5,12,Loyal Users
6622,409,13,62,3,3,3,9,Loyal Users
6825,39,6,27,5,1,2,8,Promising
7281,440,9,43,3,2,3,8,Casual Users
7387,694,6,47,2,1,3,6,Lost
7850,1832,9,113,1,2,4,7,Lost
7879,131,31,108,4,4,4,12,Champions
8222,1251,10,26,2,2,2,6,Lost
8257,100,42,142,4,4,4,12,Champions
8407,3623,6,79,1,1,4,6,Lost
8924,2869,6,19,1,1,2,4,Lost
9162,464,32,112,3,4,4,11,Loyal Users
9383,129,15,28,4,3,2,9,Loyal Users
9454,30,51,94,5,5,4,14,Champions
9517,259,25,55,3,4,3,10,Loyal Users
9558,1140,12,33,2,3,3,8,Casual Users
10708,198,15,16,3,3,2,8,Loyal Users
10798,80,28,66,4,4,4,12,Champions
10862,97,6,12,4,1,1,6,Promising
11025,2034,36,226,1,4,5,10,At Risk
11393,92,10,56,4,2,3,9,Promising
11639,1125,12,17,2,3,2,7,Casual Users
11800,1118,10,21,2,2,2,6,Lost
11936,4923,6,20,1,1,2,4,Lost
12139,1670,5,9,1,1,1,3,Lost
12393,173,85,256,3,5,5,13,Loyal Users
12998,2791,5,11,1,1,1,3,Lost
13009,33,93,376,5,5,5,15,Champions
13060,139,47,134,4,5,4,13,Champions
13207,305,38,88,3,4,4,11,Loyal Users
13483,89,5,6,4,1,1,6,Promising
85,3939,7,12,1,2,1,4,Lost
137,404,23,104,3,4,4,11,Loyal Users
251,67,6,9,5,1,1,7,Promising
451,1223,15,45,2,3,3,8,Casual Users
580,2835,5,29,1,1,2,4,Lost
808,137,8,23,4,2,2,8,Promising
1265,7,16,21,5,3,2,10,Loyal Users
1884,985,20,78,2,3,4,9,Casual Users
1975,1137,8,22,2,2,2,6,Lost
2025,55,13,71,5,3,4,12,Loyal Users
2231,1511,14,28,1,3,2,6,Casual Users
2259,155,34,341,4,4,5,13,Champions
2443,4368,10,11,1,2,1,4,Lost
2488,1158,15,51,2,3,3,8,Casual Users
2525,19,16,32,5,3,3,11,Loyal Users
2721,295,17,31,3,3,2,8,Loyal Users
2748,26,25,293,5,4,5,14,Champions
2923,1176,11,12,2,2,1,5,Lost
3089,57,22,166,5,4,5,14,Champions
3098,3790,8,13,1,2,1,4,Lost
3220,275,21,45,3,3,3,9,Loyal Users
3490,478,30,44,2,4,3,9,At Risk
3796,2730,13,19,1,3,2,6,Casual Users
3876,69,6,23,5,1,2,8,Promising
3986,365,14,20,3,3,2,8,Loyal Users
4042,1647,26,40,1,4,3,8,At Risk
4078,865,15,36,2,3,3,8,Casual Users
4186,158,83,235,4,5,5,14,Champions
4239,1569,15,53,1,3,3,7,Casual Users
4364,4402,5,31,1,1,2,4,Lost
4684,417,12,39,3,3,3,9,Loyal Users
4937,282,13,113,3,3,4,10,Loyal Users
5074,1955,9,62,1,2,3,6,Lost
5155,280,38,158,3,4,5,12,Loyal Users
5223,311,13,51,3,3,3,9,Loyal Users
5308,42,71,387,5,5,5,15,Champions
5482,409,9,9,3,2,1,6,Casual Users
6361,2,36,70,5,4,4,13,Champions
6597,5,16,82,5,3,4,12,Loyal Users
6598,92,8,15,4,2,1,7,Promising
7066,436,13,27,3,3,2,8,Loyal Users
7098,9,46,86,5,5,4,14,Champions
7120,581,16,26,2,3,2,7,Casual Users
7530,1004,12,49,2,3,3,8,Casual Users
7644,110,36,138,4,4,4,12,Champions
7910,114,11,38,4,2,3,9,Promising
8109,195,34,170,3,4,5,12,Loyal Users
8650,856,17,36,2,3,3,8,Casual Users
8743,96,21,81,4,3,4,11,Loyal Users
8779,6,57,89,5,5,4,14,Champions
8911,398,27,41,3,4,3,10,Loyal Users
9071,136,6,16,4,1,2,7,Promising
9169,411,16,46,3,3,3,9,Loyal Users
9946,177,37,188,3,4,5,12,Loyal Users
10468,1509,21,137,1,3,4,8,Casual Users
10745,0,113,343,5,5,5,15,Champions
10768,2168,12,143,1,3,4,8,Casual Users
11146,2323,6,18,1,1,2,4,Lost
11630,35,23,61,5,4,3,12,Loyal Users
11713,1538,9,12,1,2,1,4,Lost
12292,520,12,29,2,3,2,7,Casual Users
12366,2603,17,38,1,3,3,7,Casual Users
13188,2665,7,13,1,2,1,4,Lost
13465,893,5,19,2,1,2,5,Lost
13508,3570,27,34,1,4,3,8,At Risk
65,271,10,22,3,2,2,7,Casual Users
458,2,47,142,5,5,4,14,Champions
879,425,26,39,3,4,3,10,Loyal Users
883,8,9,20,5,2,2,9,Promising
1223,14,77,182,5,5,5,15,Champions
1977,1,31,93,5,4,4,13,Champions
2096,706,14,22,2,3,2,7,Casual Users
2249,86,14,29,4,3,2,9,Loyal Users
2392,3,61,135,5,5,4,14,Champions
2622,2,36,65,5,4,4,13,Champions
2655,233,39,223,3,4,5,12,Loyal Users
2656,165,57,189,4,5,5,14,Champions
2833,702,7,8,2,2,1,5,Lost
2924,3568,7,13,1,2,1,4,Lost
3377,507,6,8,2,1,1,4,Lost
3425,86,28,72,4,4,4,12,Champions
3561,95,92,153,4,5,5,14,Champions
3566,1158,56,124,2,5,4,11,At Risk
3834,809,43,72,2,4,4,10,At Risk
3913,670,45,199,2,4,5,11,At Risk
4000,274,5,22,3,1,2,6,Casual Users
4294,393,35,106,3,4,4,11,Loyal Users
4307,703,5,16,2,1,2,5,Lost
4383,244,11,13,3,2,1,6,Casual Users
4957,124,70,156,4,5,5,14,Champions
5157,150,19,56,4,3,3,10,Loyal Users
5217,29,31,167,5,4,5,14,Champions
5433,646,8,9,2,2,1,5,Lost
5513,0,20,49,5,3,3,11,Loyal Users
5578,1589,6,18,1,1,2,4,Lost
5682,396,8,15,3,2,1,6,Casual Users
5695,101,71,185,4,5,5,14,Champions
5697,140,67,108,4,5,4,13,Champions
5740,37,60,226,5,5,5,15,Champions
5907,688,11,13,2,2,1,5,Lost
6154,1,78,373,5,5,5,15,Champions
6301,210,19,98,3,3,4,10,Loyal Users
6500,3895,5,7,1,1,1,3,Lost
6934,676,6,26,2,1,2,5,Lost
6962,2153,23,66,1,4,4,9,At Risk
7152,75,47,174,4,5,5,14,Champions
7324,26,8,14,5,2,1,8,Promising
7333,91,6,8,4,1,1,6,Promising
7576,1571,12,42,1,3,3,7,Casual Users
7661,299,9,19,3,2,2,7,Casual Users
8211,53,10,28,5,2,2,9,Promising
8501,0,45,82,5,4,4,13,Champions
8577,127,8,40,4,2,3,9,Promising
8665,842,29,56,2,4,3,9,At Risk
8678,348,16,101,3,3,4,10,Loyal Users
8716,51,109,339,5,5,5,15,Champions
9153,838,9,13,2,2,1,5,Lost
9206,709,5,8,2,1,1,4,Lost
9403,128,41,173,4,4,5,13,Champions
9597,517,48,258,2,5,5,12,At Risk
9647,191,12,68,3,3,4,10,Loyal Users
9775,536,8,23,2,2,2,6,Lost
10032,237,45,268,3,4,5,12,Loyal Users
10395,846,11,23,2,2,2,6,Lost
10527,15,46,103,5,5,4,14,Champions
10567,2426,8,24,1,2,2,5,Lost
10632,1366,11,40,1,2,3,6,Lost
10788,730,16,104,2,3,4,9,Casual Users
10815,254,29,37,3,4,3,10,Loyal Users
10840,3182,6,30,1,1,2,4,Lost
11352,4880,7,23,1,2,2,5,Lost
11482,1264,13,36,1,3,3,7,Casual Users
11520,69,5,14,5,1,1,7,Promising
11745,127,17,32,4,3,3,10,Loyal Users
11928,527,43,308,2,4,5,11,At Risk
12210,1587,8,30,1,2,2,5,Lost
12249,573,15,19,2,3,2,7,Casual Users
12284,161,32,90,4,4,4,12,Champions
12322,3247,21,74,1,3,4,8,Casual Users
12607,102,54,103,4,5,4,13,Champions
13225,16,38,119,5,4,4,13,Champions
13329,1105,79,399,2,5,5,12,At Risk
13398,4763,6,8,1,1,1,3,Lost
13504,672,10,34,2,2,3,7,Lost
53,657,6,19,2,1,2,5,Lost
255,1420,5,6,1,1,1,3,Lost
481,133,20,56,4,3,3,10,Loyal Users
588,1655,7,12,1,2,1,4,Lost
799,317,15,22,3,3,2,8,Loyal Users
804,46,45,199,5,4,5,14,Champions
898,351,76,344,3,5,5,13,Loyal Users
970,2847,48,155,1,5,5,11,At Risk
1157,10,101,438,5,5,5,15,Champions
2027,143,44,110,4,4,4,12,Champions
2156,150,5,22,4,1,2,7,Promising
2247,408,58,147,3,5,5,13,Loyal Users
2559,1339,9,20,1,2,2,5,Lost
2802,2266,7,11,1,2,1,4,Lost
2914,1105,15,15,2,3,1,6,Casual Users
3028,424,12,75,3,3,4,10,Loyal Users
3042,447,16,124,3,3,4,10,Loyal Users
3105,145,9,13,4,2,1,7,Promising
3631,1213,8,26,2,2,2,6,Lost
3790,2538,16,16,1,3,2,6,Casual Users
4092,210,35,64,3,4,4,11,Loyal Users
4357,119,36,87,4,4,4,12,Champions
4477,259,11,30,3,2,2,7,Casual Users
5110,217,18,33,3,3,3,9,Loyal Users
5527,158,8,24,4,2,2,8,Promising
5847,9,32,213,5,4,5,14,Champions
5995,618,40,231,2,4,5,11,At Risk
6176,381,7,12,3,2,1,6,Casual Users
6396,833,29,101,2,4,4,10,At Risk
6552,1644,12,46,1,3,3,7,Casual Users
6722,15,35,173,5,4,5,14,Champions
6832,1,41,136,5,4,4,13,Champions
6864,362,20,35,3,3,3,9,Loyal Users
6866,3254,12,24,1,3,2,6,Casual Users
6890,113,22,69,4,4,4,12,Champions
6937,27,61,112,5,5,4,14,Champions
7109,2,52,100,5,5,4,14,Champions
7404,1685,11,33,1,2,3,6,Lost
7567,101,21,64,4,3,4,11,Loyal Users
7584,29,20,123,5,3,4,12,Loyal Users
7810,4,5,13,5,1,1,7,Promising
7892,96,74,258,4,5,5,14,Champions
7987,1960,6,79,1,1,4,6,Lost
8229,582,10,52,2,2,3,7,Lost
8701,130,12,16,4,3,2,9,Loyal Users
9181,124,16,62,4,3,3,10,Loyal Users
9344,7,93,278,5,5,5,15,Champions
9575,0,12,30,5,3,2,10,Loyal Users
9675,17,66,251,5,5,5,15,Champions
9914,18,126,243,5,5,5,15,Champions
10090,445,9,10,3,2,1,6,Casual Users
10257,49,109,579,5,5,5,15,Champions
10264,30,63,284,5,5,5,15,Champions
10416,266,37,199,3,4,5,12,Loyal Users
10597,293,92,339,3,5,5,13,Loyal Users
10786,211,79,248,3,5,5,13,Loyal Users
11143,0,94,257,5,5,5,15,Champions
11243,1786,5,30,1,1,2,4,Lost
12184,59,73,251,5,5,5,15,Champions
12207,13,42,171,5,4,5,14,Champions
12264,347,29,131,3,4,4,11,Loyal Users
12694,276,10,71,3,2,4,9,Casual Users
13468,17,14,29,5,3,2,10,Loyal Users
13500,92,60,86,4,5,4,13,Champions
133,1284,26,65,1,4,4,9,At Risk
296,2046,6,9,1,1,1,3,Lost
472,105,16,51,4,3,3,10,Loyal Users
853,379,7,14,3,2,1,6,Casual Users
1466,30,5,12,5,1,1,7,Promising
1718,133,126,249,4,5,5,14,Champions
1766,35,132,352,5,5,5,15,Champions
1787,5,14,44,5,3,3,11,Loyal Users
1888,859,13,20,2,3,2,7,Casual Users
2035,152,54,171,4,5,5,14,Champions
2238,90,51,135,4,5,4,13,Champions
2542,33,36,51,5,4,3,12,Loyal Users
2874,13,53,128,5,5,4,14,Champions
3062,118,11,39,4,2,3,9,Promising
3242,415,12,14,3,3,1,7,Loyal Users
3306,268,18,31,3,3,2,8,Loyal Users
3691,117,16,24,4,3,2,9,Loyal Users
4097,222,23,55,3,4,3,10,Loyal Users
4291,2423,6,22,1,1,2,4,Lost
4396,1507,6,6,1,1,1,3,Lost
4583,423,53,82,3,5,4,12,Loyal Users
4612,984,9,14,2,2,1,5,Lost
4799,2,99,537,5,5,5,15,Champions
4838,96,35,87,4,4,4,12,Champions
4859,492,5,18,2,1,2,5,Lost
5061,2304,6,14,1,1,1,3,Lost
5100,1952,5,6,1,1,1,3,Lost
5140,81,67,228,4,5,5,14,Champions
5178,125,14,24,4,3,2,9,Loyal Users
5670,125,37,82,4,4,4,12,Champions
5929,4160,6,7,1,1,1,3,Lost
6010,1240,7,24,2,2,2,6,Lost
6376,33,84,167,5,5,5,15,Champions
6557,32,89,286,5,5,5,15,Champions
7206,0,44,172,5,4,5,14,Champions
7222,834,5,10,2,1,1,4,Lost
7736,92,28,61,4,4,3,11,Loyal Users
8249,841,8,16,2,2,2,6,Lost
8409,2,30,40,5,4,3,12,Loyal Users
8450,548,9,27,2,2,2,6,Lost
8482,1,81,132,5,5,4,14,Champions
8534,313,83,303,3,5,5,13,Loyal Users
8612,115,6,22,4,1,2,7,Promising
8640,105,48,124,4,5,4,13,Champions
8857,1440,5,22,1,1,2,4,Lost
8927,423,5,7,3,1,1,5,Casual Users
8950,82,86,427,4,5,5,14,Champions
9338,71,63,195,4,5,5,14,Champions
9475,254,50,132,3,5,4,12,Loyal Users
9721,116,51,413,4,5,5,14,Champions
10013,3285,9,15,1,2,1,4,Lost
10128,127,44,212,4,4,5,13,Champions
10605,1705,14,29,1,3,2,6,Casual Users
10611,432,25,117,3,4,4,11,Loyal Users
10882,6,74,405,5,5,5,15,Champions
11014,58,38,223,5,4,5,14,Champions
11287,107,34,83,4,4,4,12,Champions
11402,482,20,24,2,3,2,7,Casual Users
11459,2089,11,14,1,2,1,4,Lost
11487,723,10,37,2,2,3,7,Lost
11550,697,14,48,2,3,3,8,Casual Users
12260,788,49,94,2,5,4,11,At Risk
12530,366,12,49,3,3,3,9,Loyal Users
12717,106,52,102,4,5,4,13,Champions
13313,238,64,240,3,5,5,13,Loyal Users
13544,740,6,7,2,1,1,4,Lost
78,3,27,125,5,4,4,13,Champions
322,108,39,152,4,4,5,13,Champions
513,127,8,16,4,2,2,8,Promising
918,714,16,19,2,3,2,7,Casual Users
1005,1098,15,74,2,3,4,9,Casual Users
1016,980,17,33,2,3,3,8,Casual Users
1133,156,33,336,4,4,5,13,Champions
1808,1676,6,21,1,1,2,4,Lost
2396,2,54,207,5,5,5,15,Champions
2848,597,5,24,2,1,2,5,Lost
3577,422,13,45,3,3,3,9,Loyal Users
3657,124,23,51,4,4,3,11,Loyal Users
3703,995,5,5,2,1,1,4,Lost
4167,968,8,12,2,2,1,5,Lost
4531,1013,8,10,2,2,1,5,Lost
4624,128,11,34,4,2,3,9,Promising
4697,130,77,289,4,5,5,14,Champions
5030,2119,7,25,1,2,2,5,Lost
5211,720,6,21,2,1,2,5,Lost
5457,434,8,12,3,2,1,6,Casual Users
5692,1133,12,56,2,3,3,8,Casual Users
5867,531,47,136,2,5,4,11,At Risk
5920,6,6,9,5,1,1,7,Promising
5949,1449,5,8,1,1,1,3,Lost
6082,430,17,26,3,3,2,8,Loyal Users
6142,165,18,40,4,3,3,10,Loyal Users
6378,2370,6,18,1,1,2,4,Lost
6678,84,9,24,4,2,2,8,Promising
6911,3943,6,34,1,1,3,5,Lost
7283,1410,16,55,1,3,3,7,Casual Users
7912,83,46,94,4,5,4,13,Champions
8051,1983,12,15,1,3,1,5,Casual Users
8145,116,41,94,4,4,4,12,Champions
8146,365,6,7,3,1,1,5,Casual Users
8231,3278,9,10,1,2,1,4,Lost
8627,35,58,286,5,5,5,15,Champions
8664,13,26,59,5,4,3,12,Loyal Users
8845,267,6,25,3,1,2,6,Casual Users
9018,570,6,7,2,1,1,4,Lost
9258,274,32,60,3,4,3,10,Loyal Users
9433,410,58,117,3,5,4,12,Loyal Users
9470,530,12,54,2,3,3,8,Casual Users
9731,5086,5,20,1,1,2,4,Lost
9867,5677,5,33,1,1,3,5,Lost
9925,700,14,20,2,3,2,7,Casual Users
10143,961,12,52,2,3,3,8,Casual Users
10183,288,19,41,3,3,3,9,Loyal Users
10267,651,20,54,2,3,3,8,Casual Users
10366,35,40,119,5,4,4,13,Champions
10443,423,13,15,3,3,1,7,Loyal Users
10530,92,19,46,4,3,3,10,Loyal Users
10532,136,51,153,4,5,5,14,Champions
10558,132,33,35,4,4,3,11,Loyal Users
10947,1946,15,41,1,3,3,7,Casual Users
11024,92,82,197,4,5,5,14,Champions
11194,775,8,57,2,2,3,7,Lost
11894,709,15,60,2,3,3,8,Casual Users
12118,155,29,108,4,4,4,12,Champions
12238,130,20,43,4,3,3,10,Loyal Users
12344,89,9,9,4,2,1,7,Promising
12559,132,128,534,4,5,5,14,Champions
12723,5,120,204,5,5,5,15,Champions
12727,474,12,24,2,3,2,7,Casual Users
12757,91,94,857,4,5,5,14,Champions
321,10,59,90,5,5,4,14,Champions
362,138,20,39,4,3,3,10,Loyal Users
613,3687,20,54,1,3,3,7,Casual Users
633,292,24,76,3,4,4,11,Loyal Users
673,167,65,299,3,5,5,13,Loyal Users
857,5247,6,34,1,1,3,5,Lost
961,297,20,33,3,3,3,9,Loyal Users
974,155,13,21,4,3,2,9,Loyal Users
1160,677,10,23,2,2,2,6,Lost
1533,287,16,30,3,3,2,8,Loyal Users
2479,3991,5,5,1,1,1,3,Lost
2564,3807,5,17,1,1,2,4,Lost
2625,13,59,119,5,5,4,14,Champions
2971,233,35,135,3,4,4,11,Loyal Users
3087,155,18,43,4,3,3,10,Loyal Users
3149,7,29,48,5,4,3,12,Loyal Users
4061,98,22,90,4,4,4,12,Champions
4119,667,58,149,2,5,5,12,At Risk
4126,434,19,31,3,3,2,8,Loyal Users
4259,154,19,36,4,3,3,10,Loyal Users
4512,1859,8,8,1,2,1,4,Lost
4725,429,12,26,3,3,2,8,Loyal Users
5222,1868,11,20,1,2,2,5,Lost
5251,123,48,142,4,5,4,13,Champions
5427,1350,7,15,1,2,1,4,Lost
5529,1844,33,82,1,4,4,9,At Risk
5543,34,97,415,5,5,5,15,Champions
5934,2503,9,30,1,2,2,5,Lost
6108,345,48,76,3,5,4,12,Loyal Users
6145,247,32,52,3,4,3,10,Loyal Users
6237,606,21,36,2,3,3,8,Casual Users
6939,391,33,138,3,4,4,11,Loyal Users
7131,1039,20,40,2,3,3,8,Casual Users
7169,25,25,53,5,4,3,12,Loyal Users
7817,184,30,71,3,4,4,11,Loyal Users
8042,1427,6,11,1,1,1,3,Lost
8085,56,96,208,5,5,5,15,Champions
8628,5307,5,25,1,1,2,4,Lost
9035,138,44,116,4,4,4,12,Champions
9324,443,12,101,3,3,4,10,Loyal Users
9488,984,5,14,2,1,1,4,Lost
9898,22,130,351,5,5,5,15,Champions
10022,30,73,189,5,5,5,15,Champions
10195,425,40,98,3,4,4,11,Loyal Users
10293,7,65,346,5,5,5,15,Champions
10303,5,125,693,5,5,5,15,Champions
10435,948,26,52,2,4,3,9,At Risk
10912,2128,13,80,1,3,4,8,Casual Users
11405,5,14,18,5,3,2,10,Loyal Users
11468,988,29,52,2,4,3,9,At Risk
12085,1330,18,18,1,3,2,6,Casual Users
12315,3735,7,43,1,2,3,6,Lost
12401,3274,7,16,1,2,2,5,Lost
12436,91,14,270,4,3,5,12,Loyal Users
12523,107,5,8,4,1,1,6,Promising
13022,15,20,81,5,3,4,12,Loyal Users
13214,0,99,538,5,5,5,15,Champions
13528,246,6,13,3,1,1,5,Casual Users
375,145,17,45,4,3,3,10,Loyal Users
593,109,89,284,4,5,5,14,Champions
597,1174,44,83,2,4,4,10,At Risk
876,368,12,42,3,3,3,9,Loyal Users
976,997,7,36,2,2,3,7,Lost
1199,699,7,28,2,2,2,6,Lost
1212,439,6,14,3,1,1,5,Casual Users
1417,548,17,50,2,3,3,8,Casual Users
1468,896,9,22,2,2,2,6,Lost
1653,520,33,52,2,4,3,9,At Risk
1743,526,41,87,2,4,4,10,At Risk
2173,1142,18,46,2,3,3,8,Casual Users
2513,1707,6,13,1,1,1,3,Lost
2797,965,9,13,2,2,1,5,Lost
2835,736,39,176,2,4,5,11,At Risk
3441,2407,24,50,1,4,3,8,At Risk
3601,244,64,311,3,5,5,13,Loyal Users
4182,41,20,87,5,3,4,12,Loyal Users
4401,23,71,166,5,5,5,15,Champions
4474,98,26,127,4,4,4,12,Champions
4713,747,10,19,2,2,2,6,Lost
4762,141,19,22,4,3,2,9,Loyal Users
4782,97,178,267,4,5,5,14,Champions
4796,276,25,62,3,4,3,10,Loyal Users
4798,708,5,13,2,1,1,4,Lost
4923,1694,9,30,1,2,2,5,Lost
5235,586,27,34,2,4,3,9,At Risk
5298,2135,9,63,1,2,4,7,Lost
5375,305,19,40,3,3,3,9,Loyal Users
5383,586,23,60,2,4,3,9,At Risk
5571,189,69,395,3,5,5,13,Loyal Users
5916,1590,19,39,1,3,3,7,Casual Users
6157,3460,10,18,1,2,2,5,Lost
6188,408,10,27,3,2,2,7,Casual Users
6689,2022,28,46,1,4,3,8,At Risk
6732,3518,6,13,1,1,1,3,Lost
6913,4029,14,19,1,3,2,6,Casual Users
7092,170,19,32,3,3,3,9,Loyal Users
7132,3,21,85,5,3,4,12,Loyal Users
7342,580,15,32,2,3,3,8,Casual Users
7726,5984,7,8,1,2,1,4,Lost
8350,2687,13,35,1,3,3,7,Casual Users
9006,1,71,150,5,5,5,15,Champions
9730,5534,30,30,1,4,2,7,At Risk
9968,5,28,96,5,4,4,13,Champions
11452,683,23,75,2,4,4,10,At Risk
11478,9,23,48,5,4,3,12,Loyal Users
11589,8,76,134,5,5,4,14,Champions
11609,0,29,73,5,4,4,13,Champions
11642,2148,7,9,1,2,1,4,Lost
11885,2005,5,5,1,1,1,3,Lost
11954,5,6,12,5,1,1,7,Promising
12007,217,7,15,3,2,1,6,Casual Users
12008,70,6,8,4,1,1,6,Promising
12014,1684,8,13,1,2,1,4,Lost
12169,112,34,90,4,4,4,12,Champions
12336,1300,31,46,1,4,3,8,At Risk
13003,91,20,84,4,3,4,11,Loyal Users
13046,173,25,39,3,4,3,10,Loyal Users
13172,52,9,50,5,2,3,10,Promising
13288,146,23,253,4,4,5,13,Champions
13494,689,8,8,2,2,1,5,Lost
13516,649,54,165,2,5,5,12,At Risk
108,3,62,215,5,5,5,15,Champions
155,1592,20,23,1,3,2,6,Casual Users
683,304,13,21,3,3,2,8,Loyal Users
744,83,71,225,4,5,5,14,Champions
950,3428,9,11,1,2,1,4,Lost
1331,32,74,248,5,5,5,15,Champions
1525,931,19,22,2,3,2,7,Casual Users
1561,240,25,36,3,4,3,10,Loyal Users
1700,30,17,66,5,3,4,12,Loyal Users
1863,571,29,84,2,4,4,10,At Risk
2294,1544,5,7,1,1,1,3,Lost
2606,47,84,140,5,5,4,14,Champions
2739,130,7,7,4,2,1,7,Promising
3124,2795,6,17,1,1,2,4,Lost
3431,1398,9,45,1,2,3,6,Lost
3436,691,6,14,2,1,1,4,Lost
3661,397,69,141,3,5,4,12,Loyal Users
3843,969,5,5,2,1,1,4,Lost
3844,540,26,36,2,4,3,9,At Risk
4418,155,65,217,4,5,5,14,Champions
4452,1118,9,9,2,2,1,5,Lost
4773,83,13,25,4,3,2,9,Loyal Users
5605,13,34,141,5,4,4,13,Champions
5771,257,5,41,3,1,3,7,Casual Users
5827,23,76,410,5,5,5,15,Champions
5962,48,183,896,5,5,5,15,Champions
6213,10,86,278,5,5,5,15,Champions
6754,4128,5,6,1,1,1,3,Lost
7202,442,17,151,3,3,5,11,Loyal Users
7218,1272,8,39,1,2,3,6,Lost
7359,1297,16,25,1,3,2,6,Casual Users
7481,274,23,49,3,4,3,10,Loyal Users
7497,1543,10,69,1,2,4,7,Lost
7571,2787,12,34,1,3,3,7,Casual Users
7865,255,31,127,3,4,4,11,Loyal Users
8003,1034,6,10,2,1,1,4,Lost
8423,822,9,38,2,2,3,7,Lost
8458,412,30,94,3,4,4,11,Loyal Users
8755,1379,29,42,1,4,3,8,At Risk
8935,587,24,152,2,4,5,11,At Risk
9097,439,34,98,3,4,4,11,Loyal Users
9405,131,20,131,4,3,4,11,Loyal Users
9435,973,59,83,2,5,4,11,At Risk
9492,392,22,44,3,4,3,10,Loyal Users
9640,82,50,133,4,5,4,13,Champions
10162,1264,8,14,1,2,1,4,Lost
10715,8,99,385,5,5,5,15,Champions
10898,576,10,12,2,2,1,5,Lost
11059,23,53,302,5,5,5,15,Champions
11121,48,44,703,5,4,5,14,Champions
11327,1833,26,53,1,4,3,8,At Risk
11911,849,12,61,2,3,3,8,Casual Users
12182,102,55,110,4,5,4,13,Champions
12384,225,12,17,3,3,2,8,Loyal Users
12542,132,33,147,4,4,5,13,Champions
12943,441,13,27,3,3,2,8,Loyal Users
34,70,85,337,4,5,5,14,Champions
193,229,42,153,3,4,5,12,Loyal Users
211,21,17,27,5,3,2,10,Loyal Users
368,4555,5,6,1,1,1,3,Lost
530,440,34,59,3,4,3,10,Loyal Users
642,102,44,106,4,4,4,12,Champions
796,126,11,15,4,2,1,7,Promising
1068,665,5,13,2,1,1,4,Lost
1198,1454,16,27,1,3,2,6,Casual Users
1344,28,14,28,5,3,2,10,Loyal Users
1404,531,9,11,2,2,1,5,Lost
1537,1005,7,9,2,2,1,5,Lost
1675,12,119,458,5,5,5,15,Champions
1924,150,13,59,4,3,3,10,Loyal Users
2200,5,15,54,5,3,3,11,Loyal Users
2225,6,23,83,5,4,4,13,Champions
2663,1416,6,6,1,1,1,3,Lost
2888,431,32,35,3,4,3,10,Loyal Users
3152,2566,6,6,1,1,1,3,Lost
3235,270,5,19,3,1,2,6,Casual Users
4132,1100,5,6,2,1,1,4,Lost
4172,564,18,50,2,3,3,8,Casual Users
4263,238,9,29,3,2,2,7,Casual Users
4321,157,7,16,4,2,2,8,Promising
4517,1568,9,48,1,2,3,6,Lost
5038,122,5,7,4,1,1,6,Promising
5367,31,114,413,5,5,5,15,Champions
5417,284,7,17,3,2,2,7,Casual Users
6005,636,12,27,2,3,2,7,Casual Users
6124,31,23,48,5,4,3,12,Loyal Users
6204,3755,9,57,1,2,3,6,Lost
6639,711,7,11,2,2,1,5,Lost
7103,696,5,6,2,1,1,4,Lost
7499,279,22,37,3,4,3,10,Loyal Users
7562,109,45,263,4,4,5,13,Champions
7587,3149,27,43,1,4,3,8,At Risk
7647,408,7,11,3,2,1,6,Casual Users
8011,56,65,446,5,5,5,15,Champions
8172,4,40,55,5,4,3,12,Loyal Users
8354,271,10,12,3,2,1,6,Casual Users
8396,93,35,177,4,4,5,13,Champions
8429,393,5,18,3,1,2,6,Casual Users
8464,1036,11,20,2,2,2,6,Lost
8961,136,20,64,4,3,4,11,Loyal Users
9209,424,36,129,3,4,4,11,Loyal Users
9562,1,56,148,5,5,5,15,Champions
9641,10,67,213,5,5,5,15,Champions
10168,25,80,519,5,5,5,15,Champions
10241,25,15,36,5,3,3,11,Loyal Users
10290,144,17,78,4,3,4,11,Loyal Users
10334,1114,16,39,2,3,3,8,Casual Users
10371,147,6,47,4,1,3,8,Promising
11057,2954,6,6,1,1,1,3,Lost
11183,382,22,73,3,4,4,11,Loyal Users
11333,1293,11,14,1,2,1,4,Lost
11346,270,17,28,3,3,2,8,Loyal Users
11450,2264,9,38,1,2,3,6,Lost
11578,108,12,21,4,3,2,9,Loyal Users
11627,160,15,42,4,3,3,10,Loyal Users
11835,1419,16,75,1,3,4,8,Casual Users
11876,146,23,59,4,4,3,11,Loyal Users
11897,1545,6,9,1,1,1,3,Lost
11909,674,114,251,2,5,5,12,At Risk
11941,315,8,10,3,2,1,6,Casual Users
12080,2110,52,127,1,5,4,10,At Risk
12179,23,23,42,5,4,3,12,Loyal Users
12355,3542,13,29,1,3,2,6,Casual Users
12494,616,54,362,2,5,5,12,At Risk
12566,238,37,140,3,4,4,11,Loyal Users
12755,279,10,21,3,2,2,7,Casual Users
12782,145,28,42,4,4,3,11,Loyal Users
12796,360,11,15,3,2,1,6,Casual Users
12837,95,8,10,4,2,1,7,Promising
12854,155,11,20,4,2,2,8,Promising
13066,3352,6,50,1,1,3,5,Lost
13170,7,76,133,5,5,4,14,Champions
13368,547,11,22,2,2,2,6,Lost
101,128,81,157,4,5,5,14,Champions
115,157,32,73,4,4,4,12,Champions
126,10,131,446,5,5,5,15,Champions
756,1780,5,20,1,1,2,4,Lost
772,4566,10,22,1,2,2,5,Lost
1165,53,89,235,5,5,5,15,Champions
1183,284,5,14,3,1,1,5,Casual Users
1378,2204,8,32,1,2,3,6,Lost
1500,1155,6,12,2,1,1,4,Lost
1745,406,7,12,3,2,1,6,Casual Users
1823,1296,13,56,1,3,3,7,Casual Users
2003,5,75,216,5,5,5,15,Champions
2261,174,44,108,3,4,4,11,Loyal Users
2342,146,15,22,4,3,2,9,Loyal Users
2771,2009,11,40,1,2,3,6,Lost
2907,151,52,293,4,5,5,14,Champions
3043,120,165,489,4,5,5,14,Champions
3198,1155,9,19,2,2,2,6,Lost
4153,742,6,8,2,1,1,4,Lost
4181,737,22,66,2,4,4,10,At Risk
4415,380,33,190,3,4,5,12,Loyal Users
4683,1379,32,72,1,4,4,9,At Risk
4865,73,71,588,4,5,5,14,Champions
4917,2131,9,9,1,2,1,4,Lost
4992,65,48,106,5,5,4,14,Champions
5597,48,51,317,5,5,5,15,Champions
5918,1122,10,41,2,2,3,7,Lost
5926,2441,12,37,1,3,3,7,Casual Users
6056,130,11,35,4,2,3,9,Promising
6419,20,66,153,5,5,5,15,Champions
6737,63,11,12,5,2,1,8,Promising
6933,3616,6,37,1,1,3,5,Lost
7118,680,6,17,2,1,2,5,Lost
7173,1411,32,57,1,4,3,8,At Risk
7602,265,46,98,3,5,4,12,Loyal Users
7744,273,44,125,3,4,4,11,Loyal Users
8442,676,42,83,2,4,4,10,At Risk
8536,1,44,170,5,4,5,14,Champions
8689,1149,18,53,2,3,3,8,Casual Users
8776,17,35,65,5,4,4,13,Champions
8887,86,6,23,4,1,2,7,Promising
9957,74,33,178,4,4,5,13,Champions
10018,5,53,94,5,5,4,14,Champions
10180,407,21,50,3,3,3,9,Loyal Users
10626,21,8,25,5,2,2,9,Promising
11106,59,32,46,5,4,3,12,Loyal Users
11119,4287,14,37,1,3,3,7,Casual Users
11174,80,12,67,4,3,4,11,Loyal Users
11708,567,18,108,2,3,4,9,Casual Users
11808,118,29,104,4,4,4,12,Champions
12127,748,5,5,2,1,1,4,Lost
12267,73,144,278,4,5,5,14,Champions
12362,5134,9,9,1,2,1,4,Lost
13220,2943,12,33,1,3,3,7,Casual Users
13377,101,74,207,4,5,5,14,Champions
81,139,24,40,4,4,3,11,Loyal Users
385,9,108,199,5,5,5,15,Champions
830,1118,22,119,2,4,4,10,At Risk
847,424,29,85,3,4,4,11,Loyal Users
874,152,16,55,4,3,3,10,Loyal Users
939,117,28,56,4,4,3,11,Loyal Users
1226,125,9,16,4,2,2,8,Promising
1259,948,13,117,2,3,4,9,Casual Users
1869,252,52,125,3,5,4,12,Loyal Users
2007,847,9,9,2,2,1,5,Lost
2212,3391,28,29,1,4,2,7,At Risk
2484,388,14,30,3,3,2,8,Loyal Users
2662,566,13,38,2,3,3,8,Casual Users
3008,27,17,25,5,3,2,10,Loyal Users
3026,63,101,225,5,5,5,15,Champions
3313,159,16,38,4,3,3,10,Loyal Users
3538,132,102,653,4,5,5,14,Champions
3611,5,54,188,5,5,5,15,Champions
3936,715,20,29,2,3,2,7,Casual Users
4088,212,8,36,3,2,3,8,Casual Users
4169,71,50,80,4,5,4,13,Champions
4293,91,6,12,4,1,1,6,Promising
4637,1410,8,11,1,2,1,4,Lost
4896,1416,11,18,1,2,2,5,Lost
5055,64,176,667,5,5,5,15,Champions
5151,1575,10,13,1,2,1,4,Lost
5254,566,17,53,2,3,3,8,Casual Users
5447,5854,8,11,1,2,1,4,Lost
5452,5,90,209,5,5,5,15,Champions
5490,1038,8,11,2,2,1,5,Lost
5585,1932,5,7,1,1,1,3,Lost
5699,405,31,135,3,4,4,11,Loyal Users
5785,94,181,390,4,5,5,14,Champions
6460,38,74,576,5,5,5,15,Champions
6664,4011,35,40,1,4,3,8,At Risk
6741,75,112,352,4,5,5,14,Champions
6953,88,24,63,4,4,4,12,Champions
7048,102,7,8,4,2,1,7,Promising
7331,2038,10,27,1,2,2,5,Lost
7533,67,32,57,5,4,3,12,Loyal Users
7550,98,15,26,4,3,2,9,Loyal Users
7604,6,119,342,5,5,5,15,Champions
7649,10,17,91,5,3,4,12,Loyal Users
7666,130,6,37,4,1,3,8,Promising
8001,2845,5,11,1,1,1,3,Lost
8243,85,8,8,4,2,1,7,Promising
8325,29,171,363,5,5,5,15,Champions
8352,345,38,111,3,4,4,11,Loyal Users
8412,2610,5,12,1,1,1,3,Lost
8654,849,6,12,2,1,1,4,Lost
8681,1541,7,51,1,2,3,6,Lost
8698,255,70,123,3,5,4,12,Loyal Users
8977,78,57,71,4,5,4,13,Champions
9217,32,5,15,5,1,1,7,Promising
9255,2272,22,60,1,4,3,8,At Risk
9293,565,10,12,2,2,1,5,Lost
9416,1837,9,22,1,2,2,5,Lost
10096,981,6,7,2,1,1,4,Lost
10272,1433,12,20,1,3,2,6,Casual Users
10422,17,35,139,5,4,4,13,Champions
10587,938,6,10,2,1,1,4,Lost
10727,993,12,37,2,3,3,8,Casual Users
10994,223,18,61,3,3,3,9,Loyal Users
11072,1271,55,241,1,5,5,11,At Risk
11234,98,17,78,4,3,4,11,Loyal Users
11286,113,16,80,4,3,4,11,Loyal Users
11541,97,7,13,4,2,1,7,Promising
11672,88,88,410,4,5,5,14,Champions
11912,570,11,78,2,2,4,8,Lost
12287,844,7,25,2,2,2,6,Lost
12328,1247,5,13,2,1,1,4,Lost
12447,1151,12,59,2,3,3,8,Casual Users
13027,270,13,37,3,3,3,9,Loyal Users
13054,443,7,15,3,2,1,6,Casual Users
13109,407,5,8,3,1,1,5,Casual Users
28,6,35,114,5,4,4,13,Champions
183,1830,5,5,1,1,1,3,Lost
210,857,89,372,2,5,5,12,At Risk
436,14,16,41,5,3,3,11,Loyal Users
1031,3124,8,13,1,2,1,4,Lost
1175,262,24,52,3,4,3,10,Loyal Users
1201,87,21,29,4,3,2,9,Loyal Users
1426,422,13,16,3,3,2,8,Loyal Users
1441,722,18,25,2,3,2,7,Casual Users
1496,14,20,26,5,3,2,10,Loyal Users
1892,123,48,81,4,5,4,13,Champions
2052,264,28,181,3,4,5,12,Loyal Users
2079,433,9,15,3,2,1,6,Casual Users
2180,313,37,74,3,4,4,11,Loyal Users
2209,5,67,82,5,5,4,14,Champions
2313,223,5,9,3,1,1,5,Casual Users
2463,307,23,32,3,4,3,10,Loyal Users
2522,1167,17,51,2,3,3,8,Casual Users
2683,1838,9,21,1,2,2,5,Lost
3234,136,34,60,4,4,3,11,Loyal Users
3445,115,11,22,4,2,2,8,Promising
3685,846,9,18,2,2,2,6,Lost
3841,5442,16,26,1,3,2,6,Casual Users
4208,994,8,24,2,2,2,6,Lost
4326,263,32,195,3,4,5,12,Loyal Users
4443,420,46,109,3,5,4,12,Loyal Users
4918,5,22,54,5,4,3,12,Loyal Users
4958,1133,12,28,2,3,2,7,Casual Users
5152,3026,10,17,1,2,2,5,Lost
5936,6,78,196,5,5,5,15,Champions
5961,1512,12,17,1,3,2,6,Casual Users
5981,1424,41,84,1,4,4,9,At Risk
6095,882,23,202,2,4,5,11,At Risk
6319,433,12,42,3,3,3,9,Loyal Users
7188,75,94,579,4,5,5,14,Champions
7325,740,12,32,2,3,3,8,Casual Users
7460,11,50,254,5,5,5,15,Champions
7522,125,8,14,4,2,1,7,Promising
7599,106,5,6,4,1,1,6,Promising
7613,298,18,85,3,3,4,10,Loyal Users
7800,409,10,15,3,2,1,6,Casual Users
7818,121,126,408,4,5,5,14,Champions
7935,1019,5,7,2,1,1,4,Lost
8116,1619,6,58,1,1,3,5,Lost
8478,2478,8,9,1,2,1,4,Lost
8514,403,9,64,3,2,4,9,Casual Users
8827,88,24,65,4,4,4,12,Champions
8976,0,28,75,5,4,4,13,Champions
8999,123,63,111,4,5,4,13,Champions
9207,143,37,134,4,4,4,12,Champions
9384,329,21,51,3,3,3,9,Loyal Users
9441,196,104,170,3,5,5,13,Loyal Users
9450,92,62,266,4,5,5,14,Champions
9714,1654,65,671,1,5,5,11,At Risk
9781,773,7,12,2,2,1,5,Lost
9926,99,11,29,4,2,2,8,Promising
10011,405,8,19,3,2,2,7,Casual Users
10075,12,22,29,5,4,2,11,Loyal Users
10234,862,28,121,2,4,4,10,At Risk
10254,6022,6,8,1,1,1,3,Lost
10295,11,141,436,5,5,5,15,Champions
10345,0,111,326,5,5,5,15,Champions
10414,126,58,199,4,5,5,14,Champions
10502,2287,5,7,1,1,1,3,Lost
10651,68,10,52,5,2,3,10,Promising
10979,142,27,64,4,4,4,12,Champions
11103,3707,6,15,1,1,1,3,Lost
11237,2537,9,15,1,2,1,4,Lost
11467,391,27,68,3,4,4,11,Loyal Users
11558,6055,5,10,1,1,1,3,Lost
11571,105,51,340,4,5,5,14,Champions
11838,379,40,54,3,4,3,10,Loyal Users
12030,2262,10,16,1,2,2,5,Lost
12055,2312,7,10,1,2,1,4,Lost
12077,35,38,109,5,4,4,13,Champions
12961,4238,9,14,1,2,1,4,Lost
13045,109,9,14,4,2,1,7,Promising
13195,75,7,38,4,2,3,9,Promising
497,276,44,71,3,4,4,11,Loyal Users
596,508,17,169,2,3,5,10,Casual Users
762,135,46,157,4,5,5,14,Champions
1051,858,6,8,2,1,1,4,Lost
1243,8,64,214,5,5,5,15,Champions
1274,18,19,104,5,3,4,12,Loyal Users
1296,2531,100,352,1,5,5,11,At Risk
1415,514,12,25,2,3,2,7,Casual Users
1510,383,20,81,3,3,4,10,Loyal Users
1621,3837,6,11,1,1,1,3,Lost
2018,181,53,157,3,5,5,13,Loyal Users
2044,1888,5,5,1,1,1,3,Lost
2355,407,54,96,3,5,4,12,Loyal Users
2583,2134,18,20,1,3,2,6,Casual Users
2842,661,29,82,2,4,4,10,At Risk
2905,859,12,29,2,3,2,7,Casual Users
3485,525,19,171,2,3,5,10,Casual Users
3650,288,68,289,3,5,5,13,Loyal Users
3885,130,26,63,4,4,4,12,Champions
4083,412,10,43,3,2,3,8,Casual Users
4155,1945,28,151,1,4,5,10,At Risk
4230,407,12,25,3,3,2,8,Loyal Users
4424,5,74,143,5,5,4,14,Champions
4482,151,6,20,4,1,2,7,Promising
4826,420,11,16,3,2,2,7,Casual Users
4829,122,65,146,4,5,4,13,Champions
5119,283,27,69,3,4,4,11,Loyal Users
5592,306,8,14,3,2,1,6,Casual Users
6068,130,11,41,4,2,3,9,Promising
6342,796,13,56,2,3,3,8,Casual Users
6667,3156,5,5,1,1,1,3,Lost
6855,145,35,85,4,4,4,12,Champions
7147,337,49,57,3,5,3,11,Loyal Users
7306,2,35,48,5,4,3,12,Loyal Users
7501,425,7,29,3,2,2,7,Casual Users
7531,414,20,33,3,3,3,9,Loyal Users
8090,47,39,269,5,4,5,14,Champions
8123,87,65,105,4,5,4,13,Champions
8395,2668,33,57,1,4,3,8,At Risk
8410,223,8,60,3,2,3,8,Casual Users
8500,2873,5,9,1,1,1,3,Lost
8622,133,98,206,4,5,5,14,Champions
8877,283,39,239,3,4,5,12,Loyal Users
9081,125,32,60,4,4,3,11,Loyal Users
10015,12,31,86,5,4,4,13,Champions
10058,1856,5,14,1,1,1,3,Lost
10186,212,11,62,3,2,3,8,Casual Users
10449,15,126,621,5,5,5,15,Champions
10506,23,17,27,5,3,2,10,Loyal Users
10580,392,7,20,3,2,2,7,Casual Users
10680,434,10,108,3,2,4,9,Casual Users
11124,356,11,19,3,2,2,7,Casual Users
11422,75,33,94,4,4,4,12,Champions
11496,14,25,126,5,4,4,13,Champions
11693,2258,6,13,1,1,1,3,Lost
11946,326,9,13,3,2,1,6,Casual Users
12269,1094,14,15,2,3,1,6,Casual Users
12286,147,49,98,4,5,4,13,Champions
12373,4,48,99,5,5,4,14,Champions
12453,182,8,112,3,2,4,9,Casual Users
12548,258,115,185,3,5,5,13,Loyal Users
12885,1918,6,52,1,1,3,5,Lost
12913,560,9,21,2,2,2,6,Lost
12948,560,6,58,2,1,3,6,Lost
13104,2377,10,39,1,2,3,6,Lost
13166,3,100,209,5,5,5,15,Champions
13371,72,59,166,4,5,5,14,Champions
13415,377,12,38,3,3,3,9,Loyal Users
300,114,97,419,4,5,5,14,Champions
406,3140,5,79,1,1,4,6,Lost
412,1423,10,17,1,2,2,5,Lost
784,498,29,319,2,4,5,11,At Risk
787,253,8,10,3,2,1,6,Casual Users
842,5457,5,6,1,1,1,3,Lost
1030,848,6,15,2,1,1,4,Lost
1034,40,6,51,5,1,3,9,Promising
1064,3031,7,9,1,2,1,4,Lost
1156,0,19,52,5,3,3,11,Loyal Users
1163,21,90,193,5,5,5,15,Champions
1489,1,94,622,5,5,5,15,Champions
1752,693,17,78,2,3,4,9,Casual Users
1772,934,7,13,2,2,1,5,Lost
1826,12,160,484,5,5,5,15,Champions
1974,115,94,208,4,5,5,14,Champions
2349,8,173,823,5,5,5,15,Champions
2386,834,15,16,2,3,2,7,Casual Users
2682,3132,10,17,1,2,2,5,Lost
2778,1617,8,15,1,2,1,4,Lost
2945,120,24,94,4,4,4,12,Champions
2962,0,99,156,5,5,5,15,Champions
3151,114,18,59,4,3,3,10,Loyal Users
3582,8,20,40,5,3,3,11,Loyal Users
3706,131,22,37,4,4,3,11,Loyal Users
4107,4719,5,5,1,1,1,3,Lost
4848,972,30,177,2,4,5,11,At Risk
5188,126,29,156,4,4,5,13,Champions
5337,329,39,97,3,4,4,11,Loyal Users
5552,18,137,508,5,5,5,15,Champions
5845,1267,6,11,1,1,1,3,Lost
5880,1775,16,42,1,3,3,7,Casual Users
5884,139,16,38,4,3,3,10,Loyal Users
5895,266,24,148,3,4,5,12,Loyal Users
5930,1392,17,23,1,3,2,6,Casual Users
6152,41,50,203,5,5,5,15,Champions
6476,2600,81,364,1,5,5,11,At Risk
6695,14,155,739,5,5,5,15,Champions
6820,348,5,19,3,1,2,6,Casual Users
7184,165,17,52,4,3,3,10,Loyal Users
7539,3151,17,27,1,3,2,6,Casual Users
7594,986,20,27,2,3,2,7,Casual Users
7796,15,35,47,5,4,3,12,Loyal Users
8008,19,18,39,5,3,3,11,Loyal Users
8126,563,20,76,2,3,4,9,Casual Users
8127,761,25,37,2,4,3,9,At Risk
8132,24,41,103,5,4,4,13,Champions
8809,1242,19,27,2,3,2,7,Casual Users
8915,1794,7,18,1,2,2,5,Lost
8986,34,38,156,5,4,5,14,Champions
9113,78,8,23,4,2,2,8,Promising
9434,396,13,17,3,3,2,8,Loyal Users
11125,90,38,148,4,4,5,13,Champions
11201,5434,6,10,1,1,1,3,Lost
11636,976,13,48,2,3,3,8,Casual Users
11694,289,35,76,3,4,4,11,Loyal Users
12057,135,55,91,4,5,4,13,Champions
12102,102,27,69,4,4,4,12,Champions
12117,640,38,248,2,4,5,11,At Risk
12191,96,59,443,4,5,5,14,Champions
12711,157,8,45,4,2,3,9,Promising
12725,24,109,477,5,5,5,15,Champions
12914,117,55,206,4,5,5,14,Champions
13052,3404,8,44,1,2,3,6,Lost
13139,769,6,7,2,1,1,4,Lost
587,76,75,211,4,5,5,14,Champions
731,2966,10,37,1,2,3,6,Lost
988,121,51,202,4,5,5,14,Champions
1276,19,12,26,5,3,2,10,Loyal Users
1307,2008,6,17,1,1,2,4,Lost
1574,1119,8,13,2,2,1,5,Lost
1708,111,75,433,4,5,5,14,Champions
2015,1075,24,33,2,4,3,9,At Risk
2094,119,65,364,4,5,5,14,Champions
2240,272,13,32,3,3,3,9,Loyal Users
2697,213,37,263,3,4,5,12,Loyal Users
2752,1857,15,51,1,3,3,7,Casual Users
3296,308,10,15,3,2,1,6,Casual Users
3403,2648,6,6,1,1,1,3,Lost
3624,15,23,35,5,4,3,12,Loyal Users
3626,3416,8,31,1,2,2,5,Lost
3795,1922,6,10,1,1,1,3,Lost
4229,23,37,150,5,4,5,14,Champions
4843,2412,6,17,1,1,2,4,Lost
4858,3549,5,8,1,1,1,3,Lost
4925,2804,5,10,1,1,1,3,Lost
5028,9,73,79,5,5,4,14,Champions
5663,423,18,55,3,3,3,9,Loyal Users
5691,51,32,101,5,4,4,13,Champions
5854,116,32,74,4,4,4,12,Champions
6288,7,51,153,5,5,5,15,Champions
6300,111,10,52,4,2,3,9,Promising
7088,380,21,31,3,3,2,8,Loyal Users
7237,24,19,40,5,3,3,11,Loyal Users
7634,4460,5,5,1,1,1,3,Lost
7838,123,70,345,4,5,5,14,Champions
8036,51,38,80,5,4,4,13,Champions
8210,1015,19,45,2,3,3,8,Casual Users
9029,80,35,106,4,4,4,12,Champions
9366,544,43,63,2,4,4,10,At Risk
9387,1180,7,9,2,2,1,5,Lost
9443,2,29,150,5,4,5,14,Champions
9538,1185,5,6,2,1,1,4,Lost
9669,1436,8,11,1,2,1,4,Lost
9687,17,101,262,5,5,5,15,Champions
9909,278,13,54,3,3,3,9,Loyal Users
10020,9,11,15,5,2,1,8,Promising
10043,868,11,18,2,2,2,6,Lost
10177,174,36,156,3,4,5,12,Loyal Users
10354,2334,5,8,1,1,1,3,Lost
10866,92,56,202,4,5,5,14,Champions
11041,2726,5,28,1,1,2,4,Lost
11081,2265,6,9,1,1,1,3,Lost
11334,21,75,327,5,5,5,15,Champions
11494,536,22,61,2,4,3,9,At Risk
11841,121,56,363,4,5,5,14,Champions
11883,6,47,75,5,5,4,14,Champions
12511,14,118,613,5,5,5,15,Champions
12582,406,28,52,3,4,3,10,Loyal Users
12597,1,37,52,5,4,3,12,Loyal Users
12705,482,6,7,2,1,1,4,Lost
12859,568,22,149,2,4,5,11,At Risk
12865,391,21,31,3,3,2,8,Loyal Users
12868,0,33,108,5,4,4,13,Champions
12926,282,35,127,3,4,4,11,Loyal Users
13301,276,9,69,3,2,4,9,Casual Users
13523,422,7,9,3,2,1,6,Casual Users
76,1000,8,16,2,2,2,6,Lost
667,84,13,24,4,3,2,9,Loyal Users
688,2024,7,17,1,2,2,5,Lost
723,190,28,43,3,4,3,10,Loyal Users
914,286,8,24,3,2,2,7,Casual Users
1372,120,111,408,4,5,5,14,Champions
1480,12,55,69,5,5,4,14,Champions
1816,281,17,41,3,3,3,9,Loyal Users
1871,272,61,179,3,5,5,13,Loyal Users
1889,157,141,395,4,5,5,14,Champions
2032,1837,9,14,1,2,1,4,Lost
2467,397,20,47,3,3,3,9,Loyal Users
2526,103,26,98,4,4,4,12,Champions
2678,3286,29,89,1,4,4,9,At Risk
2758,10,32,65,5,4,4,13,Champions
2871,50,78,323,5,5,5,15,Champions
3013,528,24,92,2,4,4,10,At Risk
3127,4,33,108,5,4,4,13,Champions
3166,5008,8,8,1,2,1,4,Lost
3252,260,7,9,3,2,1,6,Casual Users
3264,60,76,482,5,5,5,15,Champions
3346,270,93,340,3,5,5,13,Loyal Users
3359,219,64,142,3,5,4,12,Loyal Users
3435,342,10,12,3,2,1,6,Casual Users
3595,1366,10,34,1,2,3,6,Lost
3725,409,41,232,3,4,5,12,Loyal Users
3941,83,79,121,4,5,4,13,Champions
4197,10,35,82,5,4,4,13,Champions
4256,154,16,35,4,3,3,10,Loyal Users
4695,166,6,39,3,1,3,7,Casual Users
4700,280,42,169,3,4,5,12,Loyal Users
5006,110,63,106,4,5,4,13,Champions
5040,277,99,293,3,5,5,13,Loyal Users
5505,127,16,22,4,3,2,9,Loyal Users
5562,13,60,442,5,5,5,15,Champions
5642,943,7,13,2,2,1,5,Lost
5651,75,28,73,4,4,4,12,Champions
5756,27,100,823,5,5,5,15,Champions
5965,448,10,41,3,2,3,8,Casual Users
6705,274,23,69,3,4,4,11,Loyal Users
6863,3384,28,71,1,4,4,9,At Risk
7242,2568,8,16,1,2,2,5,Lost
7321,3080,9,35,1,2,3,6,Lost
7351,9,106,219,5,5,5,15,Champions
8006,436,6,8,3,1,1,5,Casual Users
8130,91,29,97,4,4,4,12,Champions
8247,81,94,404,4,5,5,14,Champions
8417,3130,6,20,1,1,2,4,Lost
8608,49,74,345,5,5,5,15,Champions
8747,441,5,30,3,1,2,6,Casual Users
8902,2088,10,11,1,2,1,4,Lost
9161,1,224,526,5,5,5,15,Champions
9551,266,12,21,3,3,2,8,Loyal Users
9700,270,25,102,3,4,4,11,Loyal Users
9771,17,24,71,5,4,4,13,Champions
10445,6,93,164,5,5,5,15,Champions
10544,510,44,77,2,4,4,10,At Risk
10640,2205,7,18,1,2,2,5,Lost
10654,1102,9,13,2,2,1,5,Lost
10739,1013,15,42,2,3,3,8,Casual Users
10861,243,29,131,3,4,4,11,Loyal Users
10910,327,57,365,3,5,5,13,Loyal Users
11170,8,11,18,5,2,2,9,Promising
11204,73,104,348,4,5,5,14,Champions
11213,75,5,18,4,1,2,7,Promising
11241,512,23,119,2,4,4,10,At Risk
11406,650,9,57,2,2,3,7,Lost
11686,72,20,73,4,3,4,11,Loyal Users
11868,118,34,63,4,4,4,12,Champions
12187,1000,24,71,2,4,4,10,At Risk
12555,125,33,139,4,4,4,12,Champions
12575,340,32,313,3,4,5,12,Loyal Users
12601,508,70,92,2,5,4,11,At Risk
13040,1405,13,18,1,3,2,6,Casual Users
13051,270,34,44,3,4,3,10,Loyal Users
13081,422,10,14,3,2,1,6,Casual Users
13416,731,16,37,2,3,3,8,Casual Users
26,3283,35,94,1,4,4,9,At Risk
27,296,22,51,3,4,3,10,Loyal Users
332,827,21,62,2,3,3,8,Casual Users
501,306,5,14,3,1,1,5,Casual Users
577,234,20,101,3,3,4,10,Loyal Users
626,133,52,189,4,5,5,14,Champions
1235,173,104,289,3,5,5,13,Loyal Users
1493,314,7,7,3,2,1,6,Casual Users
1634,77,27,38,4,4,3,11,Loyal Users
2023,144,27,143,4,4,4,12,Champions
2335,144,18,54,4,3,3,10,Loyal Users
2439,602,7,10,2,2,1,5,Lost
2610,2413,5,15,1,1,1,3,Lost
2650,878,34,136,2,4,4,10,At Risk
2754,616,50,61,2,5,3,10,At Risk
2857,455,9,26,3,2,2,7,Casual Users
3133,373,9,15,3,2,1,6,Casual Users
3211,1264,6,10,1,1,1,3,Lost
3270,116,47,191,4,5,5,14,Champions
3411,497,10,13,2,2,1,5,Lost
3743,667,5,13,2,1,1,4,Lost
3811,1541,16,18,1,3,2,6,Casual Users
4758,290,5,11,3,1,1,5,Casual Users
4774,1263,18,24,1,3,2,6,Casual Users
4777,113,59,116,4,5,4,13,Champions
5066,129,6,15,4,1,1,6,Promising
5095,929,7,8,2,2,1,5,Lost
5212,683,43,58,2,4,3,9,At Risk
5396,7,46,279,5,5,5,15,Champions
5586,42,10,13,5,2,1,8,Promising
5758,19,35,140,5,4,4,13,Champions
5759,71,47,159,4,5,5,14,Champions
5875,849,17,28,2,3,2,7,Casual Users
5993,993,9,41,2,2,3,7,Lost
6011,114,24,26,4,4,2,10,Loyal Users
6437,558,21,53,2,3,3,8,Casual Users
6473,125,31,49,4,4,3,11,Loyal Users
6488,649,21,59,2,3,3,8,Casual Users
6847,167,27,39,3,4,3,10,Loyal Users
6936,294,106,217,3,5,5,13,Loyal Users
6948,75,52,101,4,5,4,13,Champions
7116,1,30,130,5,4,4,13,Champions
7489,8,9,14,5,2,1,8,Promising
8303,280,12,39,3,3,3,9,Loyal Users
8329,1421,5,17,1,1,2,4,Lost
8411,323,9,21,3,2,2,7,Casual Users
8643,987,12,14,2,3,1,6,Casual Users
8656,287,24,100,3,4,4,11,Loyal Users
8864,885,15,43,2,3,3,8,Casual Users
8962,554,40,55,2,4,3,9,At Risk
8980,3818,25,35,1,4,3,8,At Risk
9120,101,10,58,4,2,3,9,Promising
9318,115,5,7,4,1,1,6,Promising
9446,139,14,16,4,3,2,9,Loyal Users
9890,128,9,10,4,2,1,7,Promising
9935,233,7,9,3,2,1,6,Casual Users
10228,222,16,76,3,3,4,10,Loyal Users
11133,2704,5,21,1,1,2,4,Lost
11624,1378,5,43,1,1,3,5,Lost
11638,2259,8,13,1,2,1,4,Lost
11675,113,24,90,4,4,4,12,Champions
11997,172,33,122,3,4,4,11,Loyal Users
12087,97,24,92,4,4,4,12,Champions
12271,2210,5,56,1,1,3,5,Lost
12329,287,21,42,3,3,3,9,Loyal Users
12385,142,16,72,4,3,4,11,Loyal Users
12893,2391,8,8,1,2,1,4,Lost
13038,233,122,433,3,5,5,13,Loyal Users
13331,6,203,440,5,5,5,15,Champions
13347,540,13,14,2,3,1,6,Casual Users
13409,506,60,193,2,5,5,12,At Risk
13497,103,86,150,4,5,5,14,Champions
13524,1833,7,8,1,2,1,4,Lost
384,159,20,63,4,3,4,11,Loyal Users
831,214,13,17,3,3,2,8,Loyal Users
1019,3064,6,8,1,1,1,3,Lost
1269,42,19,41,5,3,3,11,Loyal Users
1294,146,10,39,4,2,3,9,Promising
1927,531,20,40,2,3,3,8,Casual Users
2047,56,11,29,5,2,2,9,Promising
2189,117,119,287,4,5,5,14,Champions
2331,152,43,249,4,4,5,13,Champions
2750,2738,5,8,1,1,1,3,Lost
3072,1827,18,50,1,3,3,7,Casual Users
3387,5132,7,25,1,2,2,5,Lost
4408,70,50,256,4,5,5,14,Champions
4830,1021,37,50,2,4,3,9,At Risk
4866,94,57,119,4,5,4,13,Champions
4876,10,17,66,5,3,4,12,Loyal Users
4919,111,45,81,4,4,4,12,Champions
5024,173,152,265,3,5,5,13,Loyal Users
5037,587,21,62,2,3,3,8,Casual Users
5123,59,41,188,5,4,5,14,Champions
5160,861,13,59,2,3,3,8,Casual Users
5258,1390,11,81,1,2,4,7,Lost
5647,10,5,23,5,1,2,8,Promising
5823,79,67,188,4,5,5,14,Champions
6040,30,98,195,5,5,5,15,Champions
6865,315,11,17,3,2,2,7,Casual Users
7122,115,72,377,4,5,5,14,Champions
7192,486,11,26,2,2,2,6,Lost
7895,4960,10,15,1,2,1,4,Lost
8053,18,12,14,5,3,1,9,Loyal Users
8426,994,5,8,2,1,1,4,Lost
8438,7,30,51,5,4,3,12,Loyal Users
8822,122,72,130,4,5,4,13,Champions
8826,87,14,31,4,3,2,9,Loyal Users
8895,108,108,693,4,5,5,14,Champions
8997,697,6,18,2,1,2,5,Lost
9027,17,39,256,5,4,5,14,Champions
9165,120,51,87,4,5,4,13,Champions
9249,829,17,95,2,3,4,9,Casual Users
9270,3,25,37,5,4,3,12,Loyal Users
9442,608,8,35,2,2,3,7,Lost
9508,135,47,122,4,5,4,13,Champions
9615,507,27,58,2,4,3,9,At Risk
10063,1660,5,8,1,1,1,3,Lost
10210,237,55,273,3,5,5,13,Loyal Users
10565,2980,5,8,1,1,1,3,Lost
10732,117,5,13,4,1,1,6,Promising
10881,236,28,125,3,4,4,11,Loyal Users
11111,1353,23,70,1,4,4,9,At Risk
11258,2148,5,32,1,1,3,5,Lost
11426,1656,5,9,1,1,1,3,Lost
11547,698,12,21,2,3,2,7,Casual Users
11626,270,92,300,3,5,5,13,Loyal Users
11677,2627,8,30,1,2,2,5,Lost
11777,1680,17,44,1,3,3,7,Casual Users
12103,129,8,8,4,2,1,7,Promising
12298,1700,82,247,1,5,5,11,At Risk
12337,49,46,266,5,5,5,15,Champions
12404,85,36,62,4,4,3,11,Loyal Users
12504,65,42,171,5,4,5,14,Champions
12659,299,5,9,3,1,1,5,Casual Users
12662,132,43,123,4,4,4,12,Champions
12731,1,13,72,5,3,4,12,Loyal Users
12951,2289,7,12,1,2,1,4,Lost
44,17,94,182,5,5,5,15,Champions
159,1613,6,18,1,1,2,4,Lost
192,1953,5,15,1,1,1,3,Lost
271,1584,28,96,1,4,4,9,At Risk
606,595,10,21,2,2,2,6,Lost
743,23,45,115,5,4,4,13,Champions
811,2562,5,13,1,1,1,3,Lost
844,3303,13,100,1,3,4,8,Casual Users
908,233,145,665,3,5,5,13,Loyal Users
916,744,5,17,2,1,2,5,Lost
1135,246,12,25,3,3,2,8,Loyal Users
1350,3593,6,21,1,1,2,4,Lost
1418,206,17,110,3,3,4,10,Loyal Users
1875,649,8,33,2,2,3,7,Lost
2134,369,14,20,3,3,2,8,Loyal Users
2169,3323,12,22,1,3,2,6,Casual Users
2322,1366,38,140,1,4,4,9,At Risk
2644,88,36,114,4,4,4,12,Champions
2738,927,6,45,2,1,3,6,Lost
3017,863,8,29,2,2,2,6,Lost
3069,2109,26,193,1,4,5,10,At Risk
3123,2092,8,33,1,2,3,6,Lost
3183,3828,21,32,1,3,3,7,Casual Users
3287,990,21,35,2,3,3,8,Casual Users
3370,1624,21,39,1,3,3,7,Casual Users
3481,406,29,75,3,4,4,11,Loyal Users
3528,1435,6,18,1,1,2,4,Lost
3666,958,27,74,2,4,4,10,At Risk
3669,20,41,272,5,4,5,14,Champions
3744,103,24,166,4,4,5,13,Champions
3783,1971,6,6,1,1,1,3,Lost
3922,24,12,40,5,3,3,11,Loyal Users
4199,185,115,218,3,5,5,13,Loyal Users
4267,1265,10,20,1,2,2,5,Lost
4354,815,5,27,2,1,2,5,Lost
4538,1189,6,8,2,1,1,4,Lost
5214,5133,10,23,1,2,2,5,Lost
5219,73,14,17,4,3,2,9,Loyal Users
5405,662,10,19,2,2,2,6,Lost
5606,27,94,217,5,5,5,15,Champions
5764,2500,10,12,1,2,1,4,Lost
5852,143,8,45,4,2,3,9,Promising
6167,1862,6,9,1,1,1,3,Lost
6391,3,82,143,5,5,4,14,Champions
6491,2226,19,59,1,3,3,7,Casual Users
6509,1118,5,19,2,1,2,5,Lost
6831,1135,15,36,2,3,3,8,Casual Users
6988,16,86,236,5,5,5,15,Champions
7225,147,26,182,4,4,5,13,Champions
7250,2364,10,15,1,2,1,4,Lost
7257,2670,5,15,1,1,1,3,Lost
7290,1604,8,15,1,2,1,4,Lost
7662,2539,7,8,1,2,1,4,Lost
7676,1570,9,26,1,2,2,5,Lost
7732,934,42,69,2,4,4,10,At Risk
7901,46,147,638,5,5,5,15,Champions
7962,107,37,124,4,4,4,12,Champions
8312,319,14,43,3,3,3,9,Loyal Users
8415,230,68,275,3,5,5,13,Loyal Users
8815,4463,10,34,1,2,3,6,Lost
8967,2003,21,36,1,3,3,7,Casual Users
9038,3103,22,30,1,4,2,7,At Risk
9106,273,41,83,3,4,4,11,Loyal Users
9147,336,52,63,3,5,4,12,Loyal Users
9482,421,8,19,3,2,2,7,Casual Users
9489,12,46,196,5,5,5,15,Champions
9498,3,12,41,5,3,3,11,Loyal Users
9547,30,76,460,5,5,5,15,Champions
9716,34,33,113,5,4,4,13,Champions
9787,559,10,18,2,2,2,6,Lost
9842,73,95,603,4,5,5,14,Champions
10116,174,34,163,3,4,5,12,Loyal Users
10184,0,61,349,5,5,5,15,Champions
10487,654,7,11,2,2,1,5,Lost
10529,264,38,51,3,4,3,10,Loyal Users
11076,135,58,259,4,5,5,14,Champions
11165,670,6,8,2,1,1,4,Lost
11374,1371,48,104,1,5,4,10,At Risk
11456,277,15,32,3,3,3,9,Loyal Users
11562,330,5,5,3,1,1,5,Casual Users
11801,520,22,24,2,4,2,8,At Risk
11823,1,80,237,5,5,5,15,Champions
11839,140,41,125,4,4,4,12,Champions
12192,862,5,7,2,1,1,4,Lost
12347,694,32,67,2,4,4,10,At Risk
12806,147,6,10,4,1,1,6,Promising
12882,2,93,500,5,5,5,15,Champions
13372,151,27,101,4,4,4,12,Champions
13401,984,5,37,2,1,3,6,Lost
13477,16,26,95,5,4,4,13,Champions
253,1024,5,8,2,1,1,4,Lost
806,76,23,60,4,4,3,11,Loyal Users
1148,570,8,14,2,2,1,5,Lost
1210,2157,11,46,1,2,3,6,Lost
1280,3150,6,8,1,1,1,3,Lost
1363,2728,6,26,1,1,2,4,Lost
1689,52,19,33,5,3,3,11,Loyal Users
1759,111,45,133,4,4,4,12,Champions
1771,418,143,387,3,5,5,13,Loyal Users
1866,121,118,457,4,5,5,14,Champions
1877,315,22,40,3,4,3,10,Loyal Users
1955,392,19,31,3,3,2,8,Loyal Users
2076,420,8,29,3,2,2,7,Casual Users
2371,24,42,204,5,4,5,14,Champions
2601,2460,17,29,1,3,2,6,Casual Users
2727,1698,10,18,1,2,2,5,Lost
2804,280,5,7,3,1,1,5,Casual Users
2809,13,28,63,5,4,4,13,Champions
3010,231,48,92,3,5,4,12,Loyal Users
3587,3308,6,17,1,1,2,4,Lost
3727,1711,37,165,1,4,5,10,At Risk
4036,929,13,59,2,3,3,8,Casual Users
4209,883,14,68,2,3,4,9,Casual Users
4547,23,7,14,5,2,1,8,Promising
4779,238,13,30,3,3,2,8,Loyal Users
5448,1123,5,13,2,1,1,4,Lost
5480,845,12,25,2,3,2,7,Casual Users
5708,14,5,11,5,1,1,7,Promising
5768,2012,20,28,1,3,2,6,Casual Users
5892,1988,12,18,1,3,2,6,Casual Users
6528,92,16,70,4,3,4,11,Loyal Users
6949,2979,8,17,1,2,2,5,Lost
7023,2558,7,16,1,2,2,5,Lost
7258,452,13,79,3,3,4,10,Loyal Users
7424,8,96,200,5,5,5,15,Champions
7516,449,18,52,3,3,3,9,Loyal Users
7684,695,5,15,2,1,1,4,Lost
7788,520,25,33,2,4,3,9,At Risk
8141,1245,20,54,2,3,3,8,Casual Users
8290,1431,7,9,1,2,1,4,Lost
8568,243,10,19,3,2,2,7,Casual Users
8674,4,71,398,5,5,5,15,Champions
9016,120,39,121,4,4,4,12,Champions
9096,2149,26,31,1,4,2,7,At Risk
9126,274,5,5,3,1,1,5,Casual Users
9205,402,27,197,3,4,5,12,Loyal Users
9286,6,24,31,5,4,2,11,Loyal Users
9378,360,15,26,3,3,2,8,Loyal Users
9514,276,39,181,3,4,5,12,Loyal Users
9873,90,7,28,4,2,2,8,Promising
10094,155,12,31,4,3,2,9,Loyal Users
10252,50,28,113,5,4,4,13,Champions
10309,76,17,27,4,3,2,9,Loyal Users
10950,118,49,101,4,5,4,13,Champions
11162,3296,40,56,1,4,3,8,At Risk
11240,430,15,44,3,3,3,9,Loyal Users
11326,104,17,45,4,3,3,10,Loyal Users
11367,16,101,164,5,5,5,15,Champions
11604,266,5,6,3,1,1,5,Casual Users
12067,114,28,98,4,4,4,12,Champions
12148,73,42,185,4,4,5,13,Champions
12235,101,19,83,4,3,4,11,Loyal Users
12509,2443,9,54,1,2,3,6,Lost
12709,1577,17,187,1,3,5,9,Casual Users
12895,4147,9,11,1,2,1,4,Lost
13422,251,30,65,3,4,4,11,Loyal Users
13426,1456,10,32,1,2,3,6,Lost
13584,2424,7,9,1,2,1,4,Lost
103,18,33,105,5,4,4,13,Champions
236,19,94,221,5,5,5,15,Champions
329,124,83,266,4,5,5,14,Champions
460,1397,42,143,1,4,4,9,At Risk
1056,962,5,12,2,1,1,4,Lost
1085,292,13,21,3,3,2,8,Loyal Users
1398,541,25,67,2,4,4,10,At Risk
1873,137,16,58,4,3,3,10,Loyal Users
1890,232,95,318,3,5,5,13,Loyal Users
2062,294,9,15,3,2,1,6,Casual Users
2069,4924,6,10,1,1,1,3,Lost
2198,147,6,16,4,1,2,7,Promising
2323,565,7,11,2,2,1,5,Lost
2496,2,82,290,5,5,5,15,Champions
2497,129,9,13,4,2,1,7,Promising
2595,108,38,134,4,4,4,12,Champions
2629,31,189,769,5,5,5,15,Champions
3173,261,5,15,3,1,1,5,Casual Users
3258,55,68,183,5,5,5,15,Champions
3279,306,44,105,3,4,4,11,Loyal Users
3284,24,57,85,5,5,4,14,Champions
3456,32,40,209,5,4,5,14,Champions
3512,3207,5,10,1,1,1,3,Lost
3972,16,70,152,5,5,5,15,Champions
4025,152,24,71,4,4,4,12,Champions
4104,1269,21,21,1,3,2,6,Casual Users
4200,80,90,656,4,5,5,14,Champions
4240,1843,14,20,1,3,2,6,Casual Users
4286,853,7,30,2,2,2,6,Lost
4368,28,38,92,5,4,4,13,Champions
4610,936,5,6,2,1,1,4,Lost
4899,328,21,83,3,3,4,10,Loyal Users
5080,1779,5,7,1,1,1,3,Lost
5142,1607,5,10,1,1,1,3,Lost
5238,876,53,109,2,5,4,11,At Risk
5401,101,30,91,4,4,4,12,Champions
5891,142,20,73,4,3,4,11,Loyal Users
6030,13,13,21,5,3,2,10,Loyal Users
6110,28,24,107,5,4,4,13,Champions
6128,12,14,23,5,3,2,10,Loyal Users
6904,3079,6,11,1,1,1,3,Lost
6956,169,73,229,3,5,5,13,Loyal Users
7239,148,62,277,4,5,5,14,Champions
7244,3709,9,18,1,2,2,5,Lost
7311,5,84,202,5,5,5,15,Champions
7556,722,12,15,2,3,1,6,Casual Users
7711,270,54,150,3,5,5,13,Loyal Users
7718,519,6,10,2,1,1,4,Lost
8022,2026,14,21,1,3,2,6,Casual Users
8115,441,12,20,3,3,2,8,Loyal Users
8260,2742,16,87,1,3,4,8,Casual Users
8326,70,165,450,4,5,5,14,Champions
8391,112,36,112,4,4,4,12,Champions
8782,26,8,19,5,2,2,9,Promising
8899,2794,7,10,1,2,1,4,Lost
9254,61,9,9,5,2,1,8,Promising
9712,307,22,77,3,4,4,11,Loyal Users
9840,833,6,39,2,1,3,6,Lost
10010,234,114,293,3,5,5,13,Loyal Users
10092,575,20,89,2,3,4,9,Casual Users
10368,129,19,36,4,3,3,10,Loyal Users
10800,15,11,36,5,2,3,10,Promising
11259,1409,10,14,1,2,1,4,Lost
11260,3701,5,35,1,1,3,5,Lost
11308,136,103,248,4,5,5,14,Champions
11475,372,106,561,3,5,5,13,Loyal Users
11543,928,10,10,2,2,1,5,Lost
11598,688,12,24,2,3,2,7,Casual Users
12023,132,46,88,4,5,4,13,Champions
12293,30,166,539,5,5,5,15,Champions
12310,119,25,224,4,4,5,13,Champions
12429,74,15,34,4,3,3,10,Loyal Users
12841,303,7,16,3,2,2,7,Casual Users
12873,3665,5,10,1,1,1,3,Lost
13547,767,6,12,2,1,1,4,Lost
12,232,10,28,3,2,2,7,Casual Users
336,560,7,15,2,2,1,5,Lost
350,1845,10,20,1,2,2,5,Lost
973,2827,9,62,1,2,3,6,Lost
984,2142,6,14,1,1,1,3,Lost
1046,186,8,13,3,2,1,6,Casual Users
1093,1188,23,42,2,4,3,9,At Risk
1260,161,9,30,4,2,2,8,Promising
2228,139,26,92,4,4,4,12,Champions
2236,5117,6,7,1,1,1,3,Lost
2409,435,6,19,3,1,2,6,Casual Users
2531,5,72,326,5,5,5,15,Champions
2723,16,70,195,5,5,5,15,Champions
2939,423,6,11,3,1,1,5,Casual Users
3054,313,6,7,3,1,1,5,Casual Users
3196,279,11,42,3,2,3,8,Casual Users
3207,4680,7,13,1,2,1,4,Lost
3228,551,6,10,2,1,1,4,Lost
3328,103,101,400,4,5,5,14,Champions
3548,92,5,6,4,1,1,6,Promising
3741,1660,6,12,1,1,1,3,Lost
4144,467,38,64,3,4,4,11,Loyal Users
4198,247,7,9,3,2,1,6,Casual Users
4305,225,19,37,3,3,3,9,Loyal Users
4317,75,67,143,4,5,4,13,Champions
4523,2336,8,18,1,2,2,5,Lost
4874,2559,16,82,1,3,4,8,Casual Users
5087,970,5,6,2,1,1,4,Lost
5322,303,119,188,3,5,5,13,Loyal Users
6201,694,24,104,2,4,4,10,At Risk
6267,4,22,46,5,4,3,12,Loyal Users
6810,2123,60,128,1,5,4,10,At Risk
7005,1019,5,7,2,1,1,4,Lost
7020,1949,5,20,1,1,2,4,Lost
7447,395,16,24,3,3,2,8,Loyal Users
7786,5,52,143,5,5,4,14,Champions
7928,319,12,14,3,3,1,7,Loyal Users
7940,589,7,12,2,2,1,5,Lost
7945,3681,5,85,1,1,4,6,Lost
8184,44,33,51,5,4,3,12,Loyal Users
8198,101,71,206,4,5,5,14,Champions
8255,4,104,556,5,5,5,15,Champions
8570,0,14,65,5,3,4,12,Loyal Users
9103,264,46,132,3,5,4,12,Loyal Users
9297,429,40,55,3,4,3,10,Loyal Users
9426,2895,6,14,1,1,1,3,Lost
9523,3425,7,11,1,2,1,4,Lost
9601,440,25,111,3,4,4,11,Loyal Users
9824,5572,20,39,1,3,3,7,Casual Users
9966,149,18,110,4,3,4,11,Loyal Users
10276,1163,5,9,2,1,1,4,Lost
10539,127,25,74,4,4,4,12,Champions
11249,1143,5,29,2,1,2,5,Lost
11282,149,39,56,4,4,3,11,Loyal Users
11736,822,6,6,2,1,1,4,Lost
11950,13,99,253,5,5,5,15,Champions
12137,1855,16,39,1,3,3,7,Casual Users
12466,120,30,74,4,4,4,12,Champions
12543,264,15,15,3,3,1,7,Loyal Users
12652,182,24,85,3,4,4,11,Loyal Users
12761,2164,6,7,1,1,1,3,Lost
12881,270,26,105,3,4,4,11,Loyal Users
12935,280,12,80,3,3,4,10,Loyal Users
13101,568,10,13,2,2,1,5,Lost
13191,1407,16,37,1,3,3,7,Casual Users
13312,1424,8,10,1,2,1,4,Lost
223,114,37,78,4,4,4,12,Champions
738,280,6,19,3,1,2,6,Casual Users
860,474,6,20,2,1,2,5,Lost
1769,135,118,402,4,5,5,14,Champions
1838,990,9,27,2,2,2,6,Lost
2006,55,185,782,5,5,5,15,Champions
2090,2802,13,35,1,3,3,7,Casual Users
2675,736,6,10,2,1,1,4,Lost
2680,93,61,125,4,5,4,13,Champions
2684,548,41,133,2,4,4,10,At Risk
2692,1359,18,23,1,3,2,6,Casual Users
2701,99,11,26,4,2,2,8,Promising
2920,96,5,20,4,1,2,7,Promising
3037,3287,15,21,1,3,2,6,Casual Users
3076,514,9,21,2,2,2,6,Lost
3083,3,51,144,5,5,4,14,Champions
3116,410,21,54,3,3,3,9,Loyal Users
3171,361,31,42,3,4,3,10,Loyal Users
3325,683,16,27,2,3,2,7,Casual Users
3353,4121,8,12,1,2,1,4,Lost
3500,5090,5,5,1,1,1,3,Lost
3679,17,36,176,5,4,5,14,Champions
3792,225,43,88,3,4,4,11,Loyal Users
3859,140,30,47,4,4,3,11,Loyal Users
3990,56,52,128,5,5,4,14,Champions
4033,44,6,22,5,1,2,8,Promising
4394,15,25,40,5,4,3,12,Loyal Users
4446,544,26,57,2,4,3,9,At Risk
5003,703,13,29,2,3,2,7,Casual Users
5069,178,18,48,3,3,3,9,Loyal Users
5105,4369,5,13,1,1,1,3,Lost
5307,4436,5,6,1,1,1,3,Lost
5328,70,23,47,4,4,3,11,Loyal Users
5422,259,6,6,3,1,1,5,Casual Users
5465,123,70,123,4,5,4,13,Champions
5841,192,7,21,3,2,2,7,Casual Users
6254,141,49,69,4,5,4,13,Champions
6522,15,70,192,5,5,5,15,Champions
6538,2001,5,11,1,1,1,3,Lost
6668,0,7,8,5,2,1,8,Promising
6671,683,44,90,2,4,4,10,At Risk
6716,859,14,54,2,3,3,8,Casual Users
6970,402,7,27,3,2,2,7,Casual Users
7055,5144,9,22,1,2,2,5,Lost
7304,384,17,56,3,3,3,9,Loyal Users
8067,73,7,8,4,2,1,7,Promising
8133,272,73,134,3,5,4,12,Loyal Users
8239,1521,5,7,1,1,1,3,Lost
8287,1142,5,6,2,1,1,4,Lost
8306,853,22,62,2,4,3,9,At Risk
8460,8,23,33,5,4,3,12,Loyal Users
8693,226,11,38,3,2,3,8,Casual Users
8723,3181,5,48,1,1,3,5,Lost
8828,1269,63,165,1,5,5,11,At Risk
9235,124,43,116,4,4,4,12,Champions
9264,140,54,147,4,5,5,14,Champions
9741,101,21,253,4,3,5,12,Loyal Users
9825,858,14,21,2,3,2,7,Casual Users
10135,113,7,81,4,2,4,10,Promising
10251,1084,16,64,2,3,4,9,Casual Users
10285,77,42,264,4,4,5,13,Champions
10570,120,26,59,4,4,3,11,Loyal Users
10845,84,95,229,4,5,5,14,Champions
10864,14,70,239,5,5,5,15,Champions
11120,6025,5,7,1,1,1,3,Lost
11151,1512,9,22,1,2,2,5,Lost
11361,2520,6,7,1,1,1,3,Lost
11368,87,27,54,4,4,3,11,Loyal Users
11423,1394,6,11,1,1,1,3,Lost
11717,54,21,52,5,3,3,11,Loyal Users
11757,139,44,59,4,4,3,11,Loyal Users
12219,0,39,123,5,4,4,13,Champions
12536,15,115,161,5,5,5,15,Champions
12564,3365,5,14,1,1,1,3,Lost
12722,646,20,153,2,3,5,10,Casual Users
13117,42,150,407,5,5,5,15,Champions
13125,1202,6,21,2,1,2,5,Lost
13290,4348,39,85,1,4,4,9,At Risk
13440,630,7,35,2,2,3,7,Lost
388,2729,7,7,1,2,1,4,Lost
417,49,149,241,5,5,5,15,Champions
548,473,19,34,2,3,3,8,Casual Users
602,815,25,42,2,4,3,9,At Risk
1208,50,27,35,5,4,3,12,Loyal Users
1775,990,11,37,2,2,3,7,Lost
2168,139,42,109,4,4,4,12,Champions
2753,641,5,9,2,1,1,4,Lost
3260,2749,10,39,1,2,3,6,Lost
3502,2984,8,16,1,2,2,5,Lost
3519,843,5,6,2,1,1,4,Lost
3621,14,6,6,5,1,1,7,Promising
3865,204,9,9,3,2,1,6,Casual Users
3912,437,7,17,3,2,2,7,Casual Users
4591,144,24,64,4,4,4,12,Champions
4617,134,21,79,4,3,4,11,Loyal Users
4669,6,73,231,5,5,5,15,Champions
4873,2779,8,48,1,2,3,6,Lost
4910,4586,6,8,1,1,1,3,Lost
5062,9,92,383,5,5,5,15,Champions
5374,1116,25,54,2,4,3,9,At Risk
5886,822,6,49,2,1,3,6,Lost
5897,106,40,209,4,4,5,13,Champions
5909,645,19,86,2,3,4,9,Casual Users
6096,1691,11,27,1,2,2,5,Lost
6100,13,146,1000,5,5,5,15,Champions
6440,94,21,57,4,3,3,10,Loyal Users
6572,1381,6,12,1,1,1,3,Lost
6717,1547,8,37,1,2,3,6,Lost
6852,4422,6,13,1,1,1,3,Lost
6896,4427,24,50,1,4,3,8,At Risk
7106,1660,5,12,1,1,1,3,Lost
7418,1178,12,41,2,3,3,8,Casual Users
7504,0,5,15,5,1,1,7,Promising
7583,182,38,76,3,4,4,11,Loyal Users
7600,17,58,249,5,5,5,15,Champions
7856,208,11,46,3,2,3,8,Casual Users
8318,516,10,19,2,2,2,6,Lost
8351,96,53,205,4,5,5,14,Champions
8355,1623,6,18,1,1,2,4,Lost
8774,75,14,67,4,3,4,11,Loyal Users
8947,10,49,166,5,5,5,15,Champions
9178,114,38,166,4,4,5,13,Champions
9677,387,68,225,3,5,5,13,Loyal Users
9689,2468,6,10,1,1,1,3,Lost
9915,107,72,291,4,5,5,14,Champions
10535,119,21,52,4,3,3,10,Loyal Users
10728,36,67,246,5,5,5,15,Champions
10913,1074,8,9,2,2,1,5,Lost
11517,148,8,16,4,2,2,8,Promising
12162,1957,6,6,1,1,1,3,Lost
12232,1266,7,17,1,2,2,5,Lost
12489,2572,54,89,1,5,4,10,At Risk
13248,113,10,12,4,2,1,7,Promising
13431,3533,8,8,1,2,1,4,Lost
91,227,57,151,3,5,5,13,Loyal Users
409,2419,5,9,1,1,1,3,Lost
578,141,7,8,4,2,1,7,Promising
663,20,91,251,5,5,5,15,Champions
926,397,11,46,3,2,3,8,Casual Users
1077,409,18,25,3,3,2,8,Loyal Users
1564,501,9,43,2,2,3,7,Lost
1659,206,12,25,3,3,2,8,Loyal Users
1777,13,99,190,5,5,5,15,Champions
1820,47,130,328,5,5,5,15,Champions
1978,260,11,20,3,2,2,7,Casual Users
2022,86,7,28,4,2,2,8,Promising
2502,1253,18,42,2,3,3,8,Casual Users
2975,865,7,8,2,2,1,5,Lost
3216,1319,5,17,1,1,2,4,Lost
3711,4738,7,12,1,2,1,4,Lost
4014,1311,6,32,1,1,3,5,Lost
4047,423,10,41,3,2,3,8,Casual Users
4227,131,6,6,4,1,1,6,Promising
4363,99,36,133,4,4,4,12,Champions
4397,181,59,141,3,5,4,12,Loyal Users
4526,772,9,12,2,2,1,5,Lost
4653,4397,5,12,1,1,1,3,Lost
5333,3687,11,13,1,2,1,4,Lost
5370,81,76,274,4,5,5,14,Champions
5765,695,5,18,2,1,2,5,Lost
5843,15,61,92,5,5,4,14,Champions
6028,169,61,168,3,5,5,13,Loyal Users
6045,931,15,60,2,3,3,8,Casual Users
6495,171,15,81,3,3,4,10,Loyal Users
6629,17,87,163,5,5,5,15,Champions
6650,3481,14,48,1,3,3,7,Casual Users
6746,232,13,18,3,3,2,8,Loyal Users
6792,1086,7,26,2,2,2,6,Lost
6880,36,42,131,5,4,4,13,Champions
7032,572,12,20,2,3,2,7,Casual Users
7197,138,6,20,4,1,2,7,Promising
7710,262,32,157,3,4,5,12,Loyal Users
7742,1699,15,31,1,3,2,6,Casual Users
8270,312,41,45,3,4,3,10,Loyal Users
8419,610,17,96,2,3,4,9,Casual Users
8452,896,29,135,2,4,4,10,At Risk
8825,10,7,9,5,2,1,8,Promising
8888,505,11,36,2,2,3,7,Lost
9226,724,28,45,2,4,3,9,At Risk
9236,408,27,40,3,4,3,10,Loyal Users
9474,5,7,23,5,2,2,9,Promising
9657,4,74,472,5,5,5,15,Champions
9734,104,51,154,4,5,5,14,Champions
10082,178,10,15,3,2,1,6,Casual Users
10227,221,5,22,3,1,2,6,Casual Users
10415,48,44,179,5,4,5,14,Champions
11461,294,16,20,3,3,2,8,Loyal Users
11608,3,53,123,5,5,4,14,Champions
12000,140,7,10,4,2,1,7,Promising
12368,3988,27,61,1,4,3,8,At Risk
12708,3123,11,29,1,2,2,5,Lost
12889,14,30,92,5,4,4,13,Champions
13122,270,24,45,3,4,3,10,Loyal Users
13297,3228,10,20,1,2,2,5,Lost
13488,48,14,58,5,3,3,11,Loyal Users
333,1301,7,9,1,2,1,4,Lost
707,409,8,23,3,2,2,7,Casual Users
822,8,89,141,5,5,4,14,Champions
1215,21,32,55,5,4,3,12,Loyal Users
1290,1143,11,55,2,2,3,7,Lost
1457,1974,21,70,1,3,4,8,Casual Users
1582,152,6,11,4,1,1,6,Promising
1908,3465,6,6,1,1,1,3,Lost
1925,5063,7,28,1,2,2,5,Lost
2113,4160,6,22,1,1,2,4,Lost
2127,125,43,127,4,4,4,12,Champions
2227,21,49,209,5,5,5,15,Champions
2237,131,55,140,4,5,4,13,Champions
2255,1,21,156,5,3,5,13,Loyal Users
2668,104,17,21,4,3,2,9,Loyal Users
2726,147,68,156,4,5,5,14,Champions
2772,350,38,92,3,4,4,11,Loyal Users
2789,694,9,24,2,2,2,6,Lost
2961,884,14,43,2,3,3,8,Casual Users
3071,2579,10,35,1,2,3,6,Lost
3184,4085,8,21,1,2,2,5,Lost
3239,8,41,214,5,4,5,14,Champions
3450,430,23,49,3,4,3,10,Loyal Users
3546,487,39,46,2,4,3,9,At Risk
3814,539,5,18,2,1,2,5,Lost
3891,346,5,16,3,1,2,6,Casual Users
3963,14,8,15,5,2,1,8,Promising
4070,98,68,103,4,5,4,13,Champions
4389,1,19,169,5,3,5,13,Loyal Users
4457,177,36,79,3,4,4,11,Loyal Users
4823,862,14,127,2,3,4,9,Casual Users
4989,286,10,79,3,2,4,9,Casual Users
4994,137,33,107,4,4,4,12,Champions
5112,1573,6,12,1,1,1,3,Lost
5190,441,32,66,3,4,4,11,Loyal Users
6178,2278,9,21,1,2,2,5,Lost
6606,4023,5,5,1,1,1,3,Lost
7699,278,56,227,3,5,5,13,Loyal Users
7823,83,9,81,4,2,4,10,Promising
8155,123,5,7,4,1,1,6,Promising
8655,51,44,105,5,4,4,13,Champions
8773,1506,20,49,1,3,3,7,Casual Users
9391,3,64,109,5,5,4,14,Champions
9393,3185,8,15,1,2,1,4,Lost
9456,827,5,13,2,1,1,4,Lost
9468,2863,6,8,1,1,1,3,Lost
9629,422,34,62,3,4,3,10,Loyal Users
9783,404,20,31,3,3,2,8,Loyal Users
9919,852,17,21,2,3,2,7,Casual Users
10600,74,145,656,4,5,5,14,Champions
10684,6,125,417,5,5,5,15,Champions
10760,25,108,482,5,5,5,15,Champions
11350,312,67,173,3,5,5,13,Loyal Users
11441,234,29,56,3,4,3,10,Loyal Users
11711,31,54,204,5,5,5,15,Champions
11729,18,16,32,5,3,3,11,Loyal Users
11975,76,12,62,4,3,3,10,Loyal Users
11982,1372,13,35,1,3,3,7,Casual Users
12158,1144,7,32,2,2,3,7,Lost
12273,109,48,176,4,5,5,14,Champions
12639,95,41,134,4,4,4,12,Champions
12713,120,18,43,4,3,3,10,Loyal Users
12744,95,75,205,4,5,5,14,Champions
13111,8,102,223,5,5,5,15,Champions
13344,108,66,278,4,5,5,14,Champions
13399,1248,8,10,2,2,1,5,Lost
13589,8,36,159,5,4,5,14,Champions
222,52,145,283,5,5,5,15,Champions
285,1563,5,5,1,1,1,3,Lost
601,124,41,210,4,4,5,13,Champions
875,59,39,131,5,4,4,13,Champions
1249,1168,5,32,2,1,3,6,Lost
1324,395,20,51,3,3,3,9,Loyal Users
1565,306,75,144,3,5,4,12,Loyal Users
1804,1386,5,5,1,1,1,3,Lost
1824,1419,12,63,1,3,4,8,Casual Users
2031,111,82,140,4,5,4,13,Champions
2288,61,11,12,5,2,1,8,Promising
2532,29,8,9,5,2,1,8,Promising
3108,327,11,21,3,2,2,7,Casual Users
3180,534,32,99,2,4,4,10,At Risk
3240,764,9,67,2,2,4,8,Lost
3586,0,103,354,5,5,5,15,Champions
3654,56,19,80,5,3,4,12,Loyal Users
3673,443,17,30,3,3,2,8,Loyal Users
3886,240,18,26,3,3,2,8,Loyal Users
3888,74,61,91,4,5,4,13,Champions
3905,141,6,28,4,1,2,7,Promising
4090,87,10,19,4,2,2,8,Promising
4120,349,9,14,3,2,1,6,Casual Users
4177,112,23,36,4,4,3,11,Loyal Users
4323,323,11,20,3,2,2,7,Casual Users
4387,534,11,18,2,2,2,6,Lost
4720,569,15,51,2,3,3,8,Casual Users
4837,1134,37,109,2,4,4,10,At Risk
5905,121,101,526,4,5,5,14,Champions
5932,232,132,901,3,5,5,13,Loyal Users
6422,103,76,202,4,5,5,14,Champions
6442,4140,14,97,1,3,4,8,Casual Users
6465,124,38,155,4,4,5,13,Champions
6616,11,65,223,5,5,5,15,Champions
7026,345,12,39,3,3,3,9,Loyal Users
7216,263,32,58,3,4,3,10,Loyal Users
7446,451,24,133,3,4,4,11,Loyal Users
7873,7,92,203,5,5,5,15,Champions
8186,3760,6,6,1,1,1,3,Lost
8220,169,80,301,3,5,5,13,Loyal Users
8280,69,60,210,5,5,5,15,Champions
8511,2959,8,8,1,2,1,4,Lost
8780,783,21,129,2,3,4,9,Casual Users
8786,179,96,493,3,5,5,13,Loyal Users
9039,1097,5,43,2,1,3,6,Lost
9078,101,29,67,4,4,4,12,Champions
9193,842,61,174,2,5,5,12,At Risk
9413,118,26,123,4,4,4,12,Champions
9522,421,7,19,3,2,2,7,Casual Users
9653,96,44,88,4,4,4,12,Champions
9674,3911,5,11,1,1,1,3,Lost
9861,2226,6,10,1,1,1,3,Lost
10006,3326,8,8,1,2,1,4,Lost
10053,361,22,101,3,4,4,11,Loyal Users
10165,816,18,37,2,3,3,8,Casual Users
10433,127,73,197,4,5,5,14,Champions
10747,90,21,60,4,3,3,10,Loyal Users
10776,876,5,7,2,1,1,4,Lost
10823,39,17,20,5,3,2,10,Loyal Users
11117,287,47,268,3,5,5,13,Loyal Users
11437,2229,10,14,1,2,1,4,Lost
11491,139,13,34,4,3,3,10,Loyal Users
11531,2468,5,10,1,1,1,3,Lost
11948,1136,5,10,2,1,1,4,Lost
12227,480,18,29,2,3,2,7,Casual Users
12535,115,17,51,4,3,3,10,Loyal Users
12965,437,25,110,3,4,4,11,Loyal Users
13098,35,105,239,5,5,5,15,Champions
13219,117,73,634,4,5,5,14,Champions
22,280,24,56,3,4,3,10,Loyal Users
128,6,7,15,5,2,1,8,Promising
209,1548,7,25,1,2,2,5,Lost
330,14,35,58,5,4,3,12,Loyal Users
372,1041,15,31,2,3,2,7,Casual Users
604,6097,10,28,1,2,2,5,Lost
685,1530,6,33,1,1,3,5,Lost
727,517,14,25,2,3,2,7,Casual Users
995,45,27,67,5,4,4,13,Champions
1065,1971,54,390,1,5,5,11,At Risk
1125,526,16,123,2,3,4,9,Casual Users
1295,170,104,239,3,5,5,13,Loyal Users
1332,644,9,9,2,2,1,5,Lost
1469,402,35,109,3,4,4,11,Loyal Users
1550,58,114,283,5,5,5,15,Champions
1731,49,83,159,5,5,5,15,Champions
1796,117,6,22,4,1,2,7,Promising
1848,409,5,6,3,1,1,5,Casual Users
1886,119,6,9,4,1,1,6,Promising
1961,651,13,24,2,3,2,7,Casual Users
2242,78,75,356,4,5,5,14,Champions
2407,19,125,460,5,5,5,15,Champions
2521,2254,11,90,1,2,4,7,Lost
2725,477,5,37,2,1,3,6,Lost
3200,774,64,80,2,5,4,11,At Risk
3579,174,30,65,3,4,4,11,Loyal Users
4203,1564,6,24,1,1,2,4,Lost
4336,419,13,20,3,3,2,8,Loyal Users
4403,23,58,194,5,5,5,15,Champions
4429,646,17,43,2,3,3,8,Casual Users
4606,2501,23,36,1,4,3,8,At Risk
4718,15,78,302,5,5,5,15,Champions
4788,369,7,10,3,2,1,6,Casual Users
5213,2978,8,9,1,2,1,4,Lost
5282,3473,18,19,1,3,2,6,Casual Users
5302,3973,16,52,1,3,3,7,Casual Users
5320,1452,11,16,1,2,2,5,Lost
5953,110,9,48,4,2,3,9,Promising
6273,127,66,160,4,5,5,14,Champions
6337,803,6,9,2,1,1,4,Lost
6469,852,8,26,2,2,2,6,Lost
6630,265,12,71,3,3,4,10,Loyal Users
6887,176,8,11,3,2,1,6,Casual Users
6891,57,25,62,5,4,3,12,Loyal Users
7080,64,98,210,5,5,5,15,Champions
7198,2118,5,33,1,1,3,5,Lost
7266,696,27,75,2,4,4,10,At Risk
7683,161,50,218,4,5,5,14,Champions
7787,0,42,154,5,4,5,14,Champions
7919,84,57,281,4,5,5,14,Champions
8004,1,23,118,5,4,4,13,Champions
8427,412,24,34,3,4,3,10,Loyal Users
8473,832,13,18,2,3,2,7,Casual Users
8486,2,9,12,5,2,1,8,Promising
8846,523,22,159,2,4,5,11,At Risk
8917,109,103,209,4,5,5,14,Champions
9077,243,151,471,3,5,5,13,Loyal Users
9451,55,58,161,5,5,5,15,Champions
9592,267,48,67,3,5,4,12,Loyal Users
9611,133,8,44,4,2,3,9,Promising
9723,4475,11,13,1,2,1,4,Lost
10037,204,34,81,3,4,4,11,Loyal Users
10049,658,5,9,2,1,1,4,Lost
10084,843,13,23,2,3,2,7,Casual Users
10209,8,20,65,5,3,4,12,Loyal Users
10469,140,9,36,4,2,3,9,Promising
10671,1408,12,35,1,3,3,7,Casual Users
11342,718,39,124,2,4,4,10,At Risk
11849,1847,9,41,1,2,3,6,Lost
11888,504,5,17,2,1,2,5,Lost
11906,97,131,379,4,5,5,14,Champions
12088,1466,5,12,1,1,1,3,Lost
12146,601,28,148,2,4,5,11,At Risk
12203,970,7,42,2,2,3,7,Lost
12712,410,11,60,3,2,3,8,Casual Users
12797,2468,13,22,1,3,2,6,Casual Users
12894,12,5,12,5,1,1,7,Promising
12962,2622,6,17,1,1,2,4,Lost
12980,13,49,113,5,5,4,14,Champions
13132,28,192,537,5,5,5,15,Champions
13228,8,36,104,5,4,4,13,Champions
13295,309,5,5,3,1,1,5,Casual Users
122,195,5,7,3,1,1,5,Casual Users
230,1587,6,22,1,1,2,4,Lost
319,6,81,437,5,5,5,15,Champions
493,406,22,96,3,4,4,11,Loyal Users
625,10,64,136,5,5,4,14,Champions
686,4,199,421,5,5,5,15,Champions
1176,142,28,84,4,4,4,12,Champions
1291,4634,9,11,1,2,1,4,Lost
1583,282,7,13,3,2,1,6,Casual Users
2013,369,25,65,3,4,4,11,Loyal Users
2517,415,38,182,3,4,5,12,Loyal Users
2828,64,9,10,5,2,1,8,Promising
3689,260,95,180,3,5,5,13,Loyal Users
3728,4572,8,43,1,2,3,6,Lost
3975,1667,7,13,1,2,1,4,Lost
4028,1324,5,17,1,1,2,4,Lost
4251,610,10,17,2,2,2,6,Lost
4280,405,10,19,3,2,2,7,Casual Users
4521,1059,23,119,2,4,4,10,At Risk
5025,130,28,56,4,4,3,11,Loyal Users
5500,976,8,13,2,2,1,5,Lost
5568,275,52,201,3,5,5,13,Loyal Users
5660,422,6,17,3,1,2,6,Casual Users
6071,2154,7,14,1,2,1,4,Lost
6467,34,16,19,5,3,2,10,Loyal Users
6503,841,7,12,2,2,1,5,Lost
6835,132,52,314,4,5,5,14,Champions
7033,1598,6,26,1,1,2,4,Lost
7058,96,37,84,4,4,4,12,Champions
7065,487,24,123,2,4,4,10,At Risk
7081,269,15,186,3,3,5,11,Loyal Users
7124,2,105,210,5,5,5,15,Champions
7159,8,25,41,5,4,3,12,Loyal Users
7210,1950,7,8,1,2,1,4,Lost
7265,1694,25,29,1,4,2,7,At Risk
7551,615,26,32,2,4,3,9,At Risk
7589,264,14,38,3,3,3,9,Loyal Users
7731,594,11,18,2,2,2,6,Lost
7847,47,107,432,5,5,5,15,Champions
7989,283,17,47,3,3,3,9,Loyal Users
8005,129,8,45,4,2,3,9,Promising
8047,1179,25,89,2,4,4,10,At Risk
8264,2,70,87,5,5,4,14,Champions
8658,476,5,10,2,1,1,4,Lost
8762,280,21,124,3,3,4,10,Loyal Users
8851,7,22,63,5,4,4,13,Champions
8969,573,29,72,2,4,4,10,At Risk
9009,87,91,391,4,5,5,14,Champions
9341,145,40,122,4,4,4,12,Champions
9573,2979,8,8,1,2,1,4,Lost
10358,292,28,76,3,4,4,11,Loyal Users
10635,2596,10,14,1,2,1,4,Lost
10668,788,17,25,2,3,2,7,Casual Users
10683,842,15,89,2,3,4,9,Casual Users
11135,2105,11,34,1,2,3,6,Lost
11187,1726,11,12,1,2,1,4,Lost
11226,30,46,88,5,5,4,14,Champions
11483,129,17,25,4,3,2,9,Loyal Users
11566,265,12,18,3,3,2,8,Loyal Users
11584,420,76,243,3,5,5,13,Loyal Users
11690,687,51,62,2,5,3,10,At Risk
11829,107,20,34,4,3,3,10,Loyal Users
12170,1240,8,22,2,2,2,6,Lost
12321,54,57,95,5,5,4,14,Champions
12888,81,25,94,4,4,4,12,Champions
12910,1834,91,187,1,5,5,11,At Risk
12937,2424,6,6,1,1,1,3,Lost
13275,374,62,211,3,5,5,13,Loyal Users
13439,481,5,22,2,1,2,5,Lost
13517,118,13,40,4,3,3,10,Loyal Users
93,1599,8,14,1,2,1,4,Lost
157,1407,10,24,1,2,2,5,Lost
190,1665,9,15,1,2,1,4,Lost
225,1802,23,47,1,4,3,8,At Risk
232,498,11,34,2,2,3,7,Lost
233,900,10,13,2,2,1,5,Lost
758,2233,15,18,1,3,2,6,Casual Users
924,127,78,194,4,5,5,14,Champions
1506,460,5,62,3,1,3,7,Casual Users
1633,0,129,257,5,5,5,15,Champions
2042,1381,9,16,1,2,2,5,Lost
2148,586,10,38,2,2,3,7,Lost
2414,663,10,14,2,2,1,5,Lost
2724,300,48,103,3,5,4,12,Loyal Users
2774,97,24,41,4,4,3,11,Loyal Users
3390,107,150,687,4,5,5,14,Champions
3482,123,8,16,4,2,2,8,Promising
3884,1445,139,219,1,5,5,11,At Risk
4376,276,31,74,3,4,4,11,Loyal Users
4386,26,58,121,5,5,4,14,Champions
4726,275,10,40,3,2,3,8,Casual Users
4727,230,10,62,3,2,3,8,Casual Users
5042,190,5,12,3,1,1,5,Casual Users
5099,131,19,68,4,3,4,11,Loyal Users
5266,147,11,36,4,2,3,9,Promising
5516,1061,17,131,2,3,4,9,Casual Users
5633,485,19,95,2,3,4,9,Casual Users
5828,400,15,61,3,3,3,9,Loyal Users
6090,128,57,170,4,5,5,14,Champions
6740,30,5,10,5,1,1,7,Promising
6898,604,22,55,2,4,3,9,At Risk
6924,9,10,22,5,2,2,9,Promising
7123,1879,12,40,1,3,3,7,Casual Users
7284,797,17,53,2,3,3,8,Casual Users
7400,403,8,8,3,2,1,6,Casual Users
7454,9,148,802,5,5,5,15,Champions
7580,264,61,97,3,5,4,12,Loyal Users
7792,65,6,24,5,1,2,8,Promising
8131,273,11,16,3,2,2,7,Casual Users
8375,2,68,94,5,5,4,14,Champions
8526,440,35,179,3,4,5,12,Loyal Users
8811,105,33,169,4,4,5,13,Champions
8872,35,58,161,5,5,5,15,Champions
9053,227,6,16,3,1,2,6,Casual Users
9578,101,24,108,4,4,4,12,Champions
9769,365,43,213,3,4,5,12,Loyal Users
9878,9,143,448,5,5,5,15,Champions
9988,34,16,39,5,3,3,11,Loyal Users
10007,306,11,12,3,2,1,6,Casual Users
10982,285,9,20,3,2,2,7,Casual Users
11026,459,26,35,3,4,3,10,Loyal Users
11353,535,15,61,2,3,3,8,Casual Users
11607,133,27,48,4,4,3,11,Loyal Users
11615,133,47,61,4,5,3,12,Loyal Users
12165,152,8,14,4,2,1,7,Promising
12589,891,7,12,2,2,1,5,Lost
12777,191,19,45,3,3,3,9,Loyal Users
12921,255,9,44,3,2,3,8,Casual Users
12972,31,85,287,5,5,5,15,Champions
13000,122,10,51,4,2,3,9,Promising
13549,153,11,26,4,2,2,8,Promising
246,1913,7,9,1,2,1,4,Lost
346,1708,7,19,1,2,2,5,Lost
360,134,18,26,4,3,2,9,Loyal Users
367,155,37,133,4,4,4,12,Champions
476,3986,5,9,1,1,1,3,Lost
539,1906,23,44,1,4,3,8,At Risk
599,1225,11,28,2,2,2,6,Lost
725,11,33,54,5,4,3,12,Loyal Users
855,279,14,45,3,3,3,9,Loyal Users
861,282,58,145,3,5,4,12,Loyal Users
1061,148,29,55,4,4,3,11,Loyal Users
1588,112,37,155,4,4,5,13,Champions
2609,2737,5,16,1,1,2,4,Lost
2757,2709,6,6,1,1,1,3,Lost
2791,26,29,105,5,4,4,13,Champions
3244,633,26,43,2,4,3,9,At Risk
3276,1840,35,144,1,4,4,9,At Risk
3670,542,16,33,2,3,3,8,Casual Users
3920,185,86,309,3,5,5,13,Loyal Users
3991,26,6,7,5,1,1,7,Promising
4040,1986,6,10,1,1,1,3,Lost
4426,3545,5,7,1,1,1,3,Lost
4455,1119,11,20,2,2,2,6,Lost
4530,30,72,122,5,5,4,14,Champions
4882,3876,7,13,1,2,1,4,Lost
5524,11,80,298,5,5,5,15,Champions
5678,1665,8,73,1,2,4,7,Lost
5786,1264,7,9,1,2,1,4,Lost
5787,21,73,146,5,5,4,14,Champions
6744,1670,16,25,1,3,2,6,Casual Users
6795,116,100,481,4,5,5,14,Champions
6929,141,56,102,4,5,4,13,Champions
6954,397,27,69,3,4,4,11,Loyal Users
7293,1124,16,69,2,3,4,9,Casual Users
7938,4877,6,10,1,1,1,3,Lost
7975,2001,7,24,1,2,2,5,Lost
8037,831,9,13,2,2,1,5,Lost
8886,2258,9,11,1,2,1,4,Lost
9138,1128,7,10,2,2,1,5,Lost
9231,155,6,13,4,1,1,6,Promising
9395,394,14,38,3,3,3,9,Loyal Users
9566,113,80,126,4,5,4,13,Champions
9568,1082,13,29,2,3,2,7,Casual Users
9642,48,70,253,5,5,5,15,Champions
9759,959,10,18,2,2,2,6,Lost
9847,890,7,22,2,2,2,6,Lost
10286,57,14,24,5,3,2,10,Loyal Users
10495,1989,7,12,1,2,1,4,Lost
11105,143,5,17,4,1,2,7,Promising
11159,133,54,93,4,5,4,13,Champions
11311,424,26,143,3,4,4,11,Loyal Users
12193,112,34,112,4,4,4,12,Champions
12467,4119,6,12,1,1,1,3,Lost
12533,1217,10,37,2,2,3,7,Lost
12558,1582,9,13,1,2,1,4,Lost
12666,103,128,249,4,5,5,14,Champions
12749,621,5,5,2,1,1,4,Lost
13034,235,81,180,3,5,5,13,Loyal Users
13236,36,5,18,5,1,2,8,Promising
13374,735,11,37,2,2,3,7,Lost
13531,638,48,153,2,5,5,12,At Risk
13575,17,6,9,5,1,1,7,Promising
111,907,13,29,2,3,2,7,Casual Users
224,161,6,12,4,1,1,6,Promising
519,388,13,47,3,3,3,9,Loyal Users
654,891,7,31,2,2,2,6,Lost
1197,120,11,55,4,2,3,9,Promising
1505,307,18,141,3,3,4,10,Loyal Users
1729,129,45,104,4,4,4,12,Champions
1785,96,8,16,4,2,2,8,Promising
1942,526,85,493,2,5,5,12,At Risk
2181,2442,31,72,1,4,4,9,At Risk
2404,568,5,7,2,1,1,4,Lost
2607,109,23,128,4,4,4,12,Champions
2628,131,115,386,4,5,5,14,Champions
2896,20,13,22,5,3,2,10,Loyal Users
3132,982,71,165,2,5,5,12,At Risk
3222,3573,6,6,1,1,1,3,Lost
3495,75,82,350,4,5,5,14,Champions
3504,2527,6,9,1,1,1,3,Lost
3817,65,16,52,5,3,3,11,Loyal Users
3862,1118,12,45,2,3,3,8,Casual Users
4018,412,12,38,3,3,3,9,Loyal Users
4277,122,39,110,4,4,4,12,Champions
4459,3482,11,50,1,2,3,6,Lost
4568,199,27,36,3,4,3,10,Loyal Users
4784,18,182,510,5,5,5,15,Champions
5084,3257,52,171,1,5,5,11,At Risk
5102,569,9,10,2,2,1,5,Lost
5346,171,53,143,3,5,4,12,Loyal Users
5442,840,5,9,2,1,1,4,Lost
5478,506,17,36,2,3,3,8,Casual Users
5655,28,50,142,5,5,4,14,Champions
6350,30,21,48,5,3,3,11,Loyal Users
6607,118,14,64,4,3,4,11,Loyal Users
6836,1463,16,27,1,3,2,6,Casual Users
6993,847,13,53,2,3,3,8,Casual Users
7160,76,20,67,4,3,4,11,Loyal Users
7241,406,35,40,3,4,3,10,Loyal Users
7758,414,16,28,3,3,2,8,Loyal Users
8150,157,16,68,4,3,4,11,Loyal Users
8166,1407,8,37,1,2,3,6,Lost
8178,188,24,60,3,4,3,10,Loyal Users
8399,583,7,41,2,2,3,7,Lost
8498,842,6,7,2,1,1,4,Lost
8595,1942,8,25,1,2,2,5,Lost
9059,811,17,27,2,3,2,7,Casual Users
9247,1635,21,21,1,3,2,6,Casual Users
9311,354,13,19,3,3,2,8,Loyal Users
9571,465,42,146,3,4,4,11,Loyal Users
10070,223,34,57,3,4,3,10,Loyal Users
10269,87,15,28,4,3,2,9,Loyal Users
10409,1151,8,10,2,2,1,5,Lost
10648,402,10,57,3,2,3,8,Casual Users
10779,252,46,322,3,5,5,13,Loyal Users
11273,397,8,13,3,2,1,6,Casual Users
11445,12,15,115,5,3,4,12,Loyal Users
11476,579,27,50,2,4,3,9,At Risk
11493,992,37,69,2,4,4,10,At Risk
11513,256,19,81,3,3,4,10,Loyal Users
11927,1433,6,18,1,1,2,4,Lost
12340,2587,6,20,1,1,2,4,Lost
12462,141,10,42,4,2,3,9,Promising
12519,2649,5,61,1,1,3,5,Lost
12556,301,24,173,3,4,5,12,Loyal Users
12580,120,13,43,4,3,3,10,Loyal Users
12583,3575,21,74,1,3,4,8,Casual Users
12857,542,27,39,2,4,3,9,At Risk
12875,561,26,36,2,4,3,9,At Risk
13229,5586,8,38,1,2,3,6,Lost
13279,0,152,474,5,5,5,15,Champions
13303,218,117,323,3,5,5,13,Loyal Users
13318,676,6,7,2,1,1,4,Lost
13406,560,10,45,2,2,3,7,Lost
47,438,47,81,3,5,4,12,Loyal Users
1207,281,11,74,3,2,4,9,Casual Users
1456,1076,6,16,2,1,2,5,Lost
1477,3580,17,141,1,3,4,8,Casual Users
1939,68,166,304,5,5,5,15,Champions
1944,1024,21,40,2,3,3,8,Casual Users
2051,3570,17,64,1,3,4,8,Casual Users
2064,4,25,69,5,4,4,13,Champions
2192,2840,10,25,1,2,2,5,Lost
2284,413,15,90,3,3,4,10,Loyal Users
2549,1033,6,11,2,1,1,4,Lost
2612,221,81,136,3,5,4,12,Loyal Users
2638,123,13,14,4,3,1,8,Loyal Users
2823,91,10,26,4,2,2,8,Promising
3045,369,9,20,3,2,2,7,Casual Users
3140,1129,6,14,2,1,1,4,Lost
3144,516,23,63,2,4,4,10,At Risk
3567,414,23,43,3,4,3,10,Loyal Users
3818,423,30,51,3,4,3,10,Loyal Users
4076,271,8,20,3,2,2,7,Casual Users
4384,208,5,38,3,1,3,7,Casual Users
4481,292,5,9,3,1,1,5,Casual Users
4642,132,8,45,4,2,3,9,Promising
4655,233,7,10,3,2,1,6,Casual Users
4851,108,54,267,4,5,5,14,Champions
5090,3403,5,14,1,1,1,3,Lost
5182,74,20,120,4,3,4,11,Loyal Users
5388,12,75,419,5,5,5,15,Champions
5620,516,11,42,2,2,3,7,Lost
5640,112,55,444,4,5,5,14,Champions
5755,2147,11,23,1,2,2,5,Lost
5838,758,58,117,2,5,4,11,At Risk
6024,277,13,65,3,3,4,10,Loyal Users
6115,880,23,57,2,4,3,9,At Risk
6326,135,11,84,4,2,4,10,Promising
6339,2551,12,39,1,3,3,7,Casual Users
6504,2,31,57,5,4,3,12,Loyal Users
6553,1303,41,104,1,4,4,9,At Risk
6690,38,56,360,5,5,5,15,Champions
6960,119,6,36,4,1,3,8,Promising
7171,251,75,197,3,5,5,13,Loyal Users
7877,286,7,42,3,2,3,8,Casual Users
7890,159,10,22,4,2,2,8,Promising
7970,112,57,135,4,5,4,13,Champions
8152,534,33,112,2,4,4,10,At Risk
8163,884,5,11,2,1,1,4,Lost
8328,73,60,209,4,5,5,14,Champions
8480,2400,36,104,1,4,4,9,At Risk
8619,121,41,163,4,4,5,13,Champions
8621,32,49,191,5,5,5,15,Champions
8663,1418,26,72,1,4,4,9,At Risk
8672,1135,39,84,2,4,4,10,At Risk
8721,271,31,73,3,4,4,11,Loyal Users
8849,226,10,27,3,2,2,7,Casual Users
9110,408,12,57,3,3,3,9,Loyal Users
9166,414,6,6,3,1,1,5,Casual Users
9189,1460,7,9,1,2,1,4,Lost
9512,701,39,66,2,4,4,10,At Risk
9548,4,16,25,5,3,2,10,Loyal Users
9588,305,33,92,3,4,4,11,Loyal Users
9702,271,8,11,3,2,1,6,Casual Users
9726,19,12,16,5,3,2,10,Loyal Users
10124,362,10,43,3,2,3,8,Casual Users
10240,2255,5,39,1,1,3,5,Lost
10310,65,11,34,5,2,3,10,Promising
10344,131,6,37,4,1,3,8,Promising
11519,4409,5,32,1,1,3,5,Lost
11824,3453,15,41,1,3,3,7,Casual Users
12035,158,23,159,4,4,5,13,Champions
12241,96,14,40,4,3,3,10,Loyal Users
12459,155,64,93,4,5,4,13,Champions
12870,129,94,193,4,5,5,14,Champions
13015,770,5,7,2,1,1,4,Lost
13257,9,20,60,5,3,3,11,Loyal Users
13339,3684,6,25,1,1,2,4,Lost
13357,230,30,66,3,4,4,11,Loyal Users
140,15,26,39,5,4,3,12,Loyal Users
177,1442,12,16,1,3,2,6,Casual Users
416,14,21,54,5,3,3,11,Loyal Users
556,164,9,19,4,2,2,8,Promising
711,274,22,109,3,4,4,11,Loyal Users
827,40,72,193,5,5,5,15,Champions
1055,151,6,7,4,1,1,6,Promising
1244,164,27,72,4,4,4,12,Champions
1300,11,109,599,5,5,5,15,Champions
1425,493,8,41,2,2,3,7,Lost
1613,109,20,50,4,3,3,10,Loyal Users
1899,697,6,16,2,1,2,5,Lost
2037,624,18,55,2,3,3,8,Casual Users
2038,43,48,267,5,5,5,15,Champions
2109,372,11,29,3,2,2,7,Casual Users
2306,4255,91,349,1,5,5,11,At Risk
2398,1438,5,12,1,1,1,3,Lost
2619,995,22,35,2,4,3,9,At Risk
2998,597,14,17,2,3,2,7,Casual Users
3293,133,11,128,4,2,4,10,Promising
3498,724,12,22,2,3,2,7,Casual Users
3904,861,19,96,2,3,4,9,Casual Users
4032,232,8,26,3,2,2,7,Casual Users
4498,3550,6,15,1,1,1,3,Lost
4507,1682,10,14,1,2,1,4,Lost
4698,1653,12,28,1,3,2,6,Casual Users
4756,2,84,222,5,5,5,15,Champions
5162,1,62,304,5,5,5,15,Champions
5335,3014,9,32,1,2,3,6,Lost
5361,278,8,12,3,2,1,6,Casual Users
6014,173,21,45,3,3,3,9,Loyal Users
6143,37,22,41,5,4,3,12,Loyal Users
6394,10,81,244,5,5,5,15,Champions
6435,5108,12,44,1,3,3,7,Casual Users
6515,102,51,259,4,5,5,14,Champions
6941,1546,18,20,1,3,2,6,Casual Users
6946,137,136,694,4,5,5,14,Champions
7203,3141,17,60,1,3,3,7,Casual Users
7701,28,93,314,5,5,5,15,Champions
7896,292,9,24,3,2,2,7,Casual Users
8516,83,14,24,4,3,2,9,Loyal Users
8646,1331,28,43,1,4,3,8,At Risk
8722,1627,18,20,1,3,2,6,Casual Users
9116,1463,15,132,1,3,4,8,Casual Users
9123,79,17,43,4,3,3,10,Loyal Users
9439,241,57,102,3,5,4,12,Loyal Users
10079,1418,10,20,1,2,2,5,Lost
10166,2158,9,12,1,2,1,4,Lost
10236,755,6,11,2,1,1,4,Lost
10281,1440,22,44,1,4,3,8,At Risk
10885,5,40,99,5,4,4,13,Champions
10889,17,77,476,5,5,5,15,Champions
11444,2682,7,17,1,2,2,5,Lost
11469,12,20,152,5,3,5,13,Loyal Users
11863,427,9,21,3,2,2,7,Casual Users
11931,949,9,31,2,2,2,6,Lost
12034,2847,9,12,1,2,1,4,Lost
12279,708,5,10,2,1,1,4,Lost
12526,51,27,63,5,4,4,13,Champions
12750,3819,32,75,1,4,4,9,At Risk
12770,126,44,84,4,4,4,12,Champions
13024,4430,11,12,1,2,1,4,Lost
13267,18,50,255,5,5,5,15,Champions
132,2305,9,17,1,2,2,5,Lost
152,1629,10,21,1,2,2,5,Lost
444,32,7,15,5,2,1,8,Promising
665,60,67,174,5,5,5,15,Champions
671,405,40,100,3,4,4,11,Loyal Users
1114,406,5,8,3,1,1,5,Casual Users
1206,653,13,16,2,3,2,7,Casual Users
2056,116,7,74,4,2,4,10,Promising
2466,457,10,17,3,2,2,7,Casual Users
2582,1124,8,14,2,2,1,5,Lost
2829,2477,5,15,1,1,1,3,Lost
3104,15,60,109,5,5,4,14,Champions
3336,242,51,111,3,5,4,12,Loyal Users
3721,4945,22,26,1,4,2,7,At Risk
3734,4639,5,25,1,1,2,4,Lost
3857,20,10,25,5,2,2,9,Promising
3919,132,17,41,4,3,3,10,Loyal Users
4246,3141,10,11,1,2,1,4,Lost
4327,60,43,104,5,4,4,13,Champions
4604,77,20,84,4,3,4,11,Loyal Users
4733,127,15,65,4,3,4,11,Loyal Users
4822,3,25,29,5,4,2,11,Loyal Users
4828,262,38,54,3,4,3,10,Loyal Users
5286,3542,7,11,1,2,1,4,Lost
5309,672,7,19,2,2,2,6,Lost
5547,119,33,119,4,4,4,12,Champions
5593,5465,22,46,1,4,3,8,At Risk
5868,835,27,44,2,4,3,9,At Risk
6067,945,8,22,2,2,2,6,Lost
6076,116,62,426,4,5,5,14,Champions
6116,748,6,35,2,1,3,6,Lost
6125,4,121,189,5,5,5,15,Champions
6139,111,103,223,4,5,5,14,Champions
6536,2618,29,60,1,4,3,8,At Risk
6560,8,6,12,5,1,1,7,Promising
6774,702,11,22,2,2,2,6,Lost
6917,410,8,21,3,2,2,7,Casual Users
7119,688,7,9,2,2,1,5,Lost
7398,129,15,80,4,3,4,11,Loyal Users
7560,3283,7,18,1,2,2,5,Lost
7696,450,5,18,3,1,2,6,Casual Users
7875,247,16,40,3,3,3,9,Loyal Users
7967,141,30,55,4,4,3,11,Loyal Users
8010,303,6,8,3,1,1,5,Casual Users
8015,117,21,94,4,3,4,11,Loyal Users
8138,1123,9,9,2,2,1,5,Lost
8200,269,36,56,3,4,3,10,Loyal Users
8207,449,31,57,3,4,3,10,Loyal Users
9507,724,13,22,2,3,2,7,Casual Users
9782,677,6,10,2,1,1,4,Lost
10140,235,16,22,3,3,2,8,Loyal Users
10208,1432,8,21,1,2,2,5,Lost
10336,1711,8,25,1,2,2,5,Lost
10410,700,20,86,2,3,4,9,Casual Users
10421,746,12,83,2,3,4,9,Casual Users
10604,434,12,39,3,3,3,9,Loyal Users
10664,138,23,31,4,4,2,10,Loyal Users
10903,122,15,49,4,3,3,10,Loyal Users
11252,177,10,13,3,2,1,6,Casual Users
11289,1150,11,28,2,2,2,6,Lost
11492,278,16,24,3,3,2,8,Loyal Users
11781,181,23,35,3,4,3,10,Loyal Users
11882,140,10,11,4,2,1,7,Promising
11992,12,90,517,5,5,5,15,Champions
12431,575,13,32,2,3,3,8,Casual Users
12432,106,14,48,4,3,3,10,Loyal Users
12513,693,5,6,2,1,1,4,Lost
12765,850,6,11,2,1,1,4,Lost
13342,128,61,174,4,5,5,14,Champions
13489,1,105,332,5,5,5,15,Champions
13552,101,49,158,4,5,5,14,Champions
185,191,25,45,3,4,3,10,Loyal Users
305,1144,6,6,2,1,1,4,Lost
353,118,109,129,4,5,4,13,Champions
355,1030,5,7,2,1,1,4,Lost
618,1298,5,8,1,1,1,3,Lost
694,1607,7,20,1,2,2,5,Lost
696,109,29,195,4,4,5,13,Champions
747,7,20,102,5,3,4,12,Loyal Users
882,251,7,22,3,2,2,7,Casual Users
1512,209,43,56,3,4,3,10,Loyal Users
1542,4861,26,91,1,4,4,9,At Risk
1586,31,9,9,5,2,1,8,Promising
1599,566,10,41,2,2,3,7,Lost
1694,2277,5,6,1,1,1,3,Lost
1786,3783,6,10,1,1,1,3,Lost
2045,335,17,89,3,3,4,10,Loyal Users
2092,715,14,74,2,3,4,9,Casual Users
2312,161,16,40,4,3,3,10,Loyal Users
2616,161,20,132,4,3,4,11,Loyal Users
2882,73,66,117,4,5,4,13,Champions
2898,810,7,28,2,2,2,6,Lost
3155,1201,9,19,2,2,2,6,Lost
3349,514,15,69,2,3,4,9,Casual Users
3379,295,50,119,3,5,4,12,Loyal Users
3940,22,27,94,5,4,4,13,Champions
4185,1838,13,47,1,3,3,7,Casual Users
4469,1714,38,87,1,4,4,9,At Risk
4641,466,17,41,3,3,3,9,Loyal Users
4844,2866,14,68,1,3,4,8,Casual Users
4893,2392,6,11,1,1,1,3,Lost
5129,22,37,71,5,4,4,13,Champions
5334,180,7,8,3,2,1,6,Casual Users
5354,1525,8,15,1,2,1,4,Lost
5609,4988,5,5,1,1,1,3,Lost
6097,246,106,319,3,5,5,13,Loyal Users
6480,3,113,368,5,5,5,15,Champions
7234,157,11,19,4,2,2,8,Promising
7347,19,102,321,5,5,5,15,Champions
7361,33,6,43,5,1,3,9,Promising
7488,248,39,128,3,4,4,11,Loyal Users
7691,965,11,38,2,2,3,7,Lost
7902,1592,6,16,1,1,2,4,Lost
8029,295,23,157,3,4,5,12,Loyal Users
8271,453,15,120,3,3,4,10,Loyal Users
9732,673,31,86,2,4,4,10,At Risk
10342,124,37,223,4,4,5,13,Champions
10352,575,7,13,2,2,1,5,Lost
10377,695,11,69,2,2,4,8,Lost
10518,860,12,62,2,3,3,8,Casual Users
10589,25,33,50,5,4,3,12,Loyal Users
11250,34,10,12,5,2,1,8,Promising
11314,764,20,40,2,3,3,8,Casual Users
11335,2806,25,41,1,4,3,8,At Risk
11408,812,6,8,2,1,1,4,Lost
11707,2489,12,26,1,3,2,6,Casual Users
11764,497,22,135,2,4,4,10,At Risk
12349,1394,5,7,1,1,1,3,Lost
12421,1728,10,13,1,2,1,4,Lost
12473,1375,6,13,1,1,1,3,Lost
291,2877,12,18,1,3,2,6,Casual Users
325,6,10,49,5,2,3,10,Promising
386,5348,8,13,1,2,1,4,Lost
906,2100,6,27,1,1,2,4,Lost
955,571,8,15,2,2,1,5,Lost
1288,236,10,48,3,2,3,8,Casual Users
1306,409,15,119,3,3,4,10,Loyal Users
1311,1887,5,5,1,1,1,3,Lost
1723,18,49,168,5,5,5,15,Champions
1774,596,50,130,2,5,4,11,At Risk
2082,133,39,78,4,4,4,12,Champions
2108,845,18,48,2,3,3,8,Casual Users
2219,5082,6,15,1,1,1,3,Lost
2339,2868,5,22,1,1,2,4,Lost
2483,79,16,25,4,3,2,9,Loyal Users
2647,1015,17,43,2,3,3,8,Casual Users
3029,281,49,120,3,5,4,12,Loyal Users
3095,2205,9,16,1,2,2,5,Lost
5018,181,97,340,3,5,5,13,Loyal Users
5285,168,94,127,3,5,4,12,Loyal Users
5344,622,6,16,2,1,2,5,Lost
5365,247,14,82,3,3,4,10,Loyal Users
5450,411,21,80,3,3,4,10,Loyal Users
5595,11,14,35,5,3,3,11,Loyal Users
5639,2172,7,12,1,2,1,4,Lost
6692,487,15,50,2,3,3,8,Casual Users
6706,2876,17,88,1,3,4,8,Casual Users
6712,432,5,12,3,1,1,5,Casual Users
7001,100,146,240,4,5,5,14,Champions
7236,2672,5,18,1,1,2,4,Lost
7323,874,38,215,2,4,5,11,At Risk
7367,2982,6,11,1,1,1,3,Lost
7519,1007,5,20,2,1,2,5,Lost
7607,1369,5,11,1,1,1,3,Lost
7642,345,25,136,3,4,4,11,Loyal Users
7748,1,33,90,5,4,4,13,Champions
7898,3738,5,20,1,1,2,4,Lost
8218,105,80,198,4,5,5,14,Champions
8751,125,110,318,4,5,5,14,Champions
8893,109,54,166,4,5,5,14,Champions
9516,3471,8,35,1,2,3,6,Lost
9533,69,55,140,5,5,4,14,Champions
10235,1,7,11,5,2,1,8,Promising
10311,947,25,60,2,4,3,9,At Risk
10346,13,97,619,5,5,5,15,Champions
10480,110,42,126,4,4,4,12,Champions
10586,505,21,71,2,3,4,9,Casual Users
10774,55,164,522,5,5,5,15,Champions
10962,282,9,21,3,2,2,7,Casual Users
10984,2859,18,29,1,3,2,6,Casual Users
11113,809,16,49,2,3,3,8,Casual Users
11278,440,5,6,3,1,1,5,Casual Users
11330,5,25,67,5,4,4,13,Champions
11397,219,13,58,3,3,3,9,Loyal Users
11514,718,8,47,2,2,3,7,Lost
11616,275,12,42,3,3,3,9,Loyal Users
12003,109,44,172,4,4,5,13,Champions
12032,2228,7,24,1,2,2,5,Lost
12045,905,16,134,2,3,4,9,Casual Users
12168,92,180,613,4,5,5,14,Champions
12391,407,109,208,3,5,5,13,Loyal Users
13085,255,18,30,3,3,2,8,Loyal Users
13093,50,30,111,5,4,4,13,Champions
435,1715,18,28,1,3,2,6,Casual Users
473,223,6,10,3,1,1,5,Casual Users
581,1702,5,11,1,1,1,3,Lost
603,130,9,33,4,2,3,9,Promising
660,1,111,277,5,5,5,15,Champions
748,2,114,535,5,5,5,15,Champions
774,355,12,27,3,3,2,8,Loyal Users
912,1835,16,56,1,3,3,7,Casual Users
935,124,40,172,4,4,5,13,Champions
1170,277,22,26,3,4,2,9,Loyal Users
1266,110,23,116,4,4,4,12,Champions
1382,527,61,167,2,5,5,12,At Risk
1590,301,6,18,3,1,2,6,Casual Users
1626,2047,6,9,1,1,1,3,Lost
1681,513,9,13,2,2,1,5,Lost
2191,5090,8,30,1,2,2,5,Lost
2635,1482,6,6,1,1,1,3,Lost
2796,139,111,224,4,5,5,14,Champions
2840,1340,10,12,1,2,1,4,Lost
2886,32,14,43,5,3,3,11,Loyal Users
3020,130,37,140,4,4,4,12,Champions
3073,1509,13,42,1,3,3,7,Casual Users
3121,5186,5,11,1,1,1,3,Lost
3261,985,7,17,2,2,2,6,Lost
3753,273,20,34,3,3,3,9,Loyal Users
3956,450,119,233,3,5,5,13,Loyal Users
3976,27,78,500,5,5,5,15,Champions
4162,278,37,131,3,4,4,11,Loyal Users
4435,107,56,190,4,5,5,14,Champions
4451,1014,11,14,2,2,1,5,Lost
4524,337,6,9,3,1,1,5,Casual Users
4987,1512,21,130,1,3,4,8,Casual Users
5245,110,116,586,4,5,5,14,Champions
5303,102,10,36,4,2,3,9,Promising
5315,219,7,115,3,2,4,9,Casual Users
5947,75,9,42,4,2,3,9,Promising
6099,406,18,57,3,3,3,9,Loyal Users
6618,3695,40,43,1,4,3,8,At Risk
6637,304,8,74,3,2,4,9,Casual Users
6687,5834,5,20,1,1,2,4,Lost
6718,244,30,69,3,4,4,11,Loyal Users
6778,5,30,37,5,4,3,12,Loyal Users
6932,78,9,17,4,2,2,8,Promising
7212,269,11,59,3,2,3,8,Casual Users
7228,85,5,7,4,1,1,6,Promising
7346,257,6,13,3,1,1,5,Casual Users
7555,139,48,98,4,5,4,13,Champions
7749,1504,15,92,1,3,4,8,Casual Users
7861,4,61,337,5,5,5,15,Champions
7944,116,116,334,4,5,5,14,Champions
8040,140,48,202,4,5,5,14,Champions
8088,2181,5,5,1,1,1,3,Lost
8165,246,6,19,3,1,2,6,Casual Users
8523,4299,6,9,1,1,1,3,Lost
9001,2257,5,5,1,1,1,3,Lost
9340,21,75,95,5,5,4,14,Champions
9603,227,40,124,3,4,4,11,Loyal Users
9654,670,5,52,2,1,3,6,Lost
9678,89,7,20,4,2,2,8,Promising
9725,155,5,9,4,1,1,6,Promising
9931,1545,8,14,1,2,1,4,Lost
10002,6,112,491,5,5,5,15,Champions
10583,819,19,98,2,3,4,9,Casual Users
10932,228,28,69,3,4,4,11,Loyal Users
11310,912,48,196,2,5,5,12,At Risk
11766,33,27,43,5,4,3,12,Loyal Users
11805,2241,10,10,1,2,1,4,Lost
11978,83,13,43,4,3,3,10,Loyal Users
12316,41,33,105,5,4,4,13,Champions
12440,10,6,31,5,1,2,8,Promising
12667,1941,7,29,1,2,2,5,Lost
12896,847,5,5,2,1,1,4,Lost
13351,128,23,86,4,4,4,12,Champions
13498,123,68,115,4,5,4,13,Champions
13521,715,21,67,2,3,4,9,Casual Users
146,2555,5,9,1,1,1,3,Lost
704,1521,8,32,1,2,3,6,Lost
1122,988,5,32,2,1,3,6,Lost
1145,103,96,262,4,5,5,14,Champions
1247,23,62,254,5,5,5,15,Champions
1304,4109,5,5,1,1,1,3,Lost
1488,86,39,92,4,4,4,12,Champions
1491,222,121,670,3,5,5,13,Loyal Users
2320,823,37,95,2,4,4,10,At Risk
2329,1478,12,15,1,3,1,5,Casual Users
2760,123,34,78,4,4,4,12,Champions
3206,2982,5,18,1,1,2,4,Lost
3421,11,110,364,5,5,5,15,Champions
3636,808,40,72,2,4,4,10,At Risk
3752,579,8,10,2,2,1,5,Lost
3798,162,15,26,4,3,2,9,Loyal Users
3923,412,19,19,3,3,2,8,Loyal Users
3927,16,51,203,5,5,5,15,Champions
3970,1311,18,286,1,3,5,9,Casual Users
4111,5115,26,71,1,4,4,9,At Risk
4174,144,62,314,4,5,5,14,Champions
4428,303,21,60,3,3,3,9,Loyal Users
4472,116,6,19,4,1,2,7,Promising
4656,227,18,26,3,3,2,8,Loyal Users
4663,281,8,41,3,2,3,8,Casual Users
4766,1873,10,102,1,2,4,7,Lost
4898,383,14,31,3,3,2,8,Loyal Users
5047,5098,10,20,1,2,2,5,Lost
5306,935,9,22,2,2,2,6,Lost
5624,452,16,55,3,3,3,9,Loyal Users
5879,246,23,25,3,4,2,9,Loyal Users
6366,422,5,5,3,1,1,5,Casual Users
6382,270,47,267,3,5,5,13,Loyal Users
6384,523,8,25,2,2,2,6,Lost
6720,88,12,34,4,3,3,10,Loyal Users
6902,305,72,219,3,5,5,13,Loyal Users
7221,2,99,279,5,5,5,15,Champions
7335,3439,11,45,1,2,3,6,Lost
7343,148,39,169,4,4,5,13,Champions
7570,122,25,57,4,4,3,11,Loyal Users
7854,756,21,70,2,3,4,9,Casual Users
7990,686,7,14,2,2,1,5,Lost
8007,955,21,43,2,3,3,8,Casual Users
8770,1113,9,16,2,2,2,6,Lost
9117,449,41,134,3,4,4,11,Loyal Users
9291,255,10,42,3,2,3,8,Casual Users
9323,382,10,36,3,2,3,8,Casual Users
9399,2705,5,13,1,1,1,3,Lost
9418,429,9,10,3,2,1,6,Casual Users
9625,2309,6,7,1,1,1,3,Lost
9754,530,6,7,2,1,1,4,Lost
10463,366,21,86,3,3,4,10,Loyal Users
10869,993,5,18,2,1,2,5,Lost
10871,4952,5,21,1,1,2,4,Lost
11196,2837,5,5,1,1,1,3,Lost
11321,448,12,17,3,3,2,8,Loyal Users
11391,40,102,225,5,5,5,15,Champions
12042,103,37,68,4,4,4,12,Champions
12056,1664,5,8,1,1,1,3,Lost
12123,827,8,12,2,2,1,5,Lost
12125,2095,5,8,1,1,1,3,Lost
12167,3132,8,41,1,2,3,6,Lost
12474,5,165,393,5,5,5,15,Champions
12631,2,6,13,5,1,1,7,Promising
12704,132,73,174,4,5,5,14,Champions
12791,126,72,283,4,5,5,14,Champions
12828,5,6,6,5,1,1,7,Promising
12834,2105,10,13,1,2,1,4,Lost
12994,2,67,86,5,5,4,14,Champions
13036,568,20,110,2,3,4,9,Casual Users
13106,1228,72,139,2,5,4,11,At Risk
13168,313,21,37,3,3,3,9,Loyal Users
13249,1753,17,25,1,3,2,6,Casual Users
13397,11,17,24,5,3,2,10,Loyal Users
13518,81,19,91,4,3,4,11,Loyal Users
259,46,5,11,5,1,1,7,Promising
512,155,5,14,4,1,1,6,Promising
797,440,11,22,3,2,2,7,Casual Users
1595,148,13,34,4,3,3,10,Loyal Users
1664,831,19,29,2,3,2,7,Casual Users
1773,389,101,438,3,5,5,13,Loyal Users
1802,390,12,27,3,3,2,8,Loyal Users
2054,47,29,36,5,4,3,12,Loyal Users
2239,2377,8,19,1,2,2,5,Lost
2614,106,6,14,4,1,1,6,Promising
2781,3558,9,13,1,2,1,4,Lost
2941,2745,6,24,1,1,2,4,Lost
3025,699,17,45,2,3,3,8,Casual Users
3283,971,11,102,2,2,4,8,Lost
3449,2864,7,65,1,2,4,7,Lost
3648,1889,71,237,1,5,5,11,At Risk
3819,7,11,17,5,2,2,9,Promising
3826,2627,6,6,1,1,1,3,Lost
4102,4,25,57,5,4,3,12,Loyal Users
4515,131,20,69,4,3,4,11,Loyal Users
4561,5538,5,11,1,1,1,3,Lost
4786,222,8,12,3,2,1,6,Casual Users
4842,235,11,20,3,2,2,7,Casual Users
4973,89,19,38,4,3,3,10,Loyal Users
5499,5018,14,44,1,3,3,7,Casual Users
5611,986,7,11,2,2,1,5,Lost
5864,432,8,8,3,2,1,6,Casual Users
5959,935,12,44,2,3,3,8,Casual Users
6177,4224,14,20,1,3,2,6,Casual Users
6234,74,10,14,4,2,1,7,Promising
7355,275,68,89,3,5,4,12,Loyal Users
7472,497,30,62,2,4,3,9,At Risk
7723,10,156,467,5,5,5,15,Champions
7725,152,30,99,4,4,4,12,Champions
7768,844,5,7,2,1,1,4,Lost
7887,32,87,177,5,5,5,15,Champions
8025,230,32,295,3,4,5,12,Loyal Users
8610,87,5,8,4,1,1,6,Promising
8683,421,15,52,3,3,3,9,Loyal Users
9459,588,8,30,2,2,2,6,Lost
9758,71,56,189,4,5,5,14,Champions
10025,396,24,48,3,4,3,10,Loyal Users
10131,3012,7,22,1,2,2,5,Lost
10161,1941,95,464,1,5,5,11,At Risk
10348,142,42,102,4,4,4,12,Champions
10514,1463,10,17,1,2,2,5,Lost
10613,13,7,11,5,2,1,8,Promising
10650,4,22,29,5,4,2,11,Loyal Users
10792,197,5,6,3,1,1,5,Casual Users
11023,63,7,32,5,2,3,10,Promising
11180,2,37,74,5,4,4,13,Champions
11382,3821,5,31,1,1,2,4,Lost
11585,119,28,107,4,4,4,12,Champions
11625,3267,37,73,1,4,4,9,At Risk
11878,2387,14,24,1,3,2,6,Casual Users
11917,2128,5,13,1,1,1,3,Lost
12044,1495,6,8,1,1,1,3,Lost
12190,1096,10,27,2,2,2,6,Lost
12259,1078,6,32,2,1,3,6,Lost
12408,665,13,27,2,3,2,7,Casual Users
12414,2693,5,9,1,1,1,3,Lost
12983,117,53,177,4,5,5,14,Champions
1,123,50,117,4,5,4,13,Champions
206,97,57,173,4,5,5,14,Champions
896,623,41,95,2,4,4,10,At Risk
1008,5663,7,38,1,2,3,6,Lost
1172,77,24,64,4,4,4,12,Champions
1391,1711,6,18,1,1,2,4,Lost
1504,838,16,30,2,3,2,7,Casual Users
1516,542,9,14,2,2,1,5,Lost
2296,210,15,71,3,3,4,10,Loyal Users
2775,33,27,105,5,4,4,13,Champions
2780,10,16,17,5,3,2,10,Loyal Users
2786,46,166,737,5,5,5,15,Champions
2957,1108,6,12,2,1,1,4,Lost
3059,1904,6,8,1,1,1,3,Lost
3125,1252,6,20,2,1,2,5,Lost
3208,410,19,53,3,3,3,9,Loyal Users
3282,815,6,37,2,1,3,6,Lost
3452,115,7,29,4,2,2,8,Promising
4041,171,9,23,3,2,2,7,Casual Users
4311,55,34,97,5,4,4,13,Champions
4338,828,10,101,2,2,4,8,Lost
4351,414,45,142,3,4,4,11,Loyal Users
4931,433,6,8,3,1,1,5,Casual Users
5192,245,6,25,3,1,2,6,Casual Users
5763,15,85,409,5,5,5,15,Champions
5811,160,7,66,4,2,4,10,Promising
5960,140,15,41,4,3,3,10,Loyal Users
6230,2766,11,42,1,2,3,6,Lost
6313,138,17,71,4,3,4,11,Loyal Users
6387,40,55,121,5,5,4,14,Champions
7042,2995,7,43,1,2,3,6,Lost
7087,1590,6,12,1,1,1,3,Lost
7143,223,11,34,3,2,3,8,Casual Users
7720,222,10,22,3,2,2,7,Casual Users
7931,119,84,668,4,5,5,14,Champions
8451,5499,5,18,1,1,2,4,Lost
8587,182,8,11,3,2,1,6,Casual Users
8637,702,87,230,2,5,5,12,At Risk
8830,95,9,12,4,2,1,7,Promising
8943,926,42,89,2,4,4,10,At Risk
8982,123,55,82,4,5,4,13,Champions
9471,3,61,111,5,5,4,14,Champions
10046,101,151,252,4,5,5,14,Champions
10376,975,14,53,2,3,3,8,Casual Users
10666,3,16,36,5,3,3,11,Loyal Users
10953,273,20,86,3,3,4,10,Loyal Users
10966,131,7,8,4,2,1,7,Promising
11168,2,22,32,5,4,3,12,Loyal Users
11572,186,75,290,3,5,5,13,Loyal Users
11996,3808,9,13,1,2,1,4,Lost
12063,272,26,150,3,4,5,12,Loyal Users
12186,503,79,207,2,5,5,12,At Risk
12565,80,82,108,4,5,4,13,Champions
12671,1603,7,21,1,2,2,5,Lost
12768,529,15,21,2,3,2,7,Casual Users
13251,768,9,27,2,2,2,6,Lost
13316,233,8,15,3,2,1,6,Casual Users
13356,233,13,24,3,3,2,8,Loyal Users
52,161,14,61,4,3,3,10,Loyal Users
297,443,16,17,3,3,2,8,Loyal Users
363,2031,52,233,1,5,5,11,At Risk
768,1643,7,26,1,2,2,5,Lost
770,415,6,12,3,1,1,5,Casual Users
777,354,50,54,3,5,3,11,Loyal Users
1302,417,16,39,3,3,3,9,Loyal Users
1485,1702,14,15,1,3,1,5,Casual Users
1683,2503,6,6,1,1,1,3,Lost
1798,90,40,159,4,4,5,13,Champions
1812,154,87,274,4,5,5,14,Champions
1902,1899,49,184,1,5,5,11,At Risk
2138,1140,7,16,2,2,2,6,Lost
2183,284,13,23,3,3,2,8,Loyal Users
2364,22,244,432,5,5,5,15,Champions
2475,5290,8,25,1,2,2,5,Lost
2763,23,20,63,5,3,4,12,Loyal Users
3030,160,63,129,4,5,4,13,Champions
3060,16,35,86,5,4,4,13,Champions
3147,1435,17,24,1,3,2,6,Casual Users
3570,712,5,11,2,1,1,4,Lost
3593,3027,5,21,1,1,2,4,Lost
3622,1802,6,7,1,1,1,3,Lost
3774,267,23,132,3,4,4,11,Loyal Users
3861,707,7,16,2,2,2,6,Lost
4312,91,26,164,4,4,5,13,Champions
4315,2837,5,5,1,1,1,3,Lost
4464,434,12,114,3,3,4,10,Loyal Users
4466,593,18,21,2,3,2,7,Casual Users
4475,381,5,26,3,1,2,6,Casual Users
5496,28,8,10,5,2,1,8,Promising
5791,41,72,348,5,5,5,15,Champions
5819,725,15,22,2,3,2,7,Casual Users
5900,3,80,244,5,5,5,15,Champions
5950,160,5,11,4,1,1,6,Promising
5968,97,28,53,4,4,3,11,Loyal Users
6221,50,20,61,5,3,3,11,Loyal Users
6318,2901,6,9,1,1,1,3,Lost
6362,48,168,332,5,5,5,15,Champions
6457,663,13,45,2,3,3,8,Casual Users
6481,320,8,43,3,2,3,8,Casual Users
6766,1821,6,12,1,1,1,3,Lost
7078,40,38,93,5,4,4,13,Champions
7271,1788,12,23,1,3,2,6,Casual Users
7468,4181,47,89,1,5,4,10,At Risk
7806,126,101,168,4,5,5,14,Champions
7994,29,56,100,5,5,4,14,Champions
8176,300,12,98,3,3,4,10,Loyal Users
8191,72,32,221,4,4,5,13,Champions
8205,566,7,9,2,2,1,5,Lost
8208,2667,6,24,1,1,2,4,Lost
9076,864,7,12,2,2,1,5,Lost
9088,1270,20,57,1,3,3,7,Casual Users
9234,331,6,11,3,1,1,5,Casual Users
9624,10,83,156,5,5,5,15,Champions
9763,6,98,445,5,5,5,15,Champions
9864,686,16,86,2,3,4,9,Casual Users
10407,822,7,14,2,2,1,5,Lost
10485,284,35,246,3,4,5,12,Loyal Users
10900,11,31,90,5,4,4,13,Champions
11050,394,6,14,3,1,1,5,Casual Users
11271,114,83,106,4,5,4,13,Champions
11404,5,5,14,5,1,1,7,Promising
12853,74,22,67,4,4,4,12,Champions
12966,27,111,187,5,5,5,15,Champions
13063,101,26,103,4,4,4,12,Champions
13226,817,14,73,2,3,4,9,Casual Users
13470,231,6,28,3,1,2,6,Casual Users
13571,114,56,123,4,5,4,13,Champions
212,22,114,644,5,5,5,15,Champions
674,12,138,529,5,5,5,15,Champions
715,1088,7,16,2,2,2,6,Lost
992,28,22,31,5,4,2,11,Loyal Users
1047,1538,6,6,1,1,1,3,Lost
1190,11,59,210,5,5,5,15,Champions
1400,344,14,23,3,3,2,8,Loyal Users
1427,245,11,33,3,2,3,8,Casual Users
1458,410,8,18,3,2,2,7,Casual Users
1546,1117,12,26,2,3,2,7,Casual Users
1651,140,24,45,4,4,3,11,Loyal Users
2155,95,19,101,4,3,4,11,Loyal Users
2600,312,15,21,3,3,2,8,Loyal Users
2603,1121,11,23,2,2,2,6,Lost
2637,539,71,94,2,5,4,11,At Risk
2967,137,7,16,4,2,2,8,Promising
3006,48,18,105,5,3,4,12,Loyal Users
3162,2955,8,10,1,2,1,4,Lost
3453,3,12,19,5,3,2,10,Loyal Users
3541,15,29,114,5,4,4,13,Champions
4349,51,83,210,5,5,5,15,Champions
4438,47,129,426,5,5,5,15,Champions
4569,1092,5,17,2,1,2,5,Lost
4614,304,34,208,3,4,5,12,Loyal Users
4979,3570,5,6,1,1,1,3,Lost
5097,138,24,71,4,4,4,12,Champions
5122,0,7,35,5,2,3,10,Promising
5204,123,16,40,4,3,3,10,Loyal Users
5255,7,143,446,5,5,5,15,Champions
5336,38,81,738,5,5,5,15,Champions
5341,2297,6,13,1,1,1,3,Lost
5539,160,32,61,4,4,3,11,Loyal Users
5599,735,7,17,2,2,2,6,Lost
5761,167,12,43,3,3,3,9,Loyal Users
6227,0,52,273,5,5,5,15,Champions
6294,9,170,403,5,5,5,15,Champions
6498,56,58,171,5,5,5,15,Champions
6563,110,81,168,4,5,5,14,Champions
6786,962,9,40,2,2,3,7,Lost
6813,804,19,33,2,3,3,8,Casual Users
6837,400,31,225,3,4,5,12,Loyal Users
7140,482,13,85,2,3,4,9,Casual Users
7230,120,17,48,4,3,3,10,Loyal Users
7289,799,9,58,2,2,3,7,Lost
7769,212,11,16,3,2,2,7,Casual Users
7802,567,5,9,2,1,1,4,Lost
8158,118,49,276,4,5,5,14,Champions
8445,697,12,273,2,3,5,10,Casual Users
8699,126,37,152,4,4,5,13,Champions
8785,167,16,95,3,3,4,10,Loyal Users
9105,155,75,318,4,5,5,14,Champions
9279,117,22,71,4,4,4,12,Champions
9283,2231,7,21,1,2,2,5,Lost
9722,127,6,22,4,1,2,7,Promising
9752,417,14,25,3,3,2,8,Loyal Users
9983,900,33,183,2,4,5,11,At Risk
10318,833,18,59,2,3,3,8,Casual Users
10540,1388,22,49,1,4,3,8,At Risk
11573,24,57,253,5,5,5,15,Champions
11641,1411,8,49,1,2,3,6,Lost
11773,64,8,42,5,2,3,10,Promising
11785,1178,8,20,2,2,2,6,Lost
11854,1520,6,15,1,1,1,3,Lost
12054,1085,13,113,2,3,4,9,Casual Users
12062,530,6,17,2,1,2,5,Lost
12360,97,12,47,4,3,3,10,Loyal Users
12442,59,84,242,5,5,5,15,Champions
12529,3235,22,30,1,4,2,7,At Risk
12574,148,17,45,4,3,3,10,Loyal Users
12638,2082,5,17,1,1,2,4,Lost
12867,184,17,41,3,3,3,9,Loyal Users
13428,613,8,251,2,2,5,9,Lost
274,420,8,35,3,2,3,8,Casual Users
631,470,10,87,3,2,4,9,Casual Users
1434,90,44,153,4,4,5,13,Champions
1473,2963,14,21,1,3,2,6,Casual Users
1616,9,55,319,5,5,5,15,Champions
1722,41,7,9,5,2,1,8,Promising
1878,19,114,216,5,5,5,15,Champions
1922,711,15,42,2,3,3,8,Casual Users
2170,3156,5,5,1,1,1,3,Lost
2256,1104,23,43,2,4,3,9,At Risk
2344,176,81,265,3,5,5,13,Loyal Users
2363,278,5,19,3,1,2,6,Casual Users
2575,111,67,123,4,5,4,13,Champions
2633,448,5,5,3,1,1,5,Casual Users
2698,250,30,121,3,4,4,11,Loyal Users
2989,1299,15,25,1,3,2,6,Casual Users
3058,134,9,31,4,2,2,8,Promising
3111,2417,66,134,1,5,4,10,At Risk
3172,207,58,161,3,5,5,13,Loyal Users
3192,1531,6,35,1,1,3,5,Lost
3210,278,38,108,3,4,4,11,Loyal Users
3446,1708,9,30,1,2,2,5,Lost
3474,2643,5,8,1,1,1,3,Lost
3607,4699,5,18,1,1,2,4,Lost
3754,981,16,46,2,3,3,8,Casual Users
3987,396,51,94,3,5,4,12,Loyal Users
4093,44,21,36,5,3,3,11,Loyal Users
4325,353,39,69,3,4,4,11,Loyal Users
4450,893,65,75,2,5,4,11,At Risk
4680,562,6,8,2,1,1,4,Lost
4688,1108,18,36,2,3,3,8,Casual Users
4775,65,19,100,5,3,4,12,Loyal Users
5000,1281,6,15,1,1,1,3,Lost
5077,1162,22,69,2,4,4,10,At Risk
5114,1229,14,71,2,3,4,9,Casual Users
5588,2131,7,21,1,2,2,5,Lost
6112,430,7,9,3,2,1,6,Casual Users
6223,21,70,200,5,5,5,15,Champions
6365,675,86,189,2,5,5,12,At Risk
6508,324,27,45,3,4,3,10,Loyal Users
6537,110,22,79,4,4,4,12,Champions
6907,281,12,82,3,3,4,10,Loyal Users
6975,281,54,114,3,5,4,12,Loyal Users
6996,529,10,17,2,2,2,6,Lost
7261,15,50,82,5,5,4,14,Champions
7611,2960,5,11,1,1,1,3,Lost
7616,295,76,585,3,5,5,13,Loyal Users
7707,63,86,300,5,5,5,15,Champions
7709,38,31,40,5,4,3,12,Loyal Users
7733,14,76,283,5,5,5,15,Champions
7780,735,28,110,2,4,4,10,At Risk
7789,384,8,27,3,2,2,7,Casual Users
8121,308,9,13,3,2,1,6,Casual Users
8449,423,13,24,3,3,2,8,Loyal Users
8531,85,81,153,4,5,5,14,Champions
9164,56,29,109,5,4,4,13,Champions
10054,392,8,16,3,2,2,7,Casual Users
10136,2128,11,13,1,2,1,4,Lost
10187,83,6,68,4,1,4,9,Promising
10215,225,10,11,3,2,1,6,Casual Users
10556,67,5,8,5,1,1,7,Promising
10697,270,71,133,3,5,4,12,Loyal Users
10791,6,7,52,5,2,3,10,Promising
10894,273,74,203,3,5,5,13,Loyal Users
10948,70,12,18,4,3,2,9,Loyal Users
10975,102,33,113,4,4,4,12,Champions
11001,2,43,74,5,4,4,13,Champions
11419,70,33,54,4,4,3,11,Loyal Users
11539,2304,46,79,1,5,4,10,At Risk
11633,1424,5,10,1,1,1,3,Lost
11674,2099,10,29,1,2,2,5,Lost
11759,5,41,81,5,4,4,13,Champions
11793,2574,5,8,1,1,1,3,Lost
12025,2259,16,31,1,3,2,6,Casual Users
12075,506,21,103,2,3,4,9,Casual Users
12295,62,89,390,5,5,5,15,Champions
12306,210,22,61,3,4,3,10,Loyal Users
12346,1808,11,15,1,2,1,4,Lost
12461,730,11,42,2,2,3,7,Lost
12491,296,22,74,3,4,4,11,Loyal Users
13533,822,15,30,2,3,2,7,Casual Users
182,8,91,181,5,5,5,15,Champions
442,265,71,258,3,5,5,13,Loyal Users
689,24,12,69,5,3,4,12,Loyal Users
699,1855,14,20,1,3,2,6,Casual Users
792,695,29,58,2,4,3,9,At Risk
1137,639,45,68,2,4,4,10,At Risk
1323,308,13,19,3,3,2,8,Loyal Users
1399,2438,11,15,1,2,1,4,Lost
1608,8,39,101,5,4,4,13,Champions
1644,964,35,49,2,4,3,9,At Risk
1770,858,24,81,2,4,4,10,At Risk
1822,167,44,84,3,4,4,11,Loyal Users
2059,12,123,747,5,5,5,15,Champions
2213,163,47,86,4,5,4,13,Champions
2380,463,5,6,3,1,1,5,Casual Users
2768,226,7,21,3,2,2,7,Casual Users
3032,640,29,69,2,4,4,10,At Risk
3197,117,6,53,4,1,3,8,Promising
3272,110,70,230,4,5,5,14,Champions
3978,248,6,15,3,1,1,5,Casual Users
4288,3875,7,9,1,2,1,4,Lost
4304,277,22,53,3,4,3,10,Loyal Users
4757,478,5,6,2,1,1,4,Lost
4877,128,48,168,4,5,5,14,Champions
4936,595,41,103,2,4,4,10,At Risk
5082,136,22,33,4,4,3,11,Loyal Users
5144,1096,9,25,2,2,2,6,Lost
5231,166,13,17,3,3,2,8,Loyal Users
5621,106,52,174,4,5,5,14,Champions
5649,126,35,111,4,4,4,12,Champions
6194,1003,12,43,2,3,3,8,Casual Users
6543,60,45,72,5,4,4,13,Champions
6729,8,38,106,5,4,4,13,Champions
7008,3526,6,11,1,1,1,3,Lost
7217,425,16,63,3,3,4,10,Loyal Users
7269,3,244,559,5,5,5,15,Champions
7500,434,6,11,3,1,1,5,Casual Users
7855,417,6,13,3,1,1,5,Casual Users
7925,58,15,58,5,3,3,11,Loyal Users
8019,603,19,71,2,3,4,9,Casual Users
8238,118,9,15,4,2,1,7,Promising
8484,675,7,10,2,2,1,5,Lost
8562,139,9,40,4,2,3,9,Promising
8880,1223,5,34,2,1,3,6,Lost
8987,860,10,24,2,2,2,6,Lost
9152,25,38,110,5,4,4,13,Champions
9157,25,37,109,5,4,4,13,Champions
9158,1845,8,21,1,2,2,5,Lost
9476,413,64,330,3,5,5,13,Loyal Users
9493,90,25,79,4,4,4,12,Champions
9888,285,15,22,3,3,2,8,Loyal Users
10112,158,38,39,4,4,3,11,Loyal Users
10155,225,9,22,3,2,2,7,Casual Users
10216,58,17,39,5,3,3,11,Loyal Users
10294,140,14,59,4,3,3,10,Loyal Users
10304,9,68,322,5,5,5,15,Champions
10461,114,34,50,4,4,3,11,Loyal Users
10497,278,6,11,3,1,1,5,Casual Users
10572,572,7,15,2,2,1,5,Lost
10639,113,5,22,4,1,2,7,Promising
10663,795,38,58,2,4,3,9,At Risk
10928,127,60,187,4,5,5,14,Champions
11144,97,225,335,4,5,5,14,Champions
11644,235,66,87,3,5,4,12,Loyal Users
11892,425,7,24,3,2,2,7,Casual Users
11905,76,18,47,4,3,3,10,Loyal Users
11921,663,9,13,2,2,1,5,Lost
12500,288,6,40,3,1,3,7,Casual Users
12780,156,73,153,4,5,5,14,Champions
12936,76,38,123,4,4,4,12,Champions
12993,105,6,19,4,1,2,7,Promising
13067,3091,8,32,1,2,3,6,Lost
13119,285,8,16,3,2,2,7,Casual Users
13123,551,14,44,2,3,3,8,Casual Users
13247,24,44,326,5,4,5,14,Champions
13424,95,17,50,4,3,3,10,Loyal Users
13529,3201,7,14,1,2,1,4,Lost
13583,416,19,29,3,3,2,8,Loyal Users
13,119,8,18,4,2,2,8,Promising
218,202,84,410,3,5,5,13,Loyal Users
280,1015,10,51,2,2,3,7,Lost
348,408,100,388,3,5,5,13,Loyal Users
440,1318,21,31,1,3,2,6,Casual Users
734,417,11,20,3,2,2,7,Casual Users
1663,628,7,13,2,2,1,5,Lost
1682,18,17,25,5,3,2,10,Loyal Users
2318,560,67,90,2,5,4,11,At Risk
2337,88,102,172,4,5,5,14,Champions
2383,0,29,118,5,4,4,13,Champions
2455,2191,23,26,1,4,2,7,At Risk
2471,4883,11,14,1,2,1,4,Lost
2536,158,95,489,4,5,5,14,Champions
2956,0,8,93,5,2,4,11,Promising
3022,309,55,494,3,5,5,13,Loyal Users
3231,1688,8,47,1,2,3,6,Lost
3484,1901,14,141,1,3,4,8,Casual Users
3572,838,20,35,2,3,3,8,Casual Users
3786,4,31,116,5,4,4,13,Champions
4016,240,18,29,3,3,2,8,Loyal Users
4151,50,13,50,5,3,3,11,Loyal Users
4297,109,88,375,4,5,5,14,Champions
4487,2144,5,59,1,1,3,5,Lost
5193,3607,22,22,1,4,2,7,At Risk
5590,91,9,29,4,2,2,8,Promising
5612,580,10,39,2,2,3,7,Lost
5992,58,28,59,5,4,3,12,Loyal Users
6060,6,48,75,5,5,4,14,Champions
6282,8,50,123,5,5,4,14,Champions
6375,97,41,80,4,4,4,12,Champions
6578,1127,6,7,2,1,1,4,Lost
6612,4151,5,22,1,1,2,4,Lost
6714,12,11,13,5,2,1,8,Promising
6759,298,12,22,3,3,2,8,Loyal Users
7084,260,81,454,3,5,5,13,Loyal Users
7285,29,111,369,5,5,5,15,Champions
7286,1842,7,21,1,2,2,5,Lost
7615,447,7,15,3,2,1,6,Casual Users
7812,290,39,189,3,4,5,12,Loyal Users
7857,161,14,30,4,3,2,9,Loyal Users
7974,193,112,345,3,5,5,13,Loyal Users
8043,814,6,16,2,1,2,5,Lost
8144,2697,19,36,1,3,3,7,Casual Users
8256,415,8,74,3,2,4,9,Casual Users
8402,7,14,90,5,3,4,12,Loyal Users
8537,1165,9,14,2,2,1,5,Lost
8574,665,13,44,2,3,3,8,Casual Users
9055,164,16,22,4,3,2,9,Loyal Users
9073,126,29,66,4,4,4,12,Champions
9084,274,6,50,3,1,3,7,Casual Users
9317,1731,7,30,1,2,2,5,Lost
9328,152,61,114,4,5,4,13,Champions
9695,38,51,238,5,5,5,15,Champions
9719,363,52,97,3,5,4,12,Loyal Users
9885,111,30,70,4,4,4,12,Champions
9907,12,163,189,5,5,5,15,Champions
9944,173,7,9,3,2,1,6,Casual Users
9991,320,14,32,3,3,3,9,Loyal Users
10019,50,39,53,5,4,3,12,Loyal Users
10045,30,125,316,5,5,5,15,Champions
10326,118,42,91,4,4,4,12,Champions
10511,111,112,420,4,5,5,14,Champions
10610,30,80,171,5,5,5,15,Champions
10915,2830,58,70,1,5,4,10,At Risk
10918,233,16,135,3,3,4,10,Loyal Users
10973,9,38,256,5,4,5,14,Champions
11207,65,80,337,5,5,5,15,Champions
11741,2700,23,30,1,4,2,7,At Risk
12078,1068,6,15,2,1,1,4,Lost
12097,1092,9,35,2,2,3,7,Lost
12114,831,17,25,2,3,2,7,Casual Users
12576,311,25,49,3,4,3,10,Loyal Users
12719,114,58,350,4,5,5,14,Champions
13120,102,48,169,4,5,5,14,Champions
13469,31,14,19,5,3,2,10,Loyal Users
6,3602,10,10,1,2,1,4,Lost
16,417,8,13,3,2,1,6,Casual Users
86,4278,7,9,1,2,1,4,Lost
474,427,21,42,3,3,3,9,Loyal Users
636,134,105,203,4,5,5,14,Champions
760,14,18,43,5,3,3,11,Loyal Users
1089,819,6,6,2,1,1,4,Lost
1100,1336,17,105,1,3,4,8,Casual Users
1155,422,10,54,3,2,3,8,Casual Users
1267,2072,9,10,1,2,1,4,Lost
1367,382,14,24,3,3,2,8,Loyal Users
2102,126,48,84,4,5,4,13,Champions
2210,9,161,725,5,5,5,15,Champions
2281,9,88,874,5,5,5,15,Champions
2433,103,27,88,4,4,4,12,Champions
2685,153,24,128,4,4,4,12,Champions
3720,425,14,20,3,3,2,8,Loyal Users
4030,1550,19,23,1,3,2,6,Casual Users
4365,91,20,29,4,3,2,9,Loyal Users
4420,535,73,255,2,5,5,12,At Risk
4977,132,53,96,4,5,4,13,Champions
5281,12,8,24,5,2,2,9,Promising
5343,147,21,32,4,3,3,10,Loyal Users
5398,137,40,81,4,4,4,12,Champions
5967,840,33,93,2,4,4,10,At Risk
6244,379,15,45,3,3,3,9,Loyal Users
6755,23,93,342,5,5,5,15,Champions
6827,941,9,11,2,2,1,5,Lost
6999,427,6,13,3,1,1,5,Casual Users
7182,1691,6,10,1,1,1,3,Lost
7572,389,8,21,3,2,2,7,Casual Users
7617,11,16,67,5,3,4,12,Loyal Users
7793,131,6,27,4,1,2,7,Promising
8009,6,85,166,5,5,5,15,Champions
8199,7,44,141,5,4,4,13,Champions
8204,279,29,63,3,4,4,11,Loyal Users
8492,408,8,23,3,2,2,7,Casual Users
8513,26,104,641,5,5,5,15,Champions
9230,163,25,73,4,4,4,12,Champions
9312,142,14,36,4,3,3,10,Loyal Users
9353,546,48,114,2,5,4,11,At Risk
9607,1410,17,34,1,3,3,7,Casual Users
10562,867,8,29,2,2,2,6,Lost
10833,718,9,15,2,2,1,5,Lost
10835,275,16,37,3,3,3,9,Loyal Users
10937,228,60,132,3,5,4,12,Loyal Users
11030,451,10,16,3,2,2,7,Casual Users
11142,5119,10,36,1,2,3,6,Lost
11306,1196,5,9,2,1,1,4,Lost
11332,250,8,20,3,2,2,7,Casual Users
11947,35,22,60,5,4,3,12,Loyal Users
12106,2679,10,19,1,2,2,5,Lost
12743,65,110,373,5,5,5,15,Champions
13554,1052,18,24,2,3,2,7,Casual Users
168,6,68,151,5,5,5,15,Champions
205,5869,11,11,1,2,1,4,Lost
572,655,11,12,2,2,1,5,Lost
852,603,23,48,2,4,3,9,At Risk
887,212,19,47,3,3,3,9,Loyal Users
1952,2411,5,21,1,1,2,4,Lost
2158,138,43,276,4,4,5,13,Champions
2470,576,18,25,2,3,2,7,Casual Users
2520,988,10,21,2,2,2,6,Lost
2699,432,10,36,3,2,3,8,Casual Users
2911,14,17,81,5,3,4,12,Loyal Users
3813,2680,19,50,1,3,3,7,Casual Users
4220,2720,5,8,1,1,1,3,Lost
4565,93,13,25,4,3,2,9,Loyal Users
4570,2273,12,25,1,3,2,6,Casual Users
4672,13,34,86,5,4,4,13,Champions
4914,1665,10,12,1,2,1,4,Lost
4966,2,40,328,5,4,5,14,Champions
5001,129,15,105,4,3,4,11,Loyal Users
5016,1,13,19,5,3,2,10,Loyal Users
5158,109,13,77,4,3,4,11,Loyal Users
5167,1806,11,17,1,2,2,5,Lost
5234,4614,14,21,1,3,2,6,Casual Users
5382,96,55,148,4,5,5,14,Champions
5770,101,102,312,4,5,5,14,Champions
5777,2708,5,5,1,1,1,3,Lost
6146,407,5,9,3,1,1,5,Casual Users
6359,2016,7,86,1,2,4,7,Lost
6694,18,79,715,5,5,5,15,Champions
7402,1247,7,7,2,2,1,5,Lost
7660,1776,46,155,1,5,5,11,At Risk
8185,839,9,46,2,2,3,7,Lost
8226,10,59,80,5,5,4,14,Champions
8338,1885,15,51,1,3,3,7,Casual Users
8753,152,28,43,4,4,3,11,Loyal Users
9298,8,31,46,5,4,3,12,Loyal Users
9306,91,37,42,4,4,3,11,Loyal Users
9478,453,8,20,3,2,2,7,Casual Users
9519,730,21,41,2,3,3,8,Casual Users
9749,822,9,52,2,2,3,7,Lost
9801,702,10,11,2,2,1,5,Lost
9945,16,74,206,5,5,5,15,Champions
10338,858,14,22,2,3,2,7,Casual Users
10396,17,61,169,5,5,5,15,Champions
10505,2811,6,10,1,1,1,3,Lost
10746,8,43,48,5,4,3,12,Loyal Users
11553,4190,8,19,1,2,2,5,Lost
11743,282,33,43,3,4,3,10,Loyal Users
11750,1201,13,153,2,3,5,10,Casual Users
11862,63,46,90,5,5,4,14,Champions
12066,51,19,47,5,3,3,11,Loyal Users
12460,13,13,27,5,3,2,10,Loyal Users
12644,84,5,6,4,1,1,6,Promising
12871,408,14,45,3,3,3,9,Loyal Users
12903,415,19,19,3,3,2,8,Loyal Users
13154,62,5,12,5,1,1,7,Promising
13264,1293,9,18,1,2,2,5,Lost
13314,132,12,52,4,3,3,10,Loyal Users
13545,87,117,576,4,5,5,14,Champions
3,420,17,32,3,3,3,9,Loyal Users
142,618,8,14,2,2,1,5,Lost
178,135,13,30,4,3,2,9,Loyal Users
925,4277,6,7,1,1,1,3,Lost
972,5287,10,33,1,2,3,6,Lost
998,5717,11,29,1,2,2,5,Lost
1062,32,112,429,5,5,5,15,Champions
1082,2,36,123,5,4,4,13,Champions
1218,118,23,136,4,4,4,12,Champions
1242,164,51,154,4,5,5,14,Champions
1380,21,91,152,5,5,5,15,Champions
1749,3448,5,5,1,1,1,3,Lost
1834,65,72,361,5,5,5,15,Champions
2196,3497,7,33,1,2,3,6,Lost
2422,617,8,14,2,2,1,5,Lost
2481,265,5,11,3,1,1,5,Casual Users
2537,64,19,83,5,3,4,12,Loyal Users
2597,2,8,26,5,2,2,9,Promising
2877,291,20,25,3,3,2,8,Loyal Users
2879,3208,5,9,1,1,1,3,Lost
3340,276,34,101,3,4,4,11,Loyal Users
3509,62,138,657,5,5,5,15,Champions
3549,115,7,10,4,2,1,7,Promising
3602,3209,13,21,1,3,2,6,Casual Users
3645,106,19,27,4,3,2,9,Loyal Users
3700,1387,25,25,1,4,2,7,At Risk
3908,1597,38,123,1,4,4,9,At Risk
4013,927,28,59,2,4,3,9,At Risk
4091,50,5,7,5,1,1,7,Promising
4202,3473,10,29,1,2,2,5,Lost
4588,123,33,75,4,4,4,12,Champions
4738,169,58,129,3,5,4,12,Loyal Users
4806,707,40,94,2,4,4,10,At Risk
5004,289,6,6,3,1,1,5,Casual Users
5056,118,58,224,4,5,5,14,Champions
5230,299,11,15,3,2,1,6,Casual Users
5357,128,12,20,4,3,2,9,Loyal Users
5676,405,23,36,3,4,3,10,Loyal Users
5701,20,14,22,5,3,2,10,Loyal Users
6219,145,30,79,4,4,4,12,Champions
6826,137,5,13,4,1,1,6,Promising
6878,131,13,30,4,3,2,9,Loyal Users
7226,219,22,207,3,4,5,12,Loyal Users
7564,2385,6,21,1,1,2,4,Lost
7595,7,25,61,5,4,3,12,Loyal Users
8546,1624,27,49,1,4,3,8,At Risk
8818,4091,11,11,1,2,1,4,Lost
9154,32,101,530,5,5,5,15,Champions
9176,69,72,484,5,5,5,15,Champions
9309,1690,5,17,1,1,2,4,Lost
9833,533,18,55,2,3,3,8,Casual Users
10052,5569,10,16,1,2,2,5,Lost
10223,5,104,267,5,5,5,15,Champions
10323,30,37,108,5,4,4,13,Champions
10737,12,40,174,5,4,5,14,Champions
10839,470,28,148,3,4,5,12,Loyal Users
11036,268,12,61,3,3,3,9,Loyal Users
11212,7,58,196,5,5,5,15,Champions
11347,1961,5,20,1,1,2,4,Lost
11512,146,40,316,4,4,5,13,Champions
11645,544,12,76,2,3,4,9,Casual Users
11661,4276,8,20,1,2,2,5,Lost
11709,0,46,161,5,5,5,15,Champions
11744,107,16,48,4,3,3,10,Loyal Users
11828,52,5,6,5,1,1,7,Promising
11845,2944,7,9,1,2,1,4,Lost
12015,1653,38,53,1,4,3,8,At Risk
12409,1259,12,41,1,3,3,7,Casual Users
12549,5,85,254,5,5,5,15,Champions
12579,7,5,30,5,1,2,8,Promising
12850,2388,5,8,1,1,1,3,Lost
308,0,101,715,5,5,5,15,Champions
328,22,84,137,5,5,4,14,Champions
867,1384,10,30,1,2,2,5,Lost
1130,127,36,69,4,4,4,12,Champions
1410,3457,6,7,1,1,1,3,Lost
1627,102,87,338,4,5,5,14,Champions
1646,67,52,123,5,5,4,14,Champions
1783,105,6,11,4,1,1,6,Promising
1934,3733,43,84,1,4,4,9,At Risk
1956,171,23,48,3,4,3,10,Loyal Users
2040,66,116,226,5,5,5,15,Champions
2292,1269,6,65,1,1,4,6,Lost
2831,246,9,40,3,2,3,8,Casual Users
2852,518,20,35,2,3,3,8,Casual Users
3413,3666,7,8,1,2,1,4,Lost
3557,869,17,157,2,3,5,10,Casual Users
3659,429,44,120,3,4,4,11,Loyal Users
3890,315,114,145,3,5,4,12,Loyal Users
3893,34,108,466,5,5,5,15,Champions
4831,2,92,183,5,5,5,15,Champions
4944,607,5,14,2,1,1,4,Lost
4993,50,16,38,5,3,3,11,Loyal Users
5031,29,64,183,5,5,5,15,Champions
5325,843,14,43,2,3,3,8,Casual Users
5359,4,109,383,5,5,5,15,Champions
5381,119,5,12,4,1,1,6,Promising
5790,53,24,81,5,4,4,13,Champions
5862,669,7,30,2,2,2,6,Lost
5871,295,13,73,3,3,4,10,Loyal Users
5983,161,20,97,4,3,4,11,Loyal Users
6053,2,35,161,5,4,5,14,Champions
6334,398,11,19,3,2,2,7,Casual Users
6416,1407,11,36,1,2,3,6,Lost
6579,2,30,168,5,4,5,14,Champions
6764,120,26,104,4,4,4,12,Champions
6840,3323,5,6,1,1,1,3,Lost
7436,4426,21,62,1,3,3,7,Casual Users
7680,310,16,34,3,3,3,9,Loyal Users
7824,407,5,12,3,1,1,5,Casual Users
7906,95,9,53,4,2,3,9,Promising
8784,47,14,19,5,3,2,10,Loyal Users
8800,2116,10,13,1,2,1,4,Lost
9052,218,8,46,3,2,3,8,Casual Users
9092,270,21,43,3,3,3,9,Loyal Users
9099,27,41,64,5,4,4,13,Champions
9570,788,5,65,2,1,4,7,Lost
9707,280,81,152,3,5,5,13,Loyal Users
9937,2859,8,19,1,2,2,5,Lost
10138,34,17,26,5,3,2,10,Loyal Users
10247,2702,24,59,1,4,3,8,At Risk
10283,22,28,66,5,4,4,13,Champions
10364,215,90,309,3,5,5,13,Loyal Users
10627,1694,15,44,1,3,3,7,Casual Users
10633,124,106,265,4,5,5,14,Champions
10667,17,35,92,5,4,4,13,Champions
11248,1458,14,39,1,3,3,7,Casual Users
11581,380,24,159,3,4,5,12,Loyal Users
11988,1340,10,27,1,2,2,5,Lost
12166,171,45,149,3,4,5,12,Loyal Users
12356,79,24,32,4,4,3,11,Loyal Users
12435,255,26,44,3,4,3,10,Loyal Users
12472,242,11,45,3,2,3,8,Casual Users
12481,488,6,10,2,1,1,4,Lost
12677,575,6,6,2,1,1,4,Lost
12824,6,115,363,5,5,5,15,Champions
12827,1359,31,41,1,4,3,8,At Risk
12955,18,52,139,5,5,4,14,Champions
13180,481,9,11,2,2,1,5,Lost
13213,41,45,123,5,4,4,13,Champions
13300,120,35,186,4,4,5,13,Champions
13430,2693,16,89,1,3,4,8,Casual Users
13459,2450,6,11,1,1,1,3,Lost
13542,709,30,41,2,4,3,9,At Risk
13581,229,17,39,3,3,3,9,Loyal Users
20,1269,6,16,1,1,2,4,Lost
40,472,169,632,2,5,5,12,At Risk
164,3295,5,27,1,1,2,4,Lost
429,201,18,27,3,3,2,8,Loyal Users
470,2871,7,14,1,2,1,4,Lost
839,139,5,15,4,1,1,6,Promising
1275,311,28,33,3,4,3,10,Loyal Users
1636,568,16,103,2,3,4,9,Casual Users
1988,3380,8,21,1,2,2,5,Lost
1997,206,30,44,3,4,3,10,Loyal Users
2161,2,31,66,5,4,4,13,Champions
2391,319,18,38,3,3,3,9,Loyal Users
2577,1023,6,6,2,1,1,4,Lost
2686,4406,9,21,1,2,2,5,Lost
3115,196,41,155,3,4,5,12,Loyal Users
3167,1691,15,78,1,3,4,8,Casual Users
3195,155,33,170,4,4,5,13,Champions
3314,93,32,59,4,4,3,11,Loyal Users
3415,8,20,99,5,3,4,12,Loyal Users
3667,1660,9,13,1,2,1,4,Lost
3708,781,5,8,2,1,1,4,Lost
3925,1413,15,47,1,3,3,7,Casual Users
3983,241,34,105,3,4,4,11,Loyal Users
4094,1254,10,10,2,2,1,5,Lost
4347,1,80,185,5,5,5,15,Champions
4645,379,7,17,3,2,2,7,Casual Users
4681,44,6,16,5,1,2,8,Promising
4729,3507,9,12,1,2,1,4,Lost
5120,80,31,100,4,4,4,12,Champions
5520,1979,6,9,1,1,1,3,Lost
5724,23,80,745,5,5,5,15,Champions
5933,116,99,264,4,5,5,14,Champions
6506,173,41,107,3,4,4,11,Loyal Users
6711,435,5,7,3,1,1,5,Casual Users
6886,317,53,194,3,5,5,13,Loyal Users
7034,4583,9,9,1,2,1,4,Lost
7208,102,87,418,4,5,5,14,Champions
7791,412,14,18,3,3,2,8,Loyal Users
7852,121,17,49,4,3,3,10,Loyal Users
7894,102,9,31,4,2,2,8,Promising
7971,385,18,111,3,3,4,10,Loyal Users
8108,4125,54,141,1,5,4,10,At Risk
8217,67,6,40,5,1,3,9,Promising
8225,418,5,12,3,1,1,5,Casual Users
8405,21,20,30,5,3,2,10,Loyal Users
8578,5547,5,7,1,1,1,3,Lost
8615,1203,29,122,2,4,4,10,At Risk
8666,404,8,31,3,2,2,7,Casual Users
8708,457,13,18,3,3,2,8,Loyal Users
9086,62,49,120,5,5,4,14,Champions
9411,18,9,53,5,2,3,10,Promising
9698,1008,15,32,2,3,3,8,Casual Users
9940,2242,6,6,1,1,1,3,Lost
9981,75,49,260,4,5,5,14,Champions
10211,801,10,19,2,2,2,6,Lost
10249,555,7,26,2,2,2,6,Lost
10854,263,6,11,3,1,1,5,Casual Users
11011,303,19,36,3,3,3,9,Loyal Users
11138,326,22,30,3,4,2,9,Loyal Users
11532,309,79,151,3,5,5,13,Loyal Users
11557,1255,6,17,2,1,2,5,Lost
11722,44,53,230,5,5,5,15,Champions
11735,377,32,214,3,4,5,12,Loyal Users
12155,103,11,51,4,2,3,9,Promising
12237,60,79,243,5,5,5,15,Champions
12578,737,68,299,2,5,5,12,At Risk
12863,153,73,219,4,5,5,14,Champions
12880,427,22,37,3,4,3,10,Loyal Users
12917,371,23,38,3,4,3,10,Loyal Users
13049,96,49,133,4,5,4,13,Champions
13073,113,23,61,4,4,3,11,Loyal Users
13193,1443,63,247,1,5,5,11,At Risk
13384,1292,5,12,1,1,1,3,Lost
13511,546,8,27,2,2,2,6,Lost
13574,796,22,40,2,4,3,9,At Risk
13586,79,6,14,4,1,1,6,Promising
169,582,17,41,2,3,3,8,Casual Users
500,88,96,267,4,5,5,14,Champions
1171,526,6,27,2,1,2,5,Lost
1349,1163,32,94,2,4,4,10,At Risk
1353,181,48,137,3,5,4,12,Loyal Users
2193,4854,9,23,1,2,2,5,Lost
2326,1684,6,19,1,1,2,4,Lost
2351,2260,5,23,1,1,2,4,Lost
2729,527,24,46,2,4,3,9,At Risk
3764,140,36,73,4,4,4,12,Champions
3793,2421,20,75,1,3,4,8,Casual Users
4355,13,95,668,5,5,5,15,Champions
4562,3686,9,16,1,2,2,5,Lost
4905,26,37,179,5,4,5,14,Champions
5339,752,10,32,2,2,3,7,Lost
5445,738,12,29,2,3,2,7,Casual Users
5538,2508,10,23,1,2,2,5,Lost
5818,5652,8,10,1,2,1,4,Lost
5914,917,7,17,2,2,2,6,Lost
5971,24,12,33,5,3,3,11,Loyal Users
6243,236,6,11,3,1,1,5,Casual Users
6745,89,76,318,4,5,5,14,Champions
6781,3386,6,11,1,1,1,3,Lost
6900,48,107,398,5,5,5,15,Champions
7128,14,15,26,5,3,2,10,Loyal Users
7349,387,21,43,3,3,3,9,Loyal Users
7775,694,20,47,2,3,3,8,Casual Users
8551,412,40,68,3,4,4,11,Loyal Users
8930,612,9,13,2,2,1,5,Lost
9631,11,13,18,5,3,2,10,Loyal Users
9923,101,5,8,4,1,1,6,Promising
9980,18,10,42,5,2,3,10,Promising
10347,1247,38,79,2,4,4,10,At Risk
10434,2745,10,16,1,2,2,5,Lost
10536,268,17,28,3,3,2,8,Loyal Users
10574,0,113,453,5,5,5,15,Champions
10643,2525,11,16,1,2,2,5,Lost
10808,149,29,83,4,4,4,12,Champions
10877,5340,6,32,1,1,3,5,Lost
11028,0,104,311,5,5,5,15,Champions
11210,298,8,9,3,2,1,6,Casual Users
11484,97,42,99,4,4,4,12,Champions
12654,1447,6,38,1,1,3,5,Lost
12762,2952,20,119,1,3,4,8,Casual Users
13182,234,29,71,3,4,4,11,Loyal Users
13239,672,38,110,2,4,4,10,At Risk
13403,84,86,404,4,5,5,14,Champions
13456,698,5,8,2,1,1,4,Lost
139,92,208,461,4,5,5,14,Champions
283,714,9,9,2,2,1,5,Lost
359,575,42,48,2,4,3,9,At Risk
479,5969,9,11,1,2,1,4,Lost
1144,475,6,8,2,1,1,4,Lost
1444,415,8,11,3,2,1,6,Casual Users
1461,1693,7,8,1,2,1,4,Lost
1994,2561,17,50,1,3,3,7,Casual Users
2026,406,70,227,3,5,5,13,Loyal Users
2071,20,106,373,5,5,5,15,Champions
2519,1553,6,8,1,1,1,3,Lost
2681,667,13,23,2,3,2,7,Casual Users
2736,7,51,97,5,5,4,14,Champions
2808,701,5,21,2,1,2,5,Lost
2880,3692,18,37,1,3,3,7,Casual Users
3419,455,60,221,3,5,5,13,Loyal Users
3539,133,10,59,4,2,3,9,Promising
4012,4,20,72,5,3,4,12,Loyal Users
4258,240,7,39,3,2,3,8,Casual Users
4352,404,20,111,3,3,4,10,Loyal Users
4620,145,22,70,4,4,4,12,Champions
4644,144,14,45,4,3,3,10,Loyal Users
4991,127,79,541,4,5,5,14,Champions
5247,4,64,499,5,5,5,15,Champions
5338,30,109,338,5,5,5,15,Champions
5424,40,35,87,5,4,4,13,Champions
5444,37,45,141,5,4,4,13,Champions
5461,410,8,24,3,2,2,7,Casual Users
5485,23,22,42,5,4,3,12,Loyal Users
5577,737,50,64,2,5,4,11,At Risk
6050,75,15,39,4,3,3,10,Loyal Users
6268,111,51,87,4,5,4,13,Champions
6275,140,16,111,4,3,4,11,Loyal Users
6655,6,60,402,5,5,5,15,Champions
6756,1373,10,110,1,2,4,7,Lost
6775,272,7,31,3,2,2,7,Casual Users
6824,414,14,42,3,3,3,9,Loyal Users
6961,587,6,13,2,1,1,4,Lost
6980,268,21,73,3,3,4,10,Loyal Users
7046,1,80,281,5,5,5,15,Champions
7178,130,41,165,4,4,5,13,Champions
7470,1533,15,37,1,3,3,7,Casual Users
7490,2,184,519,5,5,5,15,Champions
8032,1407,6,10,1,1,1,3,Lost
8160,401,11,23,3,2,2,7,Casual Users
8201,217,6,9,3,1,1,5,Casual Users
8761,9,193,427,5,5,5,15,Champions
8896,192,18,55,3,3,3,9,Loyal Users
9040,1024,8,29,2,2,2,6,Lost
9090,102,66,122,4,5,4,13,Champions
9494,232,5,16,3,1,2,6,Casual Users
10036,2548,5,13,1,1,1,3,Lost
10390,139,85,121,4,5,4,13,Champions
10456,2727,47,95,1,5,4,10,At Risk
10569,273,34,119,3,4,4,11,Loyal Users
10807,911,8,24,2,2,2,6,Lost
10829,1825,10,14,1,2,1,4,Lost
11264,29,19,32,5,3,3,11,Loyal Users
11470,30,26,81,5,4,4,13,Champions
11549,60,103,415,5,5,5,15,Champions
11714,410,34,61,3,4,3,10,Loyal Users
11873,675,6,10,2,1,1,4,Lost
11962,593,6,18,2,1,2,5,Lost
12084,88,12,30,4,3,2,9,Loyal Users
12107,352,7,32,3,2,3,8,Casual Users
12365,1125,45,231,2,4,5,11,At Risk
12593,8,34,50,5,4,3,12,Loyal Users
12879,105,14,50,4,3,3,10,Loyal Users
12919,13,60,141,5,5,4,14,Champions
12974,10,68,213,5,5,5,15,Champions
13047,6,58,526,5,5,5,15,Champions
13260,1580,5,50,1,1,3,5,Lost
13471,10,76,137,5,5,4,14,Champions
13509,118,11,27,4,2,2,8,Promising
295,33,97,151,5,5,5,15,Champions
340,1580,5,5,1,1,1,3,Lost
431,1242,8,10,2,2,1,5,Lost
692,1087,57,355,2,5,5,12,At Risk
881,276,6,12,3,1,1,5,Casual Users
980,730,7,11,2,2,1,5,Lost
1021,3268,7,17,1,2,2,5,Lost
1245,5031,7,12,1,2,1,4,Lost
1335,680,24,84,2,4,4,10,At Risk
1538,390,5,5,3,1,1,5,Casual Users
1670,566,20,78,2,3,4,9,Casual Users
2185,269,10,24,3,2,2,7,Casual Users
2695,2,36,62,5,4,3,12,Loyal Users
2712,1695,6,35,1,1,3,5,Lost
2837,473,24,58,2,4,3,9,At Risk
2849,8,200,429,5,5,5,15,Champions
3439,200,5,5,3,1,1,5,Casual Users
3497,141,47,266,4,5,5,14,Champions
3625,110,16,186,4,3,5,12,Loyal Users
3791,72,30,35,4,4,3,11,Loyal Users
4279,424,113,159,3,5,5,13,Loyal Users
4314,139,30,94,4,4,4,12,Champions
4510,125,5,12,4,1,1,6,Promising
4564,7,164,331,5,5,5,15,Champions
4639,544,7,52,2,2,3,7,Lost
4807,17,7,13,5,2,1,8,Promising
4995,728,7,11,2,2,1,5,Lost
5237,1870,6,8,1,1,1,3,Lost
5373,145,164,407,4,5,5,14,Champions
5564,109,116,207,4,5,5,14,Champions
5887,152,6,19,4,1,2,7,Promising
6020,1519,6,28,1,1,2,4,Lost
6161,169,18,116,3,3,4,10,Loyal Users
6165,3,34,55,5,4,3,12,Loyal Users
6171,731,7,13,2,2,1,5,Lost
6172,118,30,41,4,4,3,11,Loyal Users
6452,131,5,41,4,1,3,8,Promising
6963,694,8,13,2,2,1,5,Lost
6992,1716,20,48,1,3,3,7,Casual Users
7009,122,49,198,4,5,5,14,Champions
7070,2271,9,14,1,2,1,4,Lost
7705,419,42,129,3,4,4,11,Loyal Users
7759,365,10,10,3,2,1,6,Casual Users
7968,1511,9,21,1,2,2,5,Lost
8378,32,63,87,5,5,4,14,Champions
8680,417,6,14,3,1,1,5,Casual Users
8903,86,23,70,4,4,4,12,Champions
9574,92,16,45,4,3,3,10,Loyal Users
9737,162,28,33,4,4,3,11,Loyal Users
9776,718,20,26,2,3,2,7,Casual Users
9827,80,68,138,4,5,4,13,Champions
9932,96,117,375,4,5,5,14,Champions
10091,1147,9,19,2,2,2,6,Lost
10847,3,58,75,5,5,4,14,Champions
10907,2531,55,134,1,5,4,10,At Risk
10935,4266,5,6,1,1,1,3,Lost
11211,695,27,98,2,4,4,10,At Risk
11357,2786,6,27,1,1,2,4,Lost
11900,8,59,122,5,5,4,14,Champions
11918,267,21,35,3,3,3,9,Loyal Users
12026,138,24,221,4,4,5,13,Champions
12081,2032,7,19,1,2,2,5,Lost
12358,1,160,213,5,5,5,15,Champions
12651,107,39,81,4,4,4,12,Champions
12877,1961,10,53,1,2,3,6,Lost
13029,588,41,91,2,4,4,10,At Risk
13242,341,6,11,3,1,1,5,Casual Users
13412,4808,6,23,1,1,2,4,Lost
13514,24,68,320,5,5,5,15,Champions
13556,3434,10,35,1,2,3,6,Lost
94,23,72,305,5,5,5,15,Champions
250,1718,6,9,1,1,1,3,Lost
377,1604,18,101,1,3,4,8,Casual Users
402,1005,17,33,2,3,3,8,Casual Users
432,857,5,12,2,1,1,4,Lost
582,220,28,36,3,4,3,10,Loyal Users
1273,5541,6,10,1,1,1,3,Lost
1301,146,50,129,4,5,4,13,Champions
1394,1746,8,11,1,2,1,4,Lost
1455,141,116,435,4,5,5,14,Champions
2560,992,25,28,2,4,2,8,At Risk
2867,375,11,66,3,2,4,9,Casual Users
3067,65,16,70,5,3,4,12,Loyal Users
3120,1419,6,7,1,1,1,3,Lost
3529,768,13,152,2,3,5,10,Casual Users
3690,64,63,366,5,5,5,15,Champions
3863,3929,13,22,1,3,2,6,Casual Users
4001,89,8,17,4,2,2,8,Promising
4038,116,29,167,4,4,5,13,Champions
4074,111,21,138,4,3,4,11,Loyal Users
4118,901,17,19,2,3,2,7,Casual Users
4176,2979,41,125,1,4,4,9,At Risk
4504,162,38,55,4,4,3,11,Loyal Users
4615,227,17,41,3,3,3,9,Loyal Users
5206,120,66,205,4,5,5,14,Champions
5440,487,37,53,2,4,3,9,At Risk
5510,1598,11,48,1,2,3,6,Lost
5551,6,36,55,5,4,3,12,Loyal Users
5591,576,52,89,2,5,4,11,At Risk
5817,318,5,7,3,1,1,5,Casual Users
5937,2141,9,14,1,2,1,4,Lost
6239,2417,17,43,1,3,3,7,Casual Users
6322,418,34,162,3,4,5,12,Loyal Users
6595,167,50,97,3,5,4,12,Loyal Users
7411,834,70,190,2,5,5,12,At Risk
7981,1290,33,45,1,4,3,8,At Risk
8030,3744,5,23,1,1,2,4,Lost
8055,350,31,86,3,4,4,11,Loyal Users
8091,467,5,16,3,1,2,6,Casual Users
8147,1147,10,25,2,2,2,6,Lost
8206,162,34,74,4,4,4,12,Champions
8453,142,45,120,4,4,4,12,Champions
8700,1108,8,20,2,2,2,6,Lost
8975,3627,9,34,1,2,3,6,Lost
9079,3,76,336,5,5,5,15,Champions
9273,72,88,265,4,5,5,14,Champions
9414,968,29,46,2,4,3,9,At Risk
9483,840,9,13,2,2,1,5,Lost
9813,380,70,92,3,5,4,12,Loyal Users
10000,3045,9,13,1,2,1,4,Lost
10104,165,28,44,4,4,3,11,Loyal Users
10268,278,24,34,3,4,3,10,Loyal Users
10374,2613,6,6,1,1,1,3,Lost
10411,2161,9,14,1,2,1,4,Lost
10501,685,8,25,2,2,2,6,Lost
10549,133,7,16,4,2,2,8,Promising
10802,623,12,38,2,3,3,8,Casual Users
10899,409,15,20,3,3,2,8,Loyal Users
11048,138,71,190,4,5,5,14,Champions
11580,20,10,67,5,2,4,11,Promising
11594,724,16,35,2,3,3,8,Casual Users
11611,389,13,26,3,3,2,8,Loyal Users
11956,2954,10,11,1,2,1,4,Lost
12424,290,39,59,3,4,3,10,Loyal Users
12562,534,9,15,2,2,1,5,Lost
12904,894,14,25,2,3,2,7,Casual Users
12981,780,15,50,2,3,3,8,Casual Users
13044,531,52,109,2,5,4,11,At Risk
13423,1388,24,77,1,4,4,9,At Risk
57,63,31,66,5,4,4,13,Champions
570,5190,10,12,1,2,1,4,Lost
868,1712,5,8,1,1,1,3,Lost
920,1252,16,37,2,3,3,8,Casual Users
1026,8,88,254,5,5,5,15,Champions
1628,2276,10,15,1,2,1,4,Lost
2343,413,28,49,3,4,3,10,Loyal Users
2384,640,6,14,2,1,1,4,Lost
2489,73,14,104,4,3,4,11,Loyal Users
2653,560,5,22,2,1,2,5,Lost
2885,128,6,11,4,1,1,6,Promising
3399,7,62,136,5,5,4,14,Champions
3489,342,8,20,3,2,2,7,Casual Users
3699,1258,9,26,1,2,2,5,Lost
3709,715,17,37,2,3,3,8,Casual Users
4137,1315,5,8,1,1,1,3,Lost
5246,164,5,5,4,1,1,6,Promising
5324,261,18,46,3,3,3,9,Loyal Users
5492,405,25,86,3,4,4,11,Loyal Users
5553,2162,6,6,1,1,1,3,Lost
6002,1335,7,11,1,2,1,4,Lost
6088,121,15,33,4,3,3,10,Loyal Users
6091,1295,5,12,1,1,1,3,Lost
6328,11,49,87,5,5,4,14,Champions
6691,2737,5,56,1,1,3,5,Lost
6734,90,71,91,4,5,4,13,Champions
6779,78,9,67,4,2,4,10,Promising
7028,96,36,227,4,4,5,13,Champions
7669,80,66,140,4,5,4,13,Champions
7980,842,10,16,2,2,2,6,Lost
8532,1462,16,32,1,3,3,7,Casual Users
8548,579,6,6,2,1,1,4,Lost
8594,436,9,24,3,2,2,7,Casual Users
8742,485,12,14,2,3,1,6,Casual Users
8807,3367,5,21,1,1,2,4,Lost
8957,1,150,491,5,5,5,15,Champions
9121,9,80,419,5,5,5,15,Champions
9272,4955,9,17,1,2,2,5,Lost
9505,117,18,25,4,3,2,9,Loyal Users
9660,355,58,133,3,5,4,12,Loyal Users
9834,106,10,113,4,2,4,10,Promising
9854,11,23,117,5,4,4,13,Champions
10260,876,12,35,2,3,3,8,Casual Users
10507,179,132,513,3,5,5,13,Loyal Users
10550,235,44,79,3,4,4,11,Loyal Users
10579,729,11,14,2,2,1,5,Lost
10838,66,28,85,5,4,4,13,Champions
10963,66,12,105,5,3,4,12,Loyal Users
11004,169,86,299,3,5,5,13,Loyal Users
11291,9,51,100,5,5,4,14,Champions
11297,642,21,61,2,3,3,8,Casual Users
11637,23,7,9,5,2,1,8,Promising
11662,459,5,15,3,1,1,5,Casual Users
11718,209,51,59,3,5,3,11,Loyal Users
11979,0,26,43,5,4,3,12,Loyal Users
12012,522,9,14,2,2,1,5,Lost
12374,136,49,55,4,5,3,12,Loyal Users
12567,662,9,36,2,2,3,7,Lost
12650,118,19,30,4,3,2,9,Loyal Users
12729,5162,7,22,1,2,2,5,Lost
12737,367,30,145,3,4,4,11,Loyal Users
12804,30,46,84,5,5,4,14,Champions
12821,2850,36,198,1,4,5,10,At Risk
13094,850,17,52,2,3,3,8,Casual Users
13215,2356,13,29,1,3,2,6,Casual Users
13271,1143,8,11,2,2,1,5,Lost
13466,1673,13,21,1,3,2,6,Casual Users
647,158,29,84,4,4,4,12,Champions
966,14,30,64,5,4,4,13,Champions
1074,920,7,8,2,2,1,5,Lost
1113,520,10,16,2,2,2,6,Lost
1467,2396,5,20,1,1,2,4,Lost
1615,31,9,69,5,2,4,11,Promising
1818,424,10,21,3,2,2,7,Casual Users
1968,14,38,134,5,4,4,13,Champions
2405,12,44,106,5,4,4,13,Champions
2464,305,5,9,3,1,1,5,Casual Users
2666,1011,5,7,2,1,1,4,Lost
2694,419,9,40,3,2,3,8,Casual Users
2782,1146,20,46,2,3,3,8,Casual Users
3613,576,13,48,2,3,3,8,Casual Users
3871,44,5,8,5,1,1,7,Promising
3932,814,34,75,2,4,4,10,At Risk
4166,1987,7,15,1,2,1,4,Lost
4544,4757,10,14,1,2,1,4,Lost
4781,4,163,391,5,5,5,15,Champions
4852,407,44,309,3,4,5,12,Loyal Users
5274,142,62,182,4,5,5,14,Champions
5467,1277,9,61,1,2,3,6,Lost
5541,506,12,78,2,3,4,9,Casual Users
5948,2672,10,24,1,2,2,5,Lost
6032,4,28,61,5,4,3,12,Loyal Users
6086,77,102,448,4,5,5,14,Champions
6197,117,170,580,4,5,5,14,Champions
6308,408,41,81,3,4,4,11,Loyal Users
6583,617,36,68,2,4,4,10,At Risk
6959,417,26,71,3,4,4,11,Loyal Users
6978,474,20,103,2,3,4,9,Casual Users
7006,2704,8,23,1,2,2,5,Lost
7019,379,24,49,3,4,3,10,Loyal Users
7110,809,9,23,2,2,2,6,Lost
7177,398,48,125,3,5,4,12,Loyal Users
7506,15,64,270,5,5,5,15,Champions
7523,31,6,11,5,1,1,7,Promising
7559,523,6,11,2,1,1,4,Lost
7657,438,6,8,3,1,1,5,Casual Users
8274,382,48,132,3,5,4,12,Loyal Users
8374,71,28,83,4,4,4,12,Champions
8691,646,10,19,2,2,2,6,Lost
9058,1347,11,17,1,2,2,5,Lost
9345,235,6,17,3,1,2,6,Casual Users
9444,992,9,15,2,2,1,5,Lost
9846,1569,11,28,1,2,2,5,Lost
9886,314,68,333,3,5,5,13,Loyal Users
10423,842,5,9,2,1,1,4,Lost
10458,566,6,6,2,1,1,4,Lost
10582,368,13,25,3,3,2,8,Loyal Users
10826,645,26,92,2,4,4,10,At Risk
10851,532,15,27,2,3,2,7,Casual Users
10998,77,49,181,4,5,5,14,Champions
11054,122,15,39,4,3,3,10,Loyal Users
11181,173,12,68,3,3,4,10,Loyal Users
11504,1982,6,28,1,1,2,4,Lost
11732,117,30,50,4,4,3,11,Loyal Users
11810,421,33,47,3,4,3,10,Loyal Users
12104,139,114,311,4,5,5,14,Champions
12323,893,7,40,2,2,3,7,Lost
12691,1303,6,38,1,1,3,5,Lost
12849,91,6,18,4,1,2,7,Promising
13375,488,13,34,2,3,3,8,Casual Users
13447,3142,6,19,1,1,2,4,Lost
292,770,9,17,2,2,2,6,Lost
306,8,22,27,5,4,2,11,Loyal Users
339,125,22,96,4,4,4,12,Champions
676,49,41,80,5,4,4,13,Champions
919,97,8,8,4,2,1,7,Promising
923,134,22,35,4,4,3,11,Loyal Users
944,4,19,44,5,3,3,11,Loyal Users
983,1564,5,19,1,1,2,4,Lost
1069,2041,9,16,1,2,2,5,Lost
1146,417,16,28,3,3,2,8,Loyal Users
1251,281,17,20,3,3,2,8,Loyal Users
1355,310,14,42,3,3,3,9,Loyal Users
1517,964,10,15,2,2,1,5,Lost
2177,10,49,174,5,5,5,15,Champions
2651,25,25,33,5,4,3,12,Loyal Users
3012,284,16,49,3,3,3,9,Loyal Users
3269,42,13,18,5,3,2,10,Loyal Users
3324,2998,7,17,1,2,2,5,Lost
3388,1857,7,9,1,2,1,4,Lost
3506,460,5,7,3,1,1,5,Casual Users
3649,131,62,141,4,5,4,13,Champions
3815,1303,10,40,1,2,3,6,Lost
3996,996,17,27,2,3,2,7,Casual Users
4157,892,13,22,2,3,2,7,Casual Users
4356,25,77,98,5,5,4,14,Champions
4603,430,9,14,3,2,1,6,Casual Users
4820,2097,6,11,1,1,1,3,Lost
4846,922,10,15,2,2,1,5,Lost
5347,11,9,22,5,2,2,9,Promising
5507,56,17,99,5,3,4,12,Loyal Users
6302,99,5,6,4,1,1,6,Promising
6472,256,98,573,3,5,5,13,Loyal Users
6738,4921,6,6,1,1,1,3,Lost
6846,93,60,274,4,5,5,14,Champions
7231,19,120,600,5,5,5,15,Champions
7280,130,40,133,4,4,4,12,Champions
7301,62,52,134,5,5,4,14,Champions
7581,5103,9,12,1,2,1,4,Lost
7739,787,18,43,2,3,3,8,Casual Users
8159,547,7,7,2,2,1,5,Lost
8416,2544,9,15,1,2,1,4,Lost
8588,3308,5,30,1,1,2,4,Lost
8611,694,18,28,2,3,2,7,Casual Users
8790,46,110,206,5,5,5,15,Champions
8992,1420,40,87,1,4,4,9,At Risk
9091,126,77,149,4,5,5,14,Champions
9241,405,17,72,3,3,4,10,Loyal Users
9333,109,17,82,4,3,4,11,Loyal Users
9614,4183,36,54,1,4,3,8,At Risk
9816,610,24,31,2,4,2,8,At Risk
9862,686,10,19,2,2,2,6,Lost
9896,4413,5,9,1,1,1,3,Lost
10035,125,91,385,4,5,5,14,Champions
10088,17,5,37,5,1,3,9,Promising
10306,142,62,241,4,5,5,14,Champions
10331,74,11,44,4,2,3,9,Promising
10378,6,32,85,5,4,4,13,Champions
10926,133,23,187,4,4,5,13,Champions
11479,124,42,77,4,4,4,12,Champions
12112,2,47,64,5,5,4,14,Champions
12390,522,7,20,2,2,2,6,Lost
12605,1430,5,9,1,1,1,3,Lost
12801,1446,7,15,1,2,1,4,Lost
13345,237,5,24,3,1,2,6,Casual Users
13407,119,17,58,4,3,3,10,Loyal Users
13408,7,163,640,5,5,5,15,Champions
54,405,5,26,3,1,2,6,Casual Users
120,119,51,83,4,5,4,13,Champions
559,10,35,57,5,4,3,12,Loyal Users
969,540,7,20,2,2,2,6,Lost
1028,67,23,96,5,4,4,13,Champions
1499,66,11,19,5,2,2,9,Promising
1781,46,25,92,5,4,4,13,Champions
1917,2562,6,74,1,1,4,6,Lost
2014,130,76,139,4,5,4,13,Champions
2232,425,18,28,3,3,2,8,Loyal Users
2779,36,82,261,5,5,5,15,Champions
3209,654,9,13,2,2,1,5,Lost
3309,1431,21,55,1,3,3,7,Casual Users
3730,127,12,28,4,3,2,9,Loyal Users
3757,316,20,24,3,3,2,8,Loyal Users
3810,748,22,59,2,4,3,9,At Risk
3827,130,85,403,4,5,5,14,Champions
3856,337,79,91,3,5,4,12,Loyal Users
3858,1555,31,41,1,4,3,8,At Risk
3969,2318,15,30,1,3,2,6,Casual Users
4136,734,8,48,2,2,3,7,Lost
4221,191,13,50,3,3,3,9,Loyal Users
4399,1101,26,70,2,4,4,10,At Risk
4631,2093,5,9,1,1,1,3,Lost
4692,1269,27,38,1,4,3,8,At Risk
4928,668,10,20,2,2,2,6,Lost
5148,6,73,146,5,5,4,14,Champions
5225,112,34,134,4,4,4,12,Champions
5555,18,63,348,5,5,5,15,Champions
6017,260,45,113,3,4,4,11,Loyal Users
6027,1,104,278,5,5,5,15,Champions
6216,73,71,195,4,5,5,14,Champions
6656,243,16,42,3,3,3,9,Loyal Users
6719,58,9,21,5,2,2,9,Promising
6994,288,5,27,3,1,2,6,Casual Users
7090,941,8,87,2,2,4,8,Lost
7101,101,57,491,4,5,5,14,Champions
7309,4209,20,24,1,3,2,6,Casual Users
7449,74,67,258,4,5,5,14,Champions
7735,57,269,523,5,5,5,15,Champions
7794,8,74,299,5,5,5,15,Champions
7952,102,40,69,4,4,4,12,Champions
8234,101,36,98,4,4,4,12,Champions
8263,1718,6,12,1,1,1,3,Lost
9008,2028,8,16,1,2,2,5,Lost
9622,105,47,161,4,5,5,14,Champions
9637,814,8,18,2,2,2,6,Lost
9902,108,86,657,4,5,5,14,Champions
9947,118,39,216,4,4,5,13,Champions
9998,414,37,47,3,4,3,10,Loyal Users
10017,47,10,22,5,2,2,9,Promising
10297,14,45,149,5,4,5,14,Champions
10325,54,80,421,5,5,5,15,Champions
10388,2490,7,8,1,2,1,4,Lost
10943,899,5,6,2,1,1,4,Lost
11037,117,66,303,4,5,5,14,Champions
11298,3747,12,14,1,3,1,5,Casual Users
11364,912,33,95,2,4,4,10,At Risk
11399,51,16,162,5,3,5,13,Loyal Users
11569,600,12,164,2,3,5,10,Casual Users
11648,1574,22,29,1,4,2,7,At Risk
11659,313,18,46,3,3,3,9,Loyal Users
11915,147,20,166,4,3,5,12,Loyal Users
11919,157,63,156,4,5,5,14,Champions
11942,2508,27,68,1,4,4,9,At Risk
12024,236,13,18,3,3,2,8,Loyal Users
12122,1999,30,61,1,4,3,8,At Risk
12134,748,6,9,2,1,1,4,Lost
12296,90,51,165,4,5,5,14,Champions
12341,4307,12,38,1,3,3,7,Casual Users
12475,4080,10,10,1,2,1,4,Lost
12909,180,5,7,3,1,1,5,Casual Users
12929,218,9,150,3,2,5,10,Casual Users
12956,287,22,47,3,4,3,10,Loyal Users
13087,1588,20,40,1,3,3,7,Casual Users
13388,67,7,46,5,2,3,10,Promising
491,2146,5,8,1,1,1,3,Lost
634,1393,10,125,1,2,4,7,Lost
646,126,9,27,4,2,2,8,Promising
1191,144,25,84,4,4,4,12,Champions
1665,109,39,56,4,4,3,11,Loyal Users
1847,519,66,128,2,5,4,11,At Risk
2223,528,6,8,2,1,1,4,Lost
2245,118,21,110,4,3,4,11,Loyal Users
2485,2504,12,29,1,3,2,6,Casual Users
2613,16,41,60,5,4,3,12,Loyal Users
2618,2626,5,16,1,1,2,4,Lost
2640,88,105,159,4,5,5,14,Champions
3049,660,5,9,2,1,1,4,Lost
3534,248,33,40,3,4,3,10,Loyal Users
3726,8,7,31,5,2,2,9,Promising
3759,483,10,23,2,2,2,6,Lost
3833,783,7,58,2,2,3,7,Lost
3967,1134,9,39,2,2,3,7,Lost
4125,369,10,35,3,2,3,8,Casual Users
4425,58,16,29,5,3,2,10,Loyal Users
4557,986,11,16,2,2,2,6,Lost
5039,804,17,93,2,3,4,9,Casual Users
5086,1576,21,37,1,3,3,7,Casual Users
5103,891,48,78,2,5,4,11,At Risk
5189,544,18,40,2,3,3,8,Casual Users
5466,8,30,143,5,4,4,13,Champions
6181,255,37,85,3,4,4,11,Loyal Users
6182,112,36,49,4,4,3,11,Loyal Users
6199,229,46,123,3,5,4,12,Loyal Users
6323,146,57,80,4,5,4,13,Champions
6370,1645,12,36,1,3,3,7,Casual Users
6403,149,10,12,4,2,1,7,Promising
7220,34,90,187,5,5,5,15,Champions
7362,384,91,164,3,5,5,13,Loyal Users
7524,1987,7,11,1,2,1,4,Lost
7532,117,13,32,4,3,3,10,Loyal Users
7703,5009,7,11,1,2,1,4,Lost
8359,143,62,228,4,5,5,14,Champions
8363,405,10,16,3,2,2,7,Casual Users
8718,2889,24,86,1,4,4,9,At Risk
8740,173,10,20,3,2,2,7,Casual Users
8848,117,19,22,4,3,2,9,Loyal Users
9276,3457,20,64,1,3,4,8,Casual Users
9650,216,39,108,3,4,4,11,Loyal Users
9748,4680,5,18,1,1,2,4,Lost
10117,370,39,301,3,4,5,12,Loyal Users
10243,2505,5,15,1,1,1,3,Lost
10557,2055,40,99,1,4,4,9,At Risk
10571,1441,5,7,1,1,1,3,Lost
10698,155,38,112,4,4,4,12,Champions
10734,2291,8,15,1,2,1,4,Lost
10875,37,20,152,5,3,5,13,Loyal Users
11045,421,7,22,3,2,2,7,Casual Users
11765,1169,10,42,2,2,3,7,Lost
11779,431,5,16,3,1,2,6,Casual Users
12037,188,15,31,3,3,2,8,Loyal Users
12230,98,28,100,4,4,4,12,Champions
12291,665,7,20,2,2,2,6,Lost
12332,88,96,623,4,5,5,14,Champions
12350,1997,5,12,1,1,1,3,Lost
12452,296,8,24,3,2,2,7,Casual Users
12520,81,17,55,4,3,3,10,Loyal Users
12531,223,26,87,3,4,4,11,Loyal Users
12632,1933,5,7,1,1,1,3,Lost
13057,254,7,16,3,2,2,7,Casual Users
13216,67,5,8,5,1,1,7,Promising
13460,582,8,8,2,2,1,5,Lost
13579,379,11,14,3,2,1,6,Casual Users
96,317,9,77,3,2,4,9,Casual Users
235,4184,5,18,1,1,2,4,Lost
545,1411,7,9,1,2,1,4,Lost
620,16,55,350,5,5,5,15,Champions
776,1263,26,34,1,4,3,8,At Risk
846,2532,9,52,1,2,3,6,Lost
871,505,11,15,2,2,1,5,Lost
1435,97,15,27,4,3,2,9,Loyal Users
1551,207,6,6,3,1,1,5,Casual Users
1605,212,58,178,3,5,5,13,Loyal Users
1701,1698,5,9,1,1,1,3,Lost
1951,390,7,34,3,2,3,8,Casual Users
2412,8,41,57,5,4,3,12,Loyal Users
2646,931,8,15,2,2,1,5,Lost
3034,914,7,29,2,2,2,6,Lost
3084,1446,26,105,1,4,4,9,At Risk
3232,135,94,153,4,5,5,14,Champions
3350,155,6,10,4,1,1,6,Promising
3473,884,6,7,2,1,1,4,Lost
4043,464,6,6,3,1,1,5,Casual Users
4159,3340,12,20,1,3,2,6,Casual Users
4226,957,10,14,2,2,1,5,Lost
4765,2542,6,22,1,1,2,4,Lost
4832,5545,5,11,1,1,1,3,Lost
4839,531,16,47,2,3,3,8,Casual Users
4976,1105,14,64,2,3,4,9,Casual Users
5096,1985,10,13,1,2,1,4,Lost
5147,451,24,35,3,4,3,10,Loyal Users
5545,79,82,371,4,5,5,14,Champions
5638,674,17,32,2,3,3,8,Casual Users
5716,90,8,27,4,2,2,8,Promising
6043,18,32,53,5,4,3,12,Loyal Users
6293,50,37,222,5,4,5,14,Champions
6520,707,7,65,2,2,4,8,Lost
7102,1703,29,179,1,4,5,10,At Risk
7112,8,8,29,5,2,2,9,Promising
7408,2,57,221,5,5,5,15,Champions
7633,626,12,14,2,3,1,6,Casual Users
7868,138,35,137,4,4,4,12,Champions
8039,1028,5,14,2,1,1,4,Lost
8092,6,43,107,5,4,4,13,Champions
8440,818,5,6,2,1,1,4,Lost
8481,231,74,224,3,5,5,13,Loyal Users
8834,808,11,44,2,2,3,7,Lost
9047,267,7,13,3,2,1,6,Casual Users
9131,901,12,49,2,3,3,8,Casual Users
9175,121,7,8,4,2,1,7,Promising
9296,1268,9,12,1,2,1,4,Lost
9334,1418,37,108,1,4,4,9,At Risk
9455,660,6,13,2,1,1,4,Lost
9515,358,5,7,3,1,1,5,Casual Users
9691,560,7,50,2,2,3,7,Lost
9779,77,26,161,4,4,5,13,Champions
9844,659,12,33,2,3,3,8,Casual Users
9895,4560,5,17,1,1,2,4,Lost
9977,1423,6,11,1,1,1,3,Lost
10171,94,14,61,4,3,3,10,Loyal Users
10207,1795,22,55,1,4,3,8,At Risk
10265,50,21,103,5,3,4,12,Loyal Users
10271,137,64,146,4,5,4,13,Champions
10351,7,84,134,5,5,4,14,Champions
11206,130,15,46,4,3,3,10,Loyal Users
11328,19,28,63,5,4,4,13,Champions
11390,373,46,106,3,5,4,12,Loyal Users
11640,95,20,113,4,3,4,11,Loyal Users
12132,237,17,25,3,3,2,8,Loyal Users
12140,981,38,99,2,4,4,10,At Risk
12587,3694,5,6,1,1,1,3,Lost
12591,2696,33,146,1,4,4,9,At Risk
13050,2003,6,9,1,1,1,3,Lost
13065,429,9,12,3,2,1,6,Casual Users
13321,1656,7,13,1,2,1,4,Lost
13485,1219,14,22,2,3,2,7,Casual Users
452,27,18,68,5,3,4,12,Loyal Users
732,582,105,525,2,5,5,12,At Risk
840,140,36,168,4,4,5,13,Champions
1029,1219,5,6,2,1,1,4,Lost
1032,974,6,17,2,1,2,5,Lost
1167,156,121,212,4,5,5,14,Champions
1464,1108,38,110,2,4,4,10,At Risk
1518,567,19,22,2,3,2,7,Casual Users
2224,3587,9,21,1,2,2,5,Lost
2447,644,23,179,2,4,5,11,At Risk
2477,1770,5,5,1,1,1,3,Lost
2535,35,32,325,5,4,5,14,Champions
3001,430,31,91,3,4,4,11,Loyal Users
3027,187,7,18,3,2,2,7,Casual Users
3075,2412,8,92,1,2,4,7,Lost
3458,7,94,324,5,5,5,15,Champions
3632,67,50,75,5,5,4,14,Champions
3663,525,44,62,2,4,3,9,At Risk
3683,90,6,21,4,1,2,7,Promising
3702,1816,14,14,1,3,1,5,Casual Users
4024,77,58,131,4,5,4,13,Champions
4027,2416,6,15,1,1,1,3,Lost
5036,250,24,103,3,4,4,11,Loyal Users
5203,1206,26,40,2,4,3,9,At Risk
5526,134,23,37,4,4,3,11,Loyal Users
5626,247,38,89,3,4,4,11,Loyal Users
5890,112,17,27,4,3,2,9,Loyal Users
5954,51,11,26,5,2,2,9,Promising
6126,4,115,228,5,5,5,15,Champions
6127,6,21,46,5,3,3,11,Loyal Users
6160,4,15,24,5,3,2,10,Loyal Users
6325,18,146,277,5,5,5,15,Champions
6430,2948,9,27,1,2,2,5,Lost
6436,40,67,402,5,5,5,15,Champions
6608,383,17,106,3,3,4,10,Loyal Users
7161,1437,12,71,1,3,4,8,Casual Users
7528,2016,11,28,1,2,2,5,Lost
7578,2891,8,16,1,2,2,5,Lost
7672,1098,16,50,2,3,3,8,Casual Users
8044,442,7,13,3,2,1,6,Casual Users
8321,1,181,379,5,5,5,15,Champions
8455,4,53,187,5,5,5,15,Champions
8652,4093,6,13,1,1,1,3,Lost
8993,1777,5,7,1,1,1,3,Lost
9313,405,10,13,3,2,1,6,Casual Users
9357,83,15,22,4,3,2,9,Loyal Users
9396,2986,15,36,1,3,3,7,Casual Users
9481,997,13,23,2,3,2,7,Casual Users
9903,472,13,35,2,3,3,8,Casual Users
10197,1170,90,385,2,5,5,12,At Risk
10339,26,14,24,5,3,2,10,Loyal Users
10977,2974,5,6,1,1,1,3,Lost
11108,379,13,21,3,3,2,8,Loyal Users
11139,857,32,101,2,4,4,10,At Risk
11446,3239,6,16,1,1,2,4,Lost
11471,385,21,31,3,3,2,8,Loyal Users
11601,735,5,8,2,1,1,4,Lost
11771,112,19,103,4,3,4,11,Loyal Users
11844,1436,36,55,1,4,3,8,At Risk
12257,45,35,116,5,4,4,13,Champions
12319,77,96,439,4,5,5,14,Champions
12598,2452,5,13,1,1,1,3,Lost
12751,756,6,14,2,1,1,4,Lost
12808,1063,9,19,2,2,2,6,Lost
12830,98,93,329,4,5,5,14,Champions
12964,434,19,34,3,3,3,9,Loyal Users
13148,2429,16,33,1,3,3,7,Casual Users
13256,2274,11,22,1,2,2,5,Lost
13287,998,17,27,2,3,2,7,Casual Users
13355,395,6,7,3,1,1,5,Casual Users
13443,117,13,22,4,3,2,9,Loyal Users
13449,13,108,211,5,5,5,15,Champions
13453,81,91,273,4,5,5,14,Champions
13458,420,33,142,3,4,4,11,Loyal Users
48,2125,5,13,1,1,1,3,Lost
266,17,85,369,5,5,5,15,Champions
507,372,46,174,3,5,5,13,Loyal Users
544,188,7,17,3,2,2,7,Casual Users
650,440,11,16,3,2,2,7,Casual Users
1811,84,24,105,4,4,4,12,Champions
1835,33,6,17,5,1,2,8,Promising
1930,257,28,103,3,4,4,11,Loyal Users
2203,282,29,53,3,4,3,10,Loyal Users
2375,91,50,73,4,5,4,13,Champions
2458,101,47,104,4,5,4,13,Champions
2602,101,80,120,4,5,4,13,Champions
2740,88,56,100,4,5,4,13,Champions
2803,111,5,24,4,1,2,7,Promising
3364,1420,24,43,1,4,3,8,At Risk
3894,73,72,398,4,5,5,14,Champions
4508,49,24,31,5,4,2,11,Loyal Users
4529,868,12,15,2,3,1,6,Casual Users
5010,1,113,380,5,5,5,15,Champions
5657,273,5,7,3,1,1,5,Casual Users
6193,77,6,10,4,1,1,6,Promising
6245,2,16,56,5,3,3,11,Loyal Users
6252,169,14,20,3,3,2,8,Loyal Users
6261,848,15,28,2,3,2,7,Casual Users
6541,9,72,218,5,5,5,15,Champions
6600,298,7,12,3,2,1,6,Casual Users
6665,1961,6,7,1,1,1,3,Lost
6676,90,27,74,4,4,4,12,Champions
6751,1559,29,61,1,4,3,8,At Risk
6990,22,22,50,5,4,3,12,Loyal Users
7108,2795,8,10,1,2,1,4,Lost
7157,478,66,94,2,5,4,11,At Risk
7191,23,29,78,5,4,4,13,Champions
7272,279,8,15,3,2,1,6,Casual Users
7601,453,27,44,3,4,3,10,Loyal Users
7832,150,20,41,4,3,3,10,Loyal Users
8012,285,65,240,3,5,5,13,Loyal Users
8034,740,5,18,2,1,2,5,Lost
8311,852,20,188,2,3,5,10,Casual Users
8381,713,32,37,2,4,3,9,At Risk
8653,435,10,23,3,2,2,7,Casual Users
8673,694,8,14,2,2,1,5,Lost
8690,140,26,52,4,4,3,11,Loyal Users
8702,2116,6,14,1,1,1,3,Lost
8707,115,113,227,4,5,5,14,Champions
9065,773,10,56,2,2,3,7,Lost
9191,5,63,475,5,5,5,15,Champions
9290,1097,11,23,2,2,2,6,Lost
9335,2563,12,23,1,3,2,6,Casual Users
9349,13,37,83,5,4,4,13,Champions
9385,1863,21,87,1,3,4,8,Casual Users
9404,7,30,75,5,4,4,13,Champions
9623,1981,6,14,1,1,1,3,Lost
9953,128,14,30,4,3,2,9,Loyal Users
10101,60,20,126,5,3,4,12,Loyal Users
10248,2405,5,27,1,1,2,4,Lost
10682,2279,17,46,1,3,3,7,Casual Users
10748,4,13,45,5,3,3,11,Loyal Users
10751,18,63,92,5,5,4,14,Champions
10766,126,33,63,4,4,4,12,Champions
10769,1045,161,250,2,5,5,12,At Risk
10846,156,17,71,4,3,4,11,Loyal Users
11039,392,9,28,3,2,2,7,Casual Users
11116,1555,7,35,1,2,3,6,Lost
11192,568,41,71,2,4,4,10,At Risk
11257,35,103,220,5,5,5,15,Champions
11755,8,7,17,5,2,2,9,Promising
11851,9,75,224,5,5,5,15,Champions
12175,2,41,94,5,4,4,13,Champions
12290,974,5,8,2,1,1,4,Lost
12515,84,19,19,4,3,2,9,Loyal Users
12954,864,9,18,2,2,2,6,Lost
13099,127,42,55,4,4,3,11,Loyal Users
13390,80,75,478,4,5,5,14,Champions
13452,566,12,30,2,3,2,7,Casual Users
13493,432,6,30,3,1,2,6,Casual Users
5,138,7,19,4,2,2,8,Promising
163,698,41,60,2,4,3,9,At Risk
191,1110,5,7,2,1,1,4,Lost
268,694,8,9,2,2,1,5,Lost
1087,131,32,93,4,4,4,12,Champions
1341,1801,6,13,1,1,1,3,Lost
1360,751,7,10,2,2,1,5,Lost
1407,143,23,32,4,4,3,11,Loyal Users
1711,104,37,103,4,4,4,12,Champions
1855,130,22,94,4,4,4,12,Champions
2128,5701,7,20,1,2,2,5,Lost
2368,59,45,112,5,4,4,13,Champions
2985,1181,7,7,2,2,1,5,Lost
3135,595,5,11,2,1,1,4,Lost
3249,978,22,44,2,4,3,9,At Risk
3937,35,66,332,5,5,5,15,Champions
4212,76,5,12,4,1,1,6,Promising
4244,105,69,443,4,5,5,14,Champions
4543,1476,9,21,1,2,2,5,Lost
4739,2977,5,15,1,1,1,3,Lost
4751,32,12,18,5,3,2,10,Loyal Users
5132,5553,5,6,1,1,1,3,Lost
5176,8,90,676,5,5,5,15,Champions
5392,1000,35,131,2,4,4,10,At Risk
5694,1817,7,22,1,2,2,5,Lost
6098,25,83,697,5,5,5,15,Champions
6155,153,30,95,4,4,4,12,Champions
6386,695,16,62,2,3,3,8,Casual Users
6529,163,8,9,4,2,1,7,Promising
6610,1580,6,23,1,1,2,4,Lost
6914,58,79,346,5,5,5,15,Champions
6974,644,5,102,2,1,4,7,Lost
7037,28,8,21,5,2,2,9,Promising
7223,1023,8,81,2,2,4,8,Lost
7911,24,12,135,5,3,4,12,Loyal Users
7914,1,8,21,5,2,2,9,Promising
8273,645,12,57,2,3,3,8,Casual Users
8360,484,43,122,2,4,4,10,At Risk
8601,126,5,8,4,1,1,6,Promising
9239,412,29,46,3,4,3,10,Loyal Users
9292,229,11,67,3,2,4,9,Casual Users
9402,926,10,24,2,2,2,6,Lost
9436,468,23,93,3,4,4,11,Loyal Users
10014,2785,5,39,1,1,3,5,Lost
10313,691,18,66,2,3,4,9,Casual Users
10397,352,50,225,3,5,5,13,Loyal Users
10720,440,24,30,3,4,2,9,Loyal Users
10767,890,30,98,2,4,4,10,At Risk
10803,54,31,147,5,4,5,14,Champions
10934,393,24,106,3,4,4,11,Loyal Users
11029,74,11,16,4,2,2,8,Promising
11214,561,10,23,2,2,2,6,Lost
11232,1988,124,424,1,5,5,11,At Risk
11242,3425,6,10,1,1,1,3,Lost
11610,405,28,75,3,4,4,11,Loyal Users
11752,943,5,10,2,1,1,4,Lost
11792,1988,9,13,1,2,1,4,Lost
12325,65,16,65,5,3,4,12,Loyal Users
12445,268,30,62,3,4,3,10,Loyal Users
12496,171,45,100,3,4,4,11,Loyal Users
12702,1383,32,87,1,4,4,9,At Risk
12767,9,51,101,5,5,4,14,Champions
13255,101,16,72,4,3,4,11,Loyal Users
13291,3396,7,25,1,2,2,5,Lost
13417,272,102,192,3,5,5,13,Loyal Users
13496,340,6,14,3,1,1,5,Casual Users
258,316,29,49,3,4,3,10,Loyal Users
279,1414,16,50,1,3,3,7,Casual Users
709,255,52,140,3,5,4,12,Loyal Users
959,143,6,10,4,1,1,6,Promising
1010,113,106,228,4,5,5,14,Champions
1232,2509,7,58,1,2,3,6,Lost
1357,200,43,64,3,4,4,11,Loyal Users
1806,13,114,222,5,5,5,15,Champions
2072,372,7,23,3,2,2,7,Casual Users
2197,241,18,39,3,3,3,9,Loyal Users
2252,3511,5,16,1,1,2,4,Lost
2268,832,5,42,2,1,3,6,Lost
2437,16,49,110,5,5,4,14,Champions
2499,3190,6,24,1,1,2,4,Lost
2824,920,39,181,2,4,5,11,At Risk
3007,993,9,20,2,2,2,6,Lost
3552,2256,8,18,1,2,2,5,Lost
3677,1292,15,39,1,3,3,7,Casual Users
4454,104,11,22,4,2,2,8,Promising
4660,472,13,23,2,3,2,7,Casual Users
4703,2252,15,24,1,3,2,6,Casual Users
5057,247,67,386,3,5,5,13,Loyal Users
5311,1394,6,6,1,1,1,3,Lost
5546,808,6,8,2,1,1,4,Lost
5625,44,94,288,5,5,5,15,Champions
5736,2,135,374,5,5,5,15,Champions
5824,4176,6,6,1,1,1,3,Lost
6710,11,19,50,5,3,3,11,Loyal Users
6801,51,10,15,5,2,1,8,Promising
6879,143,8,20,4,2,2,8,Promising
6884,1053,9,13,2,2,1,5,Lost
7158,32,115,622,5,5,5,15,Champions
7317,15,46,149,5,5,5,15,Champions
7520,101,34,92,4,4,4,12,Champions
7740,153,95,336,4,5,5,14,Champions
7757,224,53,284,3,5,5,13,Loyal Users
8563,156,7,26,4,2,2,8,Promising
8705,65,127,216,5,5,5,15,Champions
8829,10,71,93,5,5,4,14,Champions
8832,182,23,43,3,4,3,10,Loyal Users
8876,4,40,147,5,4,5,14,Champions
8941,710,5,10,2,1,1,4,Lost
9202,109,115,281,4,5,5,14,Champions
9305,2147,11,23,1,2,2,5,Lost
9491,1012,29,68,2,4,4,10,At Risk
9711,5,37,50,5,4,3,12,Loyal Users
9853,4631,9,26,1,2,2,5,Lost
10001,23,89,403,5,5,5,15,Champions
10074,2435,6,12,1,1,1,3,Lost
10190,1141,11,17,2,2,2,6,Lost
10315,35,25,57,5,4,3,12,Loyal Users
10841,69,8,46,5,2,3,10,Promising
10996,161,29,55,4,4,3,11,Loyal Users
11373,175,29,68,3,4,4,11,Loyal Users
11430,14,43,77,5,4,4,13,Champions
11631,3531,23,89,1,4,4,9,At Risk
11804,695,6,22,2,1,2,5,Lost
11809,5292,14,14,1,3,1,5,Casual Users
11893,123,6,48,4,1,3,8,Promising
12229,792,45,292,2,4,5,11,At Risk
12423,95,78,164,4,5,5,14,Champions
12457,5783,5,6,1,1,1,3,Lost
12506,361,16,34,3,3,3,9,Loyal Users
12538,92,38,72,4,4,4,12,Champions
12561,649,5,5,2,1,1,4,Lost
12613,18,75,255,5,5,5,15,Champions
13076,81,37,70,4,4,4,12,Champions
13179,59,73,201,5,5,5,15,Champions
729,516,7,28,2,2,2,6,Lost
1642,405,20,23,3,3,2,8,Loyal Users
1748,305,37,59,3,4,3,10,Loyal Users
2105,281,51,97,3,5,4,12,Loyal Users
2492,239,24,84,3,4,4,11,Loyal Users
2515,412,11,32,3,2,3,8,Casual Users
2630,709,11,62,2,2,3,7,Lost
2755,793,32,193,2,4,5,11,At Risk
3150,35,54,150,5,5,5,15,Champions
3257,437,42,49,3,4,3,10,Loyal Users
3369,1142,21,27,2,3,2,7,Casual Users
3655,583,44,66,2,4,4,10,At Risk
3750,154,15,78,4,3,4,11,Loyal Users
3816,3022,7,13,1,2,1,4,Lost
4506,141,24,87,4,4,4,12,Champions
4528,3341,14,14,1,3,1,5,Casual Users
4536,390,13,28,3,3,2,8,Loyal Users
4559,0,131,392,5,5,5,15,Champions
4627,134,11,34,4,2,3,9,Promising
4867,164,5,23,4,1,2,7,Promising
4927,397,8,71,3,2,4,9,Casual Users
5360,159,12,24,4,3,2,9,Loyal Users
5488,263,9,17,3,2,2,7,Casual Users
5735,566,9,26,2,2,2,6,Lost
5826,134,40,79,4,4,4,12,Champions
5924,34,28,47,5,4,3,12,Loyal Users
5940,5741,5,5,1,1,1,3,Lost
6284,1379,9,28,1,2,2,5,Lost
6803,31,52,151,5,5,5,15,Champions
6839,83,16,45,4,3,3,10,Loyal Users
7057,0,56,97,5,5,4,14,Champions
7214,2036,10,18,1,2,2,5,Lost
7795,530,5,6,2,1,1,4,Lost
8340,139,7,20,4,2,2,8,Promising
8490,1355,6,13,1,1,1,3,Lost
8491,526,10,12,2,2,1,5,Lost
8507,6,53,359,5,5,5,15,Champions
8614,71,164,326,4,5,5,14,Champions
8912,19,30,87,5,4,4,13,Champions
9015,7,19,70,5,3,4,12,Loyal Users
9060,16,40,101,5,4,4,13,Champions
9197,2297,7,16,1,2,2,5,Lost
9630,3689,8,20,1,2,2,5,Lost
9655,138,15,17,4,3,2,9,Loyal Users
9690,125,25,38,4,4,3,11,Loyal Users
9964,76,11,50,4,2,3,9,Promising
10114,2547,6,17,1,1,2,4,Lost
10266,831,31,207,2,4,5,11,At Risk
10394,1021,12,24,2,3,2,7,Casual Users
10520,140,9,16,4,2,2,8,Promising
10742,287,8,25,3,2,2,7,Casual Users
11043,16,41,175,5,4,5,14,Champions
11107,397,16,45,3,3,3,9,Loyal Users
11156,18,15,16,5,3,2,10,Loyal Users
11269,400,15,129,3,3,4,10,Loyal Users
11462,167,17,43,3,3,3,9,Loyal Users
11703,92,26,70,4,4,4,12,Champions
11715,962,12,27,2,3,2,7,Casual Users
12013,167,39,173,3,4,5,12,Loyal Users
12116,1729,7,22,1,2,2,5,Lost
12353,125,31,147,4,4,5,13,Champions
12495,30,61,113,5,5,4,14,Champions
12861,74,91,335,4,5,5,14,Champions
13016,12,53,195,5,5,5,15,Champions
13199,399,61,162,3,5,5,13,Loyal Users
19,1005,13,15,2,3,1,6,Casual Users
397,145,32,74,4,4,4,12,Champions
430,105,29,116,4,4,4,12,Champions
754,247,36,51,3,4,3,10,Loyal Users
989,1815,6,48,1,1,3,5,Lost
1420,398,15,22,3,3,2,8,Loyal Users
1436,248,35,196,3,4,5,12,Loyal Users
1856,250,50,288,3,5,5,13,Loyal Users
2085,2538,8,13,1,2,1,4,Lost
2451,3469,6,25,1,1,2,4,Lost
2554,3267,14,48,1,3,3,7,Casual Users
2571,53,6,14,5,1,1,7,Promising
2623,696,10,71,2,2,4,8,Lost
2652,389,8,25,3,2,2,7,Casual Users
2742,447,28,129,3,4,4,11,Loyal Users
2761,303,35,46,3,4,3,10,Loyal Users
2822,337,6,11,3,1,1,5,Casual Users
2844,411,6,7,3,1,1,5,Casual Users
2930,1183,121,683,2,5,5,12,At Risk
2950,142,44,62,4,4,3,11,Loyal Users
3039,826,12,36,2,3,3,8,Casual Users
3138,864,25,58,2,4,3,9,At Risk
3457,5760,13,13,1,3,1,5,Casual Users
3635,128,5,9,4,1,1,6,Promising
3947,155,30,157,4,4,5,13,Champions
4204,18,19,39,5,3,3,11,Loyal Users
4295,418,13,37,3,3,3,9,Loyal Users
4320,1432,17,30,1,3,2,6,Casual Users
4324,63,8,15,5,2,1,8,Promising
4390,129,66,94,4,5,4,13,Champions
4608,671,15,38,2,3,3,8,Casual Users
4849,164,39,208,4,4,5,13,Champions
4952,2914,8,13,1,2,1,4,Lost
4962,1435,12,45,1,3,3,7,Casual Users
5015,138,36,72,4,4,4,12,Champions
5109,5,7,18,5,2,2,9,Promising
5227,1307,11,38,1,2,3,6,Lost
5463,142,17,175,4,3,5,12,Loyal Users
6700,2926,24,29,1,4,2,7,At Risk
6833,2284,8,19,1,2,2,5,Lost
6985,271,32,56,3,4,3,10,Loyal Users
7096,6,45,90,5,4,4,13,Champions
7156,319,31,178,3,4,5,12,Loyal Users
7165,116,38,44,4,4,3,11,Loyal Users
7181,1405,7,13,1,2,1,4,Lost
7248,1,26,63,5,4,4,13,Champions
7372,1099,57,89,2,5,4,11,At Risk
7396,1331,11,11,1,2,1,4,Lost
7420,101,72,110,4,5,4,13,Champions
7682,423,13,18,3,3,2,8,Loyal Users
7722,1043,14,24,2,3,2,7,Casual Users
8124,68,11,15,5,2,1,8,Promising
8385,410,12,38,3,3,3,9,Loyal Users
8477,16,54,272,5,5,5,15,Champions
8760,2118,10,69,1,2,4,7,Lost
8884,3,62,213,5,5,5,15,Champions
8990,1299,51,110,1,5,4,10,At Risk
9046,1382,29,50,1,4,3,8,At Risk
9140,4414,6,20,1,1,2,4,Lost
9301,294,51,82,3,5,4,12,Loyal Users
9327,1084,5,5,2,1,1,4,Lost
9369,1738,25,88,1,4,4,9,At Risk
9429,114,31,69,4,4,4,12,Champions
9539,298,24,44,3,4,3,10,Loyal Users
9794,4,85,193,5,5,5,15,Champions
9855,422,27,99,3,4,4,11,Loyal Users
10147,223,17,91,3,3,4,10,Loyal Users
10447,2599,7,14,1,2,1,4,Lost
10517,5067,14,18,1,3,2,6,Casual Users
10524,2584,9,21,1,2,2,5,Lost
10828,431,9,32,3,2,3,8,Casual Users
11070,429,13,28,3,3,2,8,Loyal Users
11134,2132,9,27,1,2,2,5,Lost
11320,222,9,78,3,2,4,9,Casual Users
11412,423,9,70,3,2,4,9,Casual Users
11560,2187,90,335,1,5,5,11,At Risk
11990,435,16,29,3,3,2,8,Loyal Users
12216,662,5,16,2,1,2,5,Lost
13146,125,6,23,4,1,2,7,Promising
13177,155,18,321,4,3,5,12,Loyal Users
13442,58,8,31,5,2,2,9,Promising
92,696,25,43,2,4,3,9,At Risk
419,2462,7,7,1,2,1,4,Lost
542,115,14,22,4,3,2,9,Loyal Users
553,29,40,53,5,4,3,12,Loyal Users
560,2609,6,10,1,1,1,3,Lost
836,3285,7,47,1,2,3,6,Lost
1192,3754,16,33,1,3,3,7,Casual Users
1541,8,110,318,5,5,5,15,Champions
1807,943,17,20,2,3,2,7,Casual Users
1938,411,17,18,3,3,2,8,Loyal Users
2218,26,17,45,5,3,3,11,Loyal Users
2374,1654,5,9,1,1,1,3,Lost
2664,1152,6,9,2,1,1,4,Lost
2785,1663,8,13,1,2,1,4,Lost
2903,1416,20,38,1,3,3,7,Casual Users
2964,25,23,172,5,4,5,14,Champions
2994,2386,25,58,1,4,3,8,At Risk
3584,596,20,35,2,3,3,8,Casual Users
3676,132,26,31,4,4,2,10,Loyal Users
3930,521,15,37,2,3,3,8,Casual Users
4237,2294,7,12,1,2,1,4,Lost
4381,525,38,72,2,4,4,10,At Risk
4483,413,9,10,3,2,1,6,Casual Users
4961,733,23,59,2,4,3,9,At Risk
5054,17,145,838,5,5,5,15,Champions
5243,66,169,460,5,5,5,15,Champions
5385,137,15,21,4,3,2,9,Loyal Users
5489,433,12,21,3,3,2,8,Loyal Users
5917,424,23,44,3,4,3,10,Loyal Users
5964,7,90,557,5,5,5,15,Champions
6057,1279,49,87,1,5,4,10,At Risk
6149,3182,8,50,1,2,3,6,Lost
6304,273,20,82,3,3,4,10,Loyal Users
6401,57,160,304,5,5,5,15,Champions
6906,1945,5,6,1,1,1,3,Lost
7029,140,17,99,4,3,4,11,Loyal Users
7215,417,5,15,3,1,1,5,Casual Users
7262,2410,26,31,1,4,2,7,At Risk
7401,1866,6,11,1,1,1,3,Lost
7425,186,87,188,3,5,5,13,Loyal Users
7434,253,16,31,3,3,2,8,Loyal Users
7651,76,24,122,4,4,4,12,Champions
7667,394,21,31,3,3,2,8,Loyal Users
7798,151,12,14,4,3,1,8,Loyal Users
7859,113,69,313,4,5,5,14,Champions
8248,226,34,79,3,4,4,11,Loyal Users
8524,72,8,8,4,2,1,7,Promising
8558,821,6,8,2,1,1,4,Lost
8648,273,9,10,3,2,1,6,Casual Users
8686,1969,12,18,1,3,2,6,Casual Users
8844,2132,7,39,1,2,3,6,Lost
8894,154,38,455,4,4,5,13,Champions
8901,912,13,13,2,3,1,6,Casual Users
9012,861,12,76,2,3,4,9,Casual Users
9275,1263,9,15,1,2,1,4,Lost
9537,66,15,19,5,3,2,10,Loyal Users
9652,421,24,31,3,4,2,9,Loyal Users
9727,966,6,8,2,1,1,4,Lost
9822,372,25,86,3,4,4,11,Loyal Users
10056,5138,7,11,1,2,1,4,Lost
10083,1754,9,13,1,2,1,4,Lost
10115,425,36,120,3,4,4,11,Loyal Users
10282,139,18,48,4,3,3,10,Loyal Users
10341,108,7,37,4,2,3,9,Promising
10412,488,14,16,2,3,2,7,Casual Users
10417,3086,5,12,1,1,1,3,Lost
10512,97,48,83,4,5,4,13,Champions
10709,2106,5,8,1,1,1,3,Lost
10754,214,22,76,3,4,4,11,Loyal Users
11149,57,54,67,5,5,4,14,Champions
11283,771,13,18,2,3,2,7,Casual Users
11304,777,6,9,2,1,1,4,Lost
11344,71,11,29,4,2,2,8,Promising
11577,162,36,212,4,4,5,13,Champions
11740,1133,14,16,2,3,2,7,Casual Users
11981,742,10,47,2,2,3,7,Lost
11986,143,32,59,4,4,3,11,Loyal Users
12108,309,27,75,3,4,4,11,Loyal Users
12331,49,36,141,5,4,4,13,Champions
12419,90,30,88,4,4,4,12,Champions
12630,62,80,173,5,5,5,15,Champions
12679,152,12,14,4,3,1,8,Loyal Users
12815,2248,57,199,1,5,5,11,At Risk
12925,25,89,194,5,5,5,15,Champions
12989,118,92,175,4,5,5,14,Champions
12996,1267,15,44,1,3,3,7,Casual Users
13008,105,93,374,4,5,5,14,Champions
13221,29,10,22,5,2,2,9,Promising
13305,17,96,165,5,5,5,15,Champions
415,168,22,31,3,4,2,9,Loyal Users
780,1,38,139,5,4,4,13,Champions
1128,1984,13,18,1,3,2,6,Casual Users
1227,14,78,299,5,5,5,15,Champions
1475,200,66,199,3,5,5,13,Loyal Users
1486,1351,7,64,1,2,4,7,Lost
1739,286,83,427,3,5,5,13,Loyal Users
2176,117,5,5,4,1,1,6,Promising
2836,126,5,5,4,1,1,6,Promising
2856,247,19,90,3,3,4,10,Loyal Users
2892,613,10,17,2,2,2,6,Lost
3327,340,5,8,3,1,1,5,Casual Users
4322,94,25,66,4,4,4,12,Champions
4405,1703,5,12,1,1,1,3,Lost
4494,1448,13,27,1,3,2,6,Casual Users
5150,514,14,21,2,3,2,7,Casual Users
5327,1880,6,10,1,1,1,3,Lost
5702,1453,5,5,1,1,1,3,Lost
5738,1225,21,96,2,3,4,9,Casual Users
6072,133,82,333,4,5,5,14,Champions
6249,254,19,33,3,3,3,9,Loyal Users
6299,149,28,58,4,4,3,11,Loyal Users
6581,3603,5,7,1,1,1,3,Lost
7566,4,87,200,5,5,5,15,Champions
7664,83,117,436,4,5,5,14,Champions
7715,1223,5,7,2,1,1,4,Lost
7815,3232,11,20,1,2,2,5,Lost
7831,10,85,275,5,5,5,15,Champions
8140,395,16,67,3,3,4,10,Loyal Users
8161,157,7,14,4,2,1,7,Promising
8824,93,16,23,4,3,2,9,Loyal Users
8909,989,10,105,2,2,4,8,Lost
9108,402,8,46,3,2,3,8,Casual Users
9351,32,108,730,5,5,5,15,Champions
9596,122,25,41,4,4,3,11,Loyal Users
9745,52,50,112,5,5,4,14,Champions
9841,405,30,31,3,4,2,9,Loyal Users
9858,12,100,368,5,5,5,15,Champions
10363,847,21,41,2,3,3,8,Casual Users
10438,8,136,666,5,5,5,15,Champions
10459,586,8,35,2,2,3,7,Lost
10493,108,26,74,4,4,4,12,Champions
10780,273,163,589,3,5,5,13,Loyal Users
10905,543,9,32,2,2,3,7,Lost
11002,156,7,12,4,2,1,7,Promising
11215,28,59,257,5,5,5,15,Champions
11354,3565,5,6,1,1,1,3,Lost
11432,119,38,74,4,4,4,12,Champions
11697,69,26,113,5,4,4,13,Champions
11880,104,24,47,4,4,3,11,Loyal Users
11984,118,78,275,4,5,5,14,Champions
12262,377,8,18,3,2,2,7,Casual Users
12688,683,39,165,2,4,5,11,At Risk
12836,75,47,111,4,5,4,13,Champions
13097,796,5,7,2,1,1,4,Lost
13250,44,35,253,5,4,5,14,Champions
13326,136,8,61,4,2,3,9,Promising
257,27,44,109,5,4,4,13,Champions
299,17,8,11,5,2,1,8,Promising
641,933,13,52,2,3,3,8,Casual Users
644,63,158,331,5,5,5,15,Champions
826,4236,24,111,1,4,4,9,At Risk
1186,810,8,39,2,2,3,7,Lost
1250,1218,12,17,2,3,2,7,Casual Users
1314,133,56,149,4,5,5,14,Champions
1497,985,5,8,2,1,1,4,Lost
1521,4914,23,50,1,4,3,8,At Risk
1569,1405,8,12,1,2,1,4,Lost
1751,1428,9,15,1,2,1,4,Lost
1841,130,82,612,4,5,5,14,Champions
1843,393,44,76,3,4,4,11,Loyal Users
2153,33,131,600,5,5,5,15,Champions
2418,144,168,1020,4,5,5,14,Champions
3097,23,98,225,5,5,5,15,Champions
3119,33,139,164,5,5,5,15,Champions
3243,111,6,8,4,1,1,6,Promising
3332,5651,10,91,1,2,4,7,Lost
4034,12,101,764,5,5,5,15,Champions
4262,326,5,5,3,1,1,5,Casual Users
4318,432,7,18,3,2,2,7,Casual Users
4419,768,5,13,2,1,1,4,Lost
4623,40,56,505,5,5,5,15,Champions
5554,103,16,28,4,3,2,9,Loyal Users
5579,6,92,465,5,5,5,15,Champions
5594,10,52,77,5,5,4,14,Champions
5751,1134,5,9,2,1,1,4,Lost
6081,1030,5,9,2,1,1,4,Lost
6141,487,22,139,2,4,4,10,At Risk
6255,7,81,169,5,5,5,15,Champions
6379,907,10,25,2,2,2,6,Lost
6584,134,9,58,4,2,3,9,Promising
6617,96,51,162,4,5,5,14,Champions
6686,41,64,316,5,5,5,15,Champions
7053,3562,41,51,1,4,3,8,At Risk
7549,1458,11,18,1,2,2,5,Lost
7891,265,21,50,3,3,3,9,Loyal Users
8095,1390,8,34,1,2,3,6,Lost
8393,43,12,16,5,3,2,10,Loyal Users
8573,728,7,15,2,2,1,5,Lost
8712,135,77,394,4,5,5,14,Champions
8720,111,22,32,4,4,3,11,Loyal Users
9139,449,5,7,3,1,1,5,Casual Users
9343,255,77,288,3,5,5,13,Loyal Users
9659,151,44,86,4,4,4,12,Champions
9715,95,95,228,4,5,5,14,Champions
10498,27,18,36,5,3,3,11,Loyal Users
11315,415,17,44,3,3,3,9,Loyal Users
11518,181,20,50,3,3,3,9,Loyal Users
11545,424,21,23,3,3,2,8,Loyal Users
11652,2081,5,9,1,1,1,3,Lost
11701,507,20,39,2,3,3,8,Casual Users
12199,138,23,52,4,4,3,11,Loyal Users
12326,2106,15,35,1,3,3,7,Casual Users
12839,174,7,21,3,2,2,7,Casual Users
13088,571,17,31,2,3,2,7,Casual Users
13328,94,27,164,4,4,5,13,Champions
13378,1517,6,25,1,1,2,4,Lost
13577,2314,12,23,1,3,2,6,Casual Users
64,391,12,14,3,3,1,7,Loyal Users
117,124,12,51,4,3,3,10,Loyal Users
227,169,12,28,3,3,2,8,Loyal Users
579,95,23,46,4,4,3,11,Loyal Users
1220,1561,12,25,1,3,2,6,Casual Users
1222,151,5,72,4,1,4,9,Promising
1225,115,5,24,4,1,2,7,Promising
1299,5513,7,35,1,2,3,6,Lost
1478,38,6,17,5,1,2,8,Promising
1490,498,42,327,2,4,5,11,At Risk
1603,6,94,187,5,5,5,15,Champions
1874,194,16,40,3,3,3,9,Loyal Users
2131,153,113,448,4,5,5,14,Champions
2743,533,13,28,2,3,2,7,Casual Users
2845,213,30,72,3,4,4,11,Loyal Users
2891,1,82,116,5,5,4,14,Champions
2895,1,65,149,5,5,5,15,Champions
2984,78,113,460,4,5,5,14,Champions
2987,145,43,138,4,4,4,12,Champions
3056,121,44,178,4,4,5,13,Champions
3080,1164,5,10,2,1,1,4,Lost
3181,261,30,74,3,4,4,11,Loyal Users
3806,3370,5,8,1,1,1,3,Lost
3931,237,9,14,3,2,1,6,Casual Users
4130,600,40,159,2,4,5,11,At Risk
4247,122,19,23,4,3,2,9,Loyal Users
4465,76,5,26,4,1,2,7,Promising
4476,176,86,223,3,5,5,13,Loyal Users
4870,478,33,106,2,4,4,10,At Risk
5580,161,6,16,4,1,2,7,Promising
5610,695,5,8,2,1,1,4,Lost
5656,117,5,9,4,1,1,6,Promising
5713,638,23,45,2,4,3,9,At Risk
6103,567,6,19,2,1,2,5,Lost
6134,409,8,15,3,2,1,6,Casual Users
6406,28,18,37,5,3,3,11,Loyal Users
6660,4068,9,20,1,2,2,5,Lost
7441,371,44,70,3,4,4,11,Loyal Users
7465,1930,5,54,1,1,3,5,Lost
7503,11,14,59,5,3,3,11,Loyal Users
7692,590,7,24,2,2,2,6,Lost
7860,1403,15,31,1,3,2,6,Casual Users
9300,2163,7,32,1,2,3,6,Lost
9469,158,11,56,4,2,3,9,Promising
9583,773,126,433,2,5,5,12,At Risk
9664,250,45,112,3,4,4,11,Loyal Users
9814,252,10,29,3,2,2,7,Casual Users
9906,619,7,25,2,2,2,6,Lost
9930,13,13,89,5,3,4,12,Loyal Users
9995,116,21,24,4,3,2,9,Loyal Users
11073,155,16,26,4,3,2,9,Loyal Users
11865,15,70,169,5,5,5,15,Champions
12686,101,84,140,4,5,4,13,Champions
12978,5,110,327,5,5,5,15,Champions
13136,64,18,153,5,3,5,13,Loyal Users
13206,8,61,124,5,5,4,14,Champions
13418,289,5,79,3,1,4,8,Casual Users
504,1269,9,54,1,2,3,6,Lost
554,546,19,68,2,3,4,9,Casual Users
598,1664,5,16,1,1,2,4,Lost
764,2948,15,15,1,3,1,5,Casual Users
886,2490,23,29,1,4,2,7,At Risk
936,3761,13,32,1,3,3,7,Casual Users
1002,3645,19,36,1,3,3,7,Casual Users
1048,1866,56,225,1,5,5,11,At Risk
1050,317,22,62,3,4,3,10,Loyal Users
1166,534,22,52,2,4,3,9,At Risk
1252,47,43,137,5,4,4,13,Champions
1255,1016,6,16,2,1,2,5,Lost
1298,29,20,43,5,3,3,11,Loyal Users
1375,64,26,49,5,4,3,12,Loyal Users
1692,756,14,42,2,3,3,8,Casual Users
1733,4,18,56,5,3,3,11,Loyal Users
1973,128,14,70,4,3,4,11,Loyal Users
2220,2497,10,32,1,2,3,6,Lost
2286,255,22,117,3,4,4,11,Loyal Users
2627,284,10,17,3,2,2,7,Casual Users
2909,84,103,668,4,5,5,14,Champions
3281,3,79,163,5,5,5,15,Champions
3694,415,5,13,3,1,1,5,Casual Users
3762,3774,8,8,1,2,1,4,Lost
4134,3884,9,14,1,2,1,4,Lost
4374,284,21,33,3,3,3,9,Loyal Users
6185,844,5,6,2,1,1,4,Lost
6351,2397,7,7,1,2,1,4,Lost
6367,406,50,143,3,5,4,12,Loyal Users
6568,440,15,23,3,3,2,8,Loyal Users
7068,122,10,13,4,2,1,7,Promising
7127,2242,11,31,1,2,2,5,Lost
7247,189,42,78,3,4,4,11,Loyal Users
7319,19,10,33,5,2,3,10,Promising
7517,0,11,101,5,2,4,11,Promising
7926,15,65,333,5,5,5,15,Champions
7933,258,12,28,3,3,2,8,Loyal Users
8288,94,91,475,4,5,5,14,Champions
8557,158,23,124,4,4,4,12,Champions
8679,292,32,78,3,4,4,11,Loyal Users
8870,67,30,37,5,4,3,12,Loyal Users
9074,534,14,63,2,3,4,9,Casual Users
9513,1951,9,14,1,2,1,4,Lost
9621,402,53,149,3,5,5,13,Loyal Users
9768,2558,7,14,1,2,1,4,Lost
9894,88,12,14,4,3,1,8,Loyal Users
10108,46,28,33,5,4,3,12,Loyal Users
10111,208,75,719,3,5,5,13,Loyal Users
10130,2328,39,158,1,4,5,10,At Risk
10369,2107,27,134,1,4,4,9,At Risk
10430,768,8,10,2,2,1,5,Lost
10578,3555,16,50,1,3,3,7,Casual Users
10986,5096,6,9,1,1,1,3,Lost
11455,227,46,286,3,5,5,13,Loyal Users
11527,545,52,140,2,5,4,11,At Risk
11933,88,12,26,4,3,2,9,Loyal Users
12236,125,18,42,4,3,3,10,Loyal Users
12370,77,86,364,4,5,5,14,Champions
12775,3156,11,13,1,2,1,4,Lost
12817,235,7,8,3,2,1,6,Casual Users
13381,53,76,209,5,5,5,15,Champions
13461,458,8,24,3,2,2,7,Casual Users
41,317,30,55,3,4,3,10,Loyal Users
154,280,23,43,3,4,3,10,Loyal Users
309,169,22,111,3,4,4,11,Loyal Users
425,969,7,8,2,2,1,5,Lost
904,4025,6,12,1,1,1,3,Lost
931,311,34,52,3,4,3,10,Loyal Users
1181,112,20,24,4,3,2,9,Loyal Users
1189,2700,52,52,1,5,3,9,At Risk
1321,283,55,80,3,5,4,12,Loyal Users
1326,11,40,66,5,4,4,13,Champions
1452,480,5,6,2,1,1,4,Lost
1530,18,12,27,5,3,2,10,Loyal Users
1559,33,13,28,5,3,2,10,Loyal Users
1846,1293,11,14,1,2,1,4,Lost
1979,1694,19,19,1,3,2,6,Casual Users
2041,15,27,47,5,4,3,12,Loyal Users
2150,957,16,35,2,3,3,8,Casual Users
3341,3744,6,12,1,1,1,3,Lost
3440,159,15,16,4,3,2,9,Loyal Users
3573,141,56,103,4,5,4,13,Champions
3574,1825,18,44,1,3,3,7,Casual Users
3675,150,5,5,4,1,1,6,Promising
3943,3,196,938,5,5,5,15,Champions
4006,27,34,52,5,4,3,12,Loyal Users
4017,855,23,54,2,4,3,9,At Risk
4110,247,22,216,3,4,5,12,Loyal Users
4191,1570,7,13,1,2,1,4,Lost
4249,411,23,57,3,4,3,10,Loyal Users
4445,125,16,29,4,3,2,9,Loyal Users
4505,134,22,26,4,4,2,10,Loyal Users
5265,222,14,47,3,3,3,9,Loyal Users
5291,110,17,57,4,3,3,10,Loyal Users
5428,37,35,93,5,4,4,13,Champions
5728,2377,5,6,1,1,1,3,Lost
5896,22,38,100,5,4,4,13,Champions
6345,29,5,23,5,1,2,8,Promising
6414,22,55,147,5,5,5,15,Champions
6588,1610,9,21,1,2,2,5,Lost
6798,2608,8,42,1,2,3,6,Lost
6822,127,6,18,4,1,2,7,Promising
7072,20,38,103,5,4,4,13,Champions
7291,432,9,11,3,2,1,6,Casual Users
7366,651,6,7,2,1,1,4,Lost
7427,272,29,95,3,4,4,11,Loyal Users
7655,150,9,18,4,2,2,8,Promising
7870,265,10,47,3,2,3,8,Casual Users
8203,440,33,45,3,4,3,10,Loyal Users
8322,423,15,34,3,3,3,9,Loyal Users
8390,480,38,60,2,4,3,9,At Risk
8620,92,24,246,4,4,5,13,Champions
8647,4458,6,7,1,1,1,3,Lost
8985,404,25,68,3,4,4,11,Loyal Users
9021,1390,8,10,1,2,1,4,Lost
9278,631,9,12,2,2,1,5,Lost
10122,1380,16,50,1,3,3,7,Casual Users
10292,8,65,188,5,5,5,15,Champions
10330,117,26,103,4,4,4,12,Champions
10685,155,58,96,4,5,4,13,Champions
10873,3397,7,12,1,2,1,4,Lost
10954,663,31,132,2,4,4,10,At Risk
11587,1143,26,161,2,4,5,11,At Risk
11932,424,5,8,3,1,1,5,Casual Users
11971,11,54,291,5,5,5,15,Champions
12050,9,51,384,5,5,5,15,Champions
12172,9,162,645,5,5,5,15,Champions
12297,2697,9,16,1,2,2,5,Lost
12307,1950,13,54,1,3,3,7,Casual Users
12946,7,11,15,5,2,1,8,Promising
12992,96,112,298,4,5,5,14,Champions
13026,82,13,92,4,3,4,11,Loyal Users
13282,86,93,302,4,5,5,14,Champions
13478,3791,12,30,1,3,2,6,Casual Users
347,1190,9,13,2,2,1,5,Lost
447,1011,5,7,2,1,1,4,Lost
455,13,20,40,5,3,3,11,Loyal Users
484,468,9,11,3,2,1,6,Casual Users
607,1543,7,15,1,2,1,4,Lost
1035,1423,6,11,1,1,1,3,Lost
1529,1297,38,69,1,4,4,9,At Risk
1632,434,15,29,3,3,2,8,Loyal Users
1688,4,73,142,5,5,4,14,Champions
2190,424,6,12,3,1,1,5,Casual Users
2365,406,19,59,3,3,3,9,Loyal Users
2410,1678,24,55,1,4,3,8,At Risk
2569,108,31,54,4,4,3,11,Loyal Users
2801,1179,11,19,2,2,2,6,Lost
2810,228,26,55,3,4,3,10,Loyal Users
2847,101,21,106,4,3,4,11,Loyal Users
2910,5015,10,15,1,2,1,4,Lost
3256,651,33,90,2,4,4,10,At Risk
3285,207,5,16,3,1,2,6,Casual Users
3522,83,125,567,4,5,5,14,Champions
4276,3130,10,26,1,2,2,5,Lost
4393,1018,12,15,2,3,1,6,Casual Users
4416,30,69,153,5,5,5,15,Champions
4478,17,36,194,5,4,5,14,Champions
4647,650,13,25,2,3,2,7,Casual Users
4902,305,8,10,3,2,1,6,Casual Users
5572,114,17,88,4,3,4,11,Loyal Users
5789,407,14,33,3,3,3,9,Loyal Users
6084,86,13,81,4,3,4,11,Loyal Users
6562,111,19,105,4,3,4,11,Loyal Users
6776,132,18,34,4,3,3,10,Loyal Users
6921,590,9,27,2,2,2,6,Lost
7014,31,147,231,5,5,5,15,Champions
7097,245,78,425,3,5,5,13,Loyal Users
7432,236,13,16,3,3,2,8,Loyal Users
8135,179,12,27,3,3,2,8,Loyal Users
8237,770,14,16,2,3,2,7,Casual Users
8367,21,16,26,5,3,2,10,Loyal Users
8474,3159,5,12,1,1,1,3,Lost
8921,2065,10,31,1,2,2,5,Lost
9352,3,5,7,5,1,1,7,Promising
9501,267,42,60,3,4,3,10,Loyal Users
9576,374,30,106,3,4,4,11,Loyal Users
9839,198,24,54,3,4,3,10,Loyal Users
9948,537,8,26,2,2,2,6,Lost
9982,2282,6,14,1,1,1,3,Lost
10107,463,6,7,3,1,1,5,Casual Users
10220,252,121,536,3,5,5,13,Loyal Users
10289,309,7,32,3,2,3,8,Casual Users
10426,1313,9,15,1,2,1,4,Lost
10484,704,15,64,2,3,4,9,Casual Users
11343,3703,7,18,1,2,2,5,Lost
11655,3434,6,33,1,1,3,5,Lost
11679,255,18,76,3,3,4,10,Loyal Users
11847,81,6,6,4,1,1,6,Promising
12120,1528,20,41,1,3,3,7,Casual Users
12357,64,47,169,5,5,5,15,Champions
12675,85,18,34,4,3,3,10,Loyal Users
13133,266,24,32,3,4,3,10,Loyal Users
13157,198,60,101,3,5,4,12,Loyal Users
13210,4969,12,25,1,3,2,6,Casual Users
15,136,7,15,4,2,1,7,Promising
43,219,78,183,3,5,5,13,Loyal Users
845,12,85,355,5,5,5,15,Champions
1136,27,42,97,5,4,4,13,Champions
1151,119,14,48,4,3,3,10,Loyal Users
1253,247,9,13,3,2,1,6,Casual Users
1827,2428,22,91,1,4,4,9,At Risk
1861,824,9,16,2,2,2,6,Lost
2346,1461,41,65,1,4,4,9,At Risk
2420,413,61,267,3,5,5,13,Loyal Users
2545,1671,12,30,1,3,2,6,Casual Users
3112,150,5,6,4,1,1,6,Promising
3118,1000,23,48,2,4,3,9,At Risk
3320,1403,7,8,1,2,1,4,Lost
3333,588,7,16,2,2,2,6,Lost
3382,101,54,161,4,5,5,14,Champions
3434,131,18,29,4,3,2,9,Loyal Users
3638,15,9,18,5,2,2,9,Promising
3686,512,20,59,2,3,3,8,Casual Users
3789,3510,17,22,1,3,2,6,Casual Users
4015,2349,5,5,1,1,1,3,Lost
4235,340,6,10,3,1,1,5,Casual Users
4308,4,22,44,5,4,3,12,Loyal Users
4441,167,44,78,3,4,4,11,Loyal Users
4460,688,37,87,2,4,4,10,At Risk
4534,3143,7,8,1,2,1,4,Lost
4629,15,104,433,5,5,5,15,Champions
4742,132,15,17,4,3,2,9,Loyal Users
5171,2284,5,10,1,1,1,3,Lost
5330,15,51,107,5,5,4,14,Champions
5420,865,44,108,2,4,4,10,At Risk
5494,1432,11,18,1,2,2,5,Lost
5667,855,5,11,2,1,1,4,Lost
5743,128,8,99,4,2,4,10,Promising
5844,1819,30,62,1,4,3,8,At Risk
5870,235,83,204,3,5,5,13,Loyal Users
6140,76,119,259,4,5,5,14,Champions
6179,419,11,16,3,2,2,7,Casual Users
6289,956,5,13,2,1,1,4,Lost
6479,223,14,41,3,3,3,9,Loyal Users
6646,24,84,202,5,5,5,15,Champions
6748,2054,5,16,1,1,2,4,Lost
7148,555,62,177,2,5,5,12,At Risk
7249,53,29,58,5,4,3,12,Loyal Users
7275,17,174,433,5,5,5,15,Champions
7348,140,36,69,4,4,4,12,Champions
7383,231,17,22,3,3,2,8,Loyal Users
7881,7,8,35,5,2,3,10,Promising
8002,834,6,22,2,1,2,5,Lost
8244,154,10,22,4,2,2,8,Promising
8591,273,55,166,3,5,5,13,Loyal Users
8593,486,6,22,2,1,2,5,Lost
9203,128,19,65,4,3,4,11,Loyal Users
9790,761,11,21,2,2,2,6,Lost
10442,2606,18,107,1,3,4,8,Casual Users
10897,229,29,54,3,4,3,10,Loyal Users
10940,2145,6,10,1,1,1,3,Lost
11184,1096,28,83,2,4,4,10,At Risk
11477,386,20,27,3,3,2,8,Loyal Users
11606,263,78,502,3,5,5,13,Loyal Users
11875,208,27,100,3,4,4,11,Loyal Users
12147,390,8,17,3,2,2,7,Casual Users
12226,151,44,325,4,4,5,13,Champions
12243,13,57,350,5,5,5,15,Champions
12301,1352,6,11,1,1,1,3,Lost
12395,160,18,37,4,3,3,10,Loyal Users
12446,5360,8,15,1,2,1,4,Lost
12706,553,7,16,2,2,2,6,Lost
13030,454,5,6,3,1,1,5,Casual Users
13134,1750,6,8,1,1,1,3,Lost
13302,1360,7,15,1,2,1,4,Lost
262,273,91,198,3,5,5,13,Loyal Users
511,694,36,119,2,4,4,10,At Risk
929,302,8,60,3,2,3,8,Casual Users
1052,94,148,523,4,5,5,14,Champions
1756,330,32,88,3,4,4,11,Loyal Users
1904,93,87,160,4,5,5,14,Champions
1946,444,5,15,3,1,1,5,Casual Users
2385,162,65,144,4,5,4,13,Champions
2565,994,5,13,2,1,1,4,Lost
2691,3056,10,11,1,2,1,4,Lost
2741,1,8,33,5,2,3,10,Promising
2798,29,33,57,5,4,3,12,Loyal Users
2834,375,12,25,3,3,2,8,Loyal Users
3040,2925,6,25,1,1,2,4,Lost
3310,132,6,10,4,1,1,6,Promising
3383,2536,5,13,1,1,1,3,Lost
3527,2308,5,12,1,1,1,3,Lost
3612,95,22,75,4,4,4,12,Champions
3824,15,83,351,5,5,5,15,Champions
3835,674,8,29,2,2,2,6,Lost
4145,1817,9,27,1,2,2,5,Lost
4638,651,20,28,2,3,2,7,Casual Users
5210,126,103,349,4,5,5,14,Champions
5220,1436,15,22,1,3,2,6,Casual Users
5474,425,43,52,3,4,3,10,Loyal Users
5576,2411,15,84,1,3,4,8,Casual Users
5675,4549,5,14,1,1,1,3,Lost
5688,65,92,173,5,5,5,15,Champions
6166,5,6,20,5,1,2,8,Promising
6329,401,92,253,3,5,5,13,Loyal Users
6333,95,14,33,4,3,3,10,Loyal Users
6335,277,7,21,3,2,2,7,Casual Users
6426,595,18,53,2,3,3,8,Casual Users
6659,2258,7,7,1,2,1,4,Lost
6772,3056,10,21,1,2,2,5,Lost
6787,1528,9,10,1,2,1,4,Lost
6984,252,40,154,3,4,5,12,Loyal Users
7606,584,17,96,2,3,4,9,Casual Users
7628,419,16,36,3,3,3,9,Loyal Users
7693,32,162,203,5,5,5,15,Champions
7765,73,31,141,4,4,4,12,Champions
7903,122,5,17,4,1,2,7,Promising
7957,469,33,77,3,4,4,11,Loyal Users
8078,33,75,123,5,5,4,14,Champions
8216,686,13,17,2,3,2,7,Casual Users
8279,123,27,90,4,4,4,12,Champions
8462,981,8,51,2,2,3,7,Lost
8509,82,7,16,4,2,2,8,Promising
8798,654,15,73,2,3,4,9,Casual Users
8865,673,8,8,2,2,1,5,Lost
8939,3380,6,17,1,1,2,4,Lost
9325,2974,6,9,1,1,1,3,Lost
9371,1023,15,24,2,3,2,7,Casual Users
9462,391,6,7,3,1,1,5,Casual Users
9553,5891,6,7,1,1,1,3,Lost
9628,85,45,131,4,4,4,12,Champions
9760,208,32,156,3,4,5,12,Loyal Users
10367,1555,7,9,1,2,1,4,Lost
10398,75,17,46,4,3,3,10,Loyal Users
10538,96,75,189,4,5,5,14,Champions
10638,1,12,25,5,3,2,10,Loyal Users
11132,1129,7,17,2,2,2,6,Lost
11262,149,6,8,4,1,1,6,Promising
11411,1680,6,6,1,1,1,3,Lost
11568,2668,8,55,1,2,3,6,Lost
11658,262,17,28,3,3,2,8,Loyal Users
12687,106,22,67,4,4,4,12,Champions
13004,2219,34,39,1,4,3,8,At Risk
112,12,47,97,5,5,4,14,Champions
269,16,84,218,5,5,5,15,Champions
1045,145,35,96,4,4,4,12,Champions
1194,490,11,94,2,2,4,8,Lost
1750,115,80,207,4,5,5,14,Champions
1793,1977,5,7,1,1,1,3,Lost
1947,397,24,50,3,4,3,10,Loyal Users
2438,19,21,28,5,3,2,10,Loyal Users
2524,9,36,46,5,4,3,12,Loyal Users
3015,709,8,74,2,2,4,8,Lost
3086,48,42,91,5,4,4,13,Champions
3898,683,38,66,2,4,4,10,At Risk
4037,2257,6,15,1,1,1,3,Lost
4195,157,38,189,4,4,5,13,Champions
4448,93,136,295,4,5,5,14,Champions
4741,408,38,141,3,4,4,11,Loyal Users
5446,3,25,30,5,4,2,11,Loyal Users
5744,433,18,29,3,3,2,8,Loyal Users
5861,2756,7,28,1,2,2,5,Lost
5874,23,12,22,5,3,2,10,Loyal Users
6042,116,10,46,4,2,3,9,Promising
6195,7,251,394,5,5,5,15,Champions
6279,1032,5,6,2,1,1,4,Lost
6531,752,8,15,2,2,1,5,Lost
6582,218,5,9,3,1,1,5,Casual Users
6663,2967,8,41,1,2,3,6,Lost
6876,1119,6,6,2,1,1,4,Lost
6940,705,23,87,2,4,4,10,At Risk
7368,104,15,29,4,3,2,9,Loyal Users
7541,42,67,292,5,5,5,15,Champions
7641,2140,10,16,1,2,2,5,Lost
7979,723,8,11,2,2,1,5,Lost
8024,275,17,52,3,3,3,9,Loyal Users
8083,175,9,9,3,2,1,6,Casual Users
8504,1702,5,9,1,1,1,3,Lost
8569,27,181,435,5,5,5,15,Champions
8766,600,39,99,2,4,4,10,At Risk
8954,413,8,18,3,2,2,7,Casual Users
9168,1415,18,29,1,3,2,6,Casual Users
9364,783,10,21,2,2,2,6,Lost
9423,298,119,200,3,5,5,13,Loyal Users
9627,79,82,565,4,5,5,14,Champions
9832,287,19,26,3,3,2,8,Loyal Users
9992,4411,12,18,1,3,2,6,Casual Users
10016,465,8,38,3,2,3,8,Casual Users
10026,91,69,132,4,5,4,13,Champions
10099,11,63,86,5,5,4,14,Champions
10109,469,50,78,3,5,4,12,Loyal Users
10606,416,31,64,3,4,4,11,Loyal Users
11123,150,27,47,4,4,3,11,Loyal Users
11358,122,27,199,4,4,5,13,Champions
11939,3,7,11,5,2,1,8,Promising
12065,404,6,11,3,1,1,5,Casual Users
12161,141,50,90,4,5,4,13,Champions
12196,248,12,21,3,3,2,8,Loyal Users
12862,49,17,25,5,3,2,10,Loyal Users
13017,1910,5,6,1,1,1,3,Lost
13200,204,15,24,3,3,2,8,Loyal Users
13369,410,43,80,3,4,4,11,Loyal Users
327,136,17,153,4,3,5,12,Loyal Users
563,2687,5,5,1,1,1,3,Lost
615,2,115,708,5,5,5,15,Champions
849,108,34,58,4,4,3,11,Loyal Users
1263,21,23,69,5,4,4,13,Champions
1470,13,14,23,5,3,2,10,Loyal Users
1576,2115,8,12,1,2,1,4,Lost
1732,1667,25,58,1,4,3,8,At Risk
1894,832,8,12,2,2,1,5,Lost
2106,82,8,37,4,2,3,9,Promising
2246,0,88,128,5,5,4,14,Champions
2257,848,34,172,2,4,5,11,At Risk
2278,1022,10,22,2,2,2,6,Lost
2494,731,23,28,2,4,2,8,At Risk
2794,329,18,50,3,3,3,9,Loyal Users
2841,469,65,120,3,5,4,12,Loyal Users
3404,252,18,20,3,3,2,8,Loyal Users
3517,407,12,24,3,3,2,8,Loyal Users
3674,44,43,113,5,4,4,13,Champions
3766,1430,37,117,1,4,4,9,At Risk
3999,79,81,274,4,5,5,14,Champions
4073,312,35,277,3,4,5,12,Loyal Users
4348,2422,5,23,1,1,2,4,Lost
4520,481,19,122,2,3,4,9,Casual Users
4662,0,184,414,5,5,5,15,Champions
4816,1138,11,13,2,2,1,5,Lost
4885,706,5,7,2,1,1,4,Lost
4956,685,5,13,2,1,1,4,Lost
5094,117,18,44,4,3,3,10,Loyal Users
5186,553,14,40,2,3,3,8,Casual Users
5316,2483,8,11,1,2,1,4,Lost
5329,88,9,12,4,2,1,7,Promising
5619,117,36,59,4,4,3,11,Loyal Users
5876,13,51,128,5,5,4,14,Champions
5941,28,6,10,5,1,1,7,Promising
6471,1603,9,11,1,2,1,4,Lost
6514,650,38,68,2,4,4,10,At Risk
6877,266,31,37,3,4,3,10,Loyal Users
7093,88,198,385,4,5,5,14,Champions
7174,11,52,145,5,5,4,14,Champions
7365,1663,5,8,1,1,1,3,Lost
7558,701,10,40,2,2,3,7,Lost
8016,244,27,55,3,4,3,10,Loyal Users
8372,756,11,27,2,2,2,6,Lost
8406,1945,9,37,1,2,3,6,Lost
8495,8,132,256,5,5,5,15,Champions
8688,109,5,8,4,1,1,6,Promising
8996,46,101,170,5,5,5,15,Champions
9031,1381,7,17,1,2,2,5,Lost
9186,103,103,308,4,5,5,14,Champions
9350,447,17,126,3,3,4,10,Loyal Users
9528,738,19,26,2,3,2,7,Casual Users
9610,45,18,68,5,3,4,12,Loyal Users
9643,283,5,7,3,1,1,5,Casual Users
9739,841,11,24,2,2,2,6,Lost
9753,44,19,107,5,3,4,12,Loyal Users
9805,70,20,30,4,3,2,9,Loyal Users
10333,114,48,170,4,5,5,14,Champions
10949,39,43,84,5,4,4,13,Champions
11047,0,99,475,5,5,5,15,Champions
11082,433,9,33,3,2,3,8,Casual Users
11130,3465,6,10,1,1,1,3,Lost
11193,108,17,25,4,3,2,9,Loyal Users
11700,830,5,5,2,1,1,4,Lost
11763,443,21,61,3,3,3,9,Loyal Users
11784,120,33,66,4,4,4,12,Champions
12173,712,10,20,2,2,2,6,Lost
12482,147,31,46,4,4,3,11,Loyal Users
12525,3228,6,12,1,1,1,3,Lost
12640,118,33,147,4,4,5,13,Champions
12766,74,11,27,4,2,2,8,Promising
12959,2213,6,9,1,1,1,3,Lost
13346,8,6,10,5,1,1,7,Promising
165,17,37,81,5,4,4,13,Champions
666,468,11,34,3,2,3,8,Casual Users
775,16,16,132,5,3,4,12,Loyal Users
1091,577,8,12,2,2,1,5,Lost
1132,93,15,76,4,3,4,11,Loyal Users
1182,929,34,43,2,4,3,9,At Risk
1240,57,58,253,5,5,5,15,Champions
1330,2013,10,11,1,2,1,4,Lost
1654,813,8,13,2,2,1,5,Lost
1697,232,5,23,3,1,2,6,Casual Users
1703,230,59,155,3,5,5,13,Loyal Users
1800,1324,6,21,1,1,2,4,Lost
1901,539,6,48,2,1,3,6,Lost
2019,352,68,256,3,5,5,13,Loyal Users
2428,1571,9,14,1,2,1,4,Lost
2764,69,53,251,5,5,5,15,Champions
3074,4,50,137,5,5,4,14,Champions
3262,14,44,112,5,4,4,13,Champions
3401,154,24,33,4,4,3,11,Loyal Users
4595,73,34,78,4,4,4,12,Champions
4847,232,8,14,3,2,1,6,Casual Users
4921,2054,6,14,1,1,1,3,Lost
4967,1557,9,11,1,2,1,4,Lost
5044,688,14,27,2,3,2,7,Casual Users
5088,628,15,82,2,3,4,9,Casual Users
5166,1697,21,28,1,3,2,6,Casual Users
5462,274,8,34,3,2,3,8,Casual Users
5476,567,31,34,2,4,3,9,At Risk
5509,45,45,144,5,4,4,13,Champions
6670,1789,37,77,1,4,4,9,At Risk
6935,203,12,58,3,3,3,9,Loyal Users
6976,36,92,463,5,5,5,15,Champions
7213,4,55,192,5,5,5,15,Champions
7270,3444,11,16,1,2,2,5,Lost
7727,2824,9,30,1,2,2,5,Lost
7764,1987,10,75,1,2,4,7,Lost
8082,84,72,229,4,5,5,14,Champions
8094,283,17,37,3,3,3,9,Loyal Users
8177,72,71,506,4,5,5,14,Champions
8196,417,23,48,3,4,3,10,Loyal Users
8590,1607,25,52,1,4,3,8,At Risk
8605,4265,19,70,1,3,4,8,Casual Users
8706,108,58,284,4,5,5,14,Champions
8840,4821,9,12,1,2,1,4,Lost
8973,10,69,149,5,5,5,15,Champions
9287,123,37,77,4,4,4,12,Champions
9692,158,31,164,4,4,5,13,Champions
9780,960,10,142,2,2,4,8,Lost
10350,4605,5,9,1,1,1,3,Lost
10799,46,44,294,5,4,5,14,Champions
10822,416,17,106,3,3,4,10,Loyal Users
11171,967,8,10,2,2,1,5,Lost
11650,306,7,15,3,2,1,6,Casual Users
11682,154,8,34,4,2,3,9,Promising
12109,719,16,18,2,3,2,7,Casual Users
12195,186,38,77,3,4,4,11,Loyal Users
12348,122,36,62,4,4,3,11,Loyal Users
12738,953,19,63,2,3,4,9,Casual Users
12934,4523,7,9,1,2,1,4,Lost
13341,2575,6,7,1,1,1,3,Lost
13510,74,14,86,4,3,4,11,Loyal Users
13558,329,92,168,3,5,5,13,Loyal Users
13562,6,39,88,5,4,4,13,Champions
13568,1531,13,21,1,3,2,6,Casual Users
358,6,106,191,5,5,5,15,Champions
366,139,40,65,4,4,4,12,Champions
843,264,71,438,3,5,5,13,Loyal Users
854,19,89,139,5,5,4,14,Champions
1286,1082,22,122,2,4,4,10,At Risk
1831,504,17,50,2,3,3,8,Casual Users
1971,19,18,35,5,3,3,11,Loyal Users
2036,421,8,15,3,2,1,6,Casual Users
2157,166,10,18,3,2,2,7,Casual Users
2620,5170,7,11,1,2,1,4,Lost
2732,312,32,45,3,4,3,10,Loyal Users
2734,1585,8,16,1,2,2,5,Lost
3092,536,9,37,2,2,3,7,Lost
3305,106,98,309,4,5,5,14,Champions
3330,1050,17,23,2,3,2,7,Casual Users
3637,660,14,19,2,3,2,7,Casual Users
3664,18,69,133,5,5,4,14,Champions
3907,40,7,19,5,2,2,9,Promising
4007,1108,9,11,2,2,1,5,Lost
4238,1865,55,182,1,5,5,11,At Risk
4353,1416,12,24,1,3,2,6,Casual Users
4712,2649,8,25,1,2,2,5,Lost
5048,1266,26,51,1,4,3,8,At Risk
5411,97,17,23,4,3,2,9,Loyal Users
5471,239,34,54,3,4,3,10,Loyal Users
5495,82,25,58,4,4,3,11,Loyal Users
6381,2699,5,18,1,1,2,4,Lost
6449,669,19,54,2,3,3,8,Casual Users
8221,929,5,33,2,1,3,6,Lost
8519,110,31,46,4,4,3,11,Loyal Users
9066,706,5,6,2,1,1,4,Lost
9204,1130,10,11,2,2,1,5,Lost
9238,277,6,11,3,1,1,5,Casual Users
9322,182,41,74,3,4,4,11,Loyal Users
9789,233,15,18,3,3,2,8,Loyal Users
9820,84,10,32,4,2,3,9,Promising
9941,1318,5,20,1,1,2,4,Lost
10029,2449,10,16,1,2,2,5,Lost
10100,6,54,107,5,5,4,14,Champions
10106,0,83,301,5,5,5,15,Champions
10142,631,25,36,2,4,3,9,At Risk
10618,1085,9,9,2,2,1,5,Lost
10665,20,67,188,5,5,5,15,Champions
10706,1446,8,11,1,2,1,4,Lost
10942,1437,7,12,1,2,1,4,Lost
11188,23,13,71,5,3,4,12,Loyal Users
11191,434,11,22,3,2,2,7,Casual Users
11400,242,27,84,3,4,4,11,Loyal Users
11840,943,8,49,2,2,3,7,Lost
12420,23,64,215,5,5,5,15,Champions
12512,191,45,84,3,4,4,11,Loyal Users
12544,3479,5,34,1,1,3,5,Lost
12986,661,11,19,2,2,2,6,Lost
13118,4566,10,90,1,2,4,7,Lost
13553,1590,5,7,1,1,1,3,Lost
179,403,12,25,3,3,2,8,Loyal Users
189,115,5,5,4,1,1,6,Promising
207,123,17,80,4,3,4,11,Loyal Users
489,155,77,261,4,5,5,14,Champions
590,672,34,38,2,4,3,9,At Risk
675,814,13,33,2,3,3,8,Casual Users
862,1158,5,30,2,1,2,5,Lost
1073,139,30,74,4,4,4,12,Champions
1119,524,6,9,2,1,1,4,Lost
1180,1804,5,11,1,1,1,3,Lost
1527,383,7,32,3,2,3,8,Casual Users
1635,2070,5,9,1,1,1,3,Lost
1649,2419,8,12,1,2,1,4,Lost
1828,4587,10,39,1,2,3,6,Lost
1950,71,77,373,4,5,5,14,Champions
2149,13,54,124,5,5,4,14,Champions
2354,780,16,17,2,3,2,7,Casual Users
2413,822,9,35,2,2,3,7,Lost
2817,108,49,119,4,5,4,13,Champions
2876,15,23,49,5,4,3,12,Loyal Users
2942,51,66,80,5,5,4,14,Champions
3277,145,18,55,4,3,3,10,Loyal Users
3609,403,12,17,3,3,2,8,Loyal Users
3723,134,12,30,4,3,2,9,Loyal Users
3832,879,5,41,2,1,3,6,Lost
4648,75,39,114,4,4,4,12,Champions
4864,3,28,53,5,4,3,12,Loyal Users
4930,1261,5,11,1,1,1,3,Lost
4933,2135,17,56,1,3,3,7,Casual Users
5124,41,57,91,5,5,4,14,Champions
5727,28,57,178,5,5,5,15,Champions
5869,30,42,58,5,4,3,12,Loyal Users
5982,125,70,129,4,5,4,13,Champions
6019,370,5,14,3,1,1,5,Casual Users
6256,3164,17,22,1,3,2,6,Casual Users
6445,574,11,34,2,2,3,7,Lost
6523,47,108,432,5,5,5,15,Champions
6550,2660,5,5,1,1,1,3,Lost
6605,832,5,9,2,1,1,4,Lost
6647,714,14,29,2,3,2,7,Casual Users
6770,27,105,145,5,5,4,14,Champions
6780,131,23,214,4,4,5,13,Champions
7012,23,117,337,5,5,5,15,Champions
7022,116,27,176,4,4,5,13,Champions
7142,27,95,868,5,5,5,15,Champions
7254,27,7,13,5,2,1,8,Promising
7428,135,84,159,4,5,5,14,Champions
7704,1190,39,72,2,4,4,10,At Risk
7745,1424,6,20,1,1,2,4,Lost
8023,266,19,43,3,3,3,9,Loyal Users
8102,157,19,56,4,3,3,10,Loyal Users
8189,72,34,95,4,4,4,12,Champions
8510,26,18,34,5,3,3,11,Loyal Users
9409,3,47,140,5,5,4,14,Champions
9668,101,19,35,4,3,3,10,Loyal Users
9951,498,8,27,2,2,2,6,Lost
9963,44,15,16,5,3,2,10,Loyal Users
10721,67,13,18,5,3,2,10,Loyal Users
11148,92,62,118,4,5,4,13,Champions
11536,1838,6,6,1,1,1,3,Lost
11874,210,14,29,3,3,2,8,Loyal Users
12028,1785,12,23,1,3,2,6,Casual Users
12339,243,20,52,3,3,3,9,Loyal Users
12842,44,17,31,5,3,2,10,Loyal Users
13028,306,7,20,3,2,2,7,Casual Users
13077,85,13,56,4,3,3,10,Loyal Users
13108,254,6,8,3,1,1,5,Casual Users
13175,981,9,12,2,2,1,5,Lost
13194,115,48,177,4,5,5,14,Champions
13486,254,18,30,3,3,2,8,Loyal Users
37,4660,7,7,1,2,1,4,Lost
383,853,7,54,2,2,3,7,Lost
659,273,12,24,3,3,2,8,Loyal Users
1310,91,45,86,4,4,4,12,Champions
1362,37,93,179,5,5,5,15,Champions
1396,1,140,184,5,5,5,15,Champions
1624,2270,6,12,1,1,1,3,Lost
1747,1835,10,17,1,2,2,5,Lost
2241,533,59,115,2,5,4,11,At Risk
2267,39,68,132,5,5,4,14,Champions
2336,127,10,35,4,2,3,9,Promising
2468,903,12,15,2,3,1,6,Casual Users
2534,2566,5,11,1,1,1,3,Lost
2556,552,10,13,2,2,1,5,Lost
2703,2998,16,48,1,3,3,7,Casual Users
3212,2967,8,10,1,2,1,4,Lost
3280,2397,19,44,1,3,3,7,Casual Users
3412,20,80,460,5,5,5,15,Champions
3717,510,36,92,2,4,4,10,At Risk
4113,8,10,22,5,2,2,9,Promising
4281,49,108,266,5,5,5,15,Champions
4658,102,32,95,4,4,4,12,Champions
4793,2816,8,12,1,2,1,4,Lost
4999,2,102,191,5,5,5,15,Champions
5043,78,139,304,4,5,5,14,Champions
5146,369,13,56,3,3,3,9,Loyal Users
5573,284,41,124,3,4,4,11,Loyal Users
5851,286,17,23,3,3,2,8,Loyal Users
5946,127,44,110,4,4,4,12,Champions
6077,123,93,364,4,5,5,14,Champions
6105,406,9,11,3,2,1,6,Casual Users
6314,102,8,37,4,2,3,9,Promising
7083,98,10,50,4,2,3,9,Promising
7176,279,110,802,3,5,5,13,Loyal Users
7296,538,87,156,2,5,5,12,At Risk
7393,11,6,118,5,1,4,10,Promising
7621,1069,15,114,2,3,4,9,Casual Users
7886,694,6,17,2,1,2,5,Lost
8212,245,6,46,3,1,3,7,Casual Users
8344,846,8,12,2,2,1,5,Lost
8413,58,54,149,5,5,5,15,Champions
8496,26,21,62,5,3,3,11,Loyal Users
9034,2387,10,19,1,2,2,5,Lost
9269,1551,5,6,1,1,1,3,Lost
9342,65,14,152,5,3,5,13,Loyal Users
9355,1824,15,43,1,3,3,7,Casual Users
9784,3866,9,15,1,2,1,4,Lost
10098,225,7,7,3,2,1,6,Casual Users
10225,871,16,35,2,3,3,8,Casual Users
10291,298,24,42,3,4,3,10,Loyal Users
10365,423,20,83,3,3,4,10,Loyal Users
10764,1548,6,10,1,1,1,3,Lost
10796,4,22,39,5,4,3,12,Loyal Users
11027,277,7,24,3,2,2,7,Casual Users
11136,456,40,129,3,4,4,11,Loyal Users
11307,394,15,54,3,3,3,9,Loyal Users
11376,991,13,18,2,3,2,7,Casual Users
11665,335,23,69,3,4,4,11,Loyal Users
11782,1836,19,176,1,3,5,9,Casual Users
11994,1942,10,36,1,2,3,6,Lost
12090,112,186,676,4,5,5,14,Champions
12095,26,28,147,5,4,5,14,Champions
12364,583,53,195,2,5,5,12,At Risk
12585,69,22,37,5,4,3,12,Loyal Users
12648,83,62,198,4,5,5,14,Champions
13116,149,109,226,4,5,5,14,Champions
61,3418,12,12,1,3,1,5,Casual Users
127,6,55,417,5,5,5,15,Champions
316,1532,13,21,1,3,2,6,Casual Users
461,4815,5,17,1,1,2,4,Lost
502,2977,6,29,1,1,2,4,Lost
523,323,37,221,3,4,5,12,Loyal Users
819,30,23,36,5,4,3,12,Loyal Users
937,70,19,125,4,3,4,11,Loyal Users
1231,24,11,13,5,2,1,8,Promising
1334,90,35,93,4,4,4,12,Champions
1913,80,91,403,4,5,5,14,Champions
2067,893,6,51,2,1,3,6,Lost
2932,896,16,27,2,3,2,7,Casual Users
3003,507,8,88,2,2,4,8,Lost
3163,19,10,23,5,2,2,9,Promising
3301,961,26,104,2,4,4,10,At Risk
3323,695,7,10,2,2,1,5,Lost
3610,4444,26,44,1,4,3,8,At Risk
3784,3143,5,5,1,1,1,3,Lost
4296,1003,11,25,2,2,2,6,Lost
4518,709,5,5,2,1,1,4,Lost
4572,37,7,10,5,2,1,8,Promising
4625,90,8,79,4,2,4,10,Promising
4694,50,16,32,5,3,3,11,Loyal Users
4740,78,107,184,4,5,5,14,Champions
4857,5656,9,9,1,2,1,4,Lost
4948,558,15,20,2,3,2,7,Casual Users
5183,410,13,26,3,3,2,8,Loyal Users
5252,2249,9,15,1,2,1,4,Lost
5288,825,10,47,2,2,3,7,Lost
5404,664,7,23,2,2,2,6,Lost
5409,151,6,8,4,1,1,6,Promising
5618,42,61,233,5,5,5,15,Champions
6311,254,10,26,3,2,2,7,Casual Users
7233,125,40,132,4,4,4,12,Champions
7259,814,5,10,2,1,1,4,Lost
7538,412,7,10,3,2,1,6,Casual Users
8267,708,6,17,2,1,2,5,Lost
8365,55,6,10,5,1,1,7,Promising
8589,2882,6,15,1,1,1,3,Lost
8867,1087,19,122,2,3,4,9,Casual Users
9295,8,16,33,5,3,3,11,Loyal Users
10172,92,70,292,4,5,5,14,Champions
10194,2094,5,21,1,1,2,4,Lost
10660,128,49,285,4,5,5,14,Champions
10735,129,79,159,4,5,5,14,Champions
10740,1010,18,29,2,3,2,7,Casual Users
10761,3420,5,13,1,1,1,3,Lost
10849,367,73,302,3,5,5,13,Loyal Users
11177,1091,5,28,2,1,2,5,Lost
11179,4001,5,13,1,1,1,3,Lost
11253,633,7,70,2,2,4,8,Lost
12174,89,42,74,4,4,4,12,Champions
12265,94,11,73,4,2,4,10,Promising
12428,430,25,55,3,4,3,10,Loyal Users
12665,127,118,306,4,5,5,14,Champions
12864,6,57,104,5,5,4,14,Champions
13429,198,130,252,3,5,5,13,Loyal Users
13454,752,9,42,2,2,3,7,Lost
88,1611,25,33,1,4,3,8,At Risk
197,434,5,14,3,1,1,5,Casual Users
486,118,12,29,4,3,2,9,Loyal Users
531,130,77,286,4,5,5,14,Champions
903,40,55,291,5,5,5,15,Champions
979,157,101,228,4,5,5,14,Champions
993,240,15,39,3,3,3,9,Loyal Users
1487,0,54,400,5,5,5,15,Champions
1725,262,7,22,3,2,2,7,Casual Users
1949,93,25,40,4,4,3,11,Loyal Users
1966,423,122,418,3,5,5,13,Loyal Users
2567,243,5,9,3,1,1,5,Casual Users
3199,2286,5,6,1,1,1,3,Lost
3334,209,9,47,3,2,3,8,Casual Users
3398,3539,7,16,1,2,2,5,Lost
3410,14,19,29,5,3,2,10,Loyal Users
3426,4679,7,7,1,2,1,4,Lost
3471,1113,25,133,2,4,4,10,At Risk
3955,558,6,30,2,1,2,5,Lost
4211,318,8,17,3,2,2,7,Casual Users
4485,7,70,117,5,5,4,14,Champions
4542,114,42,82,4,4,4,12,Champions
4717,481,15,73,2,3,4,9,Casual Users
4770,2942,23,32,1,4,3,8,At Risk
4772,1840,12,13,1,3,1,5,Casual Users
4808,405,26,58,3,4,3,10,Loyal Users
4875,1,114,193,5,5,5,15,Champions
4884,111,72,185,4,5,5,14,Champions
5548,82,9,12,4,2,1,7,Promising
5598,415,15,45,3,3,3,9,Loyal Users
5632,2361,10,16,1,2,2,5,Lost
6051,410,34,149,3,4,5,12,Loyal Users
6085,1432,10,35,1,2,3,6,Lost
6392,3242,9,13,1,2,1,4,Lost
6532,45,44,56,5,4,3,12,Loyal Users
6747,809,29,47,2,4,3,9,At Risk
7170,976,19,39,2,3,3,8,Casual Users
7204,4137,13,29,1,3,2,6,Casual Users
7278,879,26,41,2,4,3,9,At Risk
7473,2085,8,8,1,2,1,4,Lost
7614,741,5,41,2,1,3,6,Lost
7907,385,26,106,3,4,4,11,Loyal Users
8137,227,23,254,3,4,5,12,Loyal Users
8713,2095,6,10,1,1,1,3,Lost
8715,111,27,45,4,4,3,11,Loyal Users
8839,10,85,182,5,5,5,15,Champions
9098,155,20,66,4,3,4,11,Loyal Users
9845,1027,6,11,2,1,1,4,Lost
9921,364,5,11,3,1,1,5,Casual Users
9958,525,20,26,2,3,2,7,Casual Users
10472,2419,6,9,1,1,1,3,Lost
10526,709,22,41,2,4,3,9,At Risk
10531,310,42,299,3,4,5,12,Loyal Users
10647,6,12,21,5,3,2,10,Loyal Users
10657,1850,5,7,1,1,1,3,Lost
10758,485,17,53,2,3,3,8,Casual Users
10906,227,56,156,3,5,5,13,Loyal Users
10925,863,5,6,2,1,1,4,Lost
10964,101,20,41,4,3,3,10,Loyal Users
11447,517,10,20,2,2,2,6,Lost
11490,105,56,80,4,5,4,13,Champions
11522,21,17,59,5,3,3,11,Loyal Users
12697,698,20,31,2,3,2,7,Casual Users
13053,113,25,50,4,4,3,11,Loyal Users
13091,919,9,54,2,2,3,7,Lost
318,2848,11,11,1,2,1,4,Lost
462,46,56,223,5,5,5,15,Champions
547,1750,6,16,1,1,2,4,Lost
1124,122,6,9,4,1,1,6,Promising
1216,18,13,25,5,3,2,10,Loyal Users
1248,29,82,376,5,5,5,15,Champions
1271,78,28,63,4,4,4,12,Champions
1696,135,89,486,4,5,5,14,Champions
1858,1,92,141,5,5,4,14,Champions
2060,1096,24,86,2,4,4,10,At Risk
2275,59,28,32,5,4,3,12,Loyal Users
2401,1073,16,33,2,3,3,8,Casual Users
2657,2514,15,35,1,3,3,7,Casual Users
2735,581,11,15,2,2,1,5,Lost
2819,598,24,125,2,4,4,10,At Risk
2887,19,71,248,5,5,5,15,Champions
3011,43,19,40,5,3,3,11,Loyal Users
3068,321,16,50,3,3,3,9,Loyal Users
3476,3846,5,15,1,1,1,3,Lost
3634,2417,7,14,1,2,1,4,Lost
3697,124,38,110,4,4,4,12,Champions
3797,29,94,405,5,5,5,15,Champions
3805,1236,26,44,2,4,3,9,At Risk
3839,391,10,23,3,2,2,7,Casual Users
4143,435,5,11,3,1,1,5,Casual Users
4264,38,90,383,5,5,5,15,Champions
4545,438,8,21,3,2,2,7,Casual Users
4668,152,146,466,4,5,5,14,Champions
4809,3315,8,14,1,2,1,4,Lost
4907,1415,7,10,1,2,1,4,Lost
5191,10,40,65,5,4,4,13,Champions
5283,4,23,113,5,4,4,13,Champions
5372,147,17,147,4,3,5,12,Loyal Users
5397,9,84,199,5,5,5,15,Champions
5760,411,10,19,3,2,2,7,Casual Users
6059,71,11,48,4,2,3,9,Promising
6215,118,35,102,4,4,4,12,Champions
6277,250,46,184,3,5,5,13,Loyal Users
6358,1375,5,11,1,1,1,3,Lost
6512,1287,6,30,1,1,2,4,Lost
6558,159,67,107,4,5,4,13,Champions
6631,4,50,222,5,5,5,15,Champions
6958,170,7,14,3,2,1,6,Casual Users
7117,1077,5,5,2,1,1,4,Lost
7423,2000,20,74,1,3,4,8,Casual Users
7437,187,28,177,3,4,5,12,Loyal Users
7648,10,114,360,5,5,5,15,Champions
7741,107,250,421,4,5,5,14,Champions
7842,30,63,179,5,5,5,15,Champions
8058,1151,17,31,2,3,2,7,Casual Users
8297,1086,30,89,2,4,4,10,At Risk
8337,1050,16,20,2,3,2,7,Casual Users
8408,436,8,9,3,2,1,6,Casual Users
8556,2513,6,6,1,1,1,3,Lost
9447,152,7,8,4,2,1,7,Promising
10607,21,50,207,5,5,5,15,Champions
10813,87,36,83,4,4,4,12,Champions
10976,543,62,166,2,5,5,12,At Risk
11370,17,7,40,5,2,3,10,Promising
11497,1542,12,30,1,3,2,6,Casual Users
11869,879,41,204,2,4,5,11,At Risk
12234,4,63,117,5,5,4,14,Champions
12553,11,7,31,5,2,2,9,Promising
12678,100,97,379,4,5,5,14,Champions
12884,36,6,23,5,1,2,8,Promising
12918,2972,7,18,1,2,2,5,Lost
12987,247,5,10,3,1,1,5,Casual Users
13095,33,32,101,5,4,4,13,Champions
13190,1862,7,29,1,2,2,5,Lost
13441,12,37,212,5,4,5,14,Champions
13499,1428,11,34,1,2,3,6,Lost
107,353,38,106,3,4,4,11,Loyal Users
202,978,14,36,2,3,3,8,Casual Users
263,4,7,44,5,2,3,10,Promising
374,11,6,18,5,1,2,8,Promising
564,1254,7,25,2,2,2,6,Lost
619,1431,6,10,1,1,1,3,Lost
891,6,91,379,5,5,5,15,Champions
1108,19,19,84,5,3,4,12,Loyal Users
1158,959,6,15,2,1,1,4,Lost
1641,3530,8,23,1,2,2,5,Lost
1736,137,30,153,4,4,5,13,Champions
2004,4062,5,9,1,1,1,3,Lost
2279,254,34,103,3,4,4,11,Loyal Users
2589,311,13,26,3,3,2,8,Loyal Users
2826,1274,6,17,1,1,2,4,Lost
2926,2595,5,46,1,1,3,5,Lost
2968,42,31,151,5,4,5,14,Champions
3122,517,6,21,2,1,2,5,Lost
3420,1005,5,11,2,1,1,4,Lost
3501,3956,5,8,1,1,1,3,Lost
3671,946,5,5,2,1,1,4,Lost
3773,590,9,9,2,2,1,5,Lost
3981,270,48,78,3,5,4,12,Loyal Users
4059,2512,16,52,1,3,3,7,Casual Users
4382,17,23,167,5,4,5,14,Champions
4743,114,27,85,4,4,4,12,Champions
5180,1,21,40,5,3,3,11,Loyal Users
5737,19,57,131,5,5,4,14,Champions
6006,285,19,107,3,3,4,10,Loyal Users
6009,176,68,268,3,5,5,13,Loyal Users
6029,76,160,643,4,5,5,14,Champions
6203,2498,7,18,1,2,2,5,Lost
6240,124,55,142,4,5,4,13,Champions
6447,636,6,21,2,1,2,5,Lost
6540,495,27,43,2,4,3,9,At Risk
6797,1413,14,25,1,3,2,6,Casual Users
6850,408,5,12,3,1,1,5,Casual Users
6893,118,8,93,4,2,4,10,Promising
6901,69,6,25,5,1,2,8,Promising
7107,45,10,26,5,2,2,9,Promising
7145,1968,9,27,1,2,2,5,Lost
7509,44,67,311,5,5,5,15,Champions
8117,157,36,69,4,4,4,12,Champions
8883,407,5,29,3,1,2,6,Casual Users
9069,1290,5,5,1,1,1,3,Lost
9330,371,44,83,3,4,4,11,Loyal Users
9336,935,74,296,2,5,5,12,At Risk
9425,571,7,12,2,2,1,5,Lost
9765,72,18,56,4,3,3,10,Loyal Users
9807,1124,5,10,2,1,1,4,Lost
10205,6,16,42,5,3,3,11,Loyal Users
10669,625,18,41,2,3,3,8,Casual Users
10772,1536,8,21,1,2,2,5,Lost
10939,7,20,67,5,3,4,12,Loyal Users
11153,422,10,42,3,2,3,8,Casual Users
11937,249,18,38,3,3,3,9,Loyal Users
11960,1973,10,22,1,2,2,5,Lost
12463,1317,34,65,1,4,4,9,At Risk
12479,0,141,816,5,5,5,15,Champions
12641,235,5,10,3,1,1,5,Casual Users
12742,9,36,142,5,4,4,13,Champions
12763,298,5,14,3,1,1,5,Casual Users
13048,137,42,98,4,4,4,12,Champions
13070,1561,7,25,1,2,2,5,Lost
13145,263,5,27,3,1,2,6,Casual Users
13340,285,10,61,3,2,3,8,Casual Users
13349,570,12,15,2,3,1,6,Casual Users
13389,2590,9,17,1,2,2,5,Lost
13433,136,29,45,4,4,3,11,Loyal Users
9,71,19,41,4,3,3,10,Loyal Users
17,76,14,18,4,3,2,9,Loyal Users
231,1859,5,6,1,1,1,3,Lost
552,723,38,71,2,4,4,10,At Risk
1123,75,54,166,4,5,5,14,Champions
1219,37,64,157,5,5,5,15,Champions
1406,247,9,10,3,2,1,6,Casual Users
1520,102,16,34,4,3,3,10,Loyal Users
1597,92,44,86,4,4,4,12,Champions
1991,929,26,62,2,4,3,9,At Risk
2141,282,5,34,3,1,3,7,Casual Users
2403,113,33,79,4,4,4,12,Champions
2473,813,6,7,2,1,1,4,Lost
2654,5,117,262,5,5,5,15,Champions
2702,380,18,36,3,3,3,9,Loyal Users
2777,31,190,380,5,5,5,15,Champions
2805,1399,5,18,1,1,2,4,Lost
3047,43,9,28,5,2,2,9,Promising
3066,4,51,104,5,5,4,14,Champions
3141,1362,5,28,1,1,2,4,Lost
3298,500,6,8,2,1,1,4,Lost
3451,717,19,19,2,3,2,7,Casual Users
3562,9,88,147,5,5,5,15,Champions
3687,61,139,678,5,5,5,15,Champions
3902,2126,6,16,1,1,2,4,Lost
3952,3925,7,7,1,2,1,4,Lost
4127,13,121,560,5,5,5,15,Champions
4285,121,53,98,4,5,4,13,Champions
4511,1426,6,10,1,1,1,3,Lost
4576,1958,10,38,1,2,3,6,Lost
4812,2252,10,46,1,2,3,6,Lost
4946,128,49,69,4,5,4,13,Champions
5137,973,23,48,2,4,3,9,At Risk
5257,9,138,427,5,5,5,15,Champions
5342,2580,7,8,1,2,1,4,Lost
5423,39,59,217,5,5,5,15,Champions
5470,257,10,26,3,2,2,7,Casual Users
6619,221,11,63,3,2,4,9,Casual Users
6709,6,52,139,5,5,4,14,Champions
6811,444,20,34,3,3,3,9,Loyal Users
6873,674,5,11,2,1,1,4,Lost
7480,776,6,14,2,1,1,4,Lost
7546,662,6,9,2,1,1,4,Lost
7612,17,169,455,5,5,5,15,Champions
7774,72,9,9,4,2,1,7,Promising
8269,50,5,21,5,1,2,8,Promising
8392,256,5,11,3,1,1,5,Casual Users
8632,737,7,15,2,2,1,5,Lost
9028,270,38,86,3,4,4,11,Loyal Users
9130,440,10,13,3,2,1,6,Casual Users
9267,408,10,20,3,2,2,7,Casual Users
9452,3042,7,7,1,2,1,4,Lost
9458,1399,8,15,1,2,1,4,Lost
10003,122,112,277,4,5,5,14,Champions
10040,99,9,14,4,2,1,7,Promising
10909,7,106,351,5,5,5,15,Champions
11068,112,10,43,4,2,3,9,Promising
11356,384,13,21,3,3,2,8,Loyal Users
11508,1695,15,41,1,3,3,7,Casual Users
11719,2104,7,9,1,2,1,4,Lost
11821,77,17,122,4,3,4,11,Loyal Users
12381,2488,7,20,1,2,2,5,Lost
12410,1129,7,12,2,2,1,5,Lost
12615,424,18,22,3,3,2,8,Loyal Users
12759,2427,6,6,1,1,1,3,Lost
13224,160,15,25,4,3,2,9,Loyal Users
13354,3902,5,8,1,1,1,3,Lost
13414,229,140,495,3,5,5,13,Loyal Users
324,23,21,49,5,3,3,11,Loyal Users
586,3570,5,6,1,1,1,3,Lost
609,3141,25,49,1,4,3,8,At Risk
1164,2109,8,12,1,2,1,4,Lost
1329,30,90,212,5,5,5,15,Champions
1351,4770,6,22,1,1,2,4,Lost
1706,963,5,40,2,1,3,6,Lost
1720,31,56,205,5,5,5,15,Champions
1967,137,10,19,4,2,2,8,Promising
2164,116,64,181,4,5,5,14,Champions
2305,96,6,8,4,1,1,6,Promising
2770,107,34,58,4,4,3,11,Loyal Users
2861,65,183,639,5,5,5,15,Champions
3051,870,7,11,2,2,1,5,Lost
3254,850,71,189,2,5,5,12,At Risk
3619,1072,16,36,2,3,3,8,Casual Users
3658,309,21,37,3,3,3,9,Loyal Users
3779,406,37,61,3,4,3,10,Loyal Users
4023,994,31,69,2,4,4,10,At Risk
4546,105,103,271,4,5,5,14,Champions
4589,426,66,150,3,5,5,13,Loyal Users
4593,536,6,6,2,1,1,4,Lost
4633,24,64,367,5,5,5,15,Champions
4940,411,27,33,3,4,3,10,Loyal Users
5067,118,45,370,4,4,5,13,Champions
5249,534,12,32,2,3,3,8,Casual Users
5348,103,7,29,4,2,2,8,Promising
5661,433,10,19,3,2,2,7,Casual Users
5680,11,65,129,5,5,4,14,Champions
5715,2624,6,12,1,1,1,3,Lost
5801,139,41,52,4,4,3,11,Loyal Users
5997,171,12,91,3,3,4,10,Loyal Users
6217,117,16,41,4,3,3,10,Loyal Users
6222,24,45,65,5,4,4,13,Champions
6703,32,91,311,5,5,5,15,Champions
6765,1,91,263,5,5,5,15,Champions
6841,163,14,24,4,3,2,9,Loyal Users
6882,19,69,129,5,5,4,14,Champions
7095,290,25,77,3,4,4,11,Loyal Users
7144,129,38,62,4,4,3,11,Loyal Users
7260,29,50,119,5,5,4,14,Champions
7264,3,5,11,5,1,1,7,Promising
7515,591,17,25,2,3,2,7,Casual Users
7897,1043,35,79,2,4,4,10,At Risk
7930,262,16,25,3,3,2,8,Loyal Users
8087,0,10,10,5,2,1,8,Promising
8104,1777,19,47,1,3,3,7,Casual Users
8262,1964,6,101,1,1,4,6,Lost
8566,1952,5,5,1,1,1,3,Lost
8951,1557,8,14,1,2,1,4,Lost
9095,3824,9,20,1,2,2,5,Lost
9114,3,17,36,5,3,3,11,Loyal Users
9274,302,12,12,3,3,1,7,Loyal Users
9282,270,9,12,3,2,1,6,Casual Users
9316,370,10,19,3,2,2,7,Casual Users
9373,1762,20,82,1,3,4,8,Casual Users
9613,735,28,28,2,4,2,8,At Risk
9904,251,55,92,3,5,4,12,Loyal Users
10061,113,78,151,4,5,5,14,Champions
10300,610,13,15,2,3,1,6,Casual Users
10425,244,24,93,3,4,4,11,Loyal Users
10475,453,8,19,3,2,2,7,Casual Users
11296,433,5,14,3,1,1,5,Casual Users
11385,25,123,211,5,5,5,15,Champions
11761,13,34,123,5,4,4,13,Champions
11929,191,47,216,3,5,5,13,Loyal Users
12304,2275,7,24,1,2,2,5,Lost
12400,128,74,374,4,5,5,14,Champions
12487,2107,19,53,1,3,3,7,Casual Users
12609,135,7,15,4,2,1,7,Promising
12724,274,6,18,3,1,2,6,Casual Users
13153,4083,26,113,1,4,4,9,At Risk
13330,2255,10,10,1,2,1,4,Lost
13405,353,7,15,3,2,1,6,Casual Users
72,94,48,160,4,5,5,14,Champions
286,36,103,640,5,5,5,15,Champions
398,3256,8,25,1,2,2,5,Lost
505,251,40,225,3,4,5,12,Loyal Users
538,84,70,127,4,5,4,13,Champions
1293,513,6,23,2,1,2,5,Lost
1403,153,8,9,4,2,1,7,Promising
1600,470,8,12,3,2,1,6,Casual Users
1778,117,9,36,4,2,3,9,Promising
2048,112,18,52,4,3,3,10,Loyal Users
2078,48,162,259,5,5,5,15,Champions
2087,101,16,36,4,3,3,10,Loyal Users
2107,3,145,651,5,5,5,15,Champions
2244,26,60,496,5,5,5,15,Champions
2269,434,10,47,3,2,3,8,Casual Users
2598,2825,20,69,1,3,4,8,Casual Users
2688,45,79,236,5,5,5,15,Champions
2759,126,12,41,4,3,3,10,Loyal Users
2783,1952,22,79,1,4,4,9,At Risk
2972,162,8,18,4,2,2,8,Promising
3114,196,16,35,3,3,3,9,Loyal Users
3615,282,19,30,3,3,2,8,Loyal Users
3620,117,7,30,4,2,2,8,Promising
4480,998,11,16,2,2,2,6,Lost
4571,262,16,37,3,3,3,9,Loyal Users
4587,3103,7,35,1,2,3,6,Lost
4912,16,22,76,5,4,4,13,Champions
5216,1428,7,14,1,2,1,4,Lost
5741,308,5,49,3,1,3,7,Casual Users
5750,167,65,89,3,5,4,12,Loyal Users
5800,2139,9,16,1,2,2,5,Lost
5945,856,10,60,2,2,3,7,Lost
6505,83,20,37,4,3,3,10,Loyal Users
6762,75,91,170,4,5,5,14,Champions
6768,674,14,26,2,3,2,7,Casual Users
6829,23,139,411,5,5,5,15,Champions
7327,1213,7,7,2,2,1,5,Lost
7451,2793,9,23,1,2,2,5,Lost
7552,3569,8,10,1,2,1,4,Lost
7645,105,185,383,4,5,5,14,Champions
7972,150,13,39,4,3,3,10,Loyal Users
8533,4525,18,176,1,3,5,9,Casual Users
8904,616,13,48,2,3,3,8,Casual Users
8945,1418,9,18,1,2,2,5,Lost
9014,159,74,459,4,5,5,14,Champions
9118,7,10,45,5,2,3,10,Promising
10163,7,123,302,5,5,5,15,Champions
10200,12,59,291,5,5,5,15,Champions
10246,67,77,248,5,5,5,15,Champions
11098,106,8,12,4,2,1,7,Promising
11378,192,12,63,3,3,4,10,Loyal Users
11767,1984,18,47,1,3,3,7,Casual Users
11811,578,13,41,2,3,3,8,Casual Users
12318,1391,12,28,1,3,2,6,Casual Users
12359,700,6,35,2,1,3,6,Lost
12573,719,6,14,2,1,1,4,Lost
13235,1059,11,12,2,2,1,5,Lost
13320,5877,9,10,1,2,1,4,Lost
1017,791,13,27,2,3,2,7,Casual Users
1211,308,22,27,3,4,2,9,Loyal Users
1509,32,52,171,5,5,5,15,Champions
1969,412,18,31,3,3,2,8,Loyal Users
2089,1802,32,65,1,4,4,9,At Risk
2205,1760,6,13,1,1,1,3,Lost
2211,2129,29,63,1,4,4,9,At Risk
2588,680,47,108,2,5,4,11,At Risk
2720,26,108,254,5,5,5,15,Champions
3300,569,19,63,2,3,4,9,Casual Users
3392,1424,12,42,1,3,3,7,Casual Users
4500,584,17,41,2,3,3,8,Casual Users
4537,172,77,118,3,5,4,12,Loyal Users
4983,7,95,214,5,5,5,15,Champions
5353,2080,5,18,1,1,2,4,Lost
5421,640,7,7,2,2,1,5,Lost
5453,258,35,71,3,4,4,11,Loyal Users
5515,577,7,21,2,2,2,6,Lost
5560,728,16,74,2,3,4,9,Casual Users
5664,290,99,819,3,5,5,13,Loyal Users
5748,4,39,224,5,4,5,14,Champions
5772,276,8,38,3,2,3,8,Casual Users
5829,153,27,43,4,4,3,11,Loyal Users
5943,126,24,113,4,4,4,12,Champions
6065,969,6,12,2,1,1,4,Lost
6106,7,56,153,5,5,5,15,Champions
6291,586,22,41,2,4,3,9,At Risk
6307,643,17,31,2,3,2,7,Casual Users
6463,543,16,32,2,3,3,8,Casual Users
6534,434,25,47,3,4,3,10,Loyal Users
6561,154,11,11,4,2,1,7,Promising
7328,547,11,47,2,2,3,7,Lost
7363,296,41,68,3,4,4,11,Loyal Users
7429,593,30,31,2,4,2,8,At Risk
7766,2,51,119,5,5,4,14,Champions
8075,411,8,26,3,2,2,7,Casual Users
8246,5779,8,15,1,2,1,4,Lost
8296,412,19,54,3,3,3,9,Loyal Users
9125,40,118,519,5,5,5,15,Champions
9216,914,8,78,2,2,4,8,Lost
9233,3123,8,37,1,2,3,6,Lost
9697,4,118,413,5,5,5,15,Champions
9927,206,55,369,3,5,5,13,Loyal Users
10012,1855,7,14,1,2,1,4,Lost
10169,13,48,119,5,5,4,14,Champions
10201,1106,12,15,2,3,1,6,Casual Users
10451,294,20,43,3,3,3,9,Loyal Users
11377,570,7,12,2,2,1,5,Lost
11407,16,57,96,5,5,4,14,Champions
11590,150,47,103,4,5,4,13,Champions
11664,1489,6,9,1,1,1,3,Lost
11666,134,44,96,4,4,4,12,Champions
11689,544,8,33,2,2,3,7,Lost
12079,2,41,50,5,4,3,12,Loyal Users
12244,522,13,23,2,3,2,7,Casual Users
12245,7,12,33,5,3,3,11,Loyal Users
12281,1415,10,13,1,2,1,4,Lost
13591,111,24,37,4,4,3,11,Loyal Users
13623,4729,8,24,1,2,2,5,Lost
13832,2301,5,20,1,1,2,4,Lost
13840,5518,12,34,1,3,3,7,Casual Users
14450,113,34,90,4,4,4,12,Champions
14570,306,41,64,3,4,4,11,Loyal Users
14832,73,9,41,4,2,3,9,Promising
15447,5,84,359,5,5,5,15,Champions
15619,85,123,239,4,5,5,14,Champions
15727,381,17,22,3,3,2,8,Loyal Users
15790,1837,19,292,1,3,5,9,Casual Users
15846,1850,5,18,1,1,2,4,Lost
15957,360,16,42,3,3,3,9,Loyal Users
16339,1171,10,17,2,2,2,6,Lost
16386,1,42,78,5,4,4,13,Champions
16503,11,42,56,5,4,3,12,Loyal Users
16574,880,6,30,2,1,2,5,Lost
16861,4562,5,22,1,1,2,4,Lost
17389,438,13,31,3,3,2,8,Loyal Users
17420,1586,5,7,1,1,1,3,Lost
17679,237,51,209,3,5,5,13,Loyal Users
17753,430,7,10,3,2,1,6,Casual Users
18024,2,41,81,5,4,4,13,Champions
18051,681,7,35,2,2,3,7,Lost
18498,983,5,6,2,1,1,4,Lost
18654,140,27,44,4,4,3,11,Loyal Users
18800,123,45,135,4,4,4,12,Champions
18866,20,34,73,5,4,4,13,Champions
18911,435,28,45,3,4,3,10,Loyal Users
18944,151,19,258,4,3,5,12,Loyal Users
18979,2254,5,11,1,1,1,3,Lost
19079,695,8,18,2,2,2,6,Lost
19204,106,10,13,4,2,1,7,Promising
19530,295,5,6,3,1,1,5,Casual Users
19553,2850,6,28,1,1,2,4,Lost
19984,3682,7,12,1,2,1,4,Lost
20135,32,12,22,5,3,2,10,Loyal Users
20382,135,17,106,4,3,4,11,Loyal Users
20497,411,39,65,3,4,4,11,Loyal Users
20683,127,36,52,4,4,3,11,Loyal Users
20735,695,8,22,2,2,2,6,Lost
20924,12,41,201,5,4,5,14,Champions
21220,831,35,108,2,4,4,10,At Risk
21700,1314,14,40,1,3,3,7,Casual Users
22097,186,12,17,3,3,2,8,Loyal Users
22223,881,5,11,2,1,1,4,Lost
22346,164,32,38,4,4,3,11,Loyal Users
22373,184,20,62,3,3,3,9,Loyal Users
22521,365,16,23,3,3,2,8,Loyal Users
23015,16,22,30,5,4,2,11,Loyal Users
23271,9,53,248,5,5,5,15,Champions
23336,19,40,119,5,4,4,13,Champions
23364,1355,17,35,1,3,3,7,Casual Users
23571,238,16,145,3,3,4,10,Loyal Users
24171,440,77,174,3,5,5,13,Loyal Users
24347,1412,12,13,1,3,1,5,Casual Users
24354,26,11,27,5,2,2,9,Promising
24663,168,31,60,3,4,3,10,Loyal Users
25462,0,91,315,5,5,5,15,Champions
25517,2129,5,7,1,1,1,3,Lost
25591,453,8,14,3,2,1,6,Casual Users
26087,1700,7,12,1,2,1,4,Lost
26425,112,17,36,4,3,3,10,Loyal Users
13622,164,43,78,4,4,4,12,Champions
14075,686,19,94,2,3,4,9,Casual Users
14148,30,16,69,5,3,4,12,Loyal Users
14423,2386,15,26,1,3,2,6,Casual Users
14465,22,57,105,5,5,4,14,Champions
14514,431,59,114,3,5,4,12,Loyal Users
14536,1368,6,26,1,1,2,4,Lost
14876,77,86,106,4,5,4,13,Champions
15003,1352,6,6,1,1,1,3,Lost
15004,304,32,70,3,4,4,11,Loyal Users
15100,149,9,21,4,2,2,8,Promising
15254,423,49,94,3,5,4,12,Loyal Users
15538,3156,9,14,1,2,1,4,Lost
15967,65,132,333,5,5,5,15,Champions
16500,256,40,79,3,4,4,11,Loyal Users
16916,831,19,45,2,3,3,8,Casual Users
17172,92,57,118,4,5,4,13,Champions
17607,1431,5,14,1,1,1,3,Lost
17688,80,130,487,4,5,5,14,Champions
18161,709,9,24,2,2,2,6,Lost
18201,698,16,28,2,3,2,7,Casual Users
18218,617,10,15,2,2,1,5,Lost
18282,966,5,57,2,1,3,6,Lost
18467,94,6,37,4,1,3,8,Promising
18479,512,5,20,2,1,2,5,Lost
18595,2095,27,108,1,4,4,9,At Risk
18902,115,48,61,4,5,3,12,Loyal Users
18956,4696,11,11,1,2,1,4,Lost
19200,48,23,131,5,4,4,13,Champions
19206,4424,5,6,1,1,1,3,Lost
19325,1226,15,19,2,3,2,7,Casual Users
19351,146,10,18,4,2,2,8,Promising
19499,1265,5,6,1,1,1,3,Lost
19614,1129,9,26,2,2,2,6,Lost
19669,142,22,94,4,4,4,12,Champions
19758,123,14,24,4,3,2,9,Loyal Users
19873,1812,29,33,1,4,3,8,At Risk
19878,385,46,70,3,5,4,12,Loyal Users
19886,1210,9,13,2,2,1,5,Lost
19962,2374,14,51,1,3,3,7,Casual Users
20268,219,66,305,3,5,5,13,Loyal Users
20396,1743,18,45,1,3,3,7,Casual Users
20596,261,33,91,3,4,4,11,Loyal Users
20928,424,26,156,3,4,5,12,Loyal Users
21116,117,61,231,4,5,5,14,Champions
21558,762,22,31,2,4,2,8,At Risk
21598,2575,6,13,1,1,1,3,Lost
21715,792,8,38,2,2,3,7,Lost
21859,709,24,46,2,4,3,9,At Risk
22004,495,20,31,2,3,2,7,Casual Users
22021,506,17,44,2,3,3,8,Casual Users
22188,696,11,20,2,2,2,6,Lost
22412,16,75,314,5,5,5,15,Champions
22555,411,20,72,3,3,4,10,Loyal Users
22970,3005,6,8,1,1,1,3,Lost
22990,160,89,289,4,5,5,14,Champions
23136,2403,6,8,1,1,1,3,Lost
23455,57,6,8,5,1,1,7,Promising
23523,1822,11,35,1,2,3,6,Lost
23607,0,37,107,5,4,4,13,Champions
23706,2571,5,12,1,1,1,3,Lost
23709,96,32,53,4,4,3,11,Loyal Users
23727,131,8,9,4,2,1,7,Promising
24355,296,29,115,3,4,4,11,Loyal Users
24728,1984,12,18,1,3,2,6,Casual Users
24873,511,11,11,2,2,1,5,Lost
24985,587,12,16,2,3,2,7,Casual Users
25227,607,34,122,2,4,4,10,At Risk
25283,885,8,16,2,2,2,6,Lost
25895,68,61,235,5,5,5,15,Champions
26200,1758,72,194,1,5,5,11,At Risk
13601,118,125,236,4,5,5,14,Champions
13648,113,10,21,4,2,2,8,Promising
13875,659,12,35,2,3,3,8,Casual Users
13910,213,17,104,3,3,4,10,Loyal Users
14289,105,17,44,4,3,3,10,Loyal Users
14324,1732,7,9,1,2,1,4,Lost
14377,173,16,34,3,3,3,9,Loyal Users
14420,792,46,152,2,5,5,12,At Risk
14714,2025,5,8,1,1,1,3,Lost
14837,70,64,332,4,5,5,14,Champions
14997,7,15,75,5,3,4,12,Loyal Users
15162,292,16,17,3,3,2,8,Loyal Users
15173,685,6,14,2,1,1,4,Lost
15207,162,34,84,4,4,4,12,Champions
15296,11,116,192,5,5,5,15,Champions
15655,412,45,171,3,4,5,12,Loyal Users
15738,46,55,158,5,5,5,15,Champions
16283,432,5,6,3,1,1,5,Casual Users
16534,566,12,29,2,3,2,7,Casual Users
16680,810,36,186,2,4,5,11,At Risk
16791,65,31,84,5,4,4,13,Champions
16924,1702,13,29,1,3,2,6,Casual Users
17008,579,34,41,2,4,3,9,At Risk
17028,991,8,26,2,2,2,6,Lost
17044,109,7,21,4,2,2,8,Promising
17077,273,23,78,3,4,4,11,Loyal Users
17708,24,6,8,5,1,1,7,Promising
17751,25,70,239,5,5,5,15,Champions
17754,159,16,82,4,3,4,11,Loyal Users
17775,1310,7,14,1,2,1,4,Lost
17783,144,11,13,4,2,1,7,Promising
17809,103,17,38,4,3,3,10,Loyal Users
17837,262,13,19,3,3,2,8,Loyal Users
18221,19,141,626,5,5,5,15,Champions
18382,529,5,18,2,1,2,5,Lost
18502,25,15,33,5,3,3,11,Loyal Users
18503,1763,9,33,1,2,3,6,Lost
19023,5038,6,12,1,1,1,3,Lost
19131,638,6,11,2,1,1,4,Lost
19413,261,29,132,3,4,4,11,Loyal Users
19526,543,8,9,2,2,1,5,Lost
19619,5578,25,85,1,4,4,9,At Risk
19683,1114,13,15,2,3,1,6,Casual Users
19868,1535,8,27,1,2,2,5,Lost
20020,3227,5,7,1,1,1,3,Lost
20029,27,120,851,5,5,5,15,Champions
20052,223,8,16,3,2,2,7,Casual Users
20120,381,5,8,3,1,1,5,Casual Users
20134,962,6,24,2,1,2,5,Lost
20247,985,44,75,2,4,4,10,At Risk
20398,2592,21,34,1,3,3,7,Casual Users
20467,108,52,79,4,5,4,13,Champions
20506,1255,29,114,2,4,4,10,At Risk
21058,71,33,68,4,4,4,12,Champions
21121,15,119,220,5,5,5,15,Champions
21633,724,21,157,2,3,5,10,Casual Users
22609,84,98,614,4,5,5,14,Champions
22684,222,18,76,3,3,4,10,Loyal Users
22951,85,111,239,4,5,5,14,Champions
23144,0,32,205,5,4,5,14,Champions
23868,140,99,189,4,5,5,14,Champions
24078,419,14,28,3,3,2,8,Loyal Users
24504,5405,6,10,1,1,1,3,Lost
24630,1865,5,15,1,1,1,3,Lost
24719,68,39,90,5,4,4,13,Champions
24747,276,97,265,3,5,5,13,Loyal Users
24855,125,18,71,4,3,4,11,Loyal Users
25106,1544,14,23,1,3,2,6,Casual Users
25150,3,30,43,5,4,3,12,Loyal Users
25203,693,5,7,2,1,1,4,Lost
25638,1414,6,7,1,1,1,3,Lost
25686,410,18,31,3,3,2,8,Loyal Users
26111,139,26,109,4,4,4,12,Champions
26128,1658,9,12,1,2,1,4,Lost
26178,116,57,96,4,5,4,13,Champions
13898,297,31,101,3,4,4,11,Loyal Users
13916,1399,23,85,1,4,4,9,At Risk
14315,2407,5,17,1,1,2,4,Lost
14809,1378,9,25,1,2,2,5,Lost
14958,2108,30,41,1,4,3,8,At Risk
15382,3,39,184,5,4,5,14,Champions
15575,1490,5,11,1,1,1,3,Lost
15604,2551,13,16,1,3,2,6,Casual Users
16224,28,25,49,5,4,3,12,Loyal Users
16828,1413,20,89,1,3,4,8,Casual Users
17193,656,6,14,2,1,1,4,Lost
17223,404,10,33,3,2,3,8,Casual Users
17437,150,51,139,4,5,4,13,Champions
17712,533,52,161,2,5,5,12,At Risk
18043,1400,20,39,1,3,3,7,Casual Users
18539,647,14,33,2,3,3,8,Casual Users
18746,2941,7,12,1,2,1,4,Lost
18759,300,5,10,3,1,1,5,Casual Users
18828,146,19,73,4,3,4,11,Loyal Users
18838,1576,5,25,1,1,2,4,Lost
18884,398,9,13,3,2,1,6,Casual Users
19021,615,12,57,2,3,3,8,Casual Users
19138,63,51,101,5,5,4,14,Champions
19161,743,8,61,2,2,3,7,Lost
19165,591,14,32,2,3,3,8,Casual Users
19729,71,70,118,4,5,4,13,Champions
20170,145,74,120,4,5,4,13,Champions
20425,174,13,67,3,3,4,10,Loyal Users
20473,139,152,304,4,5,5,14,Champions
20481,3473,10,30,1,2,2,5,Lost
20624,189,7,17,3,2,2,7,Casual Users
21296,23,19,54,5,3,3,11,Loyal Users
21394,2143,10,17,1,2,2,5,Lost
21412,872,9,11,2,2,1,5,Lost
21545,1257,8,16,2,2,2,6,Lost
21761,3471,8,13,1,2,1,4,Lost
21938,1604,11,15,1,2,1,4,Lost
22107,493,19,56,2,3,3,8,Casual Users
22185,70,10,24,4,2,2,8,Promising
22225,1156,16,18,2,3,2,7,Casual Users
22899,2411,6,11,1,1,1,3,Lost
22965,11,79,493,5,5,5,15,Champions
23086,1029,17,24,2,3,2,7,Casual Users
23123,600,7,42,2,2,3,7,Lost
23193,113,10,55,4,2,3,9,Promising
23267,88,12,12,4,3,1,8,Loyal Users
23367,414,49,141,3,5,4,12,Loyal Users
23439,430,127,550,3,5,5,13,Loyal Users
23658,287,14,36,3,3,3,9,Loyal Users
23694,106,75,303,4,5,5,14,Champions
24200,102,86,313,4,5,5,14,Champions
24664,72,35,95,4,4,4,12,Champions
24690,299,6,14,3,1,1,5,Casual Users
25639,405,29,36,3,4,3,10,Loyal Users
26335,2519,9,16,1,2,2,5,Lost
26375,2875,19,42,1,3,3,7,Casual Users
13765,78,70,419,4,5,5,14,Champions
13795,2622,6,7,1,1,1,3,Lost
13923,244,11,51,3,2,3,8,Casual Users
14660,2793,9,12,1,2,1,4,Lost
14713,794,10,35,2,2,3,7,Lost
14752,1438,13,17,1,3,2,6,Casual Users
14770,542,22,56,2,4,3,9,At Risk
14779,276,42,132,3,4,4,11,Loyal Users
14944,366,13,43,3,3,3,9,Loyal Users
15292,20,38,136,5,4,4,13,Champions
15429,296,25,92,3,4,4,11,Loyal Users
15535,1859,6,8,1,1,1,3,Lost
15740,4564,8,9,1,2,1,4,Lost
15960,26,67,261,5,5,5,15,Champions
16094,11,26,76,5,4,4,13,Champions
16117,3032,9,11,1,2,1,4,Lost
16232,8,25,48,5,4,3,12,Loyal Users
16565,13,42,96,5,4,4,13,Champions
16706,134,9,11,4,2,1,7,Promising
16999,243,38,342,3,4,5,12,Loyal Users
17113,27,79,256,5,5,5,15,Champions
17154,124,58,136,4,5,4,13,Champions
17190,227,75,130,3,5,4,12,Loyal Users
17836,152,39,89,4,4,4,12,Champions
17950,129,88,278,4,5,5,14,Champions
18328,151,66,168,4,5,5,14,Champions
18334,1829,10,20,1,2,2,5,Lost
18529,20,48,113,5,5,4,14,Champions
18614,861,10,89,2,2,4,8,Lost
18825,66,59,187,5,5,5,15,Champions
19067,432,15,21,3,3,2,8,Loyal Users
19149,1967,18,23,1,3,2,6,Casual Users
19317,3126,5,11,1,1,1,3,Lost
19396,3902,16,67,1,3,4,8,Casual Users
19531,108,6,17,4,1,2,7,Promising
20195,126,21,53,4,3,3,10,Loyal Users
20388,114,14,37,4,3,3,10,Loyal Users
20485,16,122,707,5,5,5,15,Champions
20719,1456,5,7,1,1,1,3,Lost
20898,431,14,15,3,3,1,7,Loyal Users
21035,138,27,108,4,4,4,12,Champions
21151,128,29,70,4,4,4,12,Champions
21298,154,48,198,4,5,5,14,Champions
21373,542,9,13,2,2,1,5,Lost
21389,134,5,6,4,1,1,6,Promising
21672,1548,14,26,1,3,2,6,Casual Users
21675,154,96,305,4,5,5,14,Champions
21769,94,39,307,4,4,5,13,Champions
21978,874,67,115,2,5,4,11,At Risk
22064,25,98,202,5,5,5,15,Champions
22215,255,38,72,3,4,4,11,Loyal Users
22443,20,20,43,5,3,3,11,Loyal Users
22652,1956,6,6,1,1,1,3,Lost
23284,1135,10,28,2,2,2,6,Lost
23286,163,9,9,4,2,1,7,Promising
23362,157,101,259,4,5,5,14,Champions
24139,13,18,58,5,3,3,11,Loyal Users
24254,42,35,94,5,4,4,13,Champions
24258,299,9,13,3,2,1,6,Casual Users
24578,447,27,135,3,4,4,11,Loyal Users
24612,73,128,330,4,5,5,14,Champions
24890,508,11,50,2,2,3,7,Lost
25316,695,62,137,2,5,4,11,At Risk
25520,653,6,24,2,1,2,5,Lost
25742,842,7,33,2,2,3,7,Lost
25862,2224,5,16,1,1,2,4,Lost
26015,837,31,77,2,4,4,10,At Risk
26219,107,6,13,4,1,1,6,Promising
13997,91,9,11,4,2,1,7,Promising
14054,813,16,82,2,3,4,9,Casual Users
14124,20,8,43,5,2,3,10,Promising
14365,14,28,41,5,4,3,12,Loyal Users
14458,968,12,21,2,3,2,7,Casual Users
14846,2,41,180,5,4,5,14,Champions
14874,850,5,10,2,1,1,4,Lost
15026,85,217,536,4,5,5,14,Champions
15070,797,7,11,2,2,1,5,Lost
15146,16,14,65,5,3,4,12,Loyal Users
15221,1202,7,22,2,2,2,6,Lost
15462,3856,8,12,1,2,1,4,Lost
15594,1419,5,10,1,1,1,3,Lost
15647,367,48,222,3,5,5,13,Loyal Users
16027,522,14,41,2,3,3,8,Casual Users
16119,706,15,23,2,3,2,7,Casual Users
16295,2950,5,7,1,1,1,3,Lost
16506,80,48,101,4,5,4,13,Champions
16510,90,100,495,4,5,5,14,Champions
16526,2477,19,28,1,3,2,6,Casual Users
16549,0,98,219,5,5,5,15,Champions
16985,185,8,40,3,2,3,8,Casual Users
17036,788,55,110,2,5,4,11,At Risk
17346,2784,6,17,1,1,2,4,Lost
17438,83,74,318,4,5,5,14,Champions
18296,128,85,180,4,5,5,14,Champions
18307,224,26,34,3,4,3,10,Loyal Users
18741,66,6,10,5,1,1,7,Promising
18831,110,8,18,4,2,2,8,Promising
18881,39,61,476,5,5,5,15,Champions
19180,2047,17,17,1,3,2,6,Casual Users
19690,16,27,100,5,4,4,13,Champions
19701,2010,13,56,1,3,3,7,Casual Users
19833,77,24,72,4,4,4,12,Champions
19965,388,24,90,3,4,4,11,Loyal Users
19998,1836,70,363,1,5,5,11,At Risk
20050,134,70,477,4,5,5,14,Champions
20124,89,107,383,4,5,5,14,Champions
20542,15,32,222,5,4,5,14,Champions
20671,412,38,64,3,4,4,11,Loyal Users
20717,2874,18,106,1,3,4,8,Casual Users
20789,307,9,15,3,2,1,6,Casual Users
21077,70,6,18,4,1,2,7,Promising
21126,332,17,21,3,3,2,8,Loyal Users
21303,890,25,209,2,4,5,11,At Risk
21307,149,6,28,4,1,2,7,Promising
21383,2033,6,33,1,1,3,5,Lost
21484,9,29,123,5,4,4,13,Champions
21603,147,36,124,4,4,4,12,Champions
21632,1241,10,35,2,2,3,7,Lost
21667,1,111,202,5,5,5,15,Champions
22116,195,36,75,3,4,4,11,Loyal Users
22236,4109,18,33,1,3,3,7,Casual Users
22364,4250,5,5,1,1,1,3,Lost
22787,119,42,170,4,4,5,13,Champions
22903,294,100,648,3,5,5,13,Loyal Users
23434,828,22,58,2,4,3,9,At Risk
23457,2432,7,25,1,2,2,5,Lost
23479,5643,7,58,1,2,3,6,Lost
23740,955,6,13,2,1,1,4,Lost
24128,1069,36,95,2,4,4,10,At Risk
24407,276,5,7,3,1,1,5,Casual Users
24464,1680,5,20,1,1,2,4,Lost
24482,448,48,74,3,5,4,12,Loyal Users
24587,143,41,81,4,4,4,12,Champions
24633,719,6,28,2,1,2,5,Lost
24787,11,46,235,5,5,5,15,Champions
24997,135,10,61,4,2,3,9,Promising
25259,1595,5,7,1,1,1,3,Lost
25355,118,14,28,4,3,2,9,Loyal Users
25628,118,34,61,4,4,3,11,Loyal Users
25812,1801,10,11,1,2,1,4,Lost
25864,1151,17,37,2,3,3,8,Casual Users
25904,1210,8,12,2,2,1,5,Lost
25908,42,8,28,5,2,2,9,Promising
25923,569,13,117,2,3,4,9,Casual Users
25948,3,110,338,5,5,5,15,Champions
26119,0,98,176,5,5,5,15,Champions
26470,45,75,196,5,5,5,15,Champions
14030,2972,16,27,1,3,2,6,Casual Users
14245,25,142,264,5,5,5,15,Champions
14284,7,144,302,5,5,5,15,Champions
14477,122,53,107,4,5,4,13,Champions
14812,9,74,232,5,5,5,15,Champions
15216,212,32,47,3,4,3,10,Loyal Users
15558,379,22,34,3,4,3,10,Loyal Users
15584,178,5,39,3,1,3,7,Casual Users
15781,20,47,67,5,5,4,14,Champions
15827,7,111,526,5,5,5,15,Champions
15931,294,7,9,3,2,1,6,Casual Users
15983,320,14,25,3,3,2,8,Loyal Users
16255,1505,5,8,1,1,1,3,Lost
16257,1439,11,20,1,2,2,5,Lost
16391,78,25,167,4,4,5,13,Champions
16505,421,30,51,3,4,3,10,Loyal Users
16601,63,23,47,5,4,3,12,Loyal Users
16724,10,15,28,5,3,2,10,Loyal Users
17213,72,77,393,4,5,5,14,Champions
17378,2693,26,42,1,4,3,8,At Risk
17613,147,59,244,4,5,5,14,Champions
17677,5230,14,80,1,3,4,8,Casual Users
17782,2354,6,8,1,1,1,3,Lost
17903,83,128,313,4,5,5,14,Champions
17904,61,64,350,5,5,5,15,Champions
18405,1140,5,9,2,1,1,4,Lost
18673,3898,6,8,1,1,1,3,Lost
18966,2283,12,21,1,3,2,6,Casual Users
19063,1508,22,59,1,4,3,8,At Risk
19066,1779,7,8,1,2,1,4,Lost
19084,1108,32,151,2,4,5,11,At Risk
19092,1087,6,45,2,1,3,6,Lost
19335,1755,5,14,1,1,1,3,Lost
19428,250,11,64,3,2,4,9,Casual Users
19733,445,6,11,3,1,1,5,Casual Users
19912,1569,24,27,1,4,2,7,At Risk
20132,1375,12,29,1,3,2,6,Casual Users
20221,677,14,64,2,3,4,9,Casual Users
20354,0,133,342,5,5,5,15,Champions
20631,308,13,18,3,3,2,8,Loyal Users
20674,595,18,54,2,3,3,8,Casual Users
20742,1291,19,61,1,3,3,7,Casual Users
20903,246,28,36,3,4,3,10,Loyal Users
20982,101,136,631,4,5,5,14,Champions
21306,412,5,9,3,1,1,5,Casual Users
21710,2154,19,33,1,3,3,7,Casual Users
22003,1832,24,52,1,4,3,8,At Risk
22040,568,5,17,2,1,2,5,Lost
22068,197,13,67,3,3,4,10,Loyal Users
22307,9,98,139,5,5,4,14,Champions
22349,146,84,575,4,5,5,14,Champions
22389,16,33,82,5,4,4,13,Champions
22713,96,59,192,4,5,5,14,Champions
23000,29,33,58,5,4,3,12,Loyal Users
23141,1633,10,11,1,2,1,4,Lost
23403,96,15,43,4,3,3,10,Loyal Users
23874,448,16,29,3,3,2,8,Loyal Users
24252,18,39,69,5,4,4,13,Champions
24299,15,8,10,5,2,1,8,Promising
24926,1738,6,9,1,1,1,3,Lost
25601,43,5,8,5,1,1,7,Promising
25820,2551,18,44,1,3,3,7,Casual Users
25831,849,8,11,2,2,1,5,Lost
26247,1355,19,22,1,3,2,6,Casual Users
26350,863,13,24,2,3,2,7,Casual Users
26434,1426,8,26,1,2,2,5,Lost
26442,134,14,37,4,3,3,10,Loyal Users
13701,1760,7,9,1,2,1,4,Lost
14532,1703,15,21,1,3,2,6,Casual Users
14556,2156,67,181,1,5,5,11,At Risk
14760,911,15,22,2,3,2,7,Casual Users
14771,694,8,13,2,2,1,5,Lost
15157,706,22,100,2,4,4,10,At Risk
15161,330,8,15,3,2,1,6,Casual Users
15348,2231,7,7,1,2,1,4,Lost
15633,7,41,96,5,4,4,13,Champions
15634,14,119,392,5,5,5,15,Champions
15966,911,5,6,2,1,1,4,Lost
16741,340,8,20,3,2,2,7,Casual Users
16766,165,15,89,4,3,4,11,Loyal Users
16800,783,9,9,2,2,1,5,Lost
16835,388,8,17,3,2,2,7,Casual Users
16947,1020,8,10,2,2,1,5,Lost
16954,6,93,617,5,5,5,15,Champions
17392,113,9,43,4,2,3,9,Promising
17396,235,6,14,3,1,1,5,Casual Users
17462,139,86,315,4,5,5,14,Champions
17502,108,52,110,4,5,4,13,Champions
17924,1,64,228,5,5,5,15,Champions
18174,867,8,93,2,2,4,8,Lost
19328,4450,12,28,1,3,2,6,Casual Users
19440,1820,7,17,1,2,2,5,Lost
19627,3972,9,13,1,2,1,4,Lost
19686,15,83,160,5,5,5,15,Champions
19976,212,10,34,3,2,3,8,Casual Users
20056,864,80,164,2,5,5,12,At Risk
20223,1844,5,6,1,1,1,3,Lost
20409,251,21,45,3,3,3,9,Loyal Users
20931,95,42,137,4,4,4,12,Champions
21201,9,51,140,5,5,4,14,Champions
21369,30,43,136,5,4,4,13,Champions
21462,706,7,19,2,2,2,6,Lost
21467,129,10,77,4,2,4,10,Promising
21508,0,15,30,5,3,2,10,Loyal Users
21909,1309,12,19,1,3,2,6,Casual Users
22045,36,33,109,5,4,4,13,Champions
22313,4859,5,6,1,1,1,3,Lost
22382,566,20,33,2,3,3,8,Casual Users
22469,567,8,9,2,2,1,5,Lost
22695,163,27,159,4,4,5,13,Champions
22824,2088,8,18,1,2,2,5,Lost
22857,946,16,45,2,3,3,8,Casual Users
22884,390,9,23,3,2,2,7,Casual Users
22917,0,43,88,5,4,4,13,Champions
22964,1349,10,31,1,2,2,5,Lost
22966,44,115,283,5,5,5,15,Champions
23303,147,17,33,4,3,3,10,Loyal Users
23487,294,10,147,3,2,5,10,Casual Users
23609,13,15,16,5,3,2,10,Loyal Users
23682,824,11,15,2,2,1,5,Lost
23696,125,70,139,4,5,4,13,Champions
23993,1122,10,28,2,2,2,6,Lost
24168,254,33,81,3,4,4,11,Loyal Users
24228,84,19,57,4,3,3,10,Loyal Users
24331,92,26,153,4,4,5,13,Champions
24518,2103,6,12,1,1,1,3,Lost
24740,7,17,32,5,3,3,11,Loyal Users
25169,306,8,23,3,2,2,7,Casual Users
25262,72,77,548,4,5,5,14,Champions
25280,382,6,7,3,1,1,5,Casual Users
25507,547,10,53,2,2,3,7,Lost
25887,85,30,39,4,4,3,11,Loyal Users
26070,972,12,22,2,3,2,7,Casual Users
26120,140,41,75,4,4,4,12,Champions
14058,293,99,465,3,5,5,13,Loyal Users
14437,977,6,8,2,1,1,4,Lost
15091,8,96,146,5,5,4,14,Champions
15164,80,58,207,4,5,5,14,Champions
15270,417,14,30,3,3,2,8,Loyal Users
15904,4,53,304,5,5,5,15,Champions
15968,101,77,199,4,5,5,14,Champions
15973,824,19,34,2,3,3,8,Casual Users
16234,62,19,151,5,3,5,13,Loyal Users
16317,10,29,69,5,4,4,13,Champions
16648,333,36,66,3,4,4,11,Loyal Users
17265,280,39,204,3,4,5,12,Loyal Users
17525,127,62,196,4,5,5,14,Champions
17774,142,15,25,4,3,2,9,Loyal Users
17926,2548,8,10,1,2,1,4,Lost
17969,1570,9,29,1,2,2,5,Lost
17972,181,44,99,3,4,4,11,Loyal Users
18014,1784,18,63,1,3,4,8,Casual Users
18107,123,49,331,4,5,5,14,Champions
18304,312,21,50,3,3,3,9,Loyal Users
18613,2290,8,26,1,2,2,5,Lost
18708,421,9,11,3,2,1,6,Casual Users
18750,211,18,57,3,3,3,9,Loyal Users
18860,46,99,131,5,5,4,14,Champions
18908,752,15,84,2,3,4,9,Casual Users
19048,694,5,57,2,1,3,6,Lost
19284,2514,12,43,1,3,3,7,Casual Users
19346,1445,10,35,1,2,3,6,Lost
19358,700,13,25,2,3,2,7,Casual Users
19567,0,32,227,5,4,5,14,Champions
19678,1293,23,61,1,4,3,8,At Risk
19757,42,88,919,5,5,5,15,Champions
19940,27,13,55,5,3,3,11,Loyal Users
20021,308,51,270,3,5,5,13,Loyal Users
20163,19,237,804,5,5,5,15,Champions
20314,2951,5,29,1,1,2,4,Lost
20316,1612,24,53,1,4,3,8,At Risk
20554,128,8,21,4,2,2,8,Promising
20738,6,14,32,5,3,3,11,Loyal Users
20785,1541,10,40,1,2,3,6,Lost
21517,422,18,77,3,3,4,10,Loyal Users
21682,2414,8,12,1,2,1,4,Lost
22638,112,28,154,4,4,5,13,Champions
22942,149,64,127,4,5,4,13,Champions
22983,2814,6,21,1,1,2,4,Lost
23010,120,55,187,4,5,5,14,Champions
23047,2966,13,47,1,3,3,7,Casual Users
23206,82,54,174,4,5,5,14,Champions
23421,583,17,52,2,3,3,8,Casual Users
23581,307,11,42,3,2,3,8,Casual Users
23619,3116,10,14,1,2,1,4,Lost
23974,228,7,27,3,2,2,7,Casual Users
24011,6,132,970,5,5,5,15,Champions
24210,17,10,45,5,2,3,10,Promising
24288,98,166,426,4,5,5,14,Champions
24509,119,21,38,4,3,3,10,Loyal Users
25055,381,26,51,3,4,3,10,Loyal Users
25146,996,9,40,2,2,3,7,Lost
25243,460,10,38,3,2,3,8,Casual Users
25434,728,12,21,2,3,2,7,Casual Users
25673,6,37,97,5,4,4,13,Champions
26379,9,72,341,5,5,5,15,Champions
13915,888,6,44,2,1,3,6,Lost
13967,978,6,35,2,1,3,6,Lost
14085,423,18,103,3,3,4,10,Loyal Users
14658,1076,8,62,2,2,3,7,Lost
15191,423,6,24,3,1,2,6,Casual Users
15491,362,48,247,3,5,5,13,Loyal Users
15658,3,47,202,5,5,5,15,Champions
16032,1373,9,10,1,2,1,4,Lost
16544,132,203,415,4,5,5,14,Champions
16813,4,23,61,5,4,3,12,Loyal Users
17067,413,7,12,3,2,1,6,Casual Users
17225,30,86,271,5,5,5,15,Champions
17253,539,23,131,2,4,4,10,At Risk
17430,2001,8,13,1,2,1,4,Lost
17554,3570,7,8,1,2,1,4,Lost
17639,3648,6,9,1,1,1,3,Lost
18645,466,81,196,3,5,5,13,Loyal Users
18652,512,17,63,2,3,4,9,Casual Users
18827,42,69,109,5,5,4,14,Champions
19480,3392,48,142,1,5,4,10,At Risk
19532,841,6,23,2,1,2,5,Lost
19862,1736,15,54,1,3,3,7,Casual Users
20058,633,15,38,2,3,3,8,Casual Users
20125,1527,9,33,1,2,3,6,Lost
20490,453,5,11,3,1,1,5,Casual Users
20540,688,31,55,2,4,3,9,At Risk
20642,150,37,58,4,4,3,11,Loyal Users
20672,107,7,90,4,2,4,10,Promising
20800,1962,8,23,1,2,2,5,Lost
21049,3818,39,110,1,4,4,9,At Risk
21073,113,45,256,4,4,5,13,Champions
21175,108,84,146,4,5,4,13,Champions
21200,144,34,102,4,4,4,12,Champions
21311,2662,6,12,1,1,1,3,Lost
21804,102,140,332,4,5,5,14,Champions
21904,699,6,11,2,1,1,4,Lost
22024,894,17,33,2,3,3,8,Casual Users
22265,541,18,94,2,3,4,9,Casual Users
22361,32,128,663,5,5,5,15,Champions
22366,118,13,40,4,3,3,10,Loyal Users
22414,141,21,44,4,3,3,10,Loyal Users
23215,3282,7,10,1,2,1,4,Lost
23491,129,76,386,4,5,5,14,Champions
23850,1042,30,150,2,4,5,11,At Risk
24176,820,13,21,2,3,2,7,Casual Users
24363,91,14,68,4,3,4,11,Loyal Users
24819,766,8,44,2,2,3,7,Lost
24858,1,117,262,5,5,5,15,Champions
24994,3427,6,12,1,1,1,3,Lost
25081,349,13,124,3,3,4,10,Loyal Users
25168,20,7,10,5,2,1,8,Promising
25190,1860,7,18,1,2,2,5,Lost
25254,520,26,87,2,4,4,10,At Risk
25627,430,12,18,3,3,2,8,Loyal Users
25913,694,20,21,2,3,2,7,Casual Users
26090,271,32,116,3,4,4,11,Loyal Users
26165,280,45,85,3,4,4,11,Loyal Users
13720,121,174,295,4,5,5,14,Champions
13751,177,7,50,3,2,3,8,Casual Users
13994,706,6,24,2,1,2,5,Lost
14064,108,14,55,4,3,3,10,Loyal Users
14332,204,31,104,3,4,4,11,Loyal Users
14589,128,117,432,4,5,5,14,Champions
14801,97,21,28,4,3,2,9,Loyal Users
15093,653,40,86,2,4,4,10,At Risk
15202,1259,19,103,1,3,4,8,Casual Users
15470,423,8,23,3,2,2,7,Casual Users
15497,104,52,348,4,5,5,14,Champions
15557,119,14,19,4,3,2,9,Loyal Users
15962,41,66,111,5,5,4,14,Champions
16738,437,8,9,3,2,1,6,Casual Users
16798,2154,18,75,1,3,4,8,Casual Users
16801,157,39,202,4,4,5,13,Champions
16913,1287,24,49,1,4,3,8,At Risk
16968,960,38,64,2,4,4,10,At Risk
17074,7,19,102,5,3,4,12,Loyal Users
17388,333,58,152,3,5,5,13,Loyal Users
17588,27,57,391,5,5,5,15,Champions
18660,25,14,108,5,3,4,12,Loyal Users
19039,0,9,22,5,2,2,9,Promising
19215,426,13,20,3,3,2,8,Loyal Users
19224,237,36,258,3,4,5,12,Loyal Users
19947,14,96,231,5,5,5,15,Champions
19996,307,13,23,3,3,2,8,Loyal Users
20097,77,53,158,4,5,5,14,Champions
20298,152,43,120,4,4,4,12,Champions
21231,2724,10,12,1,2,1,4,Lost
21756,64,82,391,5,5,5,15,Champions
21872,2406,5,13,1,1,1,3,Lost
21946,3126,18,96,1,3,4,8,Casual Users
22158,899,9,23,2,2,2,6,Lost
22190,857,14,30,2,3,2,7,Casual Users
22707,110,17,44,4,3,3,10,Loyal Users
22908,848,9,28,2,2,2,6,Lost
23032,1981,7,51,1,2,3,6,Lost
23249,319,5,27,3,1,2,6,Casual Users
23295,1133,9,10,2,2,1,5,Lost
23371,127,15,73,4,3,4,11,Loyal Users
23428,4,9,17,5,2,2,9,Promising
23496,1033,7,7,2,2,1,5,Lost
23746,1975,6,12,1,1,1,3,Lost
23901,26,8,8,5,2,1,8,Promising
23986,152,8,10,4,2,1,7,Promising
23994,546,9,29,2,2,2,6,Lost
24075,1181,6,12,2,1,1,4,Lost
24588,2935,9,10,1,2,1,4,Lost
24650,861,14,19,2,3,2,7,Casual Users
24733,283,7,30,3,2,2,7,Casual Users
24939,110,51,107,4,5,4,13,Champions
25092,492,12,23,2,3,2,7,Casual Users
25099,2792,7,16,1,2,2,5,Lost
25292,1220,7,32,2,2,3,7,Lost
25512,133,27,98,4,4,4,12,Champions
25909,982,11,12,2,2,1,5,Lost
26091,6021,15,23,1,3,2,6,Casual Users
26309,159,21,89,4,3,4,11,Loyal Users
26405,693,18,26,2,3,2,7,Casual Users
13594,1779,9,17,1,2,2,5,Lost
14336,1156,6,8,2,1,1,4,Lost
14715,3652,5,7,1,1,1,3,Lost
14935,112,9,11,4,2,1,7,Promising
15637,17,8,9,5,2,1,8,Promising
15716,116,26,86,4,4,4,12,Champions
15850,109,79,203,4,5,5,14,Champions
15902,239,32,220,3,4,5,12,Loyal Users
16125,447,8,10,3,2,1,6,Casual Users
16274,648,5,11,2,1,1,4,Lost
16375,5767,6,6,1,1,1,3,Lost
16605,14,98,189,5,5,5,15,Champions
16721,3096,5,24,1,1,2,4,Lost
16819,1116,12,30,2,3,2,7,Casual Users
17347,98,21,45,4,3,3,10,Loyal Users
17397,116,46,244,4,5,5,14,Champions
17508,66,7,8,5,2,1,8,Promising
17792,892,11,65,2,2,4,8,Lost
18030,612,8,16,2,2,2,6,Lost
18085,320,20,43,3,3,3,9,Loyal Users
18105,1582,11,120,1,2,4,7,Lost
18193,120,13,61,4,3,3,10,Loyal Users
18512,841,9,18,2,2,2,6,Lost
18818,4555,5,13,1,1,1,3,Lost
19603,107,36,50,4,4,3,11,Loyal Users
19679,9,8,12,5,2,1,8,Promising
19909,2121,14,23,1,3,2,6,Casual Users
19915,19,8,24,5,2,2,9,Promising
19949,694,7,8,2,2,1,5,Lost
20131,1282,5,7,1,1,1,3,Lost
20331,417,10,14,3,2,1,6,Casual Users
20356,128,13,24,4,3,2,9,Loyal Users
20452,847,54,107,2,5,4,11,At Risk
20471,111,88,139,4,5,4,13,Champions
20519,291,22,27,3,4,2,9,Loyal Users
21051,1843,12,14,1,3,1,5,Casual Users
21087,127,76,135,4,5,4,13,Champions
21232,5402,5,6,1,1,1,3,Lost
21683,145,13,27,4,3,2,9,Loyal Users
21910,544,11,22,2,2,2,6,Lost
21956,2135,5,27,1,1,2,4,Lost
22275,57,59,156,5,5,5,15,Champions
22665,118,16,46,4,3,3,10,Loyal Users
23100,8,8,10,5,2,1,8,Promising
24046,132,79,117,4,5,4,13,Champions
24281,179,9,23,3,2,2,7,Casual Users
24913,3099,5,17,1,1,2,4,Lost
25209,3160,10,20,1,2,2,5,Lost
25547,408,51,119,3,5,4,12,Loyal Users
26164,429,7,25,3,2,2,7,Casual Users
26258,4122,6,7,1,1,1,3,Lost
13745,2179,5,5,1,1,1,3,Lost
13782,110,61,365,4,5,5,14,Champions
13830,2124,11,45,1,2,3,6,Lost
13903,1135,7,11,2,2,1,5,Lost
13960,54,45,240,5,4,5,14,Champions
14044,1159,8,20,2,2,2,6,Lost
14101,2121,8,11,1,2,1,4,Lost
14410,3706,11,25,1,2,2,5,Lost
14501,6,67,592,5,5,5,15,Champions
14703,150,91,257,4,5,5,14,Champions
14999,112,5,10,4,1,1,6,Promising
15116,101,19,38,4,3,3,10,Loyal Users
15130,800,21,37,2,3,3,8,Casual Users
15479,504,6,12,2,1,1,4,Lost
15844,22,34,94,5,4,4,13,Champions
16002,249,45,152,3,4,5,12,Loyal Users
16189,75,6,7,4,1,1,6,Promising
16532,62,146,591,5,5,5,15,Champions
16671,1298,7,25,1,2,2,5,Lost
16707,574,29,77,2,4,4,10,At Risk
16930,609,51,71,2,5,4,11,At Risk
17001,1839,7,22,1,2,2,5,Lost
17196,1848,9,46,1,2,3,6,Lost
17353,5113,6,7,1,1,1,3,Lost
17740,317,10,23,3,2,2,7,Casual Users
17798,186,41,109,3,4,4,11,Loyal Users
18258,2102,6,6,1,1,1,3,Lost
18390,245,35,121,3,4,4,11,Loyal Users
19113,30,148,596,5,5,5,15,Champions
19264,446,29,100,3,4,4,11,Loyal Users
19316,210,22,48,3,4,3,10,Loyal Users
19642,2410,8,11,1,2,1,4,Lost
19769,46,44,150,5,4,5,14,Champions
19922,406,5,8,3,1,1,5,Casual Users
20238,12,70,88,5,5,4,14,Champions
20595,275,19,57,3,3,3,9,Loyal Users
20653,873,5,15,2,1,1,4,Lost
20688,2689,9,29,1,2,2,5,Lost
20693,426,14,38,3,3,3,9,Loyal Users
20804,512,24,47,2,4,3,9,At Risk
20819,1523,12,20,1,3,2,6,Casual Users
20907,1155,12,18,2,3,2,7,Casual Users
21016,63,31,79,5,4,4,13,Champions
21212,45,28,123,5,4,4,13,Champions
21214,98,14,16,4,3,2,9,Loyal Users
21528,415,19,29,3,3,2,8,Loyal Users
22050,974,8,11,2,2,1,5,Lost
22489,1706,25,51,1,4,3,8,At Risk
22502,544,13,113,2,3,4,9,Casual Users
22669,405,15,19,3,3,2,8,Loyal Users
22806,143,78,323,4,5,5,14,Champions
22845,105,12,29,4,3,2,9,Loyal Users
23209,2031,5,9,1,1,1,3,Lost
23544,27,18,51,5,3,3,11,Loyal Users
23683,278,34,101,3,4,4,11,Loyal Users
23948,146,34,68,4,4,4,12,Champions
24094,28,31,122,5,4,4,13,Champions
24371,3573,10,10,1,2,1,4,Lost
24526,235,61,135,3,5,4,12,Loyal Users
24529,293,27,33,3,4,3,10,Loyal Users
24575,151,144,231,4,5,5,14,Champions
24634,2,77,197,5,5,5,15,Champions
24764,1,37,102,5,4,4,13,Champions
24893,402,14,26,3,3,2,8,Loyal Users
25196,280,24,91,3,4,4,11,Loyal Users
25270,1013,5,7,2,1,1,4,Lost
25446,148,5,5,4,1,1,6,Promising
25464,65,61,65,5,5,4,14,Champions
25478,483,16,16,2,3,2,7,Casual Users
25525,2550,5,8,1,1,1,3,Lost
25599,211,39,61,3,4,3,10,Loyal Users
25645,67,10,30,5,2,2,9,Promising
25717,2201,11,32,1,2,3,6,Lost
25963,3099,5,40,1,1,3,5,Lost
26273,84,74,159,4,5,5,14,Champions
26426,1873,13,37,1,3,3,7,Casual Users
13726,299,17,17,3,3,2,8,Loyal Users
13904,4666,13,27,1,3,2,6,Casual Users
14180,2744,10,17,1,2,2,5,Lost
14402,962,11,15,2,2,1,5,Lost
14525,595,7,19,2,2,2,6,Lost
14554,1976,9,125,1,2,4,7,Lost
14555,276,7,8,3,2,1,6,Casual Users
14558,4835,5,31,1,1,2,4,Lost
15060,3549,14,15,1,3,1,5,Casual Users
15253,1199,6,7,2,1,1,4,Lost
15398,177,25,107,3,4,4,11,Loyal Users
15795,280,28,86,3,4,4,11,Loyal Users
15840,3707,11,18,1,2,2,5,Lost
16244,663,5,5,2,1,1,4,Lost
17059,104,37,244,4,4,5,13,Champions
17297,258,46,189,3,5,5,13,Loyal Users
17647,104,37,157,4,4,5,13,Champions
17678,1,35,194,5,4,5,14,Champions
17808,28,22,60,5,4,3,12,Loyal Users
17981,1842,6,7,1,1,1,3,Lost
18071,1650,5,14,1,1,1,3,Lost
18240,897,5,6,2,1,1,4,Lost
18742,4,18,32,5,3,3,11,Loyal Users
18782,285,8,25,3,2,2,7,Casual Users
18895,163,87,314,4,5,5,14,Champions
18942,1830,14,26,1,3,2,6,Casual Users
19597,132,11,16,4,2,2,8,Promising
19685,1582,20,33,1,3,3,7,Casual Users
19810,88,56,101,4,5,4,13,Champions
19939,1469,14,47,1,3,3,7,Casual Users
20069,161,18,46,4,3,3,10,Loyal Users
20199,130,20,89,4,3,4,11,Loyal Users
20418,2851,11,20,1,2,2,5,Lost
20583,2014,7,10,1,2,1,4,Lost
20955,250,10,27,3,2,2,7,Casual Users
21130,12,109,241,5,5,5,15,Champions
21140,13,95,137,5,5,4,14,Champions
21379,3418,5,5,1,1,1,3,Lost
21446,2808,118,363,1,5,5,11,At Risk
21496,74,46,97,4,5,4,13,Champions
21884,2797,6,7,1,1,1,3,Lost
22130,281,13,18,3,3,2,8,Loyal Users
22227,726,8,34,2,2,3,7,Lost
22432,16,16,23,5,3,2,10,Loyal Users
22558,1327,7,38,1,2,3,6,Lost
22834,360,42,160,3,4,5,12,Loyal Users
22851,1609,6,9,1,1,1,3,Lost
23120,132,12,33,4,3,3,10,Loyal Users
23777,21,155,341,5,5,5,15,Champions
23779,434,29,79,3,4,4,11,Loyal Users
24029,321,137,238,3,5,5,13,Loyal Users
24253,4,96,177,5,5,5,15,Champions
24310,10,38,50,5,4,3,12,Loyal Users
24759,1205,16,79,2,3,4,9,Casual Users
24803,239,76,339,3,5,5,13,Loyal Users
24908,565,5,6,2,1,1,4,Lost
25198,143,42,86,4,4,4,12,Champions
25324,2,103,230,5,5,5,15,Champions
25602,120,72,100,4,5,4,13,Champions
25699,407,11,59,3,2,3,8,Casual Users
25751,823,73,248,2,5,5,12,At Risk
26297,142,11,29,4,2,2,8,Promising
26440,1144,25,93,2,4,4,10,At Risk
13665,117,95,336,4,5,5,14,Champions
13775,109,69,272,4,5,5,14,Champions
14056,1,180,1377,5,5,5,15,Champions
14117,431,15,43,3,3,3,9,Loyal Users
14160,396,16,96,3,3,4,10,Loyal Users
14283,468,9,24,3,2,2,7,Casual Users
14367,2691,5,21,1,1,2,4,Lost
14642,160,147,248,4,5,5,14,Champions
14687,4442,6,22,1,1,2,4,Lost
14733,2703,5,9,1,1,1,3,Lost
14776,26,19,97,5,3,4,12,Loyal Users
14814,3117,27,70,1,4,4,9,At Risk
15096,142,5,8,4,1,1,6,Promising
15234,2058,13,24,1,3,2,6,Casual Users
15503,291,13,14,3,3,1,7,Loyal Users
15961,252,7,28,3,2,2,7,Casual Users
16265,282,31,83,3,4,4,11,Loyal Users
16314,53,11,32,5,2,3,10,Promising
16366,301,16,48,3,3,3,9,Loyal Users
16455,97,35,102,4,4,4,12,Champions
16839,529,14,57,2,3,3,8,Casual Users
17081,100,66,310,4,5,5,14,Champions
17147,418,7,23,3,2,2,7,Casual Users
17741,978,21,45,2,3,3,8,Casual Users
17890,33,17,31,5,3,2,10,Loyal Users
17955,46,30,146,5,4,4,13,Champions
18278,278,77,110,3,5,4,12,Loyal Users
18693,340,6,10,3,1,1,5,Casual Users
19493,1,58,371,5,5,5,15,Champions
19556,230,37,124,3,4,4,11,Loyal Users
19762,566,21,73,2,3,4,9,Casual Users
19813,242,16,26,3,3,2,8,Loyal Users
19964,600,26,57,2,4,3,9,At Risk
20018,100,76,137,4,5,4,13,Champions
20573,263,20,35,3,3,3,9,Loyal Users
20731,2,63,83,5,5,4,14,Champions
20763,2428,5,16,1,1,2,4,Lost
20913,228,28,79,3,4,4,11,Loyal Users
20917,445,6,10,3,1,1,5,Casual Users
20940,144,40,123,4,4,4,12,Champions
21037,541,9,21,2,2,2,6,Lost
21164,148,30,58,4,4,3,11,Loyal Users
21240,1781,12,43,1,3,3,7,Casual Users
21531,181,47,368,3,5,5,13,Loyal Users
21577,269,83,148,3,5,5,13,Loyal Users
21935,4017,8,9,1,2,1,4,Lost
21994,682,18,114,2,3,4,9,Casual Users
22356,23,100,320,5,5,5,15,Champions
22381,390,71,122,3,5,4,12,Loyal Users
22678,4471,18,38,1,3,3,7,Casual Users
22839,87,25,55,4,4,3,11,Loyal Users
23137,409,25,39,3,4,3,10,Loyal Users
23202,1505,11,16,1,2,2,5,Lost
23872,137,33,69,4,4,4,12,Champions
23898,1146,29,87,2,4,4,10,At Risk
24584,480,42,93,2,4,4,10,At Risk
24761,936,41,76,2,4,4,10,At Risk
24953,169,45,142,3,4,4,11,Loyal Users
25540,529,17,35,2,3,3,8,Casual Users
25714,105,20,51,4,3,3,10,Loyal Users
26167,15,52,86,5,5,4,14,Champions
26290,1668,6,15,1,1,1,3,Lost
13676,143,5,6,4,1,1,6,Promising
13738,260,33,56,3,4,3,10,Loyal Users
13836,5,35,247,5,4,5,14,Champions
13873,1409,6,6,1,1,1,3,Lost
14141,46,117,208,5,5,5,15,Champions
14177,1444,9,18,1,2,2,5,Lost
14302,467,8,11,3,2,1,6,Casual Users
14647,4729,9,9,1,2,1,4,Lost
15105,80,133,249,4,5,5,14,Champions
15666,1232,9,70,2,2,4,8,Lost
15733,572,9,31,2,2,2,6,Lost
15923,77,8,17,4,2,2,8,Promising
16043,175,5,10,3,1,1,5,Casual Users
16053,434,12,46,3,3,3,9,Loyal Users
16944,276,30,122,3,4,4,11,Loyal Users
17207,656,7,11,2,2,1,5,Lost
17281,133,26,103,4,4,4,12,Champions
17542,2125,20,69,1,3,4,8,Casual Users
17983,1146,45,96,2,4,4,10,At Risk
18406,2,60,236,5,5,5,15,Champions
18417,663,29,49,2,4,3,9,At Risk
18821,1145,7,13,2,2,1,5,Lost
18875,3736,9,9,1,2,1,4,Lost
19001,835,9,33,2,2,3,7,Lost
19007,293,12,33,3,3,3,9,Loyal Users
19579,138,6,10,4,1,1,6,Promising
19752,30,16,65,5,3,4,12,Loyal Users
19942,5,69,117,5,5,4,14,Champions
20496,84,130,361,4,5,5,14,Champions
20501,1984,5,17,1,1,2,4,Lost
20776,293,5,36,3,1,3,7,Casual Users
21053,829,18,27,2,3,2,7,Casual Users
21068,1238,37,169,2,4,5,11,At Risk
21269,126,10,30,4,2,2,8,Promising
21276,58,6,6,5,1,1,7,Promising
21915,398,7,25,3,2,2,7,Casual Users
22192,122,9,39,4,2,3,9,Promising
22409,642,13,25,2,3,2,7,Casual Users
22491,1206,62,252,2,5,5,12,At Risk
22608,77,84,106,4,5,4,13,Champions
22616,857,11,34,2,2,3,7,Lost
22960,83,23,35,4,4,3,11,Loyal Users
23219,1429,5,6,1,1,1,3,Lost
23260,1,24,91,5,4,4,13,Champions
23447,23,80,249,5,5,5,15,Champions
23464,77,49,336,4,5,5,14,Champions
23860,70,160,361,4,5,5,14,Champions
24096,2398,6,10,1,1,1,3,Lost
24552,249,15,58,3,3,3,9,Loyal Users
24632,30,67,105,5,5,4,14,Champions
25038,53,36,287,5,4,5,14,Champions
25960,455,13,28,3,3,2,8,Loyal Users
26083,131,18,44,4,3,3,10,Loyal Users
26155,5,5,9,5,1,1,7,Promising
14419,563,20,24,2,3,2,7,Casual Users
14455,2671,20,43,1,3,3,7,Casual Users
14496,3814,5,5,1,1,1,3,Lost
15024,412,18,84,3,3,4,10,Loyal Users
15062,333,10,14,3,2,1,6,Casual Users
15138,98,9,24,4,2,2,8,Promising
15219,118,13,30,4,3,2,9,Loyal Users
15242,216,75,95,3,5,4,12,Loyal Users
15260,193,73,303,3,5,5,13,Loyal Users
15262,813,9,32,2,2,3,7,Lost
15332,18,12,38,5,3,3,11,Loyal Users
15404,383,13,30,3,3,2,8,Loyal Users
15531,1,5,24,5,1,2,8,Promising
15583,719,11,24,2,2,2,6,Lost
15588,1141,21,99,2,3,4,9,Casual Users
15855,109,25,55,4,4,3,11,Loyal Users
16012,424,5,62,3,1,3,7,Casual Users
16175,863,6,20,2,1,2,5,Lost
16264,413,6,8,3,1,1,5,Casual Users
16331,90,19,43,4,3,3,10,Loyal Users
16684,31,8,47,5,2,3,10,Promising
16699,878,17,22,2,3,2,7,Casual Users
16774,6,51,202,5,5,5,15,Champions
17070,4,28,106,5,4,4,13,Champions
17148,133,23,43,4,4,3,11,Loyal Users
17463,60,52,79,5,5,4,14,Champions
18113,1104,17,19,2,3,2,7,Casual Users
18248,113,6,7,4,1,1,6,Promising
18553,158,17,27,4,3,2,9,Loyal Users
19109,459,12,59,3,3,3,9,Loyal Users
19337,102,8,21,4,2,2,8,Promising
19509,376,10,24,3,2,2,7,Casual Users
19885,31,12,13,5,3,1,9,Loyal Users
19928,237,13,21,3,3,2,8,Loyal Users
20244,3,100,267,5,5,5,15,Champions
20287,296,20,42,3,3,3,9,Loyal Users
20666,19,24,93,5,4,4,13,Champions
20946,309,21,206,3,3,5,11,Loyal Users
21131,101,9,77,4,2,4,10,Promising
21629,18,34,57,5,4,3,12,Loyal Users
21926,4,188,486,5,5,5,15,Champions
22084,15,14,19,5,3,2,10,Loyal Users
22124,15,70,201,5,5,5,15,Champions
22142,44,12,17,5,3,2,10,Loyal Users
22802,112,48,124,4,5,4,13,Champions
22846,1090,23,157,2,4,5,11,At Risk
23034,4828,5,12,1,1,1,3,Lost
23038,2179,7,15,1,2,1,4,Lost
23133,3285,5,6,1,1,1,3,Lost
23424,47,34,148,5,4,5,14,Champions
23604,122,75,259,4,5,5,14,Champions
23667,435,5,10,3,1,1,5,Casual Users
23799,1537,17,35,1,3,3,7,Casual Users
23839,327,8,14,3,2,1,6,Casual Users
24220,276,20,50,3,3,3,9,Loyal Users
24631,10,5,48,5,1,3,9,Promising
24796,432,17,73,3,3,4,10,Loyal Users
24816,160,64,160,4,5,5,14,Champions
25022,2457,7,7,1,2,1,4,Lost
25060,122,42,118,4,4,4,12,Champions
25322,1223,15,33,2,3,3,8,Casual Users
25695,1050,44,230,2,4,5,11,At Risk
25796,10,153,206,5,5,5,15,Champions
25941,19,38,133,5,4,4,13,Champions
26376,3,78,204,5,5,5,15,Champions
13847,189,22,30,3,4,2,9,Loyal Users
13946,294,7,10,3,2,1,6,Casual Users
14062,114,13,23,4,3,2,9,Loyal Users
14192,834,50,133,2,5,4,11,At Risk
14318,251,6,6,3,1,1,5,Casual Users
15071,308,16,18,3,3,2,8,Loyal Users
15073,3641,5,9,1,1,1,3,Lost
15132,329,5,27,3,1,2,6,Casual Users
15263,275,12,45,3,3,3,9,Loyal Users
15370,5270,18,57,1,3,3,7,Casual Users
15426,700,32,63,2,4,4,10,At Risk
16178,102,36,85,4,4,4,12,Champions
16326,1137,10,13,2,2,1,5,Lost
16553,524,18,113,2,3,4,9,Casual Users
16608,103,83,173,4,5,5,14,Champions
16834,5090,6,25,1,1,2,4,Lost
16885,129,122,335,4,5,5,14,Champions
17039,237,22,84,3,4,4,11,Loyal Users
17244,101,49,354,4,5,5,14,Champions
17637,1306,54,121,1,5,4,10,At Risk
17709,16,20,37,5,3,3,11,Loyal Users
17737,0,101,669,5,5,5,15,Champions
17922,685,10,33,2,2,3,7,Lost
18026,0,126,591,5,5,5,15,Champions
18096,119,5,90,4,1,4,9,Promising
18147,296,10,28,3,2,2,7,Casual Users
18381,15,37,98,5,4,4,13,Champions
18621,6,26,73,5,4,4,13,Champions
18932,320,26,107,3,4,4,11,Loyal Users
19073,2728,69,275,1,5,5,11,At Risk
19119,177,20,42,3,3,3,9,Loyal Users
19241,428,46,159,3,5,5,13,Loyal Users
19242,24,212,365,5,5,5,15,Champions
19338,2538,9,46,1,2,3,6,Lost
20433,1423,17,20,1,3,2,6,Casual Users
20455,3205,67,138,1,5,4,10,At Risk
20575,147,106,430,4,5,5,14,Champions
20696,1995,5,7,1,1,1,3,Lost
20779,1584,10,20,1,2,2,5,Lost
20894,42,39,54,5,4,3,12,Loyal Users
21382,19,21,45,5,3,3,11,Loyal Users
21853,14,40,66,5,4,4,13,Champions
21886,961,9,14,2,2,1,5,Lost
22030,538,6,18,2,1,2,5,Lost
22054,71,93,170,4,5,5,14,Champions
22173,227,20,49,3,3,3,9,Loyal Users
22202,52,69,257,5,5,5,15,Champions
22262,1527,5,38,1,1,3,5,Lost
22672,2244,15,27,1,3,2,6,Casual Users
22688,17,39,71,5,4,4,13,Champions
22826,4094,11,21,1,2,2,5,Lost
22909,406,68,187,3,5,5,13,Loyal Users
22918,972,15,18,2,3,2,7,Casual Users
23053,38,62,126,5,5,4,14,Champions
23081,633,13,84,2,3,4,9,Casual Users
23334,135,31,44,4,4,3,11,Loyal Users
23832,60,66,183,5,5,5,15,Champions
24282,3997,5,5,1,1,1,3,Lost
24536,126,10,22,4,2,2,8,Promising
24979,2063,6,14,1,1,1,3,Lost
25024,679,61,97,2,5,4,11,At Risk
25189,290,25,121,3,4,4,11,Loyal Users
25217,170,14,22,3,3,2,8,Loyal Users
25235,70,78,448,4,5,5,14,Champions
25725,2411,6,16,1,1,2,4,Lost
25793,4,13,53,5,3,3,11,Loyal Users
25828,154,47,66,4,5,4,13,Champions
25968,3710,11,64,1,2,4,7,Lost
26079,313,12,12,3,3,1,7,Loyal Users
26121,985,41,51,2,4,3,9,At Risk
26227,133,30,89,4,4,4,12,Champions
26361,548,20,40,2,3,3,8,Casual Users
14140,2513,26,151,1,4,5,10,At Risk
14274,549,48,179,2,5,5,12,At Risk
14644,14,88,127,5,5,4,14,Champions
14720,2575,6,9,1,1,1,3,Lost
14783,126,57,183,4,5,5,14,Champions
15841,37,59,88,5,5,4,14,Champions
15906,363,20,39,3,3,3,9,Loyal Users
16000,4213,8,16,1,2,2,5,Lost
16015,85,20,178,4,3,5,12,Loyal Users
16056,362,7,56,3,2,3,8,Casual Users
16078,202,14,66,3,3,4,10,Loyal Users
16352,387,12,63,3,3,4,10,Loyal Users
16760,477,11,49,2,2,3,7,Lost
17014,579,15,20,2,3,2,7,Casual Users
17053,117,31,70,4,4,4,12,Champions
17312,87,13,23,4,3,2,9,Loyal Users
17539,582,15,33,2,3,3,8,Casual Users
17549,13,90,654,5,5,5,15,Champions
17584,5321,81,100,1,5,4,10,At Risk
18057,73,95,193,4,5,5,14,Champions
18776,3,46,73,5,5,4,14,Champions
18879,683,7,11,2,2,1,5,Lost
19024,646,6,16,2,1,2,5,Lost
19135,119,5,33,4,1,3,8,Promising
19178,142,90,195,4,5,5,14,Champions
19219,79,21,88,4,3,4,11,Loyal Users
19420,1690,9,60,1,2,3,6,Lost
19476,1951,12,89,1,3,4,8,Casual Users
19665,734,25,38,2,4,3,9,At Risk
19736,210,13,28,3,3,2,8,Loyal Users
19821,4277,6,21,1,1,2,4,Lost
19936,2315,5,8,1,1,1,3,Lost
20150,1256,9,23,2,2,2,6,Lost
20335,5007,6,9,1,1,1,3,Lost
20378,971,7,15,2,2,1,5,Lost
20381,2734,5,23,1,1,2,4,Lost
20727,424,5,5,3,1,1,5,Casual Users
20932,120,13,27,4,3,2,9,Loyal Users
21030,274,5,24,3,1,2,6,Casual Users
21034,23,35,84,5,4,4,13,Champions
21252,2549,6,6,1,1,1,3,Lost
21642,846,10,56,2,2,3,7,Lost
21937,382,26,86,3,4,4,11,Loyal Users
22301,106,13,108,4,3,4,11,Loyal Users
23026,1104,20,31,2,3,2,7,Casual Users
23605,94,36,74,4,4,4,12,Champions
23669,442,16,40,3,3,3,9,Loyal Users
23807,2,109,180,5,5,5,15,Champions
23877,680,16,17,2,3,2,7,Casual Users
23900,566,6,21,2,1,2,5,Lost
23938,167,52,154,3,5,5,13,Loyal Users
24174,12,12,25,5,3,2,10,Loyal Users
24178,34,40,122,5,4,4,13,Champions
24306,3,64,428,5,5,5,15,Champions
24458,5305,21,83,1,3,4,8,Casual Users
24463,16,66,184,5,5,5,15,Champions
24920,1302,12,26,1,3,2,6,Casual Users
25010,0,122,397,5,5,5,15,Champions
25114,256,19,37,3,3,3,9,Loyal Users
25421,5,38,133,5,4,4,13,Champions
25465,129,37,52,4,4,3,11,Loyal Users
25616,291,9,23,3,2,2,7,Casual Users
25973,2748,60,85,1,5,4,10,At Risk
13838,377,6,8,3,1,1,5,Casual Users
13992,296,58,140,3,5,4,12,Loyal Users
14266,4,35,141,5,4,4,13,Champions
14961,2507,10,37,1,2,3,6,Lost
15051,127,14,109,4,3,4,11,Loyal Users
15203,1621,7,50,1,2,3,6,Lost
15485,423,7,8,3,2,1,6,Casual Users
15599,872,11,15,2,2,1,5,Lost
15918,445,15,35,3,3,3,9,Loyal Users
16075,91,7,12,4,2,1,7,Promising
16150,1127,8,23,2,2,2,6,Lost
16243,227,20,93,3,3,4,10,Loyal Users
16266,85,66,82,4,5,4,13,Champions
16338,288,66,155,3,5,5,13,Loyal Users
16571,110,41,113,4,4,4,12,Champions
16969,137,6,8,4,1,1,6,Promising
17170,32,36,158,5,4,5,14,Champions
17476,795,6,14,2,1,1,4,Lost
17496,28,76,367,5,5,5,15,Champions
17573,385,15,31,3,3,2,8,Loyal Users
17598,148,12,17,4,3,2,9,Loyal Users
17813,382,18,31,3,3,2,8,Loyal Users
17895,430,13,31,3,3,2,8,Loyal Users
17985,0,75,111,5,5,4,14,Champions
18554,4,73,88,5,5,4,14,Champions
18754,455,19,49,3,3,3,9,Loyal Users
18819,884,28,119,2,4,4,10,At Risk
19094,4974,8,36,1,2,3,6,Lost
19354,0,77,197,5,5,5,15,Champions
19921,183,28,101,3,4,4,11,Loyal Users
19934,1588,11,12,1,2,1,4,Lost
20651,6,48,132,5,5,4,14,Champions
20656,411,8,44,3,2,3,8,Casual Users
21103,5606,6,9,1,1,1,3,Lost
21191,24,23,37,5,4,3,12,Loyal Users
21222,697,6,12,2,1,1,4,Lost
21330,1510,26,38,1,4,3,8,At Risk
21569,6,51,106,5,5,4,14,Champions
21571,1426,16,26,1,3,2,6,Casual Users
21602,2675,15,34,1,3,3,7,Casual Users
22025,752,8,12,2,2,1,5,Lost
22193,1447,5,5,1,1,1,3,Lost
22217,105,90,173,4,5,5,14,Champions
22257,126,122,325,4,5,5,14,Champions
22326,1171,14,74,2,3,4,9,Casual Users
22844,118,18,33,4,3,3,10,Loyal Users
22873,59,8,10,5,2,1,8,Promising
23129,570,15,67,2,3,4,9,Casual Users
23377,31,158,795,5,5,5,15,Champions
23493,1257,6,6,2,1,1,4,Lost
23654,571,17,25,2,3,2,7,Casual Users
23676,31,90,387,5,5,5,15,Champions
23760,1454,9,17,1,2,2,5,Lost
23848,447,24,31,3,4,2,9,Loyal Users
23942,733,6,28,2,1,2,5,Lost
23983,128,36,103,4,4,4,12,Champions
24085,346,75,210,3,5,5,13,Loyal Users
24638,133,27,46,4,4,3,11,Loyal Users
24792,370,25,150,3,4,5,12,Loyal Users
24836,3552,6,10,1,1,1,3,Lost
24905,930,5,5,2,1,1,4,Lost
25009,132,44,188,4,4,5,13,Champions
25167,38,28,133,5,4,4,13,Champions
25182,545,26,76,2,4,4,10,At Risk
25247,315,40,67,3,4,4,11,Loyal Users
25494,1244,5,9,2,1,1,4,Lost
25724,274,79,109,3,5,4,12,Loyal Users
26048,1583,6,21,1,1,2,4,Lost
13730,20,82,290,5,5,5,15,Champions
14096,260,20,47,3,3,3,9,Loyal Users
14287,1683,5,10,1,1,1,3,Lost
14333,485,86,286,2,5,5,12,At Risk
14337,3411,7,43,1,2,3,6,Lost
14375,836,50,115,2,5,4,11,At Risk
14391,115,15,93,4,3,4,11,Loyal Users
14808,797,61,211,2,5,5,12,At Risk
14888,108,101,122,4,5,4,13,Champions
15040,36,11,49,5,2,3,10,Promising
15083,1671,15,87,1,3,4,8,Casual Users
15345,52,71,276,5,5,5,15,Champions
15363,108,28,170,4,4,5,13,Champions
15405,233,27,46,3,4,3,10,Loyal Users
15440,189,8,21,3,2,2,7,Casual Users
15563,834,18,34,2,3,3,8,Casual Users
15914,673,6,15,2,1,1,4,Lost
15920,120,42,320,4,4,5,13,Champions
16288,1406,6,8,1,1,1,3,Lost
16413,91,9,18,4,2,2,8,Promising
16431,126,111,625,4,5,5,14,Champions
17071,2156,6,9,1,1,1,3,Lost
17793,1679,7,7,1,2,1,4,Lost
17804,22,50,157,5,5,5,15,Champions
17928,1913,8,16,1,2,2,5,Lost
18392,416,7,14,3,2,1,6,Casual Users
18618,699,12,36,2,3,3,8,Casual Users
19542,648,21,26,2,3,2,7,Casual Users
19659,3557,9,18,1,2,2,5,Lost
19724,1689,8,11,1,2,1,4,Lost
20054,23,11,32,5,2,3,10,Promising
20141,1675,6,7,1,1,1,3,Lost
20341,425,50,60,3,5,3,11,Loyal Users
20403,50,37,73,5,4,4,13,Champions
20424,390,14,32,3,3,3,9,Loyal Users
20607,310,6,16,3,1,2,6,Casual Users
20643,402,6,8,3,1,1,5,Casual Users
20781,5670,10,27,1,2,2,5,Lost
20926,84,21,69,4,3,4,11,Loyal Users
21367,135,51,87,4,5,4,13,Champions
21377,978,5,22,2,1,2,5,Lost
21411,1244,9,36,2,2,3,7,Lost
22258,2,82,234,5,5,5,15,Champions
22906,2659,7,15,1,2,1,4,Lost
23025,679,46,91,2,5,4,11,At Risk
23344,237,11,14,3,2,1,6,Casual Users
23408,696,13,47,2,3,3,8,Casual Users
24303,58,173,555,5,5,5,15,Champions
24460,132,6,13,4,1,1,6,Promising
24734,2,54,236,5,5,5,15,Champions
25381,2,34,164,5,4,5,14,Champions
25571,340,32,94,3,4,4,11,Loyal Users
26251,1673,6,29,1,1,2,4,Lost
13685,69,118,331,5,5,5,15,Champions
13713,1021,52,123,2,5,4,11,At Risk
13811,129,23,99,4,4,4,12,Champions
14345,2,9,11,5,2,1,8,Promising
14439,928,12,26,2,3,2,7,Casual Users
14871,30,201,897,5,5,5,15,Champions
15108,108,44,272,4,4,5,13,Champions
15224,1703,20,127,1,3,4,8,Casual Users
15267,587,8,20,2,2,2,6,Lost
15454,1395,20,43,1,3,3,7,Casual Users
15559,1320,83,408,1,5,5,11,At Risk
16129,5950,9,22,1,2,2,5,Lost
16240,551,9,14,2,2,1,5,Lost
16289,102,38,49,4,4,3,11,Loyal Users
16303,12,90,360,5,5,5,15,Champions
16799,143,5,22,4,1,2,7,Promising
17029,130,15,63,4,3,4,11,Loyal Users
17097,3504,67,295,1,5,5,11,At Risk
17345,126,91,358,4,5,5,14,Champions
17423,1463,8,8,1,2,1,4,Lost
17448,472,9,10,2,2,1,5,Lost
17545,111,30,191,4,4,5,13,Champions
17811,160,110,284,4,5,5,14,Champions
18088,5105,16,55,1,3,3,7,Casual Users
18170,262,66,91,3,5,4,12,Loyal Users
18209,295,10,27,3,2,2,7,Casual Users
18286,138,8,38,4,2,3,9,Promising
18378,65,92,173,5,5,5,15,Champions
18496,417,6,20,3,1,2,6,Casual Users
18626,1695,18,85,1,3,4,8,Casual Users
18738,2425,7,14,1,2,1,4,Lost
19145,2175,7,17,1,2,2,5,Lost
19889,584,5,9,2,1,1,4,Lost
20032,97,67,261,4,5,5,14,Champions
20459,373,11,24,3,2,2,7,Casual Users
20495,622,15,43,2,3,3,8,Casual Users
20538,2079,5,7,1,1,1,3,Lost
20896,83,7,11,4,2,1,7,Promising
21168,19,8,11,5,2,1,8,Promising
22106,146,30,50,4,4,3,11,Loyal Users
22135,550,9,13,2,2,1,5,Lost
22442,4176,5,6,1,1,1,3,Lost
23051,201,23,82,3,4,4,11,Loyal Users
23166,329,11,28,3,2,2,7,Casual Users
23323,83,22,46,4,4,3,11,Loyal Users
23375,246,6,7,3,1,1,5,Casual Users
23739,50,102,466,5,5,5,15,Champions
23783,110,24,132,4,4,4,12,Champions
23803,1673,20,69,1,3,4,8,Casual Users
24061,136,25,53,4,4,3,11,Loyal Users
24528,17,99,167,5,5,5,15,Champions
24535,3366,6,17,1,1,2,4,Lost
24621,1536,5,21,1,1,2,4,Lost
24666,30,21,45,5,3,3,11,Loyal Users
24692,232,60,295,3,5,5,13,Loyal Users
24856,2250,31,89,1,4,4,9,At Risk
25023,271,29,95,3,4,4,11,Loyal Users
25155,7,66,379,5,5,5,15,Champions
25207,84,137,434,4,5,5,14,Champions
25256,244,13,23,3,3,2,8,Loyal Users
25452,0,11,11,5,2,1,8,Promising
25955,300,6,17,3,1,2,6,Casual Users
26136,1046,13,15,2,3,1,6,Casual Users
26323,715,6,15,2,1,1,4,Lost
13644,1861,11,14,1,2,1,4,Lost
14128,3505,14,38,1,3,3,7,Casual Users
14193,416,15,32,3,3,3,9,Loyal Users
14292,764,12,18,2,3,2,7,Casual Users
14565,168,16,66,3,3,4,10,Loyal Users
14813,158,26,82,4,4,4,12,Champions
15636,973,16,50,2,3,3,8,Casual Users
15895,283,32,241,3,4,5,12,Loyal Users
15905,162,5,11,4,1,1,6,Promising
15909,14,10,14,5,2,1,8,Promising
15938,153,30,175,4,4,5,13,Champions
16114,591,7,13,2,2,1,5,Lost
16134,10,161,408,5,5,5,15,Champions
16138,6025,8,65,1,2,4,7,Lost
16370,0,89,219,5,5,5,15,Champions
16383,689,8,22,2,2,2,6,Lost
16698,936,27,37,2,4,3,9,At Risk
16921,391,12,31,3,3,2,8,Loyal Users
17259,1168,7,42,2,2,3,7,Lost
17331,33,5,47,5,1,3,9,Promising
17603,33,84,215,5,5,5,15,Champions
17966,3158,13,18,1,3,2,6,Casual Users
18234,1088,13,16,2,3,2,7,Casual Users
18373,4275,6,38,1,1,3,5,Lost
18876,126,8,61,4,2,3,9,Promising
18948,872,5,7,2,1,1,4,Lost
19010,116,12,41,4,3,3,10,Loyal Users
19148,23,121,228,5,5,5,15,Champions
20102,6,179,377,5,5,5,15,Champions
20461,585,12,14,2,3,1,6,Casual Users
20470,1288,5,21,1,1,2,4,Lost
20509,247,25,39,3,4,3,10,Loyal Users
20712,7,11,61,5,2,3,10,Promising
21224,395,12,27,3,3,2,8,Loyal Users
21260,41,102,137,5,5,4,14,Champions
21288,2406,5,25,1,1,2,4,Lost
21580,745,17,29,2,3,2,7,Casual Users
21614,134,35,54,4,4,3,11,Loyal Users
21661,101,50,159,4,5,5,14,Champions
21894,490,18,21,2,3,2,7,Casual Users
22468,78,20,45,4,3,3,10,Loyal Users
22629,38,22,77,5,4,4,13,Champions
23629,44,17,66,5,3,4,12,Loyal Users
23794,852,5,38,2,1,3,6,Lost
24059,4,37,85,5,4,4,13,Champions
24659,23,48,158,5,5,5,15,Champions
25080,397,20,29,3,3,2,8,Loyal Users
25181,722,35,96,2,4,4,10,At Risk
25232,411,30,111,3,4,4,11,Loyal Users
25436,144,26,81,4,4,4,12,Champions
25499,405,13,43,3,3,3,9,Loyal Users
25776,1140,44,137,2,4,4,10,At Risk
25837,128,5,27,4,1,2,7,Promising
25906,80,92,381,4,5,5,14,Champions
26071,59,79,353,5,5,5,15,Champions
26393,1936,7,20,1,2,2,5,Lost
14102,945,9,93,2,2,4,8,Lost
14105,653,13,33,2,3,3,8,Casual Users
14317,1125,6,38,2,1,3,6,Lost
14462,126,37,64,4,4,4,12,Champions
15111,710,74,119,2,5,4,11,At Risk
15188,95,14,25,4,3,2,9,Loyal Users
16048,397,10,13,3,2,1,6,Casual Users
16131,653,8,13,2,2,1,5,Lost
17003,1587,90,276,1,5,5,11,At Risk
17504,5,90,148,5,5,5,15,Champions
17536,140,6,12,4,1,1,6,Promising
17544,8,39,111,5,4,4,13,Champions
17635,130,18,65,4,3,4,11,Loyal Users
17825,1098,5,35,2,1,3,6,Lost
17883,971,8,26,2,2,2,6,Lost
17984,1305,9,65,1,2,4,7,Lost
18050,3718,6,18,1,1,2,4,Lost
18053,103,38,68,4,4,4,12,Champions
18075,271,26,150,3,4,5,12,Loyal Users
18572,838,21,53,2,3,3,8,Casual Users
18798,9,24,59,5,4,3,12,Loyal Users
18805,1122,8,17,2,2,2,6,Lost
18975,5260,44,105,1,4,4,9,At Risk
19207,130,100,676,4,5,5,14,Champions
20129,63,31,297,5,4,5,14,Champions
20155,129,49,116,4,5,4,13,Champions
20313,72,189,420,4,5,5,14,Champions
20902,4816,21,41,1,3,3,7,Casual Users
21141,732,25,42,2,4,3,9,At Risk
21174,6,58,114,5,5,4,14,Champions
21570,12,41,229,5,4,5,14,Champions
21930,387,18,32,3,3,3,9,Loyal Users
22104,12,39,87,5,4,4,13,Champions
22140,79,61,101,4,5,4,13,Champions
22354,163,86,148,4,5,5,14,Champions
22395,3186,10,22,1,2,2,5,Lost
22405,1230,5,5,2,1,1,4,Lost
22454,120,48,76,4,5,4,13,Champions
22640,799,7,9,2,2,1,5,Lost
22953,397,21,29,3,3,2,8,Loyal Users
23113,61,106,256,5,5,5,15,Champions
23302,132,11,17,4,2,2,8,Promising
23378,3915,16,44,1,3,3,7,Casual Users
23589,278,37,127,3,4,4,11,Loyal Users
23729,273,14,24,3,3,2,8,Loyal Users
23801,27,9,22,5,2,2,9,Promising
23861,2,14,59,5,3,3,11,Loyal Users
23871,1956,14,67,1,3,4,8,Casual Users
24072,2578,8,11,1,2,1,4,Lost
24263,365,48,55,3,5,3,11,Loyal Users
24546,425,6,9,3,1,1,5,Casual Users
24676,139,17,23,4,3,2,9,Loyal Users
24853,4650,9,11,1,2,1,4,Lost
25541,2680,10,26,1,2,2,5,Lost
25791,1694,6,41,1,1,3,5,Lost
25810,438,22,64,3,4,4,11,Loyal Users
26348,3505,6,59,1,1,3,5,Lost
26385,97,93,196,4,5,5,14,Champions
13694,4200,23,48,1,4,3,8,At Risk
14036,1115,38,85,2,4,4,10,At Risk
14523,1511,9,14,1,2,1,4,Lost
14575,822,9,42,2,2,3,7,Lost
14587,17,47,215,5,5,5,15,Champions
14830,397,7,23,3,2,2,7,Casual Users
14917,121,145,378,4,5,5,14,Champions
15516,4701,6,9,1,1,1,3,Lost
15667,833,11,16,2,2,2,6,Lost
15696,122,10,11,4,2,1,7,Promising
15974,210,97,136,3,5,4,12,Loyal Users
16076,232,46,101,3,5,4,12,Loyal Users
16242,101,36,168,4,4,5,13,Champions
16253,31,32,37,5,4,3,12,Loyal Users
16491,83,89,316,4,5,5,14,Champions
16515,275,5,17,3,1,2,6,Casual Users
17563,389,20,26,3,3,2,8,Loyal Users
17566,282,29,50,3,4,3,10,Loyal Users
17685,237,7,23,3,2,2,7,Casual Users
18012,757,10,53,2,2,3,7,Lost
18029,452,99,457,3,5,5,13,Loyal Users
18330,59,40,165,5,4,5,14,Champions
18448,0,92,230,5,5,5,15,Champions
18609,847,13,51,2,3,3,8,Casual Users
18816,86,59,159,4,5,5,14,Champions
18864,696,7,12,2,2,1,5,Lost
18954,30,18,52,5,3,3,11,Loyal Users
18988,569,12,28,2,3,2,7,Casual Users
19070,39,179,609,5,5,5,15,Champions
19345,6,114,858,5,5,5,15,Champions
19355,369,16,30,3,3,2,8,Loyal Users
19572,15,131,333,5,5,5,15,Champions
19897,15,79,265,5,5,5,15,Champions
20042,84,63,256,4,5,5,14,Champions
20059,122,19,36,4,3,3,10,Loyal Users
20142,473,14,39,2,3,3,8,Casual Users
20147,244,5,6,3,1,1,5,Casual Users
20342,233,46,79,3,5,4,12,Loyal Users
20379,26,91,185,5,5,5,15,Champions
20434,16,117,279,5,5,5,15,Champions
20578,4,11,18,5,2,2,9,Promising
20790,1072,16,141,2,3,4,9,Casual Users
20839,125,44,97,4,4,4,12,Champions
20840,108,11,68,4,2,4,10,Promising
20992,447,17,90,3,3,4,10,Loyal Users
21262,2383,5,7,1,1,1,3,Lost
21326,3930,5,7,1,1,1,3,Lost
21612,384,14,50,3,3,3,9,Loyal Users
21771,1123,25,153,2,4,5,11,At Risk
22080,857,6,8,2,1,1,4,Lost
22096,157,7,31,4,2,2,8,Promising
22408,1162,6,14,2,1,1,4,Lost
22864,170,22,49,3,4,3,10,Loyal Users
22882,1161,22,45,2,4,3,9,At Risk
23351,132,8,16,4,2,2,8,Promising
24448,297,73,292,3,5,5,13,Loyal Users
24479,101,37,95,4,4,4,12,Champions
24841,635,8,10,2,2,1,5,Lost
24889,91,81,160,4,5,5,14,Champions
24900,299,11,49,3,2,3,8,Casual Users
24962,442,26,110,3,4,4,11,Loyal Users
24993,21,109,356,5,5,5,15,Champions
25179,186,24,97,3,4,4,11,Loyal Users
25309,1828,6,24,1,1,2,4,Lost
25576,2,157,302,5,5,5,15,Champions
25835,694,11,46,2,2,3,7,Lost
26159,131,17,32,4,3,3,10,Loyal Users
26217,697,6,19,2,1,2,5,Lost
26226,3,17,32,5,3,3,11,Loyal Users
26355,42,46,148,5,5,5,15,Champions
13766,827,31,79,2,4,4,10,At Risk
13958,154,15,105,4,3,4,11,Loyal Users
14669,285,17,59,3,3,3,9,Loyal Users
14831,237,19,26,3,3,2,8,Loyal Users
15152,84,85,203,4,5,5,14,Champions
15228,3142,10,14,1,2,1,4,Lost
15386,407,26,42,3,4,3,10,Loyal Users
15593,107,79,555,4,5,5,14,Champions
15614,445,12,30,3,3,2,8,Loyal Users
15815,133,14,26,4,3,2,9,Loyal Users
15849,426,7,19,3,2,2,7,Casual Users
16201,1478,6,14,1,1,1,3,Lost
16230,277,20,46,3,3,3,9,Loyal Users
16316,2986,6,8,1,1,1,3,Lost
16401,218,20,56,3,3,3,9,Loyal Users
16693,473,24,162,2,4,5,11,At Risk
16769,106,16,52,4,3,3,10,Loyal Users
16948,1812,62,150,1,5,5,11,At Risk
17285,51,9,42,5,2,3,10,Promising
17386,61,69,141,5,5,4,14,Champions
17400,15,19,66,5,3,4,12,Loyal Users
17486,4,53,242,5,5,5,15,Champions
17503,5,8,12,5,2,1,8,Promising
17706,448,9,9,3,2,1,6,Casual Users
17869,5554,6,65,1,1,4,6,Lost
17916,1678,5,6,1,1,1,3,Lost
18036,39,23,40,5,4,3,12,Loyal Users
18166,788,9,45,2,2,3,7,Lost
18331,5,23,43,5,4,3,12,Loyal Users
18540,4550,5,25,1,1,2,4,Lost
18684,500,7,12,2,2,1,5,Lost
18806,44,133,462,5,5,5,15,Champions
19211,977,204,611,2,5,5,12,At Risk
19925,4870,14,14,1,3,1,5,Casual Users
19944,3720,7,22,1,2,2,5,Lost
19969,1757,6,18,1,1,2,4,Lost
20066,58,28,61,5,4,3,12,Loyal Users
20106,239,40,168,3,4,5,12,Loyal Users
20663,448,9,12,3,2,1,6,Casual Users
20774,1,133,848,5,5,5,15,Champions
20821,107,49,311,4,5,5,14,Champions
20842,272,60,240,3,5,5,13,Loyal Users
20854,3111,6,57,1,1,3,5,Lost
21363,614,10,23,2,2,2,6,Lost
21387,135,25,45,4,4,3,11,Loyal Users
21584,157,90,458,4,5,5,14,Champions
21726,982,7,11,2,2,1,5,Lost
22152,282,19,30,3,3,2,8,Loyal Users
22477,0,107,236,5,5,5,15,Champions
22519,399,12,22,3,3,2,8,Loyal Users
22628,531,15,72,2,3,4,9,Casual Users
23099,2673,7,20,1,2,2,5,Lost
23154,1080,14,31,2,3,2,7,Casual Users
23499,297,10,23,3,2,2,7,Casual Users
23564,1564,31,38,1,4,3,8,At Risk
23596,77,76,317,4,5,5,14,Champions
23699,709,31,74,2,4,4,10,At Risk
23854,311,12,25,3,3,2,8,Loyal Users
23866,105,14,150,4,3,5,12,Loyal Users
23952,41,75,170,5,5,5,15,Champions
24053,91,29,41,4,4,3,11,Loyal Users
24127,432,5,5,3,1,1,5,Casual Users
24137,151,54,370,4,5,5,14,Champions
24197,827,5,6,2,1,1,4,Lost
24231,70,87,233,4,5,5,14,Champions
24419,1448,78,138,1,5,4,10,At Risk
24523,583,24,74,2,4,4,10,At Risk
24818,459,20,32,3,3,3,9,Loyal Users
25308,512,31,80,2,4,4,10,At Risk
25356,5532,10,10,1,2,1,4,Lost
25508,387,11,19,3,2,2,7,Casual Users
25532,390,13,22,3,3,2,8,Loyal Users
25624,1421,16,41,1,3,3,7,Casual Users
26187,4406,5,9,1,1,1,3,Lost
13781,88,51,119,4,5,4,13,Champions
14041,37,8,9,5,2,1,8,Promising
14151,183,16,18,3,3,2,8,Loyal Users
14370,110,34,69,4,4,4,12,Champions
14598,3989,7,14,1,2,1,4,Lost
14860,1389,28,59,1,4,3,8,At Risk
15357,407,6,12,3,1,1,5,Casual Users
15401,396,30,81,3,4,4,11,Loyal Users
15540,2503,5,21,1,1,2,4,Lost
15856,72,11,18,4,2,2,8,Promising
15940,30,102,332,5,5,5,15,Champions
16057,269,18,77,3,3,4,10,Loyal Users
16159,1808,5,22,1,1,2,4,Lost
16469,88,32,59,4,4,3,11,Loyal Users
16475,126,32,75,4,4,4,12,Champions
16483,31,52,209,5,5,5,15,Champions
16682,1001,37,76,2,4,4,10,At Risk
16984,845,12,26,2,3,2,7,Casual Users
17974,2963,9,14,1,2,1,4,Lost
18062,30,14,76,5,3,4,12,Loyal Users
18332,689,18,54,2,3,3,8,Casual Users
18883,153,12,30,4,3,2,9,Loyal Users
18896,421,20,35,3,3,3,9,Loyal Users
19002,106,78,568,4,5,5,14,Champions
19100,208,46,224,3,5,5,13,Loyal Users
19136,23,76,160,5,5,5,15,Champions
19188,1361,6,26,1,1,2,4,Lost
19212,575,19,100,2,3,4,9,Casual Users
19404,12,14,130,5,3,4,12,Loyal Users
19815,2739,7,12,1,2,1,4,Lost
20041,11,30,93,5,4,4,13,Champions
20377,1820,6,23,1,1,2,4,Lost
21122,429,14,25,3,3,2,8,Loyal Users
21246,245,32,80,3,4,4,11,Loyal Users
21314,4412,10,43,1,2,3,6,Lost
21430,1131,6,6,2,1,1,4,Lost
21855,698,10,10,2,2,1,5,Lost
21988,20,153,371,5,5,5,15,Champions
22189,90,12,12,4,3,1,8,Loyal Users
22229,3052,5,12,1,1,1,3,Lost
22260,23,39,82,5,4,4,13,Champions
22595,903,7,9,2,2,1,5,Lost
22887,258,8,12,3,2,1,6,Casual Users
23365,2086,6,20,1,1,2,4,Lost
23780,8,6,12,5,1,1,7,Promising
23798,183,26,46,3,4,3,10,Loyal Users
24033,1417,8,22,1,2,2,5,Lost
24115,1687,10,22,1,2,2,5,Lost
24311,121,31,177,4,4,5,13,Champions
24374,150,97,413,4,5,5,14,Champions
24655,573,20,39,2,3,3,8,Casual Users
24699,929,8,13,2,2,1,5,Lost
25005,707,41,63,2,4,4,10,At Risk
25051,40,15,68,5,3,4,12,Loyal Users
25075,374,48,90,3,5,4,12,Loyal Users
25094,4222,24,42,1,4,3,8,At Risk
25325,83,19,30,4,3,2,9,Loyal Users
25484,1146,9,19,2,2,2,6,Lost
25606,825,29,209,2,4,5,11,At Risk
25671,600,29,37,2,4,3,9,At Risk
25833,64,45,101,5,4,4,13,Champions
25871,98,92,268,4,5,5,14,Champions
14351,1111,9,12,2,2,1,5,Lost
14513,112,33,47,4,4,3,11,Loyal Users
14531,2,19,83,5,3,4,12,Loyal Users
14824,744,7,7,2,2,1,5,Lost
14904,67,60,306,5,5,5,15,Champions
14945,30,13,88,5,3,4,12,Loyal Users
15053,107,72,440,4,5,5,14,Champions
15085,161,30,75,4,4,4,12,Champions
15438,72,33,235,4,4,5,13,Champions
15543,1013,9,16,2,2,2,6,Lost
15570,272,15,45,3,3,3,9,Loyal Users
15922,40,16,102,5,3,4,12,Loyal Users
15950,156,9,13,4,2,1,7,Promising
16148,398,13,13,3,3,1,7,Loyal Users
16394,6,14,31,5,3,2,10,Loyal Users
16580,7,11,33,5,2,3,10,Promising
16695,144,30,217,4,4,5,13,Champions
17204,2165,12,71,1,3,4,8,Casual Users
17547,536,23,243,2,4,5,11,At Risk
18028,82,29,59,4,4,3,11,Loyal Users
18129,275,56,180,3,5,5,13,Loyal Users
18371,407,5,9,3,1,1,5,Casual Users
18418,1555,6,10,1,1,1,3,Lost
18724,1516,10,21,1,2,2,5,Lost
18779,1260,5,7,1,1,1,3,Lost
19172,1,8,13,5,2,1,8,Promising
19202,1038,5,33,2,1,3,6,Lost
19276,1552,17,24,1,3,2,6,Casual Users
19359,2405,8,31,1,2,2,5,Lost
19569,452,14,18,3,3,2,8,Loyal Users
19575,455,25,239,3,4,5,12,Loyal Users
19589,1405,7,13,1,2,1,4,Lost
19819,15,14,29,5,3,2,10,Loyal Users
19929,8,41,96,5,4,4,13,Champions
20613,327,9,12,3,2,1,6,Casual Users
20798,156,12,45,4,3,3,10,Loyal Users
20808,1704,5,10,1,1,1,3,Lost
20827,577,20,55,2,3,3,8,Casual Users
20875,3662,15,24,1,3,2,6,Casual Users
20904,279,20,45,3,3,3,9,Loyal Users
21319,174,11,29,3,2,2,7,Casual Users
21417,1005,16,25,2,3,2,7,Casual Users
21723,36,77,486,5,5,5,15,Champions
21754,1295,13,14,1,3,1,5,Casual Users
21788,94,42,129,4,4,4,12,Champions
21979,58,20,43,5,3,3,11,Loyal Users
22392,1450,13,40,1,3,3,7,Casual Users
22461,106,32,240,4,4,5,13,Champions
22624,116,33,266,4,4,5,13,Champions
22656,80,15,44,4,3,3,10,Loyal Users
22751,45,9,30,5,2,2,9,Promising
22752,171,100,671,3,5,5,13,Loyal Users
22854,153,38,64,4,4,4,12,Champions
22978,21,129,551,5,5,5,15,Champions
23229,64,9,12,5,2,1,8,Promising
23234,105,51,69,4,5,4,13,Champions
23390,5,109,581,5,5,5,15,Champions
23395,2395,6,14,1,1,1,3,Lost
23423,126,16,54,4,3,3,10,Loyal Users
23514,25,42,106,5,4,4,13,Champions
23662,327,10,14,3,2,1,6,Casual Users
23664,480,22,35,2,4,3,9,At Risk
24822,867,12,35,2,3,3,8,Casual Users
24915,104,68,311,4,5,5,14,Champions
25117,397,8,8,3,2,1,6,Casual Users
25261,945,5,8,2,1,1,4,Lost
25374,444,32,138,3,4,4,11,Loyal Users
25440,3,48,95,5,5,4,14,Champions
26333,93,18,144,4,3,4,11,Loyal Users
26401,91,12,43,4,3,3,10,Loyal Users
14032,2121,5,27,1,1,2,4,Lost
14327,77,89,403,4,5,5,14,Champions
14364,410,7,10,3,2,1,6,Casual Users
14588,394,28,75,3,4,4,11,Loyal Users
14606,113,47,136,4,5,4,13,Champions
14608,2842,134,252,1,5,5,11,At Risk
14977,416,24,73,3,4,4,11,Loyal Users
15305,48,41,187,5,4,5,14,Champions
15359,197,12,53,3,3,3,9,Loyal Users
15991,846,20,32,2,3,3,8,Casual Users
16073,4,34,88,5,4,4,13,Champions
16348,116,67,517,4,5,5,14,Champions
16470,993,21,56,2,3,3,8,Casual Users
16609,337,8,15,3,2,1,6,Casual Users
17692,1604,5,46,1,1,3,5,Lost
17715,1087,8,10,2,2,1,5,Lost
17720,221,20,97,3,3,4,10,Loyal Users
17852,1181,54,184,2,5,5,12,At Risk
18169,33,53,276,5,5,5,15,Champions
18238,106,40,73,4,4,4,12,Champions
18478,282,12,150,3,3,5,11,Loyal Users
18509,302,9,20,3,2,2,7,Casual Users
18862,86,126,289,4,5,5,14,Champions
19000,225,13,20,3,3,2,8,Loyal Users
19255,394,51,242,3,5,5,13,Loyal Users
19486,570,5,7,2,1,1,4,Lost
19794,460,12,71,3,3,4,10,Loyal Users
19840,57,28,37,5,4,3,12,Loyal Users
19848,399,8,14,3,2,1,6,Casual Users
19995,330,8,24,3,2,2,7,Casual Users
20234,846,18,42,2,3,3,8,Casual Users
20347,281,9,23,3,2,2,7,Casual Users
20475,25,68,379,5,5,5,15,Champions
20836,4099,6,19,1,1,2,4,Lost
20930,148,27,109,4,4,4,12,Champions
21019,717,6,20,2,1,2,5,Lost
21022,736,19,26,2,3,2,7,Casual Users
21223,1074,7,22,2,2,2,6,Lost
21456,2713,7,12,1,2,1,4,Lost
21643,544,13,37,2,3,3,8,Casual Users
21680,162,19,33,4,3,3,10,Loyal Users
21691,109,30,128,4,4,4,12,Champions
21923,1927,10,17,1,2,2,5,Lost
22164,2737,13,46,1,3,3,7,Casual Users
22350,96,67,667,4,5,5,14,Champions
22498,261,134,346,3,5,5,13,Loyal Users
22621,117,33,333,4,4,5,13,Champions
23103,3944,8,23,1,2,2,5,Lost
23222,675,23,38,2,4,3,9,At Risk
23425,829,8,34,2,2,3,7,Lost
23517,1160,9,11,2,2,1,5,Lost
23819,76,42,132,4,4,4,12,Champions
24209,1204,15,31,2,3,2,7,Casual Users
24326,935,14,29,2,3,2,7,Casual Users
24376,748,28,95,2,4,4,10,At Risk
24474,655,30,50,2,4,3,9,At Risk
24521,1944,7,14,1,2,1,4,Lost
24569,253,6,24,3,1,2,6,Casual Users
24573,2418,14,72,1,3,4,8,Casual Users
24688,86,34,255,4,4,5,13,Champions
25375,59,11,27,5,2,2,9,Promising
25420,117,36,164,4,4,5,13,Champions
25472,13,31,40,5,4,3,12,Loyal Users
25557,742,6,22,2,1,2,5,Lost
25754,5582,10,19,1,2,2,5,Lost
25763,408,19,53,3,3,3,9,Loyal Users
25874,1670,24,51,1,4,3,8,At Risk
25944,1151,27,96,2,4,4,10,At Risk
26343,747,24,34,2,4,3,9,At Risk
13975,3550,9,11,1,2,1,4,Lost
13988,63,12,28,5,3,2,10,Loyal Users
14422,2053,6,6,1,1,1,3,Lost
14507,74,61,188,4,5,5,14,Champions
14870,4,55,117,5,5,4,14,Champions
15029,1666,5,18,1,1,2,4,Lost
15364,72,53,204,4,5,5,14,Champions
15452,588,12,24,2,3,2,7,Casual Users
15474,166,37,165,3,4,5,12,Loyal Users
15742,2418,11,15,1,2,1,4,Lost
15784,119,85,106,4,5,4,13,Champions
15835,2286,7,24,1,2,2,5,Lost
15925,98,25,40,4,4,3,11,Loyal Users
16145,577,6,30,2,1,2,5,Lost
16323,173,5,13,3,1,1,5,Casual Users
16473,112,27,61,4,4,3,11,Loyal Users
16561,110,12,37,4,3,3,10,Loyal Users
17019,26,61,149,5,5,5,15,Champions
17094,12,16,41,5,3,3,11,Loyal Users
17466,122,71,224,4,5,5,14,Champions
17585,56,134,532,5,5,5,15,Champions
17730,2618,7,8,1,2,1,4,Lost
18020,108,79,103,4,5,4,13,Champions
18191,50,86,152,5,5,5,15,Champions
18732,306,7,7,3,2,1,6,Casual Users
18768,368,20,204,3,3,5,11,Loyal Users
19091,473,11,38,2,2,3,7,Lost
19297,280,17,143,3,3,4,10,Loyal Users
20033,568,11,19,2,2,2,6,Lost
20210,140,41,97,4,4,4,12,Champions
20255,805,8,18,2,2,2,6,Lost
20349,845,5,22,2,1,2,5,Lost
20628,272,13,86,3,3,4,10,Loyal Users
20702,297,6,10,3,1,1,5,Casual Users
20828,422,5,7,3,1,1,5,Casual Users
21047,4641,5,9,1,1,1,3,Lost
21086,2560,7,8,1,2,1,4,Lost
21385,16,116,558,5,5,5,15,Champions
21452,535,6,10,2,1,1,4,Lost
21519,288,57,112,3,5,4,12,Loyal Users
21585,526,6,31,2,1,2,5,Lost
21944,1132,45,230,2,4,5,11,At Risk
22023,827,8,56,2,2,3,7,Lost
22438,412,8,13,3,2,1,6,Casual Users
22690,10,100,646,5,5,5,15,Champions
23059,2833,5,5,1,1,1,3,Lost
23252,992,13,17,2,3,2,7,Casual Users
23450,703,58,132,2,5,4,11,At Risk
23765,146,42,78,4,4,4,12,Champions
23924,4098,16,19,1,3,2,6,Casual Users
23973,109,16,65,4,3,4,11,Loyal Users
24198,937,10,10,2,2,1,5,Lost
24436,44,13,94,5,3,4,12,Loyal Users
24466,5578,6,6,1,1,1,3,Lost
24471,1405,14,21,1,3,2,6,Casual Users
24679,566,7,13,2,2,1,5,Lost
24724,2849,8,14,1,2,1,4,Lost
24866,405,9,14,3,2,1,6,Casual Users
24943,487,13,123,2,3,4,9,Casual Users
25326,2239,14,88,1,3,4,8,Casual Users
25496,11,148,392,5,5,5,15,Champions
25533,983,5,8,2,1,1,4,Lost
25565,1138,7,28,2,2,2,6,Lost
25590,219,37,74,3,4,4,11,Loyal Users
25918,569,20,52,2,3,3,8,Casual Users
26032,399,9,12,3,2,1,6,Casual Users
13965,72,25,63,4,4,4,12,Champions
14035,184,173,524,3,5,5,13,Loyal Users
14051,11,83,286,5,5,5,15,Champions
14112,641,25,92,2,4,4,10,At Risk
14328,564,27,100,2,4,4,10,At Risk
14415,303,10,18,3,2,2,7,Casual Users
14775,4,105,213,5,5,5,15,Champions
15283,657,27,70,2,4,4,10,At Risk
15532,466,18,91,3,3,4,10,Loyal Users
15882,129,26,88,4,4,4,12,Champions
16467,246,7,10,3,2,1,6,Casual Users
16775,75,62,100,4,5,4,13,Champions
16928,1810,78,102,1,5,4,10,At Risk
17176,22,18,22,5,3,2,10,Loyal Users
17242,118,69,351,4,5,5,14,Champions
17444,255,23,78,3,4,4,11,Loyal Users
17785,303,19,40,3,3,3,9,Loyal Users
17805,376,28,42,3,4,3,10,Loyal Users
17819,545,17,37,2,3,3,8,Casual Users
17871,4250,5,7,1,1,1,3,Lost
17918,1318,6,6,1,1,1,3,Lost
18060,273,16,26,3,3,2,8,Loyal Users
18102,134,34,57,4,4,3,11,Loyal Users
18153,18,182,344,5,5,5,15,Champions
18252,2465,18,26,1,3,2,6,Casual Users
18971,694,9,11,2,2,1,5,Lost
19016,8,146,444,5,5,5,15,Champions
19872,397,25,143,3,4,4,11,Loyal Users
20422,2483,24,51,1,4,3,8,At Risk
20438,6,77,398,5,5,5,15,Champions
20921,4,30,65,5,4,4,13,Champions
21299,120,80,150,4,5,5,14,Champions
21829,274,11,20,3,2,2,7,Casual Users
21883,9,12,18,5,3,2,10,Loyal Users
22111,32,9,14,5,2,1,8,Promising
22150,103,55,138,4,5,4,13,Champions
22495,16,142,623,5,5,5,15,Champions
22863,62,18,102,5,3,4,12,Loyal Users
23310,2480,8,25,1,2,2,5,Lost
23311,463,7,12,3,2,1,6,Casual Users
23472,326,22,159,3,4,5,12,Loyal Users
24152,1232,25,49,2,4,3,9,At Risk
24225,2085,10,32,1,2,3,6,Lost
24540,6,99,216,5,5,5,15,Champions
24786,292,6,13,3,1,1,5,Casual Users
24883,156,46,159,4,5,5,14,Champions
24898,2364,20,21,1,3,2,6,Casual Users
24952,6136,16,16,1,3,2,6,Casual Users
25058,2013,6,8,1,1,1,3,Lost
25239,26,11,25,5,2,2,9,Promising
25453,708,26,130,2,4,4,10,At Risk
25535,32,53,94,5,5,4,14,Champions
25773,3602,14,23,1,3,2,6,Casual Users
25847,851,37,128,2,4,4,10,At Risk
26281,251,14,37,3,3,3,9,Loyal Users
13746,136,22,121,4,4,4,12,Champions
14013,106,14,110,4,3,4,11,Loyal Users
14139,2314,10,15,1,2,1,4,Lost
14436,326,27,44,3,4,3,10,Loyal Users
14453,515,5,21,2,1,2,5,Lost
14474,217,27,34,3,4,3,10,Loyal Users
15163,405,9,15,3,2,1,6,Casual Users
15206,3591,6,9,1,1,1,3,Lost
15330,178,9,32,3,2,3,8,Casual Users
15638,3638,5,5,1,1,1,3,Lost
15689,323,13,69,3,3,4,10,Loyal Users
15700,138,9,13,4,2,1,7,Promising
15792,993,5,6,2,1,1,4,Lost
15829,240,16,101,3,3,4,10,Loyal Users
16155,7,84,179,5,5,5,15,Champions
16191,590,39,64,2,4,4,10,At Risk
16204,86,105,210,4,5,5,14,Champions
16292,95,44,63,4,4,4,12,Champions
16637,940,15,101,2,3,4,9,Casual Users
16657,1856,23,115,1,4,4,9,At Risk
16688,1080,32,100,2,4,4,10,At Risk
16732,81,135,449,4,5,5,14,Champions
16917,22,66,336,5,5,5,15,Champions
16934,517,15,76,2,3,4,9,Casual Users
16952,128,30,213,4,4,5,13,Champions
17018,437,8,13,3,2,1,6,Casual Users
17447,709,26,40,2,4,3,9,At Risk
17817,222,9,20,3,2,2,7,Casual Users
17915,1,121,220,5,5,5,15,Champions
17946,3078,5,10,1,1,1,3,Lost
18303,360,7,8,3,2,1,6,Casual Users
18430,0,44,283,5,4,5,14,Champions
19088,1412,9,37,1,2,3,6,Lost
19171,1296,5,15,1,1,1,3,Lost
19828,520,8,23,2,2,2,6,Lost
19866,545,21,43,2,3,3,8,Casual Users
19988,418,8,8,3,2,1,6,Casual Users
20478,103,24,95,4,4,4,12,Champions
20498,407,38,195,3,4,5,12,Loyal Users
20574,1412,5,5,1,1,1,3,Lost
20724,275,12,54,3,3,3,9,Loyal Users
20900,501,31,114,2,4,4,10,At Risk
21268,154,5,54,4,1,3,8,Promising
21312,2394,8,26,1,2,2,5,Lost
21564,446,13,26,3,3,2,8,Loyal Users
21984,5,97,332,5,5,5,15,Champions
22018,161,51,112,4,5,4,13,Champions
22034,174,9,20,3,2,2,7,Casual Users
22228,38,86,176,5,5,5,15,Champions
22736,130,32,112,4,4,4,12,Champions
23246,906,39,58,2,4,3,9,At Risk
23308,563,13,201,2,3,5,10,Casual Users
23831,619,7,54,2,2,3,7,Lost
23851,146,34,90,4,4,4,12,Champions
24227,736,10,40,2,2,3,7,Lost
24268,235,24,54,3,4,3,10,Loyal Users
24395,273,60,88,3,5,4,12,Loyal Users
24542,2137,9,16,1,2,2,5,Lost
24596,605,19,53,2,3,3,8,Casual Users
24645,102,20,127,4,3,4,11,Loyal Users
24704,130,51,515,4,5,5,14,Champions
24706,2651,32,38,1,4,3,8,At Risk
24814,139,114,209,4,5,5,14,Champions
25193,653,7,10,2,2,1,5,Lost
25218,85,12,68,4,3,4,11,Loyal Users
25288,527,21,29,2,3,2,7,Casual Users
25377,62,114,338,5,5,5,15,Champions
25596,413,18,59,3,3,3,9,Loyal Users
25969,163,20,45,4,3,3,10,Loyal Users
13734,103,10,34,4,2,3,9,Promising
13921,796,15,41,2,3,3,8,Casual Users
13983,429,6,6,3,1,1,5,Casual Users
14197,389,39,78,3,4,4,11,Loyal Users
14564,2740,20,43,1,3,3,7,Casual Users
14774,251,77,93,3,5,4,12,Loyal Users
15046,90,7,8,4,2,1,7,Promising
15061,2673,5,26,1,1,2,4,Lost
15097,3713,12,24,1,3,2,6,Casual Users
15549,582,9,28,2,2,2,6,Lost
15958,1308,11,42,1,2,3,6,Lost
16285,72,22,180,4,4,5,13,Champions
16476,46,8,14,5,2,1,8,Promising
16516,370,5,6,3,1,1,5,Casual Users
16543,227,19,46,3,3,3,9,Loyal Users
16853,698,11,24,2,2,2,6,Lost
17098,1,118,362,5,5,5,15,Champions
17101,152,8,13,4,2,1,7,Promising
17296,708,12,47,2,3,3,8,Casual Users
17861,597,5,10,2,1,1,4,Lost
18259,117,104,359,4,5,5,14,Champions
18365,103,5,9,4,1,1,6,Promising
18445,100,22,45,4,4,3,11,Loyal Users
19103,2287,21,44,1,3,3,7,Casual Users
19118,3496,7,10,1,2,1,4,Lost
19162,254,11,66,3,2,4,9,Casual Users
19197,1015,6,21,2,1,2,5,Lost
19507,799,11,27,2,2,2,6,Lost
20122,55,92,311,5,5,5,15,Champions
20344,64,110,191,5,5,5,15,Champions
20453,11,14,35,5,3,3,11,Loyal Users
20555,411,8,9,3,2,1,6,Casual Users
20644,13,18,21,5,3,2,10,Loyal Users
20700,65,49,203,5,5,5,15,Champions
21187,1024,8,10,2,2,1,5,Lost
21364,413,5,8,3,1,1,5,Casual Users
21732,117,91,210,4,5,5,14,Champions
21942,157,42,81,4,4,4,12,Champions
22077,334,18,139,3,3,4,10,Loyal Users
22244,21,93,663,5,5,5,15,Champions
22311,414,30,111,3,4,4,11,Loyal Users
22317,136,21,40,4,3,3,10,Loyal Users
22323,709,13,39,2,3,3,8,Casual Users
22581,314,14,25,3,3,2,8,Loyal Users
22592,527,9,34,2,2,3,7,Lost
22659,676,10,42,2,2,3,7,Lost
22817,101,7,53,4,2,3,9,Promising
23398,6,72,180,5,5,5,15,Champions
23551,329,26,57,3,4,3,10,Loyal Users
24084,75,54,101,4,5,4,13,Champions
24106,2303,5,12,1,1,1,3,Lost
24189,668,7,46,2,2,3,7,Lost
24681,14,74,432,5,5,5,15,Champions
25141,1565,5,5,1,1,1,3,Lost
25176,1665,11,38,1,2,3,6,Lost
25331,1643,5,36,1,1,3,5,Lost
25388,10,8,17,5,2,2,9,Promising
25735,1298,11,16,1,2,2,5,Lost
25780,1424,6,7,1,1,1,3,Lost
25807,72,84,216,4,5,5,14,Champions
25914,265,106,220,3,5,5,13,Loyal Users
13879,4582,7,46,1,2,3,6,Lost
13895,17,26,36,5,4,3,12,Loyal Users
13993,552,14,50,2,3,3,8,Casual Users
14088,262,16,73,3,3,4,10,Loyal Users
14230,27,77,688,5,5,5,15,Champions
14534,45,83,324,5,5,5,15,Champions
14538,49,166,362,5,5,5,15,Champions
14730,547,6,8,2,1,1,4,Lost
14828,502,5,7,2,1,1,4,Lost
14975,572,12,18,2,3,2,7,Casual Users
15013,40,54,106,5,5,4,14,Champions
15014,774,6,12,2,1,1,4,Lost
15388,152,6,14,4,1,1,6,Promising
15518,107,22,120,4,4,4,12,Champions
15719,229,32,40,3,4,3,10,Loyal Users
15894,4086,7,23,1,2,2,5,Lost
15942,415,12,20,3,3,2,8,Loyal Users
16055,61,7,26,5,2,2,9,Promising
16168,114,82,383,4,5,5,14,Champions
16389,1733,7,14,1,2,1,4,Lost
17119,1610,6,11,1,1,1,3,Lost
17187,416,24,30,3,4,2,9,Loyal Users
17295,3481,19,46,1,3,3,7,Casual Users
17619,448,5,5,3,1,1,5,Casual Users
18059,5,5,17,5,1,2,8,Promising
18100,3461,5,10,1,1,1,3,Lost
18162,1776,12,66,1,3,4,8,Casual Users
18173,11,22,72,5,4,4,13,Champions
18425,260,24,99,3,4,4,11,Loyal Users
18483,4,56,322,5,5,5,15,Champions
18564,30,129,411,5,5,5,15,Champions
18920,235,62,169,3,5,5,13,Loyal Users
19015,1128,15,46,2,3,3,8,Casual Users
19496,137,13,44,4,3,3,10,Loyal Users
19497,1274,7,27,1,2,2,5,Lost
19515,122,8,10,4,2,1,7,Promising
19643,1835,5,7,1,1,1,3,Lost
19702,859,14,36,2,3,3,8,Casual Users
20087,6,149,457,5,5,5,15,Champions
20116,99,39,127,4,4,4,12,Champions
20338,57,81,275,5,5,5,15,Champions
20897,0,7,22,5,2,2,9,Promising
21283,3410,6,17,1,1,2,4,Lost
21420,3895,5,8,1,1,1,3,Lost
21505,4,128,222,5,5,5,15,Champions
21669,122,68,272,4,5,5,14,Champions
21706,8,71,162,5,5,5,15,Champions
21861,79,12,21,4,3,2,9,Loyal Users
22397,1718,13,23,1,3,2,6,Casual Users
22467,427,6,13,3,1,1,5,Casual Users
22565,514,19,82,2,3,4,9,Casual Users
22755,101,74,418,4,5,5,14,Champions
22995,1030,7,7,2,2,1,5,Lost
23078,94,14,73,4,3,4,11,Loyal Users
23162,78,26,114,4,4,4,12,Champions
23556,675,12,18,2,3,2,7,Casual Users
23756,74,213,984,4,5,5,14,Champions
23932,436,55,112,3,5,4,12,Loyal Users
24093,2613,5,11,1,1,1,3,Lost
24823,100,98,164,4,5,5,14,Champions
25246,168,100,145,3,5,4,12,Loyal Users
25593,926,8,42,2,2,3,7,Lost
25631,23,23,43,5,4,3,12,Loyal Users
25767,816,20,62,2,3,3,8,Casual Users
25839,149,7,38,4,2,3,9,Promising
25883,36,16,21,5,3,2,10,Loyal Users
25933,2875,20,45,1,3,3,7,Casual Users
26084,4974,6,14,1,1,1,3,Lost
26085,85,29,42,4,4,3,11,Loyal Users
26093,32,20,76,5,3,4,12,Loyal Users
26315,83,9,29,4,2,2,8,Promising
13661,704,14,55,2,3,3,8,Casual Users
14040,23,38,183,5,4,5,14,Champions
14154,424,5,6,3,1,1,5,Casual Users
14210,1272,15,20,1,3,2,6,Casual Users
14257,125,10,56,4,2,3,9,Promising
14656,145,18,117,4,3,4,11,Loyal Users
14743,307,12,43,3,3,3,9,Loyal Users
14833,242,6,17,3,1,2,6,Casual Users
15034,99,63,125,4,5,4,13,Champions
15159,1886,27,32,1,4,3,8,At Risk
15199,2605,5,9,1,1,1,3,Lost
15252,0,67,219,5,5,5,15,Champions
15865,415,18,98,3,3,4,10,Loyal Users
16024,332,8,19,3,2,2,7,Casual Users
16419,580,9,10,2,2,1,5,Lost
16882,623,11,23,2,2,2,6,Lost
17033,1206,24,77,2,4,4,10,At Risk
17350,255,61,246,3,5,5,13,Loyal Users
17519,104,12,22,4,3,2,9,Loyal Users
17739,3138,10,14,1,2,1,4,Lost
17885,94,12,24,4,3,2,9,Loyal Users
17886,1105,6,13,2,1,1,4,Lost
18068,10,18,29,5,3,2,10,Loyal Users
18084,15,117,262,5,5,5,15,Champions
18145,2427,56,98,1,5,4,10,At Risk
18399,2124,12,27,1,3,2,6,Casual Users
19459,2302,6,14,1,1,1,3,Lost
19468,634,14,18,2,3,2,7,Casual Users
19666,1837,10,17,1,2,2,5,Lost
20014,2710,8,16,1,2,2,5,Lost
20511,1206,26,95,2,4,4,10,At Risk
20658,82,12,23,4,3,2,9,Loyal Users
20891,124,6,17,4,1,2,7,Promising
21145,117,11,53,4,2,3,9,Promising
21161,2083,17,85,1,3,4,8,Casual Users
21165,1667,7,11,1,2,1,4,Lost
21261,1146,9,29,2,2,2,6,Lost
21313,230,20,38,3,3,3,9,Loyal Users
21425,2090,12,20,1,3,2,6,Casual Users
21475,1296,6,10,1,1,1,3,Lost
21555,2431,10,19,1,2,2,5,Lost
21695,108,37,341,4,4,5,13,Champions
21712,4261,11,19,1,2,2,5,Lost
21739,133,58,243,4,5,5,14,Champions
22058,71,25,106,4,4,4,12,Champions
22089,1304,10,25,1,2,2,5,Lost
22218,183,30,49,3,4,3,10,Loyal Users
22241,9,224,480,5,5,5,15,Champions
22430,337,27,41,3,4,3,10,Loyal Users
22580,430,44,163,3,4,5,12,Loyal Users
22653,166,31,119,3,4,4,11,Loyal Users
22692,653,5,6,2,1,1,4,Lost
22756,134,20,32,4,3,3,10,Loyal Users
22994,2531,16,45,1,3,3,7,Casual Users
23063,407,47,137,3,5,4,12,Loyal Users
23217,149,8,26,4,2,2,8,Promising
23250,1824,5,7,1,1,1,3,Lost
23433,592,5,8,2,1,1,4,Lost
23443,116,24,70,4,4,4,12,Champions
23476,124,12,44,4,3,3,10,Loyal Users
23505,300,29,185,3,4,5,12,Loyal Users
23545,125,17,63,4,3,4,11,Loyal Users
23882,846,18,40,2,3,3,8,Casual Users
23931,7,25,50,5,4,3,12,Loyal Users
24276,2535,5,7,1,1,1,3,Lost
24426,531,12,25,2,3,2,7,Casual Users
24430,1319,30,47,1,4,3,8,At Risk
24623,5144,7,11,1,2,1,4,Lost
24763,1540,10,11,1,2,1,4,Lost
24806,2702,21,79,1,3,4,8,Casual Users
25125,124,6,12,4,1,1,6,Promising
25127,2653,6,9,1,1,1,3,Lost
25286,2075,9,12,1,2,1,4,Lost
25741,24,52,137,5,5,4,14,Champions
25943,830,5,15,2,1,1,4,Lost
26230,8,63,251,5,5,5,15,Champions
26319,312,8,8,3,2,1,6,Casual Users
26451,1578,5,8,1,1,1,3,Lost
13829,376,19,87,3,3,4,10,Loyal Users
14077,845,47,96,2,5,4,11,At Risk
14089,0,13,78,5,3,4,12,Loyal Users
14291,271,40,63,3,4,4,11,Loyal Users
14407,1034,20,86,2,3,4,9,Casual Users
14638,3615,17,20,1,3,2,6,Casual Users
14861,125,38,78,4,4,4,12,Champions
14862,90,5,7,4,1,1,6,Promising
15333,145,71,84,4,5,4,13,Champions
15347,8,132,272,5,5,5,15,Champions
15508,313,13,57,3,3,3,9,Loyal Users
15702,678,86,217,2,5,5,12,At Risk
16038,6,84,191,5,5,5,15,Champions
16459,788,5,24,2,1,2,5,Lost
17049,2117,5,20,1,1,2,4,Lost
17263,1,159,606,5,5,5,15,Champions
17377,2938,6,14,1,1,1,3,Lost
17771,57,120,194,5,5,5,15,Champions
17868,314,9,18,3,2,2,7,Casual Users
18002,26,66,125,5,5,4,14,Champions
18041,48,109,422,5,5,5,15,Champions
18133,280,129,316,3,5,5,13,Loyal Users
18438,31,94,146,5,5,4,14,Champions
18900,1120,5,9,2,1,1,4,Lost
18965,1015,5,14,2,1,1,4,Lost
18973,3383,5,9,1,1,1,3,Lost
19218,303,88,181,3,5,5,13,Loyal Users
19334,52,61,154,5,5,5,15,Champions
19520,75,42,139,4,4,4,12,Champions
20413,135,6,9,4,1,1,6,Promising
21149,1413,9,9,1,2,1,4,Lost
21270,4325,6,6,1,1,1,3,Lost
21399,802,19,42,2,3,3,8,Casual Users
21553,2148,5,11,1,1,1,3,Lost
21917,458,18,51,3,3,3,9,Loyal Users
22041,1154,24,46,2,4,3,9,At Risk
22159,1339,13,43,1,3,3,7,Casual Users
22512,273,24,34,3,4,3,10,Loyal Users
22515,2946,10,15,1,2,1,4,Lost
22588,144,58,216,4,5,5,14,Champions
22594,20,29,46,5,4,3,12,Loyal Users
22872,50,128,194,5,5,5,15,Champions
22963,3,130,450,5,5,5,15,Champions
23009,1456,9,19,1,2,2,5,Lost
23073,254,16,59,3,3,3,9,Loyal Users
23547,1131,26,80,2,4,4,10,At Risk
23582,3245,16,24,1,3,2,6,Casual Users
24125,1459,33,143,1,4,4,9,At Risk
24194,45,97,203,5,5,5,15,Champions
24429,138,38,74,4,4,4,12,Champions
24498,1008,7,7,2,2,1,5,Lost
24512,165,11,19,4,2,2,8,Promising
24571,22,63,238,5,5,5,15,Champions
24582,6101,9,9,1,2,1,4,Lost
24996,149,12,61,4,3,3,10,Loyal Users
25105,523,5,44,2,1,3,6,Lost
25284,216,39,150,3,4,5,12,Loyal Users
25296,42,119,326,5,5,5,15,Champions
25427,590,5,23,2,1,2,5,Lost
25431,2205,6,61,1,1,3,5,Lost
25824,566,69,120,2,5,4,11,At Risk
25928,829,9,11,2,2,1,5,Lost
26054,107,61,169,4,5,5,14,Champions
26057,19,32,116,5,4,4,13,Champions
13643,824,6,13,2,1,1,4,Lost
13698,2387,5,6,1,1,1,3,Lost
13757,74,12,16,4,3,2,9,Loyal Users
14488,126,61,129,4,5,4,13,Champions
14571,3,114,281,5,5,5,15,Champions
14591,182,74,329,3,5,5,13,Loyal Users
14988,198,77,314,3,5,5,13,Loyal Users
15027,90,40,136,4,4,4,12,Champions
15190,121,39,142,4,4,4,12,Champions
15546,3385,12,20,1,3,2,6,Casual Users
15560,3312,7,14,1,2,1,4,Lost
15806,2466,15,29,1,3,2,6,Casual Users
16273,249,29,63,3,4,4,11,Loyal Users
16533,843,31,44,2,4,3,9,At Risk
16558,409,6,16,3,1,2,6,Casual Users
16685,532,20,66,2,3,4,9,Casual Users
16942,126,36,63,4,4,4,12,Champions
17150,9,63,289,5,5,5,15,Champions
17482,70,7,23,4,2,2,8,Promising
17531,103,11,44,4,2,3,9,Promising
17702,668,8,10,2,2,1,5,Lost
18128,113,24,135,4,4,4,12,Champions
18619,231,18,41,3,3,3,9,Loyal Users
18756,1852,10,15,1,2,1,4,Lost
18795,2860,6,13,1,1,1,3,Lost
18947,6,75,205,5,5,5,15,Champions
18969,10,144,567,5,5,5,15,Champions
19385,1,73,321,5,5,5,15,Champions
19529,159,5,5,4,1,1,6,Promising
19677,285,7,27,3,2,2,7,Casual Users
19787,532,14,33,2,3,3,8,Casual Users
19901,2980,11,26,1,2,2,5,Lost
20105,192,8,12,3,2,1,6,Casual Users
20154,1827,8,16,1,2,2,5,Lost
20159,161,33,71,4,4,4,12,Champions
20602,707,13,41,2,3,3,8,Casual Users
20637,424,13,18,3,3,2,8,Loyal Users
20768,1067,12,75,2,3,4,9,Casual Users
20810,488,103,338,2,5,5,12,At Risk
21272,2,12,41,5,3,3,11,Loyal Users
21846,59,20,72,5,3,4,12,Loyal Users
21939,17,121,243,5,5,5,15,Champions
22441,17,10,37,5,2,3,10,Promising
22487,49,28,76,5,4,4,13,Champions
22833,216,85,285,3,5,5,13,Loyal Users
23731,537,12,47,2,3,3,8,Casual Users
23826,2486,5,9,1,1,1,3,Lost
23999,673,22,25,2,4,2,8,At Risk
24193,3398,12,23,1,3,2,6,Casual Users
24248,13,18,42,5,3,3,11,Loyal Users
24453,62,77,147,5,5,5,15,Champions
24570,65,45,173,5,4,5,14,Champions
24811,11,95,180,5,5,5,15,Champions
24813,124,48,108,4,5,4,13,Champions
24865,130,32,61,4,4,3,11,Loyal Users
25095,539,27,70,2,4,4,10,At Risk
25655,7,32,118,5,4,4,13,Champions
25769,2114,13,17,1,3,2,6,Casual Users
25932,571,24,40,2,4,3,9,At Risk
26269,153,26,30,4,4,2,10,Loyal Users
26295,526,5,5,2,1,1,4,Lost
26423,124,22,47,4,4,3,11,Loyal Users
13783,501,9,22,2,2,2,6,Lost
14095,95,39,93,4,4,4,12,Champions
14214,3159,5,6,1,1,1,3,Lost
14297,1851,5,12,1,1,1,3,Lost
14681,23,30,192,5,4,5,14,Champions
14717,248,19,47,3,3,3,9,Loyal Users
14853,4695,7,23,1,2,2,5,Lost
15050,614,7,16,2,2,2,6,Lost
15223,201,35,188,3,4,5,12,Loyal Users
15276,415,35,78,3,4,4,11,Loyal Users
15506,835,6,14,2,1,1,4,Lost
15701,1434,7,32,1,2,3,6,Lost
15746,113,24,60,4,4,3,11,Loyal Users
15760,1413,10,13,1,2,1,4,Lost
15871,115,40,106,4,4,4,12,Champions
15997,87,19,57,4,3,3,10,Loyal Users
16687,699,5,5,2,1,1,4,Lost
16754,978,5,13,2,1,1,4,Lost
16932,518,6,16,2,1,2,5,Lost
17129,69,13,16,5,3,2,10,Loyal Users
17325,732,76,275,2,5,5,12,At Risk
17382,602,28,82,2,4,4,10,At Risk
17543,498,7,14,2,2,1,5,Lost
17859,149,21,29,4,3,2,9,Loyal Users
18123,21,114,546,5,5,5,15,Champions
18617,0,61,108,5,5,4,14,Champions
18851,2604,5,10,1,1,1,3,Lost
19768,130,39,159,4,4,5,13,Champions
20160,121,10,40,4,2,3,9,Promising
20305,270,63,314,3,5,5,13,Loyal Users
20662,117,23,37,4,4,3,11,Loyal Users
20709,838,16,46,2,3,3,8,Casual Users
20765,1301,6,34,1,1,3,5,Lost
20923,107,21,46,4,3,3,10,Loyal Users
21225,115,30,40,4,4,3,11,Loyal Users
21332,174,20,24,3,3,2,8,Loyal Users
21952,39,90,278,5,5,5,15,Champions
21955,4,87,154,5,5,5,15,Champions
22062,2,58,190,5,5,5,15,Champions
22110,288,17,64,3,3,4,10,Loyal Users
22315,413,14,34,3,3,3,9,Loyal Users
22725,5748,8,18,1,2,2,5,Lost
22840,841,14,37,2,3,3,8,Casual Users
23399,2091,19,21,1,3,2,6,Casual Users
23560,418,20,69,3,3,4,10,Loyal Users
24136,1820,5,30,1,1,2,4,Lost
24142,12,15,42,5,3,3,11,Loyal Users
24237,285,17,67,3,3,4,10,Loyal Users
24293,172,7,46,3,2,3,8,Casual Users
24393,1713,18,23,1,3,2,6,Casual Users
24801,1104,8,16,2,2,2,6,Lost
24829,2574,7,30,1,2,2,5,Lost
25343,407,16,23,3,3,2,8,Loyal Users
25560,138,40,87,4,4,4,12,Champions
26099,152,6,13,4,1,1,6,Promising
26378,893,17,25,2,3,2,7,Casual Users
13655,1443,15,96,1,3,4,8,Casual Users
13859,959,20,62,2,3,3,8,Casual Users
14113,1137,9,9,2,2,1,5,Lost
14132,1648,6,20,1,1,2,4,Lost
14202,357,43,122,3,4,4,11,Loyal Users
14308,5530,12,40,1,3,3,7,Casual Users
14354,396,10,24,3,2,2,7,Casual Users
14404,111,8,39,4,2,3,9,Promising
14451,416,7,22,3,2,2,7,Casual Users
14618,40,111,674,5,5,5,15,Champions
14648,7,64,104,5,5,4,14,Champions
14706,69,5,7,5,1,1,7,Promising
14785,399,27,89,3,4,4,11,Loyal Users
14852,6,91,216,5,5,5,15,Champions
14954,489,17,32,2,3,3,8,Casual Users
15186,440,26,121,3,4,4,11,Loyal Users
15245,56,44,97,5,4,4,13,Champions
15339,482,25,78,2,4,4,10,At Risk
15365,4658,5,6,1,1,1,3,Lost
15393,687,11,25,2,2,2,6,Lost
15435,415,10,28,3,2,2,7,Casual Users
15504,89,5,17,4,1,2,7,Promising
15582,148,104,251,4,5,5,14,Champions
15811,303,16,41,3,3,3,9,Loyal Users
15873,407,19,130,3,3,4,10,Loyal Users
15984,154,90,126,4,5,4,13,Champions
16052,1143,9,19,2,2,2,6,Lost
16328,2,14,113,5,3,4,12,Loyal Users
16369,10,129,339,5,5,5,15,Champions
16400,408,8,23,3,2,2,7,Casual Users
16429,307,87,294,3,5,5,13,Loyal Users
16573,302,8,26,3,2,2,7,Casual Users
16591,89,119,323,4,5,5,14,Champions
16974,100,32,57,4,4,3,11,Loyal Users
17130,1961,6,25,1,1,2,4,Lost
17135,1138,31,46,2,4,3,9,At Risk
17171,651,29,37,2,4,3,9,At Risk
17318,60,35,99,5,4,4,13,Champions
17398,128,78,591,4,5,5,14,Champions
17618,519,6,13,2,1,1,4,Lost
17840,1672,68,98,1,5,4,10,At Risk
18015,84,13,120,4,3,4,11,Loyal Users
18140,162,25,38,4,4,3,11,Loyal Users
18632,2172,18,32,1,3,3,7,Casual Users
18778,543,5,8,2,1,1,4,Lost
19038,528,60,318,2,5,5,12,At Risk
19062,214,51,193,3,5,5,13,Loyal Users
19183,39,62,248,5,5,5,15,Champions
19189,2205,12,34,1,3,3,7,Casual Users
19216,864,8,26,2,2,2,6,Lost
19448,310,12,73,3,3,4,10,Loyal Users
19879,38,126,178,5,5,5,15,Champions
20201,822,7,34,2,2,3,7,Lost
20235,5599,6,10,1,1,1,3,Lost
20448,71,44,258,4,4,5,13,Champions
20622,151,6,30,4,1,2,7,Promising
20884,1715,9,33,1,2,3,6,Lost
20977,79,24,133,4,4,4,12,Champions
21029,755,19,60,2,3,3,8,Casual Users
21258,32,54,66,5,5,4,14,Champions
21429,213,49,253,3,5,5,13,Loyal Users
21579,268,29,41,3,4,3,10,Loyal Users
21623,418,7,8,3,2,1,6,Casual Users
21753,121,35,72,4,4,4,12,Champions
21906,1078,5,12,2,1,1,4,Lost
22011,162,10,19,4,2,2,8,Promising
22086,335,10,11,3,2,1,6,Casual Users
22177,90,11,14,4,2,1,7,Promising
22352,94,29,65,4,4,4,12,Champions
22483,181,8,13,3,2,1,6,Casual Users
23321,83,25,39,4,4,3,11,Loyal Users
23503,801,27,105,2,4,4,10,At Risk
23910,238,7,10,3,2,1,6,Casual Users
23969,161,18,54,4,3,3,10,Loyal Users
24129,125,27,61,4,4,3,11,Loyal Users
24151,76,82,245,4,5,5,14,Champions
24345,11,108,460,5,5,5,15,Champions
24348,30,21,73,5,3,4,12,Loyal Users
25039,38,40,51,5,4,3,12,Loyal Users
25087,132,24,125,4,4,4,12,Champions
25458,727,6,6,2,1,1,4,Lost
25834,7,18,32,5,3,3,11,Loyal Users
25931,1977,11,34,1,2,3,6,Lost
26233,1637,37,332,1,4,5,10,At Risk
26267,113,15,31,4,3,2,9,Loyal Users
26383,424,6,35,3,1,3,7,Casual Users
13717,1928,23,57,1,4,3,8,At Risk
13951,10,21,47,5,3,3,11,Loyal Users
14278,69,6,27,5,1,2,8,Promising
14540,1653,9,43,1,2,3,6,Lost
14580,1560,7,24,1,2,2,5,Lost
14596,857,7,8,2,2,1,5,Lost
14628,279,59,94,3,5,4,12,Loyal Users
14804,117,33,187,4,4,5,13,Champions
15747,1302,16,25,1,3,2,6,Casual Users
15987,4398,7,57,1,2,3,6,Lost
15995,305,11,24,3,2,2,7,Casual Users
16082,805,5,30,2,1,2,5,Lost
16104,12,136,614,5,5,5,15,Champions
16411,4783,6,13,1,1,1,3,Lost
16949,73,59,152,4,5,5,14,Champions
16971,129,29,205,4,4,5,13,Champions
17258,8,104,217,5,5,5,15,Champions
17453,672,25,92,2,4,4,10,At Risk
17589,174,86,397,3,5,5,13,Loyal Users
17967,278,13,42,3,3,3,9,Loyal Users
18038,3,125,402,5,5,5,15,Champions
18446,255,38,103,3,4,4,11,Loyal Users
18500,408,16,29,3,3,2,8,Loyal Users
18863,269,92,331,3,5,5,13,Loyal Users
19008,1037,8,24,2,2,2,6,Lost
19332,2468,12,39,1,3,3,7,Casual Users
19368,30,12,44,5,3,3,11,Loyal Users
19938,58,95,232,5,5,5,15,Champions
19950,523,16,68,2,3,4,9,Casual Users
20308,83,29,42,4,4,3,11,Loyal Users
20625,940,7,8,2,2,1,5,Lost
21177,2044,24,94,1,4,4,9,At Risk
21284,24,17,50,5,3,3,11,Loyal Users
21659,729,7,12,2,2,1,5,Lost
21869,768,13,21,2,3,2,7,Casual Users
21993,721,6,46,2,1,3,6,Lost
22295,2528,11,43,1,2,3,6,Lost
22444,155,49,87,4,5,4,13,Champions
22643,2282,6,31,1,1,2,4,Lost
22753,335,10,28,3,2,2,7,Casual Users
22789,14,7,13,5,2,1,8,Promising
23097,270,48,101,3,5,4,12,Loyal Users
23235,442,12,22,3,3,2,8,Loyal Users
23418,1055,8,8,2,2,1,5,Lost
23583,5,30,69,5,4,4,13,Champions
23809,992,5,10,2,1,1,4,Lost
24524,289,32,72,3,4,4,11,Loyal Users
24602,521,9,12,2,2,1,5,Lost
24636,3468,5,5,1,1,1,3,Lost
24755,740,5,5,2,1,1,4,Lost
24935,269,20,98,3,3,4,10,Loyal Users
25014,1,15,18,5,3,2,10,Loyal Users
25285,135,14,53,4,3,3,10,Loyal Users
25337,142,32,88,4,4,4,12,Champions
25352,285,27,57,3,4,3,10,Loyal Users
25778,459,7,8,3,2,1,6,Casual Users
25827,132,6,44,4,1,3,8,Promising
25867,851,51,96,2,5,4,11,At Risk
25953,2,59,281,5,5,5,15,Champions
26256,2108,6,8,1,1,1,3,Lost
13868,107,125,236,4,5,5,14,Champions
14676,264,5,22,3,1,2,6,Casual Users
14757,116,9,11,4,2,1,7,Promising
14903,1863,5,11,1,1,1,3,Lost
14949,132,32,140,4,4,4,12,Champions
14978,121,9,19,4,2,2,8,Promising
15064,27,63,108,5,5,4,14,Champions
15471,108,28,47,4,4,3,11,Loyal Users
15548,1001,8,24,2,2,2,6,Lost
15766,574,17,27,2,3,2,7,Casual Users
15801,155,60,242,4,5,5,14,Champions
16236,575,9,20,2,2,2,6,Lost
16311,1095,20,45,2,3,3,8,Casual Users
16396,132,12,22,4,3,2,9,Loyal Users
16595,245,6,23,3,1,2,6,Casual Users
16786,4448,6,10,1,1,1,3,Lost
16871,664,14,24,2,3,2,7,Casual Users
16887,3299,5,10,1,1,1,3,Lost
17326,868,6,71,2,1,4,7,Lost
17551,85,12,30,4,3,2,9,Loyal Users
17556,28,27,97,5,4,4,13,Champions
17623,237,11,26,3,2,2,7,Casual Users
17665,2,64,99,5,5,4,14,Champions
18143,341,7,17,3,2,2,7,Casual Users
18244,284,10,40,3,2,3,8,Casual Users
18317,5002,6,12,1,1,1,3,Lost
18350,711,10,17,2,2,2,6,Lost
18608,5,5,25,5,1,2,8,Promising
18740,149,5,7,4,1,1,6,Promising
20004,79,26,31,4,4,2,10,Loyal Users
20137,177,11,39,3,2,3,8,Casual Users
20391,5552,5,13,1,1,1,3,Lost
20477,57,74,396,5,5,5,15,Champions
20604,1271,27,81,1,4,4,9,At Risk
20967,18,53,224,5,5,5,15,Champions
21280,1106,8,83,2,2,4,8,Lost
22371,2944,12,16,1,3,2,6,Casual Users
22471,92,75,382,4,5,5,14,Champions
22623,9,6,18,5,1,2,8,Promising
22772,448,19,46,3,3,3,9,Loyal Users
22991,302,19,104,3,3,4,10,Loyal Users
23402,1417,7,14,1,2,1,4,Lost
23533,3799,18,77,1,3,4,8,Casual Users
23567,3,8,24,5,2,2,9,Promising
23704,7,78,243,5,5,5,15,Champions
24150,5180,9,12,1,2,1,4,Lost
24308,153,47,132,4,5,4,13,Champions
24646,1518,13,23,1,3,2,6,Casual Users
25003,325,6,44,3,1,3,7,Casual Users
25387,1146,5,18,2,1,2,5,Lost
25417,4592,8,9,1,2,1,4,Lost
25531,1447,20,29,1,3,2,6,Casual Users
26129,76,13,23,4,3,2,9,Loyal Users
26298,12,25,137,5,4,4,13,Champions
26322,4001,5,23,1,1,2,4,Lost
26341,41,7,20,5,2,2,9,Promising
26364,54,84,235,5,5,5,15,Champions
13689,116,32,59,4,4,3,11,Loyal Users
14020,116,36,89,4,4,4,12,Champions
14065,1662,18,31,1,3,2,6,Casual Users
14349,1285,8,23,1,2,2,5,Lost
15002,289,16,34,3,3,3,9,Loyal Users
15208,2,52,122,5,5,4,14,Champions
15237,1260,36,104,1,4,4,9,At Risk
15602,0,169,351,5,5,5,15,Champions
15628,72,32,115,4,4,4,12,Champions
15648,139,41,236,4,4,5,13,Champions
16006,2735,5,36,1,1,3,5,Lost
16610,37,136,168,5,5,5,15,Champions
16960,1007,7,13,2,2,1,5,Lost
17124,120,14,25,4,3,2,9,Loyal Users
17155,566,13,18,2,3,2,7,Casual Users
17156,439,5,14,3,1,1,5,Casual Users
17267,299,21,40,3,3,3,9,Loyal Users
17268,84,18,56,4,3,3,10,Loyal Users
17744,1268,24,36,1,4,3,8,At Risk
17996,528,34,126,2,4,4,10,At Risk
18227,156,21,43,4,3,3,10,Loyal Users
18301,809,6,12,2,1,1,4,Lost
18342,16,8,19,5,2,2,9,Promising
18366,98,31,48,4,4,3,11,Loyal Users
18481,13,19,55,5,3,3,11,Loyal Users
18548,102,35,53,4,4,3,11,Loyal Users
18605,846,5,56,2,1,3,6,Lost
18679,968,9,19,2,2,2,6,Lost
18765,1141,13,19,2,3,2,7,Casual Users
18791,81,28,75,4,4,4,12,Champions
19271,170,11,19,3,2,2,7,Casual Users
19319,248,11,12,3,2,1,6,Casual Users
19557,1663,24,70,1,4,4,9,At Risk
19617,581,33,73,2,4,4,10,At Risk
19636,71,15,134,4,3,4,11,Loyal Users
19722,2659,10,13,1,2,1,4,Lost
19788,57,6,34,5,1,3,9,Promising
20006,243,18,28,3,3,2,8,Loyal Users
20083,1468,17,38,1,3,3,7,Casual Users
20593,171,5,8,3,1,1,5,Casual Users
20635,866,31,41,2,4,3,9,At Risk
20670,1429,5,6,1,1,1,3,Lost
20697,1524,8,18,1,2,2,5,Lost
20793,6,41,80,5,4,4,13,Champions
20948,477,24,59,2,4,3,9,At Risk
21033,503,16,46,2,3,3,8,Casual Users
21138,25,23,38,5,4,3,12,Loyal Users
21243,132,19,59,4,3,3,10,Loyal Users
21287,437,16,52,3,3,3,9,Loyal Users
21403,7,8,18,5,2,2,9,Promising
21722,5418,5,5,1,1,1,3,Lost
21724,7,29,73,5,4,4,13,Champions
22170,156,17,22,4,3,2,9,Loyal Users
22293,56,8,14,5,2,1,8,Promising
22433,130,65,313,4,5,5,14,Champions
22560,276,19,26,3,3,2,8,Loyal Users
22723,3784,6,15,1,1,1,3,Lost
23016,917,37,90,2,4,4,10,At Risk
23413,162,12,28,4,3,2,9,Loyal Users
23466,270,15,36,3,3,3,9,Loyal Users
23606,2304,22,39,1,4,3,8,At Risk
23700,2086,6,23,1,1,2,4,Lost
23732,469,23,69,3,4,4,11,Loyal Users
23754,98,10,25,4,2,2,8,Promising
23989,64,26,142,5,4,4,13,Champions
24169,31,46,172,5,5,5,15,Champions
24175,66,68,140,5,5,4,14,Champions
24735,5143,8,13,1,2,1,4,Lost
24845,549,6,17,2,1,2,5,Lost
24875,6,82,167,5,5,5,15,Champions
24878,64,40,198,5,4,5,14,Champions
25219,1,25,29,5,4,2,11,Loyal Users
25276,791,5,13,2,1,1,4,Lost
25300,1233,14,28,2,3,2,7,Casual Users
25350,1675,7,40,1,2,3,6,Lost
25891,39,5,7,5,1,1,7,Promising
26008,240,7,21,3,2,2,7,Casual Users
26280,2,100,288,5,5,5,15,Champions
26330,284,8,9,3,2,1,6,Casual Users
26338,3534,5,17,1,1,2,4,Lost
26372,77,19,55,4,3,3,10,Loyal Users
13878,803,34,225,2,4,5,11,At Risk
14417,138,63,199,4,5,5,14,Champions
14600,65,36,105,5,4,4,13,Champions
14841,26,28,53,5,4,3,12,Loyal Users
15059,409,28,164,3,4,5,12,Loyal Users
15304,757,6,9,2,1,1,4,Lost
15465,1158,12,27,2,3,2,7,Casual Users
15621,1249,6,11,2,1,1,4,Lost
15764,416,5,8,3,1,1,5,Casual Users
16296,1205,32,111,2,4,4,10,At Risk
16622,2,21,53,5,3,3,11,Loyal Users
16967,55,75,622,5,5,5,15,Champions
17179,1124,56,75,2,5,4,11,At Risk
17457,443,14,53,3,3,3,9,Loyal Users
17866,64,47,81,5,5,4,14,Champions
18593,478,8,109,2,2,4,8,Lost
18811,584,5,15,2,1,1,4,Lost
19174,737,24,51,2,4,3,9,At Risk
19306,9,41,134,5,4,4,13,Champions
19352,124,108,509,4,5,5,14,Champions
19612,591,18,24,2,3,2,7,Casual Users
19978,102,16,55,4,3,3,10,Loyal Users
20220,320,66,479,3,5,5,13,Loyal Users
21045,266,11,15,3,2,1,6,Casual Users
21088,86,78,302,4,5,5,14,Champions
21631,288,6,23,3,1,2,6,Casual Users
21820,1135,5,8,2,1,1,4,Lost
21832,353,13,26,3,3,2,8,Loyal Users
21905,586,14,21,2,3,2,7,Casual Users
22320,715,8,81,2,2,4,8,Lost
22582,72,16,21,4,3,2,9,Loyal Users
22596,330,15,28,3,3,2,8,Loyal Users
22645,2134,93,167,1,5,5,11,At Risk
22685,30,9,61,5,2,3,10,Promising
22812,270,9,13,3,2,1,6,Casual Users
22911,26,106,686,5,5,5,15,Champions
22986,166,46,205,3,5,5,13,Loyal Users
23024,217,47,283,3,5,5,13,Loyal Users
23082,271,77,177,3,5,5,13,Loyal Users
23093,3291,12,17,1,3,2,6,Casual Users
23553,379,8,17,3,2,2,7,Casual Users
23975,73,16,27,4,3,2,9,Loyal Users
24319,413,12,46,3,3,3,9,Loyal Users
24335,10,9,17,5,2,2,9,Promising
24990,38,68,526,5,5,5,15,Champions
25043,12,76,334,5,5,5,15,Champions
25264,5,88,219,5,5,5,15,Champions
25612,770,63,105,2,5,4,11,At Risk
25749,30,94,254,5,5,5,15,Champions
25772,1731,13,22,1,3,2,6,Casual Users
25808,14,28,73,5,4,4,13,Champions
26092,290,24,31,3,4,2,9,Loyal Users
26122,3713,23,50,1,4,3,8,At Risk
26244,51,30,112,5,4,4,13,Champions
26305,709,25,67,2,4,4,10,At Risk
26337,2868,5,5,1,1,1,3,Lost
26358,98,27,63,4,4,4,12,Champions
13596,14,102,208,5,5,5,15,Champions
13743,697,5,11,2,1,1,4,Lost
14195,542,22,78,2,4,4,10,At Risk
14205,0,68,299,5,5,5,15,Champions
14254,445,74,92,3,5,4,12,Loyal Users
14350,459,40,72,3,4,4,11,Loyal Users
14445,149,7,19,4,2,2,8,Promising
14470,1,76,104,5,5,4,14,Champions
14972,731,8,13,2,2,1,5,Lost
14998,1360,5,8,1,1,1,3,Lost
15403,230,41,153,3,4,5,12,Loyal Users
15544,1868,17,27,1,3,2,6,Casual Users
15587,260,38,91,3,4,4,11,Loyal Users
15725,70,54,95,4,5,4,13,Champions
16372,270,37,45,3,4,3,10,Loyal Users
16458,33,66,268,5,5,5,15,Champions
16668,136,20,31,4,3,2,9,Loyal Users
17013,314,11,13,3,2,1,6,Casual Users
17016,666,11,55,2,2,3,7,Lost
17205,417,14,44,3,3,3,9,Loyal Users
17238,1105,36,109,2,4,4,10,At Risk
17261,2662,6,11,1,1,1,3,Lost
17276,125,69,101,4,5,4,13,Champions
17332,9,79,162,5,5,5,15,Champions
17488,402,34,53,3,4,3,10,Loyal Users
17790,3,174,341,5,5,5,15,Champions
17874,7,27,85,5,4,4,13,Champions
17959,569,8,12,2,2,1,5,Lost
18018,83,15,31,4,3,2,9,Loyal Users
18171,90,43,157,4,4,5,13,Champions
18215,2,83,184,5,5,5,15,Champions
18315,586,7,69,2,2,4,8,Lost
18522,890,33,74,2,4,4,10,At Risk
18743,2490,21,39,1,3,3,7,Casual Users
18880,25,32,167,5,4,5,14,Champions
19035,2521,6,7,1,1,1,3,Lost
19045,52,44,199,5,4,5,14,Champions
19187,494,25,78,2,4,4,10,At Risk
19343,573,5,8,2,1,1,4,Lost
19456,1121,18,41,2,3,3,8,Casual Users
19761,440,20,32,3,3,3,9,Loyal Users
19967,278,33,129,3,4,4,11,Loyal Users
20060,1610,5,5,1,1,1,3,Lost
20232,429,13,46,3,3,3,9,Loyal Users
20290,177,10,29,3,2,2,7,Casual Users
20318,1080,8,9,2,2,1,5,Lost
20395,113,61,282,4,5,5,14,Champions
20571,3,64,119,5,5,4,14,Champions
20852,258,7,53,3,2,3,8,Casual Users
21317,392,21,29,3,3,2,8,Loyal Users
21334,260,69,118,3,5,4,12,Loyal Users
21488,153,134,288,4,5,5,14,Champions
21575,813,6,13,2,1,1,4,Lost
21604,6,133,472,5,5,5,15,Champions
21798,500,12,33,2,3,3,8,Casual Users
21815,1300,8,25,1,2,2,5,Lost
21823,1742,14,39,1,3,3,7,Casual Users
22160,50,75,229,5,5,5,15,Champions
22255,2,41,41,5,4,3,12,Loyal Users
22270,925,52,76,2,5,4,11,At Risk
22568,143,12,142,4,3,4,11,Loyal Users
22877,843,17,22,2,3,2,7,Casual Users
23091,231,10,14,3,2,1,6,Casual Users
23130,723,5,14,2,1,1,4,Lost
23236,447,23,118,3,4,4,11,Loyal Users
23278,1672,19,267,1,3,5,9,Casual Users
23691,576,10,79,2,2,4,8,Lost
23697,5504,6,6,1,1,1,3,Lost
23701,384,18,41,3,3,3,9,Loyal Users
23959,162,13,43,4,3,3,10,Loyal Users
24119,10,72,229,5,5,5,15,Champions
24218,706,13,22,2,3,2,7,Casual Users
24357,1054,6,20,2,1,2,5,Lost
24412,1002,8,12,2,2,1,5,Lost
24414,410,25,56,3,4,3,10,Loyal Users
24644,2263,20,53,1,3,3,7,Casual Users
24869,121,18,54,4,3,3,10,Loyal Users
25184,2010,6,17,1,1,2,4,Lost
25664,533,5,18,2,1,2,5,Lost
25962,546,20,45,2,3,3,8,Casual Users
26097,126,7,29,4,2,2,8,Promising
26140,592,12,77,2,3,4,9,Casual Users
26182,129,19,85,4,3,4,11,Loyal Users
26196,2403,6,9,1,1,1,3,Lost
26210,111,26,48,4,4,3,11,Loyal Users
26279,68,51,124,5,5,4,14,Champions
26363,276,12,17,3,3,2,8,Loyal Users
13858,402,29,66,3,4,4,11,Loyal Users
13887,77,17,38,4,3,3,10,Loyal Users
14079,874,8,25,2,2,2,6,Lost
14144,1477,6,25,1,1,2,4,Lost
14815,251,19,115,3,3,4,10,Loyal Users
14847,440,6,15,3,1,1,5,Casual Users
15076,729,8,30,2,2,2,6,Lost
15478,36,106,272,5,5,5,15,Champions
15537,277,40,52,3,4,3,10,Loyal Users
15580,182,36,65,3,4,4,11,Loyal Users
15631,24,101,413,5,5,5,15,Champions
15704,138,41,122,4,4,4,12,Champions
15724,4985,10,10,1,2,1,4,Lost
16197,16,40,224,5,4,5,14,Champions
16895,3,14,29,5,3,2,10,Loyal Users
16965,677,19,33,2,3,3,8,Casual Users
17222,893,5,30,2,1,2,5,Lost
17433,299,44,67,3,4,4,11,Loyal Users
17564,4,73,220,5,5,5,15,Champions
17596,547,46,199,2,5,5,12,At Risk
17682,11,85,253,5,5,5,15,Champions
18118,604,50,168,2,5,5,12,At Risk
18464,675,18,44,2,3,3,8,Casual Users
18582,1528,6,9,1,1,1,3,Lost
18757,1,52,184,5,5,5,15,Champions
18775,846,5,14,2,1,1,4,Lost
18936,78,14,42,4,3,3,10,Loyal Users
19186,319,6,42,3,1,3,7,Casual Users
19490,1742,12,101,1,3,4,8,Casual Users
19608,935,13,23,2,3,2,7,Casual Users
19837,16,176,577,5,5,5,15,Champions
19876,15,45,75,5,4,4,13,Champions
20431,1451,27,54,1,4,3,8,At Risk
20543,5506,9,20,1,2,2,5,Lost
20559,434,65,155,3,5,5,13,Loyal Users
20822,475,9,43,2,2,3,7,Lost
21233,416,18,92,3,3,4,10,Loyal Users
21636,318,81,201,3,5,5,13,Loyal Users
21991,5,18,28,5,3,2,10,Loyal Users
23115,471,107,615,2,5,5,12,At Risk
23218,1419,6,7,1,1,1,3,Lost
23558,732,5,9,2,1,1,4,Lost
23963,107,36,150,4,4,5,13,Champions
24295,1183,5,6,2,1,1,4,Lost
24327,55,131,454,5,5,5,15,Champions
24554,125,7,9,4,2,1,7,Promising
25238,11,43,221,5,4,5,14,Champions
25251,266,5,23,3,1,2,6,Casual Users
25382,160,6,57,4,1,3,8,Promising
25545,416,10,12,3,2,1,6,Casual Users
25885,122,19,58,4,3,3,10,Loyal Users
25952,398,28,34,3,4,3,10,Loyal Users
26139,3172,11,16,1,2,2,5,Lost
26191,707,13,21,2,3,2,7,Casual Users
14010,262,13,47,3,3,3,9,Loyal Users
14163,6,79,175,5,5,5,15,Champions
14347,4,140,227,5,5,5,15,Champions
14355,420,20,40,3,3,3,9,Loyal Users
15355,1100,8,14,2,2,1,5,Lost
15562,1861,7,7,1,2,1,4,Lost
16393,466,7,16,3,2,2,7,Casual Users
16811,954,56,159,2,5,5,12,At Risk
17157,69,8,14,5,2,1,8,Promising
17307,839,10,25,2,2,2,6,Lost
17399,23,50,326,5,5,5,15,Champions
17574,845,6,16,2,1,2,5,Lost
17675,7,65,191,5,5,5,15,Champions
17772,174,89,221,3,5,5,13,Loyal Users
18168,40,32,116,5,4,4,13,Champions
18214,613,70,287,2,5,5,12,At Risk
18490,93,89,323,4,5,5,14,Champions
18508,20,15,39,5,3,3,11,Loyal Users
18521,1289,14,67,1,3,4,8,Casual Users
18575,10,18,21,5,3,2,10,Loyal Users
18663,1224,12,30,2,3,2,7,Casual Users
18840,1091,5,8,2,1,1,4,Lost
18962,217,22,63,3,4,4,11,Loyal Users
19331,16,21,244,5,3,5,13,Loyal Users
19826,1399,13,20,1,3,2,6,Casual Users
20185,3134,12,20,1,3,2,6,Casual Users
20646,156,16,22,4,3,2,9,Loyal Users
20664,128,5,11,4,1,1,6,Promising
20762,9,113,354,5,5,5,15,Champions
21358,871,11,11,2,2,1,5,Lost
21471,4701,6,8,1,1,1,3,Lost
21537,65,74,604,5,5,5,15,Champions
21699,4,11,29,5,2,2,9,Promising
21959,122,90,181,4,5,5,14,Champions
22014,38,18,49,5,3,3,11,Loyal Users
22179,34,63,93,5,5,4,14,Champions
22387,528,30,50,2,4,3,9,At Risk
22500,116,49,107,4,5,4,13,Champions
22607,831,8,15,2,2,1,5,Lost
22631,139,15,19,4,3,2,9,Loyal Users
22820,20,170,922,5,5,5,15,Champions
23153,3413,5,5,1,1,1,3,Lost
23320,174,8,29,3,2,2,7,Casual Users
23585,92,77,143,4,5,4,13,Champions
23987,258,11,15,3,2,1,6,Casual Users
24305,2,103,282,5,5,5,15,Champions
24318,129,23,52,4,4,3,11,Loyal Users
24343,13,82,132,5,5,4,14,Champions
24760,42,125,701,5,5,5,15,Champions
24894,1743,19,48,1,3,3,7,Casual Users
25306,580,17,125,2,3,4,9,Casual Users
25567,1546,10,12,1,2,1,4,Lost
25588,398,91,203,3,5,5,13,Loyal Users
25771,1042,15,28,2,3,2,7,Casual Users
26272,41,132,332,5,5,5,15,Champions
26346,1428,7,20,1,2,2,5,Lost
14338,1549,19,43,1,3,3,7,Casual Users
14967,2,124,326,5,5,5,15,Champions
15963,71,26,40,4,4,3,11,Loyal Users
15996,143,18,37,4,3,3,10,Loyal Users
16214,2278,11,23,1,2,2,5,Lost
16278,4336,29,110,1,4,4,9,At Risk
16643,1098,14,57,2,3,3,8,Casual Users
16874,1690,11,21,1,2,2,5,Lost
16907,30,97,429,5,5,5,15,Champions
16909,2411,12,110,1,3,4,8,Casual Users
17025,247,56,257,3,5,5,13,Loyal Users
17241,35,70,132,5,5,4,14,Champions
17680,134,52,202,4,5,5,14,Champions
17889,1848,17,73,1,3,4,8,Casual Users
17894,1545,6,10,1,1,1,3,Lost
17901,60,8,40,5,2,3,10,Promising
18124,635,52,206,2,5,5,12,At Risk
18358,5,31,46,5,4,3,12,Loyal Users
18412,1109,5,8,2,1,1,4,Lost
18487,2400,5,17,1,1,2,4,Lost
18494,719,19,183,2,3,5,10,Casual Users
18612,243,44,114,3,4,4,11,Loyal Users
18707,466,15,33,3,3,3,9,Loyal Users
19077,3259,29,75,1,4,4,9,At Risk
19114,24,31,59,5,4,3,12,Loyal Users
19406,30,27,76,5,4,4,13,Champions
19827,263,24,87,3,4,4,11,Loyal Users
19943,204,83,193,3,5,5,13,Loyal Users
20064,2561,37,69,1,4,4,9,At Risk
20278,1116,17,47,2,3,3,8,Casual Users
20340,123,118,334,4,5,5,14,Champions
20362,7,234,393,5,5,5,15,Champions
20565,3278,5,16,1,1,2,4,Lost
20650,233,15,18,3,3,2,8,Loyal Users
20673,413,9,14,3,2,1,6,Casual Users
20747,439,14,100,3,3,4,10,Loyal Users
21040,2220,6,14,1,1,1,3,Lost
21101,871,5,6,2,1,1,4,Lost
21320,137,12,25,4,3,2,9,Loyal Users
21522,117,12,16,4,3,2,9,Loyal Users
21565,842,11,18,2,2,2,6,Lost
21566,1033,7,8,2,2,1,5,Lost
21840,430,7,62,3,2,3,8,Casual Users
21874,39,54,277,5,5,5,15,Champions
22234,212,6,7,3,1,1,5,Casual Users
22451,971,7,50,2,2,3,7,Lost
22481,575,10,16,2,2,2,6,Lost
22626,81,19,42,4,3,3,10,Loyal Users
22780,157,33,54,4,4,3,11,Loyal Users
22968,2374,9,20,1,2,2,5,Lost
23008,69,14,69,5,3,4,12,Loyal Users
23539,184,17,106,3,3,4,10,Loyal Users
23751,2727,29,60,1,4,3,8,At Risk
23768,248,41,202,3,4,5,12,Loyal Users
23899,287,13,19,3,3,2,8,Loyal Users
24145,994,15,41,2,3,3,8,Casual Users
24167,830,21,69,2,3,4,9,Casual Users
24309,147,22,73,4,4,4,12,Champions
24781,173,18,104,3,3,4,10,Loyal Users
25046,85,11,20,4,2,2,8,Promising
25162,34,8,16,5,2,2,9,Promising
25277,1106,6,8,2,1,1,4,Lost
25497,582,5,39,2,1,3,6,Lost
25629,248,106,294,3,5,5,13,Loyal Users
25708,1,12,105,5,3,4,12,Loyal Users
26030,539,8,8,2,2,1,5,Lost
13702,964,12,27,2,3,2,7,Casual Users
13712,142,10,24,4,2,2,8,Promising
13779,464,57,155,3,5,5,13,Loyal Users
13991,2106,7,29,1,2,2,5,Lost
14198,745,20,33,2,3,3,8,Casual Users
14213,1459,8,16,1,2,2,5,Lost
14216,123,57,226,4,5,5,14,Champions
14290,125,21,49,4,3,3,10,Loyal Users
14387,253,33,83,3,4,4,11,Loyal Users
14547,649,15,54,2,3,3,8,Casual Users
15098,163,6,10,4,1,1,6,Promising
15482,77,66,96,4,5,4,13,Champions
15977,212,52,192,3,5,5,13,Loyal Users
16061,2130,56,198,1,5,5,11,At Risk
16578,992,5,10,2,1,1,4,Lost
16640,76,10,73,4,2,4,10,Promising
17066,175,13,65,3,3,4,10,Loyal Users
17091,19,72,230,5,5,5,15,Champions
17283,1690,12,22,1,3,2,6,Casual Users
17313,1,27,65,5,4,4,13,Champions
17506,176,8,55,3,2,3,8,Casual Users
17517,1426,12,18,1,3,2,6,Casual Users
17755,9,78,269,5,5,5,15,Champions
17937,499,6,9,2,1,1,4,Lost
18037,4315,6,6,1,1,1,3,Lost
18428,87,40,62,4,4,3,11,Loyal Users
18886,399,11,15,3,2,1,6,Casual Users
19051,290,6,21,3,1,2,6,Casual Users
19209,184,24,27,3,4,2,9,Loyal Users
19336,23,21,51,5,3,3,11,Loyal Users
20375,358,6,8,3,1,1,5,Casual Users
20421,451,7,23,3,2,2,7,Casual Users
20474,1328,5,6,1,1,1,3,Lost
20960,484,39,385,2,4,5,11,At Risk
21015,701,17,23,2,3,2,7,Casual Users
21392,701,16,34,2,3,3,8,Casual Users
21615,90,41,55,4,4,3,11,Loyal Users
21757,15,32,145,5,4,4,13,Champions
21758,430,14,58,3,3,3,9,Loyal Users
22213,815,25,29,2,4,2,8,At Risk
22428,4,7,11,5,2,1,8,Promising
22879,76,32,238,4,4,5,13,Champions
22971,0,107,189,5,5,5,15,Champions
23529,1,39,117,5,4,4,13,Champions
23602,4,49,120,5,5,4,14,Champions
23648,179,46,133,3,5,4,12,Loyal Users
24014,677,20,36,2,3,3,8,Casual Users
24017,193,5,9,3,1,1,5,Casual Users
24113,69,96,339,5,5,5,15,Champions
25098,1541,8,25,1,2,2,5,Lost
25515,141,12,44,4,3,3,10,Loyal Users
25688,454,26,138,3,4,4,11,Loyal Users
25694,145,51,156,4,5,5,14,Champions
26260,411,54,163,3,5,5,13,Loyal Users
13690,5768,6,17,1,1,2,4,Lost
13801,1630,5,26,1,1,2,4,Lost
14031,1830,7,10,1,2,1,4,Lost
14104,15,38,60,5,4,3,12,Loyal Users
14495,131,30,227,4,4,5,13,Champions
14542,218,12,114,3,3,4,10,Loyal Users
14603,7,23,81,5,4,4,13,Champions
14989,549,148,393,2,5,5,12,At Risk
15044,295,60,87,3,5,4,12,Loyal Users
15639,299,28,110,3,4,4,11,Loyal Users
15852,1502,14,54,1,3,3,7,Casual Users
16113,9,123,288,5,5,5,15,Champions
16284,173,11,33,3,2,3,8,Casual Users
16305,101,8,79,4,2,4,10,Promising
16649,578,7,10,2,2,1,5,Lost
16780,27,81,669,5,5,5,15,Champions
17032,216,47,99,3,5,4,12,Loyal Users
17198,53,37,124,5,4,4,13,Champions
17513,101,18,30,4,3,2,9,Loyal Users
17606,14,35,103,5,4,4,13,Champions
18407,1134,6,13,2,1,1,4,Lost
18668,468,8,10,3,2,1,6,Casual Users
19330,3455,8,21,1,2,2,5,Lost
19545,2,41,124,5,4,4,13,Champions
19831,106,81,371,4,5,5,14,Champions
19851,163,55,78,4,5,4,13,Champions
20016,345,5,37,3,1,3,7,Casual Users
20034,144,31,40,4,4,3,11,Loyal Users
20166,823,5,5,2,1,1,4,Lost
20178,336,10,21,3,2,2,7,Casual Users
20228,106,76,513,4,5,5,14,Champions
20443,77,54,141,4,5,4,13,Champions
20484,92,103,910,4,5,5,14,Champions
20612,1,159,246,5,5,5,15,Champions
20614,405,6,16,3,1,2,6,Casual Users
20639,647,47,215,2,5,5,12,At Risk
20729,121,7,7,4,2,1,7,Promising
20957,137,21,26,4,3,2,9,Loyal Users
21018,659,6,17,2,1,2,5,Lost
21137,154,23,70,4,4,4,12,Champions
21206,128,96,903,4,5,5,14,Champions
21282,130,68,170,4,5,5,14,Champions
21338,689,14,22,2,3,2,7,Casual Users
21651,184,6,9,3,1,1,5,Casual Users
21965,1982,9,11,1,2,1,4,Lost
22141,5,88,152,5,5,5,15,Champions
22196,114,37,84,4,4,4,12,Champions
22341,254,59,202,3,5,5,13,Loyal Users
22363,822,7,11,2,2,1,5,Lost
22630,63,45,217,5,4,5,14,Champions
22748,1837,8,20,1,2,2,5,Lost
23293,3874,7,13,1,2,1,4,Lost
23724,562,6,10,2,1,1,4,Lost
24104,731,12,15,2,3,1,6,Casual Users
24226,81,114,153,4,5,5,14,Champions
24405,129,8,12,4,2,1,7,Promising
24413,788,9,13,2,2,1,5,Lost
24576,555,39,159,2,4,5,11,At Risk
25020,333,61,71,3,5,4,12,Loyal Users
25145,651,12,30,2,3,2,7,Casual Users
25444,3976,5,8,1,1,1,3,Lost
25530,1980,6,11,1,1,1,3,Lost
25537,2564,5,8,1,1,1,3,Lost
25870,1731,18,96,1,3,4,8,Casual Users
26066,2275,9,25,1,2,2,5,Lost
26283,20,24,38,5,4,3,12,Loyal Users
13659,27,28,59,5,4,3,12,Loyal Users
13674,1258,6,8,1,1,1,3,Lost
13825,1078,23,52,2,4,3,9,At Risk
13880,477,21,59,2,3,3,8,Casual Users
14003,368,12,64,3,3,4,10,Loyal Users
14052,2,10,32,5,2,3,10,Promising
14150,833,18,51,2,3,3,8,Casual Users
14389,1985,16,76,1,3,4,8,Casual Users
14643,174,47,85,3,5,4,12,Loyal Users
15145,10,218,399,5,5,5,15,Champions
15151,21,76,260,5,5,5,15,Champions
15171,622,5,21,2,1,2,5,Lost
15238,54,84,104,5,5,4,14,Champions
15259,2069,59,159,1,5,5,11,At Risk
15547,919,8,10,2,2,1,5,Lost
15812,78,24,89,4,4,4,12,Champions
16165,434,48,127,3,5,4,12,Loyal Users
16406,4568,5,5,1,1,1,3,Lost
16547,4,62,244,5,5,5,15,Champions
16613,2155,14,36,1,3,3,7,Casual Users
16756,102,130,532,4,5,5,14,Champions
16902,14,139,910,5,5,5,15,Champions
17058,686,7,9,2,2,1,5,Lost
17192,288,53,94,3,5,4,12,Loyal Users
17419,118,20,30,4,3,2,9,Loyal Users
17728,2939,36,128,1,4,4,9,At Risk
17830,165,30,305,4,4,5,13,Champions
17976,3587,60,165,1,5,5,11,At Risk
18044,381,7,69,3,2,4,9,Casual Users
18235,447,6,17,3,1,2,6,Casual Users
18375,1221,13,118,2,3,4,9,Casual Users
18401,118,39,91,4,4,4,12,Champions
18565,56,22,38,5,4,3,12,Loyal Users
18646,36,32,79,5,4,4,13,Champions
19214,827,15,47,2,3,3,8,Casual Users
19389,566,12,64,2,3,4,9,Casual Users
19836,203,57,135,3,5,4,12,Loyal Users
19974,3,57,404,5,5,5,15,Champions
20194,0,14,29,5,3,2,10,Loyal Users
20239,4,29,83,5,4,4,13,Champions
20429,27,7,31,5,2,2,9,Promising
20773,119,62,286,4,5,5,14,Champions
21308,723,15,22,2,3,2,7,Casual Users
21395,695,20,42,2,3,3,8,Casual Users
21472,0,96,209,5,5,5,15,Champions
21482,411,14,17,3,3,2,8,Loyal Users
21770,87,203,326,4,5,5,14,Champions
22243,44,32,81,5,4,4,13,Champions
22283,12,38,75,5,4,4,13,Champions
22327,35,57,210,5,5,5,15,Champions
22473,418,43,236,3,4,5,12,Loyal Users
22574,30,27,41,5,4,3,12,Loyal Users
22786,243,38,104,3,4,4,11,Loyal Users
22836,1121,11,24,2,2,2,6,Lost
23639,863,9,69,2,2,4,8,Lost
23720,353,47,77,3,5,4,12,Loyal Users
23811,240,8,11,3,2,1,6,Casual Users
23845,685,11,21,2,2,2,6,Lost
23905,84,17,32,4,3,3,10,Loyal Users
23912,5006,5,7,1,1,1,3,Lost
23922,829,14,92,2,3,4,9,Casual Users
24292,837,7,7,2,2,1,5,Lost
24525,739,27,57,2,4,3,9,At Risk
24527,2540,5,6,1,1,1,3,Lost
24662,529,7,30,2,2,2,6,Lost
25036,705,23,31,2,4,2,8,At Risk
25120,690,8,9,2,2,1,5,Lost
25192,96,6,12,4,1,1,6,Promising
25294,4117,9,24,1,2,2,5,Lost
25305,271,5,9,3,1,1,5,Casual Users
25466,228,111,590,3,5,5,13,Loyal Users
25493,144,71,373,4,5,5,14,Champions
25539,127,15,34,4,3,3,10,Loyal Users
25901,271,33,76,3,4,4,11,Loyal Users
26005,124,29,72,4,4,4,12,Champions
26124,0,224,419,5,5,5,15,Champions
26285,317,33,166,3,4,5,12,Loyal Users
26446,83,33,111,4,4,4,12,Champions
13696,1674,20,73,1,3,4,8,Casual Users
13784,102,51,328,4,5,5,14,Champions
13794,2888,13,31,1,3,2,6,Casual Users
14273,1694,5,13,1,1,1,3,Lost
14396,563,23,68,2,4,4,10,At Risk
14408,124,17,28,4,3,2,9,Loyal Users
14500,18,130,659,5,5,5,15,Champions
15128,697,42,72,2,4,4,10,At Risk
15280,12,66,157,5,5,5,15,Champions
15307,32,96,159,5,5,5,15,Champions
15753,135,8,11,4,2,1,7,Promising
15896,392,6,8,3,1,1,5,Casual Users
16327,957,7,12,2,2,1,5,Lost
16597,122,45,91,4,4,4,12,Champions
16745,169,15,41,3,3,3,9,Loyal Users
16981,732,10,70,2,2,4,8,Lost
17560,4730,5,10,1,1,1,3,Lost
17609,1,67,317,5,5,5,15,Champions
17652,90,23,47,4,4,3,11,Loyal Users
17698,2715,7,7,1,2,1,4,Lost
17732,3886,5,12,1,1,1,3,Lost
17789,502,11,47,2,2,3,7,Lost
18074,841,8,8,2,2,1,5,Lost
18253,5662,8,8,1,2,1,4,Lost
18423,1624,22,99,1,4,4,9,At Risk
18455,0,128,233,5,5,5,15,Champions
18585,1708,7,24,1,2,2,5,Lost
18774,121,17,31,4,3,2,9,Loyal Users
18905,38,37,60,5,4,3,12,Loyal Users
19097,394,10,14,3,2,1,6,Casual Users
19244,3683,5,16,1,1,2,4,Lost
19324,236,35,116,3,4,4,11,Loyal Users
19451,1124,8,14,2,2,1,5,Lost
19601,407,6,25,3,1,2,6,Casual Users
19703,25,141,240,5,5,5,15,Champions
20412,661,19,29,2,3,2,7,Casual Users
20435,278,50,135,3,5,4,12,Loyal Users
20634,410,17,18,3,3,2,8,Loyal Users
20677,1006,16,30,2,3,2,7,Casual Users
20934,213,14,65,3,3,4,10,Loyal Users
20981,117,42,108,4,4,4,12,Champions
21348,1384,12,37,1,3,3,7,Casual Users
21415,67,17,21,5,3,2,10,Loyal Users
21833,111,18,61,4,3,3,10,Loyal Users
21949,4517,5,18,1,1,2,4,Lost
22472,414,14,68,3,3,4,10,Loyal Users
22541,5533,11,43,1,2,3,6,Lost
22570,1025,16,97,2,3,4,9,Casual Users
22709,138,61,218,4,5,5,14,Champions
22767,1560,7,23,1,2,2,5,Lost
22946,172,18,48,3,3,3,9,Loyal Users
23188,8,26,69,5,4,4,13,Champions
23495,275,22,87,3,4,4,11,Loyal Users
23501,411,26,105,3,4,4,11,Loyal Users
23793,126,26,69,4,4,4,12,Champions
24026,112,7,81,4,2,4,10,Promising
24287,169,32,96,3,4,4,11,Loyal Users
24324,91,22,67,4,4,4,12,Champions
24333,3,58,95,5,5,4,14,Champions
24689,990,23,56,2,4,3,9,At Risk
24718,3117,12,17,1,3,2,6,Casual Users
24758,121,6,10,4,1,1,6,Promising
24868,717,14,73,2,3,4,9,Casual Users
25064,121,8,40,4,2,3,9,Promising
25449,1217,5,10,2,1,1,4,Lost
25461,601,8,15,2,2,1,5,Lost
25562,287,24,84,3,4,4,11,Loyal Users
25737,526,8,12,2,2,1,5,Lost
25897,2446,7,26,1,2,2,5,Lost
25924,98,25,37,4,4,3,11,Loyal Users
25978,264,7,30,3,2,2,7,Casual Users
25985,139,11,21,4,2,2,8,Promising
26035,1230,7,13,2,2,1,5,Lost
13630,1303,19,35,1,3,3,7,Casual Users
13675,105,61,171,4,5,5,14,Champions
13749,113,51,217,4,5,5,14,Champions
14228,784,19,120,2,3,4,9,Casual Users
14248,258,45,134,3,4,4,11,Loyal Users
14735,364,29,105,3,4,4,11,Loyal Users
14826,7,40,105,5,4,4,13,Champions
15010,42,113,251,5,5,5,15,Champions
15074,6,107,442,5,5,5,15,Champions
15200,12,30,117,5,4,4,13,Champions
15432,67,122,434,5,5,5,15,Champions
15876,1719,29,84,1,4,4,9,At Risk
15939,4668,9,14,1,2,1,4,Lost
16081,204,40,190,3,4,5,12,Loyal Users
16116,241,24,47,3,4,3,10,Loyal Users
16300,406,124,497,3,5,5,13,Loyal Users
16353,595,10,11,2,2,1,5,Lost
16513,84,44,195,4,4,5,13,Champions
16664,954,11,16,2,2,2,6,Lost
16863,1906,8,68,1,2,4,7,Lost
17167,681,8,95,2,2,4,8,Lost
17336,259,8,23,3,2,2,7,Casual Users
17394,408,113,360,3,5,5,13,Loyal Users
17570,2142,6,24,1,1,2,4,Lost
18313,76,60,477,4,5,5,14,Champions
18388,245,111,564,3,5,5,13,Loyal Users
18620,4302,11,32,1,2,3,6,Lost
18763,186,10,44,3,2,3,8,Casual Users
18810,1666,10,20,1,2,2,5,Lost
18842,421,64,247,3,5,5,13,Loyal Users
19560,6,57,98,5,5,4,14,Champions
19838,285,13,94,3,3,4,10,Loyal Users
19960,128,8,64,4,2,4,10,Promising
19991,4369,10,15,1,2,1,4,Lost
19997,2355,10,26,1,2,2,5,Lost
20550,697,27,63,2,4,4,10,At Risk
20710,695,12,40,2,3,3,8,Casual Users
20882,288,114,278,3,5,5,13,Loyal Users
21155,92,70,98,4,5,4,13,Champions
21251,133,17,61,4,3,3,10,Loyal Users
21279,844,14,31,2,3,2,7,Casual Users
21342,534,35,67,2,4,4,10,At Risk
21503,0,15,42,5,3,3,11,Loyal Users
21513,19,32,89,5,4,4,13,Champions
21551,119,28,80,4,4,4,12,Champions
21618,158,33,38,4,4,3,11,Loyal Users
21620,117,42,187,4,4,5,13,Champions
22400,299,51,164,3,5,5,13,Loyal Users
22671,220,11,48,3,2,3,8,Casual Users
22881,24,25,36,5,4,3,12,Loyal Users
23914,131,109,343,4,5,5,14,Champions
24000,1718,10,19,1,2,2,5,Lost
24068,30,129,564,5,5,5,15,Champions
24563,635,32,36,2,4,3,9,At Risk
24739,547,66,219,2,5,5,12,At Risk
24754,142,16,57,4,3,3,10,Loyal Users
24882,71,30,96,4,4,4,12,Champions
25287,37,115,660,5,5,5,15,Champions
25313,216,54,230,3,5,5,13,Loyal Users
25346,198,29,110,3,4,4,11,Loyal Users
25917,181,26,55,3,4,3,10,Loyal Users
26046,717,116,222,2,5,5,12,At Risk
26089,333,57,133,3,5,4,12,Loyal Users
26112,56,23,56,5,4,3,12,Loyal Users
26162,185,19,89,3,3,4,10,Loyal Users
26185,20,67,169,5,5,5,15,Champions
13634,1088,11,16,2,2,2,6,Lost
13959,1709,13,86,1,3,4,8,Casual Users
14166,50,16,27,5,3,2,10,Loyal Users
14282,1158,5,11,2,1,1,4,Lost
14472,112,78,230,4,5,5,14,Champions
15501,1561,13,27,1,3,2,6,Casual Users
15607,2754,21,197,1,3,5,9,Casual Users
15646,81,64,172,4,5,5,14,Champions
16001,128,32,100,4,4,4,12,Champions
16185,390,50,137,3,5,4,12,Loyal Users
16226,343,12,28,3,3,2,8,Loyal Users
16507,7,47,95,5,5,4,14,Champions
16576,5,51,133,5,5,4,14,Champions
16587,4,18,183,5,3,5,13,Loyal Users
16747,146,16,86,4,3,4,11,Loyal Users
16805,11,50,70,5,5,4,14,Champions
16806,176,14,68,3,3,4,10,Loyal Users
17274,3928,9,13,1,2,1,4,Lost
17357,257,5,19,3,1,2,6,Casual Users
17757,2865,11,13,1,2,1,4,Lost
17767,1592,8,24,1,2,2,5,Lost
17949,538,15,31,2,3,2,7,Casual Users
17980,1464,7,14,1,2,1,4,Lost
18080,785,5,53,2,1,3,6,Lost
18403,174,15,18,3,3,2,8,Loyal Users
18441,249,21,37,3,3,3,9,Loyal Users
18659,93,28,130,4,4,4,12,Champions
18859,527,6,9,2,1,1,4,Lost
18982,1242,13,100,2,3,4,9,Casual Users
19441,318,31,77,3,4,4,11,Loyal Users
19538,12,16,16,5,3,2,10,Loyal Users
19968,179,16,55,3,3,3,9,Loyal Users
20699,92,86,442,4,5,5,14,Champions
20813,162,17,73,4,3,4,11,Loyal Users
20845,295,6,11,3,1,1,5,Casual Users
20883,797,5,6,2,1,1,4,Lost
20971,69,58,144,5,5,4,14,Champions
21052,26,146,477,5,5,5,15,Champions
21216,127,64,147,4,5,5,14,Champions
21450,1844,6,22,1,1,2,4,Lost
21670,29,21,74,5,3,4,12,Loyal Users
21841,806,23,31,2,4,2,8,At Risk
22120,11,86,213,5,5,5,15,Champions
22484,819,23,105,2,4,4,10,At Risk
22776,577,6,9,2,1,1,4,Lost
23208,110,11,186,4,2,5,11,Promising
23220,84,10,37,4,2,3,9,Promising
23625,129,10,58,4,2,3,9,Promising
23738,2118,6,18,1,1,2,4,Lost
23908,476,10,16,2,2,2,6,Lost
23935,1360,26,28,1,4,2,7,At Risk
24042,2289,6,23,1,1,2,4,Lost
24265,850,8,18,2,2,2,6,Lost
24341,3715,9,77,1,2,4,7,Lost
24404,640,16,63,2,3,4,9,Casual Users
24775,179,20,28,3,3,2,8,Loyal Users
24870,125,64,78,4,5,4,13,Champions
25072,4654,6,23,1,1,2,4,Lost
25128,1133,5,8,2,1,1,4,Lost
25253,935,7,36,2,2,3,7,Lost
25445,15,29,40,5,4,3,12,Loyal Users
25475,260,20,67,3,3,4,10,Loyal Users
25488,40,26,134,5,4,4,13,Champions
25573,3840,23,72,1,4,4,9,At Risk
25733,142,50,159,4,5,5,14,Champions
26104,672,6,6,2,1,1,4,Lost
26143,161,8,10,4,2,1,7,Promising
26399,575,29,72,2,4,4,10,At Risk
13768,2,140,336,5,5,5,15,Champions
13855,4,53,103,5,5,4,14,Champions
13961,154,5,38,4,1,3,8,Promising
14156,96,34,47,4,4,3,11,Loyal Users
14275,2978,10,11,1,2,1,4,Lost
14339,1076,23,47,2,4,3,9,At Risk
14637,80,74,148,4,5,5,14,Champions
14654,73,114,344,4,5,5,14,Champions
15114,111,60,174,4,5,5,14,Champions
15133,466,10,11,3,2,1,6,Casual Users
15169,2,155,768,5,5,5,15,Champions
15241,1159,5,5,2,1,1,4,Lost
15367,0,210,520,5,5,5,15,Champions
15413,603,10,23,2,2,2,6,Lost
15934,150,24,39,4,4,3,11,Loyal Users
16247,537,14,92,2,3,4,9,Casual Users
16336,75,17,23,4,3,2,9,Loyal Users
16536,77,30,69,4,4,4,12,Champions
16767,783,5,66,2,1,4,7,Lost
16979,2687,10,12,1,2,1,4,Lost
17186,150,19,37,4,3,3,10,Loyal Users
17330,3262,5,5,1,1,1,3,Lost
17342,19,92,490,5,5,5,15,Champions
17407,483,26,46,2,4,3,9,At Risk
17477,86,58,145,4,5,4,13,Champions
17629,284,39,266,3,4,5,12,Loyal Users
17655,406,81,197,3,5,5,13,Loyal Users
17847,11,134,1044,5,5,5,15,Champions
18271,388,29,40,3,4,3,10,Loyal Users
18324,290,47,63,3,5,4,12,Loyal Users
18497,541,13,72,2,3,4,9,Casual Users
18616,723,9,23,2,2,2,6,Lost
19005,1013,12,42,2,3,3,8,Casual Users
19166,255,7,8,3,2,1,6,Casual Users
19263,4249,5,11,1,1,1,3,Lost
19288,435,39,85,3,4,4,11,Loyal Users
19318,156,30,58,4,4,3,11,Loyal Users
19759,271,30,88,3,4,4,11,Loyal Users
19954,864,6,21,2,1,2,5,Lost
20128,90,44,79,4,4,4,12,Champions
20136,44,19,71,5,3,4,12,Loyal Users
20183,394,38,62,3,4,3,10,Loyal Users
20191,3998,6,12,1,1,1,3,Lost
20277,3414,6,14,1,1,1,3,Lost
20374,135,25,81,4,4,4,12,Champions
20831,84,31,155,4,4,5,13,Champions
20846,122,33,64,4,4,4,12,Champions
20974,26,92,410,5,5,5,15,Champions
21044,266,34,55,3,4,3,10,Loyal Users
21108,563,18,90,2,3,4,9,Casual Users
21346,532,5,20,2,1,2,5,Lost
21546,120,5,12,4,1,1,6,Promising
21671,117,36,69,4,4,4,12,Champions
22017,22,8,19,5,2,2,9,Promising
22102,1290,11,22,1,2,2,5,Lost
22266,1268,13,22,1,3,2,6,Casual Users
22510,133,7,42,4,2,3,9,Promising
22542,676,11,14,2,2,1,5,Lost
22605,2028,13,58,1,3,3,7,Casual Users
22729,173,35,198,3,4,5,12,Loyal Users
22973,814,10,22,2,2,2,6,Lost
23401,130,18,103,4,3,4,11,Loyal Users
23884,137,7,39,4,2,3,9,Promising
23998,1287,9,31,1,2,2,5,Lost
24079,11,10,100,5,2,4,11,Promising
24443,2407,7,41,1,2,3,6,Lost
24538,116,24,76,4,4,4,12,Champions
24595,553,71,167,2,5,5,12,At Risk
24600,626,12,27,2,3,2,7,Casual Users
24670,726,13,20,2,3,2,7,Casual Users
24860,142,46,130,4,5,4,13,Champions
25000,407,12,31,3,3,2,8,Loyal Users
25360,17,182,380,5,5,5,15,Champions
25832,34,78,259,5,5,5,15,Champions
25925,1870,7,25,1,2,2,5,Lost
26004,1720,7,13,1,2,1,4,Lost
26198,275,75,184,3,5,5,13,Loyal Users
26242,281,19,27,3,3,2,8,Loyal Users
26394,304,6,25,3,1,2,6,Casual Users
13597,3743,14,26,1,3,2,6,Casual Users
13670,437,7,11,3,2,1,6,Casual Users
13892,532,39,143,2,4,4,10,At Risk
14070,92,80,403,4,5,5,14,Champions
14234,245,54,418,3,5,5,13,Loyal Users
14475,672,96,143,2,5,4,11,At Risk
14518,2406,6,6,1,1,1,3,Lost
14615,689,118,176,2,5,5,12,At Risk
14882,515,7,16,2,2,2,6,Lost
14890,67,27,300,5,4,5,14,Champions
14896,3084,7,10,1,2,1,4,Lost
15626,577,24,34,2,4,3,9,At Risk
15695,19,86,289,5,5,5,15,Champions
16098,440,20,51,3,3,3,9,Loyal Users
16319,2553,6,16,1,1,2,4,Lost
16446,547,35,115,2,4,4,10,At Risk
16694,1682,7,7,1,2,1,4,Lost
16716,670,25,63,2,4,4,10,At Risk
16736,281,35,133,3,4,4,11,Loyal Users
16920,2118,5,14,1,1,1,3,Lost
17023,542,34,127,2,4,4,10,At Risk
17510,526,15,24,2,3,2,7,Casual Users
17759,309,5,5,3,1,1,5,Casual Users
17843,735,6,24,2,1,2,5,Lost
17948,3626,6,7,1,1,1,3,Lost
18027,455,7,13,3,2,1,6,Casual Users
18319,993,20,142,2,3,4,9,Casual Users
18372,115,8,18,4,2,2,8,Promising
18472,1093,9,25,2,2,2,6,Lost
18571,446,12,15,3,3,1,7,Loyal Users
18700,143,5,27,4,1,2,7,Promising
19033,424,13,39,3,3,3,9,Loyal Users
19453,3,37,228,5,4,5,14,Champions
19770,727,12,21,2,3,2,7,Casual Users
19864,34,30,113,5,4,4,13,Champions
20237,140,54,94,4,5,4,13,Champions
20523,0,152,847,5,5,5,15,Champions
20730,1061,7,17,2,2,2,6,Lost
20756,438,11,17,3,2,2,7,Casual Users
21249,431,37,89,3,4,4,11,Loyal Users
21324,3916,6,6,1,1,1,3,Lost
21402,830,9,11,2,2,1,5,Lost
21418,8,17,80,5,3,4,12,Loyal Users
21464,1,8,18,5,2,2,9,Promising
21863,2707,7,22,1,2,2,5,Lost
21927,163,65,135,4,5,4,13,Champions
22488,5,40,230,5,4,5,14,Champions
22499,4171,6,12,1,1,1,3,Lost
22850,53,89,159,5,5,5,15,Champions
23020,794,6,25,2,1,2,5,Lost
23084,827,8,9,2,2,1,5,Lost
23087,15,36,126,5,4,4,13,Champions
23212,887,19,68,2,3,4,9,Casual Users
23262,824,37,101,2,4,4,10,At Risk
23291,914,15,25,2,3,2,7,Casual Users
23335,77,10,17,4,2,2,8,Promising
23359,2039,8,19,1,2,2,5,Lost
23638,36,11,34,5,2,3,10,Promising
23757,51,93,297,5,5,5,15,Champions
23856,39,127,454,5,5,5,15,Champions
23961,1977,52,181,1,5,5,11,At Risk
24020,226,97,517,3,5,5,13,Loyal Users
24021,539,12,24,2,3,2,7,Casual Users
24035,81,71,220,4,5,5,14,Champions
24099,5485,6,50,1,1,3,5,Lost
24382,428,7,48,3,2,3,8,Casual Users
24550,13,10,11,5,2,1,8,Promising
24667,1515,7,14,1,2,1,4,Lost
13633,160,45,158,4,4,5,13,Champions
13654,5315,6,63,1,1,4,6,Lost
13761,732,13,63,2,3,4,9,Casual Users
13802,1396,12,32,1,3,3,7,Casual Users
14363,1114,19,30,2,3,2,7,Casual Users
14444,2,79,361,5,5,5,15,Champions
14483,1146,13,16,2,3,2,7,Casual Users
14675,955,15,32,2,3,3,8,Casual Users
14823,2172,23,39,1,4,3,8,At Risk
14864,811,7,9,2,2,1,5,Lost
14906,99,57,212,4,5,5,14,Champions
15057,780,28,51,2,4,3,9,At Risk
15311,155,10,96,4,2,4,10,Promising
15590,72,5,15,4,1,1,6,Promising
15785,2136,45,154,1,4,5,10,At Risk
15870,285,8,14,3,2,1,6,Casual Users
16122,219,30,119,3,4,4,11,Loyal Users
16147,13,49,170,5,5,5,15,Champions
16315,2805,6,20,1,1,2,4,Lost
16540,262,12,39,3,3,3,9,Loyal Users
16655,648,6,6,2,1,1,4,Lost
17104,529,14,62,2,3,3,8,Casual Users
17634,124,12,128,4,3,4,11,Loyal Users
17705,29,25,49,5,4,3,12,Loyal Users
17806,15,20,39,5,3,3,11,Loyal Users
18285,1683,15,63,1,3,4,8,Casual Users
18651,2625,5,6,1,1,1,3,Lost
18983,213,33,160,3,4,5,12,Loyal Users
19029,87,20,33,4,3,3,10,Loyal Users
19259,212,24,118,3,4,4,11,Loyal Users
19320,285,23,118,3,4,4,11,Loyal Users
19583,2,99,236,5,5,5,15,Champions
19676,4848,5,8,1,1,1,3,Lost
19706,16,6,10,5,1,1,7,Promising
20057,9,58,116,5,5,4,14,Champions
20399,3431,5,7,1,1,1,3,Lost
20456,4757,7,8,1,2,1,4,Lost
20515,485,9,11,2,2,1,5,Lost
20746,39,40,85,5,4,4,13,Champions
20751,472,6,16,2,1,2,5,Lost
20843,74,9,38,4,2,3,9,Promising
20936,29,24,43,5,4,3,12,Loyal Users
21384,880,106,262,2,5,5,12,At Risk
21433,2295,9,36,1,2,3,6,Lost
21468,683,21,89,2,3,4,9,Casual Users
21696,101,15,21,4,3,2,9,Loyal Users
21953,110,93,435,4,5,5,14,Champions
22075,318,5,7,3,1,1,5,Casual Users
22178,8,33,103,5,4,4,13,Champions
22259,66,15,38,5,3,3,11,Loyal Users
22287,1862,16,25,1,3,2,6,Casual Users
22490,6,12,18,5,3,2,10,Loyal Users
22849,709,17,48,2,3,3,8,Casual Users
22929,203,8,12,3,2,1,6,Casual Users
22936,2148,12,45,1,3,3,7,Casual Users
23150,3794,5,22,1,1,2,4,Lost
23228,77,18,68,4,3,4,11,Loyal Users
23331,164,34,75,4,4,4,12,Champions
23363,2393,6,10,1,1,1,3,Lost
24123,971,6,21,2,1,2,5,Lost
24179,3289,7,18,1,2,2,5,Lost
24195,1537,5,6,1,1,1,3,Lost
24445,92,112,233,4,5,5,14,Champions
24478,240,18,22,3,3,2,8,Loyal Users
24774,862,6,7,2,1,1,4,Lost
24788,164,22,66,4,4,4,12,Champions
24821,1442,5,15,1,1,1,3,Lost
25044,459,28,143,3,4,4,11,Loyal Users
25384,92,77,352,4,5,5,14,Champions
25542,598,5,9,2,1,1,4,Lost
25687,33,27,100,5,4,4,13,Champions
25797,28,42,167,5,4,5,14,Champions
25848,1233,6,32,2,1,3,6,Lost
25934,401,12,17,3,3,2,8,Loyal Users
26095,5198,6,6,1,1,1,3,Lost
13652,202,12,97,3,3,4,10,Loyal Users
13844,687,9,28,2,2,2,6,Lost
14025,2917,6,13,1,1,1,3,Lost
14131,421,27,101,3,4,4,11,Loyal Users
14510,4976,6,14,1,1,1,3,Lost
14640,17,109,220,5,5,5,15,Champions
14657,236,32,68,3,4,4,11,Loyal Users
14793,2367,9,10,1,2,1,4,Lost
15066,74,31,84,4,4,4,12,Champions
15113,4283,12,23,1,3,2,6,Casual Users
16176,1538,10,23,1,2,2,5,Lost
16552,96,19,32,4,3,3,10,Loyal Users
16820,3,62,161,5,5,5,15,Champions
16926,21,41,120,5,4,4,13,Champions
17571,2585,8,12,1,2,1,4,Lost
17572,108,62,203,4,5,5,14,Champions
17864,90,13,84,4,3,4,11,Loyal Users
18099,144,7,33,4,2,3,9,Promising
18311,1555,17,55,1,3,3,7,Casual Users
18649,21,60,134,5,5,4,14,Champions
18664,1301,8,27,1,2,2,5,Lost
18698,319,9,10,3,2,1,6,Casual Users
18797,4,21,36,5,3,3,11,Loyal Users
19973,264,39,224,3,4,5,12,Loyal Users
20047,1563,10,44,1,2,3,6,Lost
20117,4978,33,136,1,4,4,9,At Risk
20145,1262,8,47,1,2,3,6,Lost
20198,936,14,22,2,3,2,7,Casual Users
20289,45,10,63,5,2,4,11,Promising
20423,7,33,90,5,4,4,13,Champions
20780,80,62,299,4,5,5,14,Champions
21092,2327,6,7,1,1,1,3,Lost
21199,5336,5,23,1,1,2,4,Lost
21305,1850,15,54,1,3,3,7,Casual Users
21485,114,6,8,4,1,1,6,Promising
21591,114,61,270,4,5,5,14,Champions
21708,273,71,353,3,5,5,13,Loyal Users
21793,75,39,127,4,4,4,12,Champions
21899,116,55,98,4,5,4,13,Champions
22026,1010,10,59,2,2,3,7,Lost
23041,130,10,18,4,2,2,8,Promising
23644,141,17,25,4,3,2,9,Loyal Users
24080,4726,5,6,1,1,1,3,Lost
24166,275,13,25,3,3,2,8,Loyal Users
24222,770,5,6,2,1,1,4,Lost
24533,217,8,16,3,2,2,7,Casual Users
25083,138,21,54,4,3,3,10,Loyal Users
25236,730,21,206,2,3,5,10,Casual Users
25556,3185,7,14,1,2,1,4,Lost
25594,405,19,43,3,3,3,9,Loyal Users
25691,224,19,45,3,3,3,9,Loyal Users
25738,1708,8,34,1,2,3,6,Lost
25744,119,23,133,4,4,4,12,Champions
25795,432,6,9,3,1,1,5,Casual Users
25995,1658,5,8,1,1,1,3,Lost
26407,334,5,24,3,1,2,6,Casual Users
26443,125,5,5,4,1,1,6,Promising
13650,1950,5,6,1,1,1,3,Lost
13982,440,30,45,3,4,3,10,Loyal Users
14004,514,17,49,2,3,3,8,Casual Users
14006,9,30,47,5,4,3,12,Loyal Users
14008,294,44,136,3,4,4,11,Loyal Users
14080,2122,10,20,1,2,2,5,Lost
14403,247,16,25,3,3,2,8,Loyal Users
14649,1560,40,278,1,4,5,10,At Risk
14799,520,6,13,2,1,1,4,Lost
14918,265,8,21,3,2,2,7,Casual Users
15247,38,8,48,5,2,3,10,Promising
15408,4,16,81,5,3,4,12,Loyal Users
15688,3662,5,9,1,1,1,3,Lost
15797,320,13,28,3,3,2,8,Loyal Users
15928,1230,6,11,2,1,1,4,Lost
15947,32,83,172,5,5,5,15,Champions
16014,242,19,41,3,3,3,9,Loyal Users
16541,56,133,425,5,5,5,15,Champions
16719,771,12,39,2,3,3,8,Casual Users
16842,50,18,58,5,3,3,11,Loyal Users
16910,261,16,55,3,3,3,9,Loyal Users
17056,530,63,76,2,5,4,11,At Risk
17080,551,6,9,2,1,1,4,Lost
17230,107,61,156,4,5,5,14,Champions
17362,323,9,10,3,2,1,6,Casual Users
17515,566,9,18,2,2,2,6,Lost
17722,97,10,15,4,2,1,7,Promising
17899,1957,10,33,1,2,3,6,Lost
17938,833,32,131,2,4,4,10,At Risk
18762,1998,6,47,1,1,3,5,Lost
18771,4927,12,13,1,3,1,5,Casual Users
18832,696,12,84,2,3,4,9,Casual Users
19027,5158,9,9,1,2,1,4,Lost
19457,732,35,71,2,4,4,10,At Risk
19479,1400,13,39,1,3,3,7,Casual Users
19839,58,8,16,5,2,2,9,Promising
20231,132,45,59,4,4,3,11,Loyal Users
20358,2260,9,11,1,2,1,4,Lost
20718,868,11,55,2,2,3,7,Lost
20944,397,28,64,3,4,4,11,Loyal Users
21094,142,19,79,4,3,4,11,Loyal Users
21366,773,12,15,2,3,1,6,Casual Users
21455,263,7,13,3,2,1,6,Casual Users
21535,170,87,445,3,5,5,13,Loyal Users
21582,3073,9,17,1,2,2,5,Lost
21843,131,8,18,4,2,2,8,Promising
21971,11,88,139,5,5,4,14,Champions
22083,449,12,46,3,3,3,9,Loyal Users
22206,96,55,94,4,5,4,13,Champions
23106,128,11,20,4,2,2,8,Promising
23332,431,15,168,3,3,5,11,Loyal Users
23650,345,73,241,3,5,5,13,Loyal Users
23907,513,6,18,2,1,2,5,Lost
24439,2884,8,10,1,2,1,4,Lost
24639,5,90,153,5,5,5,15,Champions
24714,552,35,74,2,4,4,10,At Risk
24846,1219,7,11,2,2,1,5,Lost
24989,844,14,26,2,3,2,7,Casual Users
25813,410,5,6,3,1,1,5,Casual Users
25907,8,35,91,5,4,4,13,Champions
26216,2545,20,52,1,3,3,7,Casual Users
26371,6,124,356,5,5,5,15,Champions
13737,2443,9,19,1,2,2,5,Lost
13786,124,5,8,4,1,1,6,Promising
13791,1,126,513,5,5,5,15,Champions
13803,5,153,530,5,5,5,15,Champions
13908,4,41,302,5,4,5,14,Champions
14126,298,6,13,3,1,1,5,Casual Users
14145,113,25,76,4,4,4,12,Champions
14152,154,10,33,4,2,3,9,Promising
14208,400,11,56,3,2,3,8,Casual Users
14522,400,70,161,3,5,5,13,Loyal Users
14524,1724,7,39,1,2,3,6,Lost
14533,69,51,152,5,5,5,15,Champions
14941,80,8,14,4,2,1,7,Promising
15039,740,9,25,2,2,2,6,Lost
15189,17,24,127,5,4,4,13,Champions
15466,14,15,40,5,3,3,11,Loyal Users
16120,66,40,130,5,4,4,13,Champions
16355,22,11,41,5,2,3,10,Promising
16666,1853,8,30,1,2,2,5,Lost
16733,17,85,664,5,5,5,15,Champions
16746,824,8,11,2,2,1,5,Lost
16840,1837,5,10,1,1,1,3,Lost
16905,68,95,171,5,5,5,15,Champions
17246,615,9,43,2,2,3,7,Lost
17324,384,14,46,3,3,3,9,Loyal Users
17373,402,39,141,3,4,4,11,Loyal Users
17385,95,11,25,4,2,2,8,Promising
17594,117,19,21,4,3,2,9,Loyal Users
18007,125,8,9,4,2,1,7,Promising
18544,483,14,169,2,3,5,10,Casual Users
18898,1992,7,11,1,2,1,4,Lost
18918,547,5,10,2,1,1,4,Lost
18989,407,16,76,3,3,4,10,Loyal Users
19283,170,19,19,3,3,2,8,Loyal Users
19620,275,10,29,3,2,2,7,Casual Users
19740,110,14,157,4,3,5,12,Loyal Users
19790,851,5,5,2,1,1,4,Lost
20036,837,14,167,2,3,5,10,Casual Users
20414,402,10,13,3,2,1,6,Casual Users
20561,107,97,225,4,5,5,14,Champions
20713,262,15,23,3,3,2,8,Loyal Users
20911,274,29,37,3,4,3,10,Loyal Users
21021,22,19,38,5,3,3,11,Loyal Users
21082,23,47,260,5,5,5,15,Champions
21408,1213,5,8,2,1,1,4,Lost
21750,19,50,108,5,5,4,14,Champions
21941,114,57,92,4,5,4,13,Champions
22342,507,12,25,2,3,2,7,Casual Users
22345,1799,7,17,1,2,2,5,Lost
22347,8,108,341,5,5,5,15,Champions
22448,1476,17,22,1,3,2,6,Casual Users
22563,161,43,97,4,4,4,12,Champions
22618,446,15,33,3,3,3,9,Loyal Users
22831,448,9,22,3,2,2,7,Casual Users
22835,84,15,20,4,3,2,9,Loyal Users
23001,146,22,43,4,4,3,11,Loyal Users
23060,122,28,95,4,4,4,12,Champions
23116,392,27,112,3,4,4,11,Loyal Users
23563,7,20,95,5,3,4,12,Loyal Users
23707,110,30,73,4,4,4,12,Champions
23788,0,22,127,5,4,4,13,Champions
24008,317,8,22,3,2,2,7,Casual Users
24207,3609,7,7,1,2,1,4,Lost
24776,251,11,13,3,2,1,6,Casual Users
25335,5,11,31,5,2,2,9,Promising
25617,683,35,123,2,4,4,10,At Risk
26340,1118,9,19,2,2,2,6,Lost
13621,103,19,52,4,3,3,10,Loyal Users
14084,47,107,519,5,5,5,15,Champions
14508,3223,7,8,1,2,1,4,Lost
14746,3876,9,13,1,2,1,4,Lost
14811,995,14,108,2,3,4,9,Casual Users
14968,133,5,52,4,1,3,8,Promising
15419,2,8,18,5,2,2,9,Promising
15463,6,51,123,5,5,4,14,Champions
16088,18,41,196,5,4,5,14,Champions
16099,5003,11,16,1,2,2,5,Lost
16146,259,34,78,3,4,4,11,Loyal Users
16697,420,5,11,3,1,1,5,Casual Users
16764,1500,82,178,1,5,5,11,At Risk
17319,632,7,46,2,2,3,7,Lost
17429,168,8,17,3,2,2,7,Casual Users
17615,243,5,19,3,1,2,6,Casual Users
18035,1585,15,87,1,3,4,8,Casual Users
18241,26,21,92,5,3,4,12,Loyal Users
18361,82,51,178,4,5,5,14,Champions
18471,2401,11,35,1,2,3,6,Lost
18576,236,10,37,3,2,3,8,Casual Users
18938,2703,9,38,1,2,3,6,Lost
18955,414,8,13,3,2,1,6,Casual Users
19060,120,27,78,4,4,4,12,Champions
19146,31,107,350,5,5,5,15,Champions
19782,92,10,23,4,2,2,8,Promising
19927,475,8,16,2,2,2,6,Lost
20304,254,14,38,3,3,3,9,Loyal Users
20365,837,23,58,2,4,3,9,At Risk
20532,15,21,72,5,3,4,12,Loyal Users
20569,23,55,114,5,5,4,14,Champions
20649,144,9,27,4,2,2,8,Promising
20737,1538,10,19,1,2,2,5,Lost
20986,506,11,16,2,2,2,6,Lost
21023,2143,14,15,1,3,1,5,Casual Users
21409,103,99,388,4,5,5,14,Champions
21442,226,7,13,3,2,1,6,Casual Users
21556,126,103,285,4,5,5,14,Champions
21650,2758,8,34,1,2,3,6,Lost
21721,136,24,40,4,4,3,11,Loyal Users
22112,1574,14,35,1,3,3,7,Casual Users
22391,175,29,41,3,4,3,10,Loyal Users
22421,405,60,156,3,5,5,13,Loyal Users
22470,2086,8,9,1,2,1,4,Lost
22586,0,29,47,5,4,3,12,Loyal Users
22587,235,38,84,3,4,4,11,Loyal Users
22818,122,47,107,4,5,4,13,Champions
22998,65,116,559,5,5,5,15,Champions
23325,256,16,23,3,3,2,8,Loyal Users
23414,37,100,386,5,5,5,15,Champions
23454,665,10,10,2,2,1,5,Lost
23652,2728,6,7,1,1,1,3,Lost
23762,143,13,20,4,3,2,9,Loyal Users
24132,342,6,17,3,1,2,6,Casual Users
24192,0,13,141,5,3,4,12,Loyal Users
24423,272,69,130,3,5,4,12,Loyal Users
24475,221,87,335,3,5,5,13,Loyal Users
24574,11,78,208,5,5,5,15,Champions
24741,1530,31,228,1,4,5,10,At Risk
24757,90,46,390,4,5,5,14,Champions
25226,572,21,103,2,3,4,9,Casual Users
25351,1512,15,99,1,3,4,8,Casual Users
25460,333,6,7,3,1,1,5,Casual Users
25510,1011,8,47,2,2,3,7,Lost
25651,166,11,75,3,2,4,9,Casual Users
26160,756,7,11,2,2,1,5,Lost
26241,57,53,91,5,5,4,14,Champions
13688,420,12,37,3,3,3,9,Loyal Users
13721,794,115,363,2,5,5,12,At Risk
13722,807,6,22,2,1,2,5,Lost
13812,2407,9,13,1,2,1,4,Lost
13914,609,15,57,2,3,3,8,Casual Users
14276,1577,18,200,1,3,5,9,Casual Users
14280,244,8,77,3,2,4,9,Casual Users
14353,832,35,114,2,4,4,10,At Risk
14548,28,127,231,5,5,5,15,Champions
14579,34,77,123,5,5,4,14,Champions
15476,1436,8,14,1,2,1,4,Lost
15901,7,134,421,5,5,5,15,Champions
16612,1118,20,35,2,3,3,8,Casual Users
16628,2498,9,20,1,2,2,5,Lost
16829,51,5,15,5,1,1,7,Promising
17249,411,32,52,3,4,3,10,Loyal Users
17286,0,58,160,5,5,5,15,Champions
17760,1097,8,20,2,2,2,6,Lost
17896,35,125,458,5,5,5,15,Champions
17991,424,8,17,3,2,2,7,Casual Users
18008,449,12,54,3,3,3,9,Loyal Users
18518,572,6,23,2,1,2,5,Lost
18809,446,6,8,3,1,1,5,Casual Users
18922,1178,6,7,2,1,1,4,Lost
19101,107,8,14,4,2,1,7,Promising
19195,668,18,33,2,3,3,8,Casual Users
19222,57,47,92,5,5,4,14,Champions
19464,191,9,11,3,2,1,6,Casual Users
19550,4024,11,14,1,2,1,4,Lost
19610,8,71,144,5,5,4,14,Champions
20229,132,38,74,4,4,4,12,Champions
20951,127,12,17,4,3,2,9,Loyal Users
21181,3656,6,10,1,1,1,3,Lost
21396,3121,18,48,1,3,3,7,Casual Users
21587,1373,12,14,1,3,1,5,Casual Users
21743,384,23,43,3,4,3,10,Loyal Users
21858,439,25,60,3,4,3,10,Loyal Users
22012,1193,76,397,2,5,5,12,At Risk
22169,99,26,247,4,4,5,13,Champions
22277,2507,8,34,1,2,3,6,Lost
22620,129,20,60,4,3,3,10,Loyal Users
22842,165,22,53,4,4,3,11,Loyal Users
22920,566,6,9,2,1,1,4,Lost
23554,2507,7,25,1,2,2,5,Lost
23730,1213,19,59,2,3,3,8,Casual Users
23883,307,36,63,3,4,4,11,Loyal Users
23930,2689,9,58,1,2,3,6,Lost
24205,2458,7,13,1,2,1,4,Lost
24224,1550,7,14,1,2,1,4,Lost
24361,1223,6,20,2,1,2,5,Lost
24386,33,5,30,5,1,2,8,Promising
24695,926,10,40,2,2,3,7,Lost
24838,1391,6,20,1,1,2,4,Lost
24872,288,15,31,3,3,2,8,Loyal Users
25103,125,16,22,4,3,2,9,Loyal Users
25341,525,77,106,2,5,4,11,At Risk
25380,81,23,42,4,4,3,11,Loyal Users
25476,125,88,182,4,5,5,14,Champions
25929,981,10,13,2,2,1,5,Lost
25966,1407,12,19,1,3,2,6,Casual Users
26175,1001,14,28,2,3,2,7,Casual Users
26416,229,8,50,3,2,3,8,Casual Users
13616,87,7,23,4,2,2,8,Promising
13955,4,124,250,5,5,5,15,Champions
14662,167,8,76,3,2,4,9,Casual Users
15379,230,19,25,3,3,2,8,Loyal Users
15662,163,13,28,4,3,2,9,Loyal Users
15752,92,46,108,4,5,4,13,Champions
15884,843,22,101,2,4,4,10,At Risk
15916,134,12,27,4,3,2,9,Loyal Users
16142,237,6,41,3,1,3,7,Casual Users
16371,138,139,361,4,5,5,14,Champions
16627,2716,6,7,1,1,1,3,Lost
16720,699,25,100,2,4,4,10,At Risk
16826,5161,10,37,1,2,3,6,Lost
17636,16,44,67,5,4,4,13,Champions
17958,1990,17,22,1,3,2,6,Casual Users
18121,414,66,339,3,5,5,13,Loyal Users
18139,50,57,138,5,5,4,14,Champions
18213,101,23,38,4,4,3,11,Loyal Users
18369,23,9,15,5,2,1,8,Promising
18486,1996,14,41,1,3,3,7,Casual Users
18780,2716,17,27,1,3,2,6,Casual Users
18899,329,8,8,3,2,1,6,Casual Users
18960,61,73,368,5,5,5,15,Champions
19030,57,112,403,5,5,5,15,Champions
19272,260,29,89,3,4,4,11,Loyal Users
19285,2006,14,25,1,3,2,6,Casual Users
19369,411,25,32,3,4,3,10,Loyal Users
19458,242,9,40,3,2,3,8,Casual Users
19519,966,17,71,2,3,4,9,Casual Users
19987,3,28,65,5,4,4,13,Champions
20206,458,66,348,3,5,5,13,Loyal Users
20352,408,23,59,3,4,3,10,Loyal Users
20794,293,10,12,3,2,1,6,Casual Users
20797,955,36,147,2,4,5,11,At Risk
21285,106,10,18,4,2,2,8,Promising
21375,4188,6,8,1,1,1,3,Lost
21510,21,50,243,5,5,5,15,Champions
21752,80,12,34,4,3,3,10,Loyal Users
21856,852,9,9,2,2,1,5,Lost
22284,64,167,568,5,5,5,15,Champions
22344,700,7,10,2,2,1,5,Lost
22465,79,79,470,4,5,5,14,Champions
22539,1248,7,19,2,2,2,6,Lost
22749,388,30,57,3,4,3,10,Loyal Users
22778,1560,7,9,1,2,1,4,Lost
22798,206,10,11,3,2,1,6,Casual Users
23013,104,34,115,4,4,4,12,Champions
23021,1002,6,20,2,1,2,5,Lost
23039,840,6,28,2,1,2,5,Lost
23121,2237,7,42,1,2,3,6,Lost
23175,1269,8,16,1,2,2,5,Lost
23214,48,33,285,5,4,5,14,Champions
23297,3955,7,10,1,2,1,4,Lost
23318,129,32,204,4,4,5,13,Champions
23474,942,21,28,2,3,2,7,Casual Users
23719,395,10,100,3,2,4,9,Casual Users
23725,3,35,125,5,4,4,13,Champions
23944,951,32,137,2,4,4,10,At Risk
24120,1116,8,64,2,2,4,8,Lost
24159,499,39,116,2,4,4,10,At Risk
24202,14,18,54,5,3,3,11,Loyal Users
24307,113,11,16,4,2,2,8,Promising
24359,954,14,24,2,3,2,7,Casual Users
24603,179,64,170,3,5,5,13,Loyal Users
24649,411,5,11,3,1,1,5,Casual Users
25104,829,19,52,2,3,3,8,Casual Users
25208,112,113,277,4,5,5,14,Champions
25667,2741,5,7,1,1,1,3,Lost
25702,1809,8,65,1,2,4,7,Lost
25752,427,6,11,3,1,1,5,Casual Users
26238,593,9,26,2,2,2,6,Lost
26432,117,75,545,4,5,5,14,Champions
14001,530,9,43,2,2,3,7,Lost
14134,3482,9,17,1,2,2,5,Lost
14219,79,43,136,4,4,4,12,Champions
14382,16,147,332,5,5,5,15,Champions
14434,940,7,11,2,2,1,5,Lost
14476,2576,5,15,1,1,1,3,Lost
14527,134,15,66,4,3,4,11,Loyal Users
14541,27,107,332,5,5,5,15,Champions
14716,569,12,36,2,3,3,8,Casual Users
15354,285,57,327,3,5,5,13,Loyal Users
15451,385,7,15,3,2,1,6,Casual Users
15566,1097,6,30,2,1,2,5,Lost
15755,842,7,31,2,2,2,6,Lost
15823,875,5,15,2,1,1,4,Lost
15825,272,41,160,3,4,5,12,Loyal Users
16070,434,26,112,3,4,4,11,Loyal Users
16133,1225,27,98,2,4,4,10,At Risk
16235,40,7,23,5,2,2,9,Promising
16358,399,32,89,3,4,4,11,Loyal Users
17026,94,5,5,4,1,1,6,Promising
17120,238,42,259,3,4,5,12,Loyal Users
17964,28,33,88,5,4,4,13,Champions
18087,366,17,46,3,3,3,9,Loyal Users
18177,130,24,28,4,4,2,10,Loyal Users
18326,407,59,150,3,5,5,13,Loyal Users
18327,2590,7,23,1,2,2,5,Lost
18391,39,64,199,5,5,5,15,Champions
18541,90,8,88,4,2,4,10,Promising
18563,294,14,41,3,3,3,9,Loyal Users
18567,92,14,42,4,3,3,10,Loyal Users
18710,74,53,233,4,5,5,14,Champions
19504,294,9,15,3,2,1,6,Casual Users
19584,222,133,230,3,5,5,13,Loyal Users
19776,1403,7,20,1,2,2,5,Lost
19809,83,65,143,4,5,4,13,Champions
19858,165,11,46,4,2,3,9,Promising
20256,131,68,239,4,5,5,14,Champions
20302,12,114,325,5,5,5,15,Champions
20394,227,19,77,3,3,4,10,Loyal Users
20494,268,30,284,3,4,5,12,Loyal Users
20610,204,7,33,3,2,3,8,Casual Users
21003,129,35,118,4,4,4,12,Champions
21061,1398,7,10,1,2,1,4,Lost
21209,838,10,20,2,2,2,6,Lost
22406,264,23,99,3,4,4,11,Loyal Users
23092,102,14,37,4,3,3,10,Loyal Users
23261,113,19,83,4,3,4,11,Loyal Users
23698,1,8,53,5,2,3,10,Promising
24116,521,41,68,2,4,4,10,At Risk
24338,4883,10,22,1,2,2,5,Lost
25033,1641,13,27,1,3,2,6,Casual Users
25172,134,35,120,4,4,4,12,Champions
25610,111,84,317,4,5,5,14,Champions
25654,1,25,57,5,4,3,12,Loyal Users
25662,1804,6,12,1,1,1,3,Lost
25680,548,8,33,2,2,3,7,Lost
25878,163,13,26,4,3,2,9,Loyal Users
25945,768,5,10,2,1,1,4,Lost
26064,126,25,157,4,4,5,13,Champions
26353,2858,8,21,1,2,2,5,Lost
26448,75,29,60,4,4,3,11,Loyal Users
14454,11,28,98,5,4,4,13,Champions
14574,112,28,100,4,4,4,12,Champions
14685,201,12,118,3,3,4,10,Loyal Users
14825,177,21,31,3,3,2,8,Loyal Users
15031,253,49,193,3,5,5,13,Loyal Users
15117,218,40,196,3,4,5,12,Loyal Users
15175,15,31,47,5,4,3,12,Loyal Users
15325,600,37,91,2,4,4,10,At Risk
15668,130,10,15,4,2,1,7,Promising
15814,1285,13,48,1,3,3,7,Casual Users
15832,1428,6,13,1,1,1,3,Lost
15833,1438,15,46,1,3,3,7,Casual Users
15889,997,6,9,2,1,1,4,Lost
16445,2294,7,21,1,2,2,5,Lost
16846,130,44,292,4,4,5,13,Champions
17062,174,12,17,3,3,2,8,Loyal Users
17138,4842,8,22,1,2,2,5,Lost
17968,4295,24,38,1,4,3,8,At Risk
18219,156,14,20,4,3,2,9,Loyal Users
18431,644,15,34,2,3,3,8,Casual Users
18650,743,5,18,2,1,2,5,Lost
18695,277,50,257,3,5,5,13,Loyal Users
19229,1307,8,13,1,2,1,4,Lost
19280,1858,17,167,1,3,5,9,Casual Users
19618,522,5,23,2,1,2,5,Lost
19680,851,58,175,2,5,5,12,At Risk
19731,412,23,35,3,4,3,10,Loyal Users
19780,85,98,369,4,5,5,14,Champions
19820,33,74,116,5,5,4,14,Champions
19951,56,30,105,5,4,4,13,Champions
20140,2954,5,26,1,1,2,4,Lost
20328,110,24,72,4,4,4,12,Champions
20698,1277,6,29,1,1,2,4,Lost
20901,230,5,6,3,1,1,5,Casual Users
21294,255,13,46,3,3,3,9,Loyal Users
21337,1533,10,40,1,2,3,6,Lost
21538,76,33,118,4,4,4,12,Champions
21589,126,33,182,4,4,5,13,Champions
21892,424,95,218,3,5,5,13,Loyal Users
22214,868,6,34,2,1,3,6,Lost
22945,662,13,20,2,3,2,7,Casual Users
22984,79,114,572,4,5,5,14,Champions
23306,883,12,58,2,3,3,8,Casual Users
23543,73,103,366,4,5,5,14,Champions
23829,121,6,10,4,1,1,6,Promising
24047,1,24,147,5,4,5,14,Champions
24048,47,16,18,5,3,2,10,Loyal Users
24071,127,38,67,4,4,4,12,Champions
24232,85,135,230,4,5,5,14,Champions
24651,18,90,298,5,5,5,15,Champions
24669,111,200,275,4,5,5,14,Champions
24715,18,46,81,5,5,4,14,Champions
24797,1113,10,34,2,2,3,7,Lost
24903,140,30,64,4,4,4,12,Champions
24916,122,5,7,4,1,1,6,Promising
25451,130,8,35,4,2,3,9,Promising
26016,200,11,25,3,2,2,7,Casual Users
26148,228,8,12,3,2,1,6,Casual Users
26252,13,64,114,5,5,4,14,Champions
26384,835,9,29,2,2,2,6,Lost
26433,1426,59,214,1,5,5,11,At Risk
26447,19,139,302,5,5,5,15,Champions
13629,2292,5,21,1,1,2,4,Lost
13902,508,12,15,2,3,1,6,Casual Users
14143,1643,6,16,1,1,2,4,Lost
14165,59,74,310,5,5,5,15,Champions
14225,1763,9,56,1,2,3,6,Lost
14482,27,130,575,5,5,5,15,Champions
14786,264,24,133,3,4,4,11,Loyal Users
14952,1405,10,30,1,2,2,5,Lost
15018,1847,10,13,1,2,1,4,Lost
15115,863,6,8,2,1,1,4,Lost
15218,657,8,15,2,2,1,5,Lost
15231,2096,6,6,1,1,1,3,Lost
15458,119,13,66,4,3,4,11,Loyal Users
15635,26,49,294,5,5,5,15,Champions
15862,673,27,102,2,4,4,10,At Risk
16333,118,48,100,4,5,4,13,Champions
16390,132,21,58,4,3,3,10,Loyal Users
16402,1398,24,44,1,4,3,8,At Risk
16416,1,115,490,5,5,5,15,Champions
16457,367,52,197,3,5,5,13,Loyal Users
16726,1840,9,36,1,2,3,6,Lost
16761,698,44,111,2,4,4,10,At Risk
16770,241,33,73,3,4,4,11,Loyal Users
16880,2936,13,19,1,3,2,6,Casual Users
16995,1392,5,8,1,1,1,3,Lost
17052,135,12,74,4,3,4,11,Loyal Users
17177,1851,7,24,1,2,2,5,Lost
17427,401,5,10,3,1,1,5,Casual Users
17879,29,72,268,5,5,5,15,Champions
17927,1420,128,348,1,5,5,11,At Risk
18040,1681,13,17,1,3,2,6,Casual Users
18150,238,49,83,3,5,4,12,Loyal Users
18346,46,73,458,5,5,5,15,Champions
18506,406,39,144,3,4,4,11,Loyal Users
18826,91,64,218,4,5,5,14,Champions
19449,28,7,20,5,2,2,9,Promising
19741,1576,24,44,1,4,3,8,At Risk
20127,115,10,33,4,2,3,9,Promising
20190,23,37,86,5,4,4,13,Champions
20915,356,17,49,3,3,3,9,Loyal Users
21227,71,14,72,4,3,4,11,Loyal Users
21606,162,19,47,4,3,3,10,Loyal Users
21787,1751,8,16,1,2,2,5,Lost
21845,1875,5,9,1,1,1,3,Lost
21907,139,48,106,4,5,4,13,Champions
21995,4,97,342,5,5,5,15,Champions
22037,18,7,25,5,2,2,9,Promising
22209,9,23,96,5,4,4,13,Champions
23019,438,13,19,3,3,2,8,Loyal Users
23406,3008,5,5,1,1,1,3,Lost
23451,513,9,14,2,2,1,5,Lost
24944,4,48,185,5,5,5,15,Champions
24983,17,41,72,5,4,4,13,Champions
25004,3827,7,9,1,2,1,4,Lost
25113,4153,5,13,1,1,1,3,Lost
25151,532,12,15,2,3,1,6,Casual Users
25272,263,24,71,3,4,4,11,Loyal Users
25336,179,12,16,3,3,2,8,Loyal Users
25407,390,22,121,3,4,4,11,Loyal Users
25513,969,14,21,2,3,2,7,Casual Users
25635,409,19,36,3,3,3,9,Loyal Users
26045,65,98,130,5,5,4,14,Champions
26312,137,5,16,4,1,2,7,Promising
13772,857,66,131,2,5,4,11,At Risk
13810,2579,6,7,1,1,1,3,Lost
13884,249,14,25,3,3,2,8,Loyal Users
13945,382,6,10,3,1,1,5,Casual Users
14204,539,7,12,2,2,1,5,Lost
14242,850,11,98,2,2,4,8,Lost
14416,418,39,67,3,4,4,11,Loyal Users
14585,1157,5,6,2,1,1,4,Lost
15302,667,5,18,2,1,2,5,Lost
15464,1979,5,8,1,1,1,3,Lost
15853,93,41,54,4,4,3,11,Loyal Users
16424,9,61,101,5,5,4,14,Champions
17095,182,38,67,3,4,4,11,Loyal Users
17209,5425,11,22,1,2,2,5,Lost
17567,1228,7,15,2,2,1,5,Lost
17703,491,51,199,2,5,5,12,At Risk
17884,147,64,104,4,5,4,13,Champions
17888,169,62,231,3,5,5,13,Loyal Users
18117,3,83,90,5,5,4,14,Champions
18222,3,10,36,5,2,3,10,Promising
18246,413,19,42,3,3,3,9,Loyal Users
18568,1139,10,59,2,2,3,7,Lost
18745,137,7,26,4,2,2,8,Promising
18882,155,29,60,4,4,3,11,Loyal Users
19076,1001,16,36,2,3,3,8,Casual Users
19159,37,62,146,5,5,4,14,Champions
19681,9,64,82,5,5,4,14,Champions
20101,1946,16,29,1,3,2,6,Casual Users
20325,1285,8,17,1,2,2,5,Lost
20410,989,10,12,2,2,1,5,Lost
20487,147,27,88,4,4,4,12,Champions
20787,40,16,91,5,3,4,12,Loyal Users
21001,379,13,16,3,3,2,8,Loyal Users
21221,3189,8,17,1,2,2,5,Lost
21422,115,92,568,4,5,5,14,Champions
21605,683,13,38,2,3,3,8,Casual Users
21877,108,12,15,4,3,1,8,Loyal Users
21908,402,6,7,3,1,1,5,Casual Users
22000,140,15,49,4,3,3,10,Loyal Users
22199,38,113,169,5,5,5,15,Champions
22312,44,120,273,5,5,5,15,Champions
22338,2735,5,10,1,1,1,3,Lost
22377,2556,13,29,1,3,2,6,Casual Users
22564,2,92,575,5,5,5,15,Champions
22576,239,5,5,3,1,1,5,Casual Users
22667,6,31,67,5,4,4,13,Champions
22775,4670,6,27,1,1,2,4,Lost
23183,310,18,35,3,3,3,9,Loyal Users
23642,1690,5,9,1,1,1,3,Lost
24144,254,24,59,3,4,3,10,Loyal Users
24337,754,14,21,2,3,2,7,Casual Users
24397,66,18,52,5,3,3,11,Loyal Users
24564,3442,8,10,1,2,1,4,Lost
24619,0,45,123,5,4,4,13,Champions
24749,961,7,12,2,2,1,5,Lost
24847,1019,14,41,2,3,3,8,Casual Users
24887,119,74,209,4,5,5,14,Champions
25096,435,12,21,3,3,2,8,Loyal Users
25759,545,8,10,2,2,1,5,Lost
25779,4,66,85,5,5,4,14,Champions
25822,2176,32,97,1,4,4,9,At Risk
26390,4,33,44,5,4,3,12,Loyal Users
13657,133,51,77,4,5,4,13,Champions
13752,258,10,14,3,2,1,6,Casual Users
13789,542,25,90,2,4,4,10,At Risk
13805,98,72,222,4,5,5,14,Champions
13807,974,6,31,2,1,2,5,Lost
14473,6136,6,6,1,1,1,3,Lost
14619,46,173,438,5,5,5,15,Champions
14645,208,16,35,3,3,3,9,Loyal Users
14905,274,19,43,3,3,3,9,Loyal Users
15012,850,6,14,2,1,1,4,Lost
15038,108,23,93,4,4,4,12,Champions
15314,427,9,44,3,2,3,8,Casual Users
15400,3606,8,15,1,2,1,4,Lost
15415,61,16,116,5,3,4,12,Loyal Users
15495,175,23,63,3,4,4,11,Loyal Users
15613,151,6,25,4,1,2,7,Promising
15735,122,46,102,4,5,4,13,Champions
16016,848,16,52,2,3,3,8,Casual Users
16047,1410,18,27,1,3,2,6,Casual Users
16509,86,37,272,4,4,5,13,Champions
16645,265,30,65,3,4,4,11,Loyal Users
16777,73,12,37,4,3,3,10,Loyal Users
17183,389,24,108,3,4,4,11,Loyal Users
17221,153,11,30,4,2,2,8,Promising
17335,114,61,92,4,5,4,13,Champions
17528,273,5,13,3,1,1,5,Casual Users
17736,44,16,19,5,3,2,10,Loyal Users
17878,407,29,87,3,4,4,11,Loyal Users
17906,813,8,73,2,2,4,8,Lost
17913,245,7,19,3,2,2,7,Casual Users
18076,1845,7,19,1,2,2,5,Lost
18077,1854,6,13,1,1,1,3,Lost
18093,52,34,258,5,4,5,14,Champions
18255,2418,6,7,1,1,1,3,Lost
18594,975,11,26,2,2,2,6,Lost
18696,5854,9,16,1,2,2,5,Lost
18701,862,33,86,2,4,4,10,At Risk
18839,399,10,15,3,2,1,6,Casual Users
19247,392,21,93,3,3,4,10,Loyal Users
19260,292,55,194,3,5,5,13,Loyal Users
19289,12,118,258,5,5,5,15,Champions
19403,74,36,138,4,4,4,12,Champions
20157,3031,16,47,1,3,3,7,Casual Users
20224,4608,6,6,1,1,1,3,Lost
20281,403,12,20,3,3,2,8,Loyal Users
20303,278,32,71,3,4,4,11,Loyal Users
20748,258,13,80,3,3,4,10,Loyal Users
21010,82,49,92,4,5,4,13,Champions
21057,446,8,22,3,2,2,7,Casual Users
21084,259,10,11,3,2,1,6,Casual Users
21407,719,16,47,2,3,3,8,Casual Users
21677,98,33,42,4,4,3,11,Loyal Users
21914,1009,55,78,2,5,4,11,At Risk
22095,159,19,34,4,3,3,10,Loyal Users
22308,1712,96,447,1,5,5,11,At Risk
22492,272,6,13,3,1,1,5,Casual Users
22664,2216,5,5,1,1,1,3,Lost
22937,839,22,75,2,4,4,10,At Risk
23035,6,97,266,5,5,5,15,Champions
23482,224,26,291,3,4,5,12,Loyal Users
23548,410,10,20,3,2,2,7,Casual Users
23632,104,29,141,4,4,4,12,Champions
23836,379,27,58,3,4,3,10,Loyal Users
23888,3314,12,28,1,3,2,6,Casual Users
23954,115,74,148,4,5,5,14,Champions
24060,459,57,226,3,5,5,13,Loyal Users
24257,4161,11,17,1,2,2,5,Lost
24294,99,70,156,4,5,5,14,Champions
24437,559,6,10,2,1,1,4,Lost
24802,887,14,68,2,3,4,9,Casual Users
24835,5092,9,10,1,2,1,4,Lost
24850,137,61,154,4,5,5,14,Champions
24914,3431,7,39,1,2,3,6,Lost
24948,855,31,64,2,4,4,10,At Risk
24992,288,9,21,3,2,2,7,Casual Users
25115,220,12,50,3,3,3,9,Loyal Users
25265,650,6,35,2,1,3,6,Lost
25743,115,23,78,4,4,4,12,Champions
26417,4437,5,7,1,1,1,3,Lost
13911,1872,7,13,1,2,1,4,Lost
13927,1227,23,55,2,4,3,9,At Risk
14034,228,68,142,3,5,4,12,Loyal Users
14108,1424,14,44,1,3,3,7,Casual Users
14586,15,95,135,5,5,4,14,Champions
14889,3,58,178,5,5,5,15,Champions
15230,1,21,37,5,3,3,11,Loyal Users
15327,173,28,72,3,4,4,11,Loyal Users
15649,2157,6,12,1,1,1,3,Lost
15684,248,9,27,3,2,2,7,Casual Users
16137,1018,10,15,2,2,1,5,Lost
16539,224,41,83,3,4,4,11,Loyal Users
16929,406,5,25,3,1,2,6,Casual Users
17500,95,21,23,4,3,2,9,Loyal Users
17691,45,29,44,5,4,3,12,Loyal Users
17780,28,60,126,5,5,4,14,Champions
17787,2710,24,36,1,4,3,8,At Risk
17952,44,16,25,5,3,2,10,Loyal Users
18199,247,45,289,3,4,5,12,Loyal Users
18514,117,15,49,4,3,3,10,Loyal Users
18560,3574,6,10,1,1,1,3,Lost
18712,446,17,70,3,3,4,10,Loyal Users
18874,2147,31,56,1,4,3,8,At Risk
18987,16,170,1007,5,5,5,15,Champions
19160,1086,5,5,2,1,1,4,Lost
19210,2189,7,33,1,2,3,6,Lost
19347,57,10,35,5,2,3,10,Promising
19382,139,5,14,4,1,1,6,Promising
19534,672,6,28,2,1,2,5,Lost
19720,797,17,63,2,3,4,9,Casual Users
19880,1434,14,17,1,3,2,6,Casual Users
20075,85,163,251,4,5,5,14,Champions
20161,126,39,132,4,4,4,12,Champions
20265,157,21,38,4,3,3,10,Loyal Users
20620,430,17,60,3,3,3,9,Loyal Users
20753,432,16,39,3,3,3,9,Loyal Users
20890,4970,6,18,1,1,2,4,Lost
21009,142,53,275,4,5,5,14,Champions
21041,2248,5,13,1,1,1,3,Lost
21069,2,193,393,5,5,5,15,Champions
21370,384,43,69,3,4,4,11,Loyal Users
21622,4135,5,5,1,1,1,3,Lost
21731,272,47,106,3,5,4,12,Loyal Users
21960,2651,20,43,1,3,3,7,Casual Users
22171,121,56,68,4,5,4,13,Champions
22268,101,12,39,4,3,3,10,Loyal Users
22437,6,21,41,5,3,3,11,Loyal Users
22445,2997,6,28,1,1,2,4,Lost
23211,431,20,29,3,3,2,8,Loyal Users
23369,56,92,299,5,5,5,15,Champions
23674,4248,20,48,1,3,3,7,Casual Users
23862,25,169,584,5,5,5,15,Champions
24050,1476,10,114,1,2,4,7,Lost
24135,1488,5,14,1,1,1,3,Lost
24162,1424,32,53,1,4,3,8,At Risk
24315,159,9,31,4,2,2,8,Promising
24446,14,81,176,5,5,5,15,Champions
25140,684,8,18,2,2,2,6,Lost
25147,155,6,13,4,1,1,6,Promising
25250,515,35,55,2,4,3,9,At Risk
25861,379,8,11,3,2,1,6,Casual Users
25889,150,16,43,4,3,3,10,Loyal Users
26110,1218,9,14,2,2,1,5,Lost
26147,644,11,21,2,2,2,6,Lost
13917,149,84,206,4,5,5,14,Champions
14038,1528,5,7,1,1,1,3,Lost
14425,19,8,8,5,2,1,8,Promising
14800,133,56,146,4,5,4,13,Champions
15194,128,17,51,4,3,3,10,Loyal Users
15342,580,49,79,2,5,4,11,At Risk
15410,24,171,276,5,5,5,15,Champions
15567,965,8,12,2,2,1,5,Lost
16297,1740,5,8,1,1,1,3,Lost
16299,1094,13,102,2,3,4,9,Casual Users
16464,691,5,6,2,1,1,4,Lost
16512,560,7,21,2,2,2,6,Lost
17045,181,20,67,3,3,4,10,Loyal Users
17314,2,27,206,5,4,5,14,Champions
17812,3639,19,38,1,3,3,7,Casual Users
17873,3666,5,6,1,1,1,3,Lost
17982,679,24,61,2,4,3,9,At Risk
18052,1571,21,30,1,3,2,6,Casual Users
18409,969,12,48,2,3,3,8,Casual Users
18462,352,19,103,3,3,4,10,Loyal Users
18998,85,26,66,4,4,4,12,Champions
19026,3811,5,7,1,1,1,3,Lost
19240,2795,65,113,1,5,4,10,At Risk
19513,93,6,6,4,1,1,6,Promising
19548,116,24,82,4,4,4,12,Champions
19586,4131,13,56,1,3,3,7,Casual Users
19763,277,10,58,3,2,3,8,Casual Users
19801,926,9,54,2,2,3,7,Lost
19814,1234,8,18,2,2,2,6,Lost
21153,144,25,36,4,4,3,11,Loyal Users
21159,28,63,337,5,5,5,15,Champions
21163,471,33,103,2,4,4,10,At Risk
21207,291,41,69,3,4,4,11,Loyal Users
21328,106,28,72,4,4,4,12,Champions
21401,433,13,53,3,3,3,9,Loyal Users
21890,561,31,240,2,4,5,11,At Risk
22029,947,26,37,2,4,3,9,At Risk
22282,281,7,50,3,2,3,8,Casual Users
22768,326,7,20,3,2,2,7,Casual Users
23118,7,36,62,5,4,3,12,Loyal Users
23653,144,16,99,4,3,4,11,Loyal Users
23666,2389,5,7,1,1,1,3,Lost
23712,71,57,158,4,5,5,14,Champions
24196,130,49,324,4,5,5,14,Champions
24300,255,50,95,3,5,4,12,Loyal Users
24442,109,49,172,4,5,5,14,Champions
24476,90,8,13,4,2,1,7,Promising
24837,1419,5,26,1,1,2,4,Lost
24951,481,21,103,2,3,4,9,Casual Users
24980,1,117,365,5,5,5,15,Champions
25212,700,18,84,2,3,4,9,Casual Users
25546,5658,10,39,1,2,3,6,Lost
25618,2,49,72,5,5,4,14,Champions
25740,1554,11,22,1,2,2,5,Lost
25851,271,34,64,3,4,4,11,Loyal Users
25892,1143,10,12,2,2,1,5,Lost
26106,1309,5,17,1,1,2,4,Lost
26207,443,7,24,3,2,2,7,Casual Users
26349,216,14,45,3,3,3,9,Loyal Users
26386,2693,5,14,1,1,1,3,Lost
13619,252,22,29,3,4,2,9,Loyal Users
13624,481,94,249,2,5,5,12,At Risk
13919,143,94,114,4,5,4,13,Champions
13948,262,21,71,3,3,4,10,Loyal Users
14209,3789,27,68,1,4,4,9,At Risk
14818,973,8,20,2,2,2,6,Lost
14880,5,9,19,5,2,2,9,Promising
14931,3069,18,43,1,3,3,7,Casual Users
14942,153,16,60,4,3,3,10,Loyal Users
14980,67,125,203,5,5,5,15,Champions
14990,1133,17,127,2,3,4,9,Casual Users
15319,1,15,76,5,3,4,12,Loyal Users
15394,981,5,16,2,1,2,5,Lost
15468,1682,21,23,1,3,2,6,Casual Users
15514,117,21,163,4,3,5,12,Loyal Users
15877,407,7,14,3,2,1,6,Casual Users
16218,574,18,38,2,3,3,8,Casual Users
16856,599,5,27,2,1,2,5,Lost
16876,246,15,23,3,3,2,8,Loyal Users
16899,3453,22,55,1,4,3,8,At Risk
17160,1,54,323,5,5,5,15,Champions
17455,587,12,27,2,3,2,7,Casual Users
17465,124,10,23,4,2,2,8,Promising
17643,2532,5,15,1,1,1,3,Lost
17669,1016,6,6,2,1,1,4,Lost
17718,373,19,75,3,3,4,10,Loyal Users
17900,41,63,123,5,5,4,14,Champions
17911,250,40,96,3,4,4,11,Loyal Users
17993,688,23,145,2,4,4,10,At Risk
18183,4098,10,11,1,2,1,4,Lost
18583,142,22,38,4,4,3,11,Loyal Users
18923,41,110,459,5,5,5,15,Champions
19378,1510,7,40,1,2,3,6,Lost
19398,2184,8,14,1,2,1,4,Lost
19402,2786,6,28,1,1,2,4,Lost
19442,422,11,50,3,2,3,8,Casual Users
19638,243,18,35,3,3,3,9,Loyal Users
19646,1255,8,12,2,2,1,5,Lost
19655,13,5,11,5,1,1,7,Promising
19750,4518,9,27,1,2,2,5,Lost
19972,144,9,16,4,2,2,8,Promising
20299,2410,6,38,1,1,3,5,Lost
20436,938,7,27,2,2,2,6,Lost
20601,1715,9,9,1,2,1,4,Lost
20755,124,30,66,4,4,4,12,Champions
20933,81,71,90,4,5,4,13,Champions
21219,251,13,28,3,3,2,8,Loyal Users
21245,0,82,336,5,5,5,15,Champions
21487,1802,8,15,1,2,1,4,Lost
21630,52,14,18,5,3,2,10,Loyal Users
22117,2434,9,21,1,2,2,5,Lost
22760,59,43,72,5,4,4,13,Champions
22939,107,63,287,4,5,5,14,Champions
23007,45,54,141,5,5,4,14,Champions
23227,3307,8,23,1,2,2,5,Lost
23264,231,23,54,3,4,3,10,Loyal Users
23373,20,10,20,5,2,2,9,Promising
23385,432,34,47,3,4,3,10,Loyal Users
23430,420,12,15,3,3,1,7,Loyal Users
23442,2134,6,9,1,1,1,3,Lost
23515,243,46,140,3,5,4,12,Loyal Users
23527,936,12,32,2,3,3,8,Casual Users
24041,1295,7,13,1,2,1,4,Lost
25091,1849,14,25,1,3,2,6,Casual Users
25411,429,60,469,3,5,5,13,Loyal Users
25636,382,28,50,3,4,3,10,Loyal Users
25951,260,48,106,3,5,4,12,Loyal Users
13641,890,21,33,2,3,3,8,Casual Users
13703,405,6,27,3,1,2,6,Casual Users
13711,581,10,34,2,2,3,7,Lost
14399,931,18,108,2,3,4,9,Casual Users
14431,644,5,40,2,1,3,6,Lost
14535,2127,22,73,1,4,4,9,At Risk
14551,114,28,52,4,4,3,11,Loyal Users
14724,1261,10,44,1,2,3,6,Lost
14932,1185,19,24,2,3,2,7,Casual Users
15110,60,28,47,5,4,3,12,Loyal Users
15243,433,14,64,3,3,4,10,Loyal Users
15374,14,47,306,5,5,5,15,Champions
15786,846,5,8,2,1,1,4,Lost
16554,132,8,11,4,2,1,7,Promising
17126,112,40,174,4,4,5,13,Champions
17166,24,25,218,5,4,5,14,Champions
17435,692,16,20,2,3,2,7,Casual Users
17777,100,43,216,4,4,5,13,Champions
18237,798,20,26,2,3,2,7,Casual Users
18265,66,10,12,5,2,1,8,Promising
18394,65,49,261,5,5,5,15,Champions
18474,984,22,39,2,4,3,9,At Risk
18551,412,14,63,3,3,4,10,Loyal Users
18786,36,151,893,5,5,5,15,Champions
19052,267,20,54,3,3,3,9,Loyal Users
19261,2256,6,35,1,1,3,5,Lost
19811,83,125,283,4,5,5,14,Champions
20212,822,26,81,2,4,4,10,At Risk
20336,123,13,39,4,3,3,10,Loyal Users
20458,3545,5,6,1,1,1,3,Lost
20679,3038,13,22,1,3,2,6,Casual Users
20783,204,8,15,3,2,1,6,Casual Users
20803,45,48,288,5,5,5,15,Champions
20844,352,51,223,3,5,5,13,Loyal Users
21011,1094,8,14,2,2,1,5,Lost
21056,217,49,287,3,5,5,13,Loyal Users
21478,1922,5,15,1,1,1,3,Lost
22134,136,24,29,4,4,2,10,Loyal Users
22330,7,57,332,5,5,5,15,Champions
22959,2690,7,32,1,2,3,6,Lost
23269,32,68,143,5,5,4,14,Champions
23552,11,41,165,5,4,5,14,Champions
23570,540,39,65,2,4,4,10,At Risk
23668,673,55,145,2,5,4,11,At Risk
23776,139,22,137,4,4,4,12,Champions
24235,2583,16,33,1,3,3,7,Casual Users
24709,131,55,100,4,5,4,13,Champions
24730,3859,7,9,1,2,1,4,Lost
24830,18,84,226,5,5,5,15,Champions
24842,2125,13,59,1,3,3,7,Casual Users
25017,84,69,135,4,5,4,13,Champions
25068,16,103,789,5,5,5,15,Champions
25410,2485,143,468,1,5,5,11,At Risk
25470,276,8,10,3,2,1,6,Casual Users
25521,7,27,48,5,4,3,12,Loyal Users
25580,5,5,16,5,1,2,8,Promising
25582,1668,8,13,1,2,1,4,Lost
25984,144,38,110,4,4,4,12,Champions
26027,92,15,68,4,3,4,11,Loyal Users
26288,7,52,137,5,5,4,14,Champions
26317,845,33,48,2,4,3,9,At Risk
26424,643,32,169,2,4,5,11,At Risk
13856,447,81,351,3,5,5,13,Loyal Users
13869,2,43,88,5,4,4,13,Champions
14060,75,190,857,4,5,5,14,Champions
14246,135,6,17,4,1,2,7,Promising
14499,3701,6,17,1,1,2,4,Lost
14584,1472,17,83,1,3,4,8,Casual Users
14616,44,35,108,5,4,4,13,Champions
15049,2714,8,28,1,2,2,5,Lost
15431,424,17,38,3,3,3,9,Loyal Users
15530,116,80,119,4,5,4,13,Champions
16351,1960,13,25,1,3,2,6,Casual Users
16443,296,18,45,3,3,3,9,Loyal Users
16461,101,5,12,4,1,1,6,Promising
16592,107,19,130,4,3,4,11,Loyal Users
17069,1125,11,32,2,2,3,7,Lost
17291,116,18,23,4,3,2,9,Loyal Users
17305,247,55,155,3,5,5,13,Loyal Users
17505,139,25,63,4,4,4,12,Champions
17742,121,20,28,4,3,2,9,Loyal Users
17781,120,21,54,4,3,3,10,Loyal Users
17821,1,102,324,5,5,5,15,Champions
17851,28,12,15,5,3,1,9,Loyal Users
17965,129,55,112,4,5,4,13,Champions
18081,422,9,25,3,2,2,7,Casual Users
18293,126,29,83,4,4,4,12,Champions
18511,253,14,23,3,3,2,8,Loyal Users
18599,2125,10,12,1,2,1,4,Lost
18721,652,8,24,2,2,2,6,Lost
18747,3550,13,14,1,3,1,5,Casual Users
18873,708,7,35,2,2,3,7,Lost
18990,655,6,59,2,1,3,6,Lost
19393,343,41,129,3,4,4,11,Loyal Users
19621,283,23,52,3,4,3,10,Loyal Users
19786,35,154,582,5,5,5,15,Champions
20177,915,7,18,2,2,2,6,Lost
20180,20,48,168,5,5,5,15,Champions
20230,438,12,18,3,3,2,8,Loyal Users
20505,1085,16,88,2,3,4,9,Casual Users
20553,133,13,51,4,3,3,10,Loyal Users
20694,2375,19,94,1,3,4,8,Casual Users
20945,6,59,590,5,5,5,15,Champions
21124,255,28,125,3,4,4,11,Loyal Users
21158,381,7,7,3,2,1,6,Casual Users
21673,105,109,226,4,5,5,14,Champions
21842,111,45,258,4,4,5,13,Champions
21857,105,15,40,4,3,3,10,Loyal Users
21903,380,8,12,3,2,1,6,Casual Users
22125,3,59,213,5,5,5,15,Champions
22139,4379,5,22,1,1,2,4,Lost
22348,407,8,11,3,2,1,6,Casual Users
22550,128,7,11,4,2,1,7,Promising
22584,723,5,13,2,1,1,4,Lost
22726,178,24,37,3,4,3,10,Loyal Users
23205,23,30,107,5,4,4,13,Champions
23449,1973,6,7,1,1,1,3,Lost
23893,417,10,13,3,2,1,6,Casual Users
23940,583,19,26,2,3,2,7,Casual Users
24238,141,87,192,4,5,5,14,Champions
24351,266,39,217,3,4,5,12,Loyal Users
24467,182,17,27,3,3,2,8,Loyal Users
24917,159,68,93,4,5,4,13,Champions
24940,1745,5,6,1,1,1,3,Lost
25183,4690,5,32,1,1,3,5,Lost
25385,276,9,23,3,2,2,7,Casual Users
25397,37,117,189,5,5,5,15,Champions
25784,2,105,688,5,5,5,15,Champions
25856,549,10,18,2,2,2,6,Lost
25961,1642,9,46,1,2,3,6,Lost
26088,192,7,13,3,2,1,6,Casual Users
26152,22,38,98,5,4,4,13,Champions
26170,2695,5,6,1,1,1,3,Lost
13707,1244,7,8,2,2,1,5,Lost
14281,299,43,58,3,4,3,10,Loyal Users
14414,130,8,71,4,2,4,10,Promising
14486,996,6,14,2,1,1,4,Lost
15329,208,19,101,3,3,4,10,Loyal Users
15930,86,29,91,4,4,4,12,Champions
16080,394,101,776,3,5,5,13,Loyal Users
16187,1103,15,73,2,3,4,9,Casual Users
16387,3146,6,13,1,1,1,3,Lost
16495,29,24,41,5,4,3,12,Loyal Users
16653,251,20,71,3,3,4,10,Loyal Users
16781,414,24,51,3,4,3,10,Loyal Users
16879,376,7,33,3,2,3,8,Casual Users
17245,3864,7,41,1,2,3,6,Lost
17666,125,23,107,4,4,4,12,Champions
17762,145,20,76,4,3,4,11,Loyal Users
17824,49,74,117,5,5,4,14,Champions
17934,440,33,119,3,4,4,11,Loyal Users
18606,439,23,48,3,4,3,10,Loyal Users
18677,44,74,396,5,5,5,15,Champions
19675,1013,22,38,2,4,3,9,At Risk
19852,1026,6,9,2,1,1,4,Lost
19853,873,13,22,2,3,2,7,Casual Users
20088,101,34,52,4,4,3,11,Loyal Users
20098,240,9,11,3,2,1,6,Casual Users
21160,234,15,29,3,3,2,8,Loyal Users
21448,1159,13,21,2,3,2,7,Casual Users
21511,3132,7,16,1,2,2,5,Lost
21749,3124,6,13,1,1,1,3,Lost
21966,523,11,37,2,2,3,7,Lost
22101,454,37,145,3,4,4,11,Loyal Users
22195,1766,24,43,1,4,3,8,At Risk
22264,41,10,61,5,2,3,10,Promising
22273,285,75,235,3,5,5,13,Loyal Users
22322,2991,5,6,1,1,1,3,Lost
22379,264,60,75,3,5,4,12,Loyal Users
22401,4432,5,11,1,1,1,3,Lost
22455,2084,19,87,1,3,4,8,Casual Users
22646,3956,17,19,1,3,2,6,Casual Users
22661,169,15,73,3,3,4,10,Loyal Users
22733,444,12,45,3,3,3,9,Loyal Users
22969,120,27,46,4,4,3,11,Loyal Users
23046,0,156,419,5,5,5,15,Champions
23125,117,37,146,4,4,4,12,Champions
23248,521,11,55,2,2,3,7,Lost
23288,980,61,312,2,5,5,12,At Risk
23337,26,204,287,5,5,5,15,Champions
23339,154,9,32,4,2,3,9,Promising
23388,966,7,21,2,2,2,6,Lost
23716,569,43,286,2,4,5,11,At Risk
23844,2213,6,11,1,1,1,3,Lost
23858,3122,7,34,1,2,3,6,Lost
23960,270,16,31,3,3,2,8,Loyal Users
23977,422,14,27,3,3,2,8,Loyal Users
24095,946,17,52,2,3,3,8,Casual Users
24289,145,28,44,4,4,3,11,Loyal Users
24388,1762,8,11,1,2,1,4,Lost
24468,2257,14,32,1,3,3,7,Casual Users
24686,468,12,24,3,3,2,8,Loyal Users
24732,48,75,163,5,5,5,15,Champions
24832,349,20,46,3,3,3,9,Loyal Users
24956,1411,13,17,1,3,2,6,Casual Users
25097,94,22,48,4,4,3,11,Loyal Users
25405,66,54,265,5,5,5,15,Champions
25630,4338,36,61,1,4,3,8,At Risk
25643,1613,6,10,1,1,1,3,Lost
13714,59,54,133,5,5,4,14,Champions
13890,3413,15,42,1,3,3,7,Casual Users
14264,48,111,193,5,5,5,15,Champions
14334,1662,9,13,1,2,1,4,Lost
14385,2118,5,17,1,1,2,4,Lost
14671,586,6,6,2,1,1,4,Lost
15469,1249,11,50,2,2,3,7,Lost
16158,1411,16,19,1,3,2,6,Casual Users
16251,5858,5,6,1,1,1,3,Lost
16341,113,8,23,4,2,2,8,Promising
16377,8,42,111,5,4,4,13,Champions
16678,1954,58,136,1,5,4,10,At Risk
17043,0,27,52,5,4,3,12,Loyal Users
17103,414,5,14,3,1,1,5,Casual Users
17627,304,15,51,3,3,3,9,Loyal Users
17947,5920,11,22,1,2,2,5,Lost
18190,605,5,7,2,1,1,4,Lost
18211,139,94,525,4,5,5,14,Champions
18461,546,28,42,2,4,3,9,At Risk
18588,586,28,41,2,4,3,9,At Risk
19184,122,34,194,4,4,5,13,Champions
19279,53,26,66,5,4,4,13,Champions
19300,214,10,27,3,2,2,7,Casual Users
19478,125,21,184,4,3,5,12,Loyal Users
19494,110,79,702,4,5,5,14,Champions
19945,13,30,42,5,4,3,12,Loyal Users
20045,1163,15,29,2,3,2,7,Casual Users
20114,1064,6,10,2,1,1,4,Lost
20144,6,146,602,5,5,5,15,Champions
20146,2374,6,6,1,1,1,3,Lost
20301,1928,16,22,1,3,2,6,Casual Users
21129,180,59,82,3,5,4,12,Loyal Users
21473,957,25,70,2,4,4,10,At Risk
21626,128,20,32,4,3,3,10,Loyal Users
21648,148,42,111,4,4,4,12,Champions
21850,1598,7,16,1,2,2,5,Lost
22247,435,26,35,3,4,3,10,Loyal Users
22403,96,18,76,4,3,4,11,Loyal Users
23014,402,16,44,3,3,3,9,Loyal Users
23470,122,9,40,4,2,3,9,Promising
23753,6,67,315,5,5,5,15,Champions
23837,2764,5,9,1,1,1,3,Lost
23956,29,62,214,5,5,5,15,Champions
24018,306,6,9,3,1,1,5,Casual Users
24438,0,26,71,5,4,4,13,Champions
24516,846,5,10,2,1,1,4,Lost
24820,41,61,222,5,5,5,15,Champions
24923,262,16,45,3,3,3,9,Loyal Users
24941,694,8,11,2,2,1,5,Lost
25130,2990,8,36,1,2,3,6,Lost
25153,1118,5,8,2,1,1,4,Lost
25222,181,10,25,3,2,2,7,Casual Users
25425,694,6,18,2,1,2,5,Lost
25526,33,6,8,5,1,1,7,Promising
25826,4,56,155,5,5,5,15,Champions
25996,2181,5,7,1,1,1,3,Lost
26052,0,65,278,5,5,5,15,Champions
26304,2477,16,62,1,3,3,7,Casual Users
26352,397,21,70,3,3,4,10,Loyal Users
26410,93,35,84,4,4,4,12,Champions
26457,27,45,168,5,4,5,14,Champions
13677,326,37,455,3,4,5,12,Loyal Users
13792,45,32,165,5,4,5,14,Champions
14137,119,9,31,4,2,2,8,Promising
14153,1516,6,27,1,1,2,4,Lost
14158,1350,14,24,1,3,2,6,Casual Users
14311,2469,6,10,1,1,1,3,Lost
14448,55,124,498,5,5,5,15,Champions
14725,243,71,171,3,5,5,13,Loyal Users
15106,4365,5,9,1,1,1,3,Lost
15172,3820,5,18,1,1,2,4,Lost
15196,4176,5,8,1,1,1,3,Lost
15204,270,24,47,3,4,3,10,Loyal Users
15236,683,10,23,2,2,2,6,Lost
15457,2683,15,42,1,3,3,7,Casual Users
15585,169,41,196,3,4,5,12,Loyal Users
16192,13,38,86,5,4,4,13,Champions
16626,9,81,231,5,5,5,15,Champions
16893,49,7,20,5,2,2,9,Promising
17020,82,6,20,4,1,2,7,Promising
17111,588,42,310,2,4,5,11,At Risk
17271,980,8,18,2,2,2,6,Lost
17323,437,8,8,3,2,1,6,Casual Users
17384,230,7,12,3,2,1,6,Casual Users
17484,4289,15,39,1,3,3,7,Casual Users
17524,25,6,9,5,1,1,7,Promising
17550,146,13,154,4,3,5,12,Loyal Users
17575,139,61,104,4,5,4,13,Champions
17608,499,13,62,2,3,3,8,Casual Users
17630,135,41,109,4,4,4,12,Champions
17694,163,24,74,4,4,4,12,Champions
18058,603,65,229,2,5,5,12,At Risk
18433,594,24,50,2,4,3,9,At Risk
18688,2560,6,18,1,1,2,4,Lost
19540,5,94,273,5,5,5,15,Champions
19592,3047,7,11,1,2,1,4,Lost
19605,2243,8,16,1,2,2,5,Lost
19935,23,15,67,5,3,4,12,Loyal Users
20096,843,12,34,2,3,3,8,Casual Users
20286,134,10,20,4,2,2,8,Promising
21352,4,111,209,5,5,5,15,Champions
21773,145,17,38,4,3,3,10,Loyal Users
21800,811,8,22,2,2,2,6,Lost
21887,25,13,24,5,3,2,10,Loyal Users
22002,1016,6,40,2,1,3,6,Lost
22298,189,39,109,3,4,4,11,Loyal Users
22924,402,26,37,3,4,3,10,Loyal Users
23213,144,56,160,4,5,5,14,Champions
23670,260,36,43,3,4,3,10,Loyal Users
23769,18,189,417,5,5,5,15,Champions
23770,431,18,34,3,3,3,9,Loyal Users
23802,221,30,137,3,4,4,11,Loyal Users
24230,160,39,57,4,4,3,11,Loyal Users
24312,835,39,86,2,4,4,10,At Risk
24454,1298,6,32,1,1,3,5,Lost
24751,2,70,160,5,5,5,15,Champions
25037,1519,14,24,1,3,2,6,Casual Users
25297,1372,9,14,1,2,1,4,Lost
25456,673,12,16,2,3,2,7,Casual Users
25511,2833,15,29,1,3,2,6,Casual Users
25558,862,6,17,2,1,2,5,Lost
25623,3572,5,5,1,1,1,3,Lost
25719,226,6,19,3,1,2,6,Casual Users
26275,5,126,375,5,5,5,15,Champions
13615,3947,6,7,1,1,1,3,Lost
13691,155,21,124,4,3,4,11,Loyal Users
13767,2307,11,14,1,2,1,4,Lost
13827,111,40,57,4,4,3,11,Loyal Users
14066,5674,7,10,1,2,1,4,Lost
14237,388,9,35,3,2,3,8,Casual Users
14620,841,9,13,2,2,1,5,Lost
15505,2219,12,53,1,3,3,7,Casual Users
15834,8,80,667,5,5,5,15,Champions
17100,225,29,113,3,4,4,11,Loyal Users
17185,31,63,119,5,5,4,14,Champions
17191,1,169,767,5,5,5,15,Champions
17483,229,8,9,3,2,1,6,Casual Users
17535,247,5,15,3,1,1,5,Casual Users
17935,148,5,27,4,1,2,7,Promising
18108,0,13,58,5,3,3,11,Loyal Users
18466,498,122,461,2,5,5,12,At Risk
18590,447,36,49,3,4,3,10,Loyal Users
18711,40,39,50,5,4,3,12,Loyal Users
19310,221,12,15,3,3,1,7,Loyal Users
19512,520,29,88,2,4,4,10,At Risk
19661,1122,14,29,2,3,2,7,Casual Users
19687,417,8,11,3,2,1,6,Casual Users
19735,24,20,92,5,3,4,12,Loyal Users
19772,124,40,269,4,4,5,13,Champions
20151,7,66,365,5,5,5,15,Champions
20689,17,82,437,5,5,5,15,Champions
20880,161,107,397,4,5,5,14,Champions
20961,295,31,64,3,4,4,11,Loyal Users
21117,50,6,11,5,1,1,7,Promising
21325,1971,8,18,1,2,2,5,Lost
21404,2548,5,21,1,1,2,4,Lost
21550,708,13,56,2,3,3,8,Casual Users
21635,80,7,20,4,2,2,8,Promising
21795,242,43,123,3,4,4,11,Loyal Users
22147,168,8,14,3,2,1,6,Casual Users
22237,1812,9,47,1,2,3,6,Lost
22434,3,59,177,5,5,5,15,Champions
22447,708,8,17,2,2,2,6,Lost
22619,18,24,68,5,4,4,13,Champions
22657,1398,10,26,1,2,2,5,Lost
22741,173,40,81,3,4,4,11,Loyal Users
23577,839,5,6,2,1,1,4,Lost
23834,449,44,65,3,4,4,11,Loyal Users
24204,5,100,804,5,5,5,15,Champions
24506,3700,5,8,1,1,1,3,Lost
24862,21,24,63,5,4,4,13,Champions
14069,5679,9,21,1,2,2,5,Lost
14244,602,15,18,2,3,2,7,Casual Users
14326,113,18,231,4,3,5,12,Loyal Users
14709,1127,23,139,2,4,4,10,At Risk
14891,508,23,69,2,4,4,10,At Risk
15322,501,29,91,2,4,4,10,At Risk
15460,276,6,10,3,1,1,5,Casual Users
15617,12,50,128,5,5,4,14,Champions
15632,137,9,33,4,2,3,9,Promising
15818,51,174,755,5,5,5,15,Champions
15885,463,13,50,3,3,3,9,Loyal Users
15927,179,19,41,3,3,3,9,Loyal Users
15953,49,12,31,5,3,2,10,Loyal Users
16420,1542,5,19,1,1,2,4,Lost
16452,15,10,21,5,2,2,9,Promising
16891,114,26,32,4,4,3,11,Loyal Users
17046,382,20,99,3,3,4,10,Loyal Users
17509,1210,26,55,2,4,3,9,At Risk
17898,114,171,254,4,5,5,14,Champions
18092,4078,30,94,1,4,4,9,At Risk
18323,108,21,31,4,3,2,9,Loyal Users
18728,423,6,14,3,1,1,5,Casual Users
18737,717,12,93,2,3,4,9,Casual Users
19046,21,73,159,5,5,5,15,Champions
19130,747,17,38,2,3,3,8,Casual Users
19270,432,5,11,3,1,1,5,Casual Users
19273,3268,7,16,1,2,2,5,Lost
19498,2589,7,20,1,2,2,5,Lost
19645,1259,13,19,1,3,2,6,Casual Users
19705,276,13,44,3,3,3,9,Loyal Users
19778,12,19,35,5,3,3,11,Loyal Users
19882,49,60,121,5,5,4,14,Champions
19906,27,132,458,5,5,5,15,Champions
19918,124,106,495,4,5,5,14,Champions
20123,423,5,10,3,1,1,5,Casual Users
20326,283,16,47,3,3,3,9,Loyal Users
20508,351,54,199,3,5,5,13,Loyal Users
20874,13,103,213,5,5,5,15,Champions
21036,12,116,270,5,5,5,15,Champions
21078,75,67,303,4,5,5,14,Champions
21264,277,31,204,3,4,5,12,Loyal Users
21826,268,17,45,3,3,3,9,Loyal Users
22599,40,46,213,5,5,5,15,Champions
22975,109,50,184,4,5,5,14,Champions
23043,150,20,31,4,3,2,9,Loyal Users
23349,1957,11,68,1,2,4,7,Lost
23507,14,34,198,5,4,5,14,Champions
23686,37,5,9,5,1,1,7,Promising
23734,92,166,578,4,5,5,14,Champions
23923,4619,5,5,1,1,1,3,Lost
24043,133,9,15,4,2,1,7,Promising
24330,2814,9,29,1,2,2,5,Lost
24349,640,6,12,2,1,1,4,Lost
24702,2606,8,9,1,2,1,4,Lost
24876,47,49,139,5,5,4,14,Champions
25570,3520,9,63,1,2,4,7,Lost
25660,708,9,15,2,2,1,5,Lost
25706,2619,6,11,1,1,1,3,Lost
26100,756,23,64,2,4,4,10,At Risk
26392,12,165,385,5,5,5,15,Champions
14183,71,86,556,4,5,5,14,Champions
14838,148,43,175,4,4,5,13,Champions
14854,16,13,20,5,3,2,10,Loyal Users
14943,284,8,47,3,2,3,8,Casual Users
15028,2197,8,11,1,2,1,4,Lost
15232,699,14,45,2,3,3,8,Casual Users
15336,7,14,22,5,3,2,10,Loyal Users
15338,30,22,145,5,4,4,13,Champions
15652,94,12,22,4,3,2,9,Loyal Users
16018,112,15,139,4,3,4,11,Loyal Users
16069,5515,6,9,1,1,1,3,Lost
16634,257,6,28,3,1,2,6,Casual Users
16771,4609,7,20,1,2,2,5,Lost
16849,807,9,12,2,2,1,5,Lost
16992,1425,9,10,1,2,1,4,Lost
16998,2713,91,376,1,5,5,11,At Risk
17282,250,27,152,3,4,5,12,Loyal Users
17650,5,6,12,5,1,1,7,Promising
17660,770,61,75,2,5,4,11,At Risk
17995,80,115,456,4,5,5,14,Champions
18001,108,8,40,4,2,3,9,Promising
18272,110,24,61,4,4,3,11,Loyal Users
18274,3116,6,41,1,1,3,5,Lost
18376,1669,8,10,1,2,1,4,Lost
18429,75,7,25,4,2,2,8,Promising
18499,6070,7,7,1,2,1,4,Lost
18598,8,27,44,5,4,3,12,Loyal Users
18804,12,104,354,5,5,5,15,Champions
19203,810,13,23,2,3,2,7,Casual Users
19303,1713,6,25,1,1,2,4,Lost
19383,87,34,119,4,4,4,12,Champions
19566,257,36,277,3,4,5,12,Loyal Users
20449,785,7,10,2,2,1,5,Lost
20617,102,49,295,4,5,5,14,Champions
20660,855,81,139,2,5,4,11,At Risk
20885,290,12,43,3,3,3,9,Loyal Users
20893,1541,10,16,1,2,2,5,Lost
21072,322,5,9,3,1,1,5,Casual Users
21184,6,13,102,5,3,4,12,Loyal Users
21239,153,11,30,4,2,2,8,Promising
21548,129,11,18,4,2,2,8,Promising
21652,397,23,45,3,4,3,10,Loyal Users
21735,255,70,380,3,5,5,13,Loyal Users
21950,0,17,34,5,3,3,11,Loyal Users
22031,471,6,6,2,1,1,4,Lost
22478,5872,8,12,1,2,1,4,Lost
22535,63,84,330,5,5,5,15,Champions
22808,249,34,69,3,4,4,11,Loyal Users
23190,24,140,968,5,5,5,15,Champions
23272,729,7,8,2,2,1,5,Lost
23393,6,53,155,5,5,5,15,Champions
24091,10,33,114,5,4,4,13,Champions
24112,871,18,87,2,3,4,9,Casual Users
24133,31,18,30,5,3,2,10,Loyal Users
24537,407,10,34,3,2,3,8,Casual Users
24909,231,24,87,3,4,4,11,Loyal Users
25107,821,74,117,2,5,4,11,At Risk
25234,518,5,26,2,1,2,5,Lost
25437,6,33,66,5,4,4,13,Champions
25463,139,25,128,4,4,4,12,Champions
26028,2407,5,14,1,1,1,3,Lost
26427,248,62,79,3,5,4,12,Loyal Users
26436,578,16,82,2,3,4,9,Casual Users
13681,32,19,60,5,3,3,11,Loyal Users
13682,105,42,246,4,4,5,13,Champions
14037,143,6,8,4,1,1,6,Promising
14207,488,12,89,2,3,4,9,Casual Users
14217,142,8,28,4,2,2,8,Promising
14610,1237,5,5,2,1,1,4,Lost
14680,131,66,120,4,5,4,13,Champions
14887,71,98,373,4,5,5,14,Champions
14970,1592,6,8,1,1,1,3,Lost
14979,412,12,24,3,3,2,8,Loyal Users
15183,122,9,73,4,2,4,10,Promising
15264,5590,5,17,1,1,2,4,Lost
15443,1428,7,15,1,2,1,4,Lost
15473,2477,7,14,1,2,1,4,Lost
15509,2056,7,11,1,2,1,4,Lost
15783,116,9,14,4,2,1,7,Promising
15809,1829,9,49,1,2,3,6,Lost
15964,2,57,144,5,5,4,14,Champions
16272,3,8,22,5,2,2,9,Promising
16545,1380,13,17,1,3,2,6,Casual Users
16728,20,57,176,5,5,5,15,Champions
16795,120,10,14,4,2,1,7,Promising
16796,241,12,92,3,3,4,10,Loyal Users
17220,84,34,177,4,4,5,13,Champions
17358,1267,12,20,1,3,2,6,Casual Users
17492,14,42,103,5,4,4,13,Champions
17932,572,7,13,2,2,1,5,Lost
17939,29,69,206,5,5,5,15,Champions
17941,282,44,93,3,4,4,11,Loyal Users
18197,3,143,448,5,5,5,15,Champions
18289,5050,7,27,1,2,2,5,Lost
18380,381,8,15,3,2,1,6,Casual Users
18812,148,25,60,4,4,3,11,Loyal Users
19362,276,15,64,3,3,4,10,Loyal Users
19394,35,58,88,5,5,4,14,Champions
19615,422,5,9,3,1,1,5,Casual Users
19727,1992,6,10,1,1,1,3,Lost
19985,3816,29,45,1,4,3,8,At Risk
20000,841,22,147,2,4,5,11,At Risk
20035,8,60,103,5,5,4,14,Champions
20148,392,13,39,3,3,3,9,Loyal Users
20153,101,10,42,4,2,3,9,Promising
20211,240,14,47,3,3,3,9,Loyal Users
20276,409,12,16,3,3,2,8,Loyal Users
20364,283,19,51,3,3,3,9,Loyal Users
21006,168,7,18,3,2,2,7,Casual Users
21316,46,116,951,5,5,5,15,Champions
21666,394,46,165,3,5,5,13,Loyal Users
21790,136,28,118,4,4,4,12,Champions
21852,684,9,21,2,2,2,6,Lost
22129,162,94,262,4,5,5,14,Champions
22132,52,26,63,5,4,4,13,Champions
22785,246,15,84,3,3,4,10,Loyal Users
22860,625,32,100,2,4,4,10,At Risk
22941,123,8,22,4,2,2,8,Promising
23049,37,47,74,5,5,4,14,Champions
23270,91,38,71,4,4,4,12,Champions
23346,409,29,41,3,4,3,10,Loyal Users
23525,81,29,141,4,4,4,12,Champions
23715,648,6,25,2,1,2,5,Lost
23792,153,46,83,4,5,4,13,Champions
23904,3,18,74,5,3,4,12,Loyal Users
24177,64,14,80,5,3,4,12,Loyal Users
24249,131,17,32,4,3,3,10,Loyal Users
24495,542,15,63,2,3,4,9,Casual Users
24545,85,20,193,4,3,5,12,Loyal Users
24999,4233,7,16,1,2,2,5,Lost
25057,971,10,22,2,2,2,6,Lost
25102,114,22,40,4,4,3,11,Loyal Users
25228,287,11,45,3,2,3,8,Casual Users
25548,541,22,65,2,4,4,10,At Risk
25637,3162,5,11,1,1,1,3,Lost
25762,131,89,192,4,5,5,14,Champions
25957,309,26,66,3,4,4,11,Loyal Users
25974,611,19,139,2,3,4,9,Casual Users
25993,62,109,212,5,5,5,15,Champions
26293,761,7,22,2,2,2,6,Lost
26301,688,31,46,2,4,3,9,At Risk
13886,73,23,61,4,4,3,11,Loyal Users
13980,1557,60,270,1,5,5,11,At Risk
14099,886,5,7,2,1,1,4,Lost
14359,477,49,188,2,5,5,12,At Risk
14578,986,9,10,2,2,1,5,Lost
14930,129,32,57,4,4,3,11,Loyal Users
15023,48,22,37,5,4,3,12,Loyal Users
15075,3027,24,62,1,4,3,8,At Risk
15112,34,120,301,5,5,5,15,Champions
15353,558,6,15,2,1,1,4,Lost
15387,236,20,98,3,3,4,10,Loyal Users
15409,29,215,480,5,5,5,15,Champions
16064,2066,7,7,1,2,1,4,Lost
16219,981,25,36,2,4,3,9,At Risk
16564,582,23,37,2,4,3,9,At Risk
17165,33,31,86,5,4,4,13,Champions
17424,77,113,200,4,5,5,14,Champions
17768,117,10,13,4,2,1,7,Promising
18167,184,53,182,3,5,5,13,Loyal Users
18245,77,33,79,4,4,4,12,Champions
18283,123,10,18,4,2,2,8,Promising
18891,2873,8,8,1,2,1,4,Lost
18910,4184,13,16,1,3,2,6,Casual Users
18929,2492,18,59,1,3,3,7,Casual Users
19044,133,103,455,4,5,5,14,Champions
19475,0,78,175,5,5,5,15,Champions
19765,286,20,27,3,3,2,8,Loyal Users
19958,2705,5,13,1,1,1,3,Lost
19959,2983,5,51,1,1,3,5,Lost
20038,3,103,271,5,5,5,15,Champions
20073,736,12,39,2,3,3,8,Casual Users
20544,66,17,64,5,3,4,12,Loyal Users
20752,139,11,17,4,2,2,8,Promising
21118,130,41,65,4,4,4,12,Champions
21120,802,13,20,2,3,2,7,Casual Users
21210,3141,9,10,1,2,1,4,Lost
21470,1389,37,119,1,4,4,9,At Risk
21540,1584,8,20,1,2,2,5,Lost
21719,878,6,9,2,1,1,4,Lost
21786,277,25,51,3,4,3,10,Loyal Users
21911,149,13,14,4,3,1,8,Loyal Users
21974,1074,5,9,2,1,1,4,Lost
22046,59,23,51,5,4,3,12,Loyal Users
22090,87,8,41,4,2,3,9,Promising
22386,2530,10,31,1,2,2,5,Lost
22388,1,33,91,5,4,4,13,Champions
22734,1112,12,36,2,3,3,8,Casual Users
23247,193,13,69,3,3,4,10,Loyal Users
23299,2582,6,6,1,1,1,3,Lost
23415,349,19,40,3,3,3,9,Loyal Users
23784,518,51,119,2,5,4,11,At Risk
23894,1026,11,54,2,2,3,7,Lost
24138,106,8,28,4,2,2,8,Promising
24203,585,27,91,2,4,4,10,At Risk
24259,832,29,56,2,4,3,9,At Risk
24328,266,36,78,3,4,4,11,Loyal Users
24329,386,11,47,3,2,3,8,Casual Users
24332,901,8,9,2,2,1,5,Lost
24700,2135,6,20,1,1,2,4,Lost
24817,264,32,174,3,4,5,12,Loyal Users
24960,119,7,35,4,2,3,9,Promising
25157,1,127,642,5,5,5,15,Champions
25214,3,38,159,5,4,5,14,Champions
25406,241,5,15,3,1,1,5,Casual Users
25422,1719,9,16,1,2,2,5,Lost
25661,1469,5,11,1,1,1,3,Lost
25701,601,9,19,2,2,2,6,Lost
25886,173,89,223,3,5,5,13,Loyal Users
26402,311,16,24,3,3,2,8,Loyal Users
13800,2377,6,21,1,1,2,4,Lost
13897,12,98,147,5,5,5,15,Champions
14135,3904,5,8,1,1,1,3,Lost
14172,121,7,24,4,2,2,8,Promising
14624,1988,6,37,1,1,3,5,Lost
14855,2402,8,8,1,2,1,4,Lost
14872,1356,8,10,1,2,1,4,Lost
15277,3705,13,14,1,3,1,5,Casual Users
15439,77,71,192,4,5,5,14,Champions
15511,30,15,62,5,3,3,11,Loyal Users
15778,230,182,299,3,5,5,13,Loyal Users
15929,2109,11,29,1,2,2,5,Lost
16450,151,14,68,4,3,4,11,Loyal Users
16631,638,62,168,2,5,5,12,At Risk
16784,36,39,112,5,4,4,13,Champions
16933,3,70,208,5,5,5,15,Champions
17152,1080,6,18,2,1,2,5,Lost
17255,111,66,288,4,5,5,14,Champions
17359,13,130,232,5,5,5,15,Champions
17475,21,19,47,5,3,3,11,Loyal Users
17586,9,22,40,5,4,3,12,Loyal Users
17624,430,17,110,3,3,4,10,Loyal Users
17663,2056,16,44,1,3,3,7,Casual Users
17779,1264,7,22,1,2,2,5,Lost
17850,68,31,47,5,4,3,12,Loyal Users
18134,31,56,111,5,5,4,14,Champions
18469,110,15,17,4,3,2,9,Loyal Users
18941,209,39,214,3,4,5,12,Loyal Users
19042,221,16,96,3,3,4,10,Loyal Users
19065,4095,9,22,1,2,2,5,Lost
19132,117,162,387,4,5,5,14,Champions
19551,221,11,22,3,2,2,7,Casual Users
19570,286,58,73,3,5,4,12,Loyal Users
19587,22,111,584,5,5,5,15,Champions
19711,5716,8,11,1,2,1,4,Lost
19715,309,10,11,3,2,1,6,Casual Users
19844,1425,25,39,1,4,3,8,At Risk
19856,122,30,34,4,4,3,11,Loyal Users
20980,5,57,170,5,5,5,15,Champions
21179,79,5,13,4,1,1,6,Promising
21183,242,36,217,3,4,5,12,Loyal Users
21653,113,32,174,4,4,5,13,Champions
21729,8,26,58,5,4,3,12,Loyal Users
21737,10,37,97,5,4,4,13,Champions
21772,656,15,31,2,3,2,7,Casual Users
21885,1298,5,5,1,1,1,3,Lost
22902,10,60,249,5,5,5,15,Champions
22916,420,26,46,3,4,3,10,Loyal Users
23148,518,16,49,2,3,3,8,Casual Users
23459,96,22,40,4,4,3,11,Loyal Users
23726,19,29,298,5,4,5,14,Champions
23767,1398,5,9,1,1,1,3,Lost
23950,525,28,45,2,4,3,9,At Risk
24400,204,30,148,3,4,5,12,Loyal Users
24440,36,101,177,5,5,5,15,Champions
24472,132,40,49,4,4,3,11,Loyal Users
24531,9,16,31,5,3,2,10,Loyal Users
24624,22,38,76,5,4,4,13,Champions
24680,314,25,95,3,4,4,11,Loyal Users
25722,2676,75,451,1,5,5,11,At Risk
25902,12,41,163,5,4,5,14,Champions
26029,7,79,217,5,5,5,15,Champions
26068,150,32,144,4,4,4,12,Champions
26133,63,13,33,5,3,3,11,Loyal Users
26213,2847,7,9,1,2,1,4,Lost
26468,1870,5,6,1,1,1,3,Lost
14429,2113,9,15,1,2,1,4,Lost
14452,413,11,35,3,2,3,8,Casual Users
14516,74,16,20,4,3,2,9,Loyal Users
14914,2665,31,98,1,4,4,9,At Risk
15058,2128,21,38,1,3,3,7,Casual Users
15174,4544,5,6,1,1,1,3,Lost
15750,143,21,32,4,3,3,10,Loyal Users
15893,428,36,64,3,4,4,11,Loyal Users
15956,33,116,332,5,5,5,15,Champions
16020,7,10,25,5,2,2,9,Promising
16031,38,57,88,5,5,4,14,Champions
16395,4,165,342,5,5,5,15,Champions
16460,116,29,166,4,4,5,13,Champions
16584,3374,5,5,1,1,1,3,Lost
16743,146,44,74,4,4,4,12,Champions
16765,3391,5,5,1,1,1,3,Lost
16773,282,27,146,3,4,4,11,Loyal Users
16792,4706,6,43,1,1,3,5,Lost
17006,2420,22,55,1,4,3,8,At Risk
17478,567,14,85,2,3,4,9,Casual Users
17909,976,41,281,2,4,5,11,At Risk
17978,801,27,165,2,4,5,11,At Risk
18343,3279,6,90,1,1,4,6,Lost
18547,255,39,62,3,4,3,10,Loyal Users
19155,61,74,154,5,5,5,15,Champions
19291,125,6,9,4,1,1,6,Promising
19390,2485,7,48,1,2,3,6,Lost
19407,77,28,143,4,4,4,12,Champions
19433,878,12,48,2,3,3,8,Casual Users
19436,34,56,257,5,5,5,15,Champions
19748,276,12,30,3,3,2,8,Loyal Users
20011,427,9,12,3,2,1,6,Casual Users
20040,287,55,120,3,5,4,12,Loyal Users
20107,290,72,179,3,5,5,13,Loyal Users
20270,720,21,34,2,3,3,8,Casual Users
20706,149,63,355,4,5,5,14,Champions
21026,230,28,133,3,4,4,11,Loyal Users
21050,347,7,19,3,2,2,7,Casual Users
21365,98,5,8,4,1,1,6,Promising
21656,44,66,223,5,5,5,15,Champions
21688,371,16,94,3,3,4,10,Loyal Users
21958,682,12,15,2,3,1,6,Casual Users
22059,21,12,19,5,3,2,10,Loyal Users
22074,287,25,143,3,4,4,11,Loyal Users
22452,141,14,53,4,3,3,10,Loyal Users
22485,418,30,64,3,4,4,11,Loyal Users
22668,694,25,66,2,4,4,10,At Risk
23027,117,14,69,4,3,4,11,Loyal Users
23186,264,34,135,3,4,4,11,Loyal Users
23255,4,75,259,5,5,5,15,Champions
25084,2298,10,27,1,2,2,5,Lost
25231,128,24,60,4,4,3,11,Loyal Users
25529,18,5,12,5,1,1,7,Promising
25859,1278,8,14,1,2,1,4,Lost
25972,239,5,8,3,1,1,5,Casual Users
26049,91,44,89,4,4,4,12,Champions
26061,177,34,84,3,4,4,11,Loyal Users
26184,11,39,103,5,4,4,13,Champions
26450,257,28,56,3,4,3,10,Loyal Users
13680,502,15,111,2,3,4,9,Casual Users
13748,50,26,39,5,4,3,12,Loyal Users
13939,271,18,33,3,3,3,9,Loyal Users
13996,129,8,14,4,2,1,7,Promising
14082,196,14,47,3,3,3,9,Loyal Users
14111,122,81,292,4,5,5,14,Champions
14348,551,13,31,2,3,2,7,Casual Users
14430,537,5,25,2,1,2,5,Lost
14567,25,20,42,5,3,3,11,Loyal Users
14845,699,11,40,2,2,3,7,Lost
15043,1097,15,31,2,3,2,7,Casual Users
15086,981,12,29,2,3,2,7,Casual Users
15129,90,177,505,4,5,5,14,Champions
15441,53,56,186,5,5,5,15,Champions
15519,298,13,23,3,3,2,8,Loyal Users
15618,720,11,23,2,2,2,6,Lost
15670,28,37,74,5,4,4,13,Champions
15769,405,16,40,3,3,3,9,Loyal Users
16011,635,8,68,2,2,4,8,Lost
16220,298,20,33,3,3,3,9,Loyal Users
16221,2569,5,19,1,1,2,4,Lost
17625,1215,8,10,2,2,1,5,Lost
18083,3125,17,49,1,3,3,7,Casual Users
18422,4,108,258,5,5,5,15,Champions
18716,67,78,420,5,5,5,15,Champions
18833,29,61,120,5,5,4,14,Champions
18867,129,41,63,4,4,4,12,Champions
18869,833,40,86,2,4,4,10,At Risk
18917,867,8,50,2,2,3,7,Lost
19058,1111,42,130,2,4,4,10,At Risk
19175,3868,7,12,1,2,1,4,Lost
19286,932,10,39,2,2,3,7,Lost
19630,553,16,17,2,3,2,7,Casual Users
19709,101,76,163,4,5,5,14,Champions
19753,1538,11,40,1,2,3,6,Lost
19832,824,6,13,2,1,1,4,Lost
19877,542,92,175,2,5,5,12,At Risk
20334,239,10,35,3,2,3,8,Casual Users
20520,161,22,55,4,4,3,11,Loyal Users
21039,16,40,95,5,4,4,13,Champions
21217,128,83,212,4,5,5,14,Champions
21523,2558,8,14,1,2,1,4,Lost
21934,5767,7,7,1,2,1,4,Lost
22198,451,30,85,3,4,4,11,Loyal Users
22522,86,34,238,4,4,5,13,Champions
22859,15,9,9,5,2,1,8,Promising
22870,369,54,255,3,5,5,13,Loyal Users
23512,32,110,245,5,5,5,15,Champions
23575,73,100,251,4,5,5,14,Champions
24065,122,15,20,4,3,2,9,Loyal Users
24070,267,59,170,3,5,5,13,Loyal Users
24109,128,80,123,4,5,4,13,Champions
24143,59,5,13,5,1,1,7,Promising
24378,71,73,281,4,5,5,14,Champions
24433,159,9,43,4,2,3,9,Promising
24450,41,61,130,5,5,4,14,Champions
24559,310,19,24,3,3,2,8,Loyal Users
24694,718,15,116,2,3,4,9,Casual Users
24879,1843,12,37,1,3,3,7,Casual Users
25121,1,11,37,5,2,3,10,Promising
25123,271,6,32,3,1,3,7,Casual Users
25389,1959,6,6,1,1,1,3,Lost
25448,318,45,101,3,4,4,11,Loyal Users
25670,28,54,118,5,5,4,14,Champions
25781,13,136,284,5,5,5,15,Champions
25823,4508,8,31,1,2,2,5,Lost
25898,807,19,52,2,3,3,8,Casual Users
26135,1779,12,27,1,3,2,6,Casual Users
26156,1246,10,19,2,2,2,6,Lost
26391,12,77,250,5,5,5,15,Champions
13687,89,98,389,4,5,5,14,Champions
13845,6,66,319,5,5,5,15,Champions
14033,179,72,190,3,5,5,13,Loyal Users
14777,1106,8,28,2,2,2,6,Lost
14788,586,10,46,2,2,3,7,Lost
14791,110,19,41,4,3,3,10,Loyal Users
14938,4229,6,52,1,1,3,5,Lost
14964,264,63,125,3,5,4,12,Loyal Users
15127,83,6,14,4,1,1,6,Promising
15693,555,5,6,2,1,1,4,Lost
15898,2677,5,7,1,1,1,3,Lost
16085,2319,21,43,1,3,3,7,Casual Users
16477,961,15,26,2,3,2,7,Casual Users
16776,8,21,52,5,3,3,11,Loyal Users
16859,379,29,64,3,4,4,11,Loyal Users
17137,963,11,17,2,2,2,6,Lost
17203,204,43,159,3,4,5,12,Loyal Users
17254,68,28,120,5,4,4,13,Champions
17395,126,67,209,4,5,5,14,Champions
17499,114,36,122,4,4,4,12,Champions
17687,986,19,49,2,3,3,8,Casual Users
18091,33,90,237,5,5,5,15,Champions
18194,2565,6,16,1,1,2,4,Lost
18212,453,11,61,3,2,3,8,Casual Users
18264,72,21,51,4,3,3,10,Loyal Users
19622,569,5,13,2,1,1,4,Lost
19764,239,57,243,3,5,5,13,Loyal Users
19975,131,119,736,4,5,5,14,Champions
20024,1984,6,8,1,1,1,3,Lost
20077,286,38,51,3,4,3,10,Loyal Users
20100,251,12,80,3,3,4,10,Loyal Users
20203,242,31,56,3,4,3,10,Loyal Users
20213,1867,27,66,1,4,4,9,At Risk
20262,70,19,28,4,3,2,9,Loyal Users
20415,215,7,14,3,2,1,6,Casual Users
20500,1614,6,10,1,1,1,3,Lost
20504,502,55,168,2,5,5,12,At Risk
20577,18,96,172,5,5,5,15,Champions
20764,137,11,11,4,2,1,7,Promising
20856,84,20,49,4,3,3,10,Loyal Users
20929,2713,7,27,1,2,2,5,Lost
20962,419,7,14,3,2,1,6,Casual Users
21372,392,29,98,3,4,4,11,Loyal Users
21573,2445,21,75,1,3,4,8,Casual Users
22514,11,14,55,5,3,3,11,Loyal Users
22583,78,31,79,4,4,4,12,Champions
22666,109,126,895,4,5,5,14,Champions
23309,1411,10,21,1,2,2,5,Lost
23329,22,93,418,5,5,5,15,Champions
23436,4263,10,18,1,2,2,5,Lost
23592,711,5,11,2,1,1,4,Lost
23846,168,78,281,3,5,5,13,Loyal Users
24037,1118,29,82,2,4,4,10,At Risk
24086,13,7,48,5,2,3,10,Promising
24221,19,26,82,5,4,4,13,Champions
24267,610,21,27,2,3,2,7,Casual Users
24269,86,103,454,4,5,5,14,Champions
24591,1682,20,39,1,3,3,7,Casual Users
24752,166,56,183,3,5,5,13,Loyal Users
25090,180,5,26,3,1,2,6,Casual Users
25589,2622,7,10,1,2,1,4,Lost
25803,115,63,243,4,5,5,14,Champions
26039,33,91,587,5,5,5,15,Champions
26257,426,8,10,3,2,1,6,Casual Users
14042,83,6,14,4,1,1,6,Promising
14115,402,13,23,3,3,2,8,Loyal Users
14147,2161,16,24,1,3,2,6,Casual Users
14155,480,10,30,2,2,2,6,Lost
14182,443,29,50,3,4,3,10,Loyal Users
14300,397,8,9,3,2,1,6,Casual Users
14314,301,8,11,3,2,1,6,Casual Users
14505,365,14,78,3,3,4,10,Loyal Users
14751,630,10,23,2,2,2,6,Lost
14827,20,49,124,5,5,4,14,Champions
15323,678,22,147,2,4,5,11,At Risk
15368,1502,5,38,1,1,3,5,Lost
15384,80,25,46,4,4,3,11,Loyal Users
15397,2868,11,51,1,2,3,6,Lost
15416,1127,19,33,2,3,3,8,Casual Users
15515,3229,5,7,1,1,1,3,Lost
15534,163,9,29,4,2,2,8,Promising
15640,45,62,85,5,5,4,14,Champions
15673,70,33,42,4,4,3,11,Loyal Users
16096,18,22,95,5,4,4,13,Champions
16136,111,85,299,4,5,5,14,Champions
16261,865,7,9,2,2,1,5,Lost
16360,178,7,9,3,2,1,6,Casual Users
16408,590,5,25,2,1,2,5,Lost
16449,2289,6,23,1,1,2,4,Lost
16824,177,28,72,3,4,4,11,Loyal Users
17040,157,72,177,4,5,5,14,Champions
17083,39,31,129,5,4,4,13,Champions
17189,61,9,11,5,2,1,8,Promising
17445,65,66,88,5,5,4,14,Champions
17522,562,15,16,2,3,2,7,Casual Users
17750,16,15,92,5,3,4,12,Loyal Users
17796,426,39,134,3,4,4,11,Loyal Users
17908,1549,6,14,1,1,1,3,Lost
18268,542,33,72,2,4,4,10,At Risk
18300,1825,11,15,1,2,1,4,Lost
18691,0,55,86,5,5,4,14,Champions
18704,954,25,61,2,4,3,9,At Risk
18733,51,164,259,5,5,5,15,Champions
18751,26,49,161,5,5,5,15,Champions
19154,3850,18,49,1,3,3,7,Casual Users
19594,3,109,318,5,5,5,15,Champions
19874,5736,7,14,1,2,1,4,Lost
19884,1258,15,21,1,3,2,6,Casual Users
19966,3668,5,10,1,1,1,3,Lost
20526,857,27,60,2,4,3,9,At Risk
20771,673,16,30,2,3,2,7,Casual Users
20847,1140,6,6,2,1,1,4,Lost
21012,1710,6,12,1,1,1,3,Lost
21066,841,28,33,2,4,3,9,At Risk
21247,84,71,123,4,5,4,13,Champions
21266,235,7,37,3,2,3,8,Casual Users
21834,522,9,30,2,2,2,6,Lost
21968,152,68,601,4,5,5,14,Champions
21990,123,37,186,4,4,5,13,Champions
22154,420,5,5,3,1,1,5,Casual Users
22240,19,46,100,5,5,4,14,Champions
22353,1164,8,8,2,2,1,5,Lost
22368,161,13,34,4,3,3,10,Loyal Users
22841,2,237,382,5,5,5,15,Champions
22930,24,19,33,5,3,3,11,Loyal Users
22993,511,18,112,2,3,4,9,Casual Users
23347,38,70,769,5,5,5,15,Champions
23498,252,37,127,3,4,4,11,Loyal Users
23675,509,38,107,2,4,4,10,At Risk
23957,285,27,77,3,4,4,11,Loyal Users
24121,54,57,161,5,5,5,15,Champions
24391,1665,15,103,1,3,4,8,Casual Users
24427,571,43,69,2,4,4,10,At Risk
24745,501,60,118,2,5,4,11,At Risk
24848,9,74,228,5,5,5,15,Champions
24942,1424,5,8,1,1,1,3,Lost
24974,1399,5,19,1,1,2,4,Lost
25213,45,156,550,5,5,5,15,Champions
25240,1947,17,30,1,3,2,6,Casual Users
25267,690,29,102,2,4,4,10,At Risk
25726,127,27,109,4,4,4,12,Champions
25947,45,16,30,5,3,2,10,Loyal Users
26002,4242,5,7,1,1,1,3,Lost
26013,124,9,39,4,2,3,9,Promising
26017,304,32,50,3,4,3,10,Loyal Users
26232,165,73,253,4,5,5,14,Champions
26289,584,6,20,2,1,2,5,Lost
13732,98,107,346,4,5,5,14,Champions
14014,141,26,66,4,4,4,12,Champions
14067,886,12,23,2,3,2,7,Casual Users
15081,1029,34,264,2,4,5,11,At Risk
15892,1587,6,8,1,1,1,3,Lost
16277,435,10,34,3,2,3,8,Casual Users
16779,23,13,76,5,3,4,12,Loyal Users
16922,2086,27,197,1,4,5,10,At Risk
17031,34,127,369,5,5,5,15,Champions
17174,3692,9,196,1,2,5,8,Lost
17264,4,6,18,5,1,2,8,Promising
17417,741,23,55,2,4,3,9,At Risk
17743,424,7,9,3,2,1,6,Casual Users
18094,158,10,54,4,2,3,9,Promising
18149,1312,11,32,1,2,3,6,Lost
18266,131,13,43,4,3,3,10,Loyal Users
18841,356,38,91,3,4,4,11,Loyal Users
18991,496,6,15,2,1,1,4,Lost
19078,115,23,181,4,4,5,13,Champions
19503,422,8,11,3,2,1,6,Casual Users
19718,96,46,99,4,5,4,13,Champions
20226,489,49,58,2,5,3,10,At Risk
20373,114,88,178,4,5,5,14,Champions
20411,652,8,51,2,2,3,7,Lost
20579,2304,9,10,1,2,1,4,Lost
20609,2730,10,43,1,2,3,6,Lost
20734,267,27,87,3,4,4,11,Loyal Users
20834,298,9,16,3,2,2,7,Casual Users
20871,282,81,371,3,5,5,13,Loyal Users
20939,168,12,34,3,3,3,9,Loyal Users
21111,0,49,175,5,5,5,15,Champions
21194,573,39,152,2,4,5,11,At Risk
21647,264,31,39,3,4,3,10,Loyal Users
21947,813,14,31,2,3,2,7,Casual Users
22057,17,24,55,5,4,3,12,Loyal Users
22230,148,30,59,4,4,3,11,Loyal Users
22248,129,99,278,4,5,5,14,Champions
22324,3388,6,7,1,1,1,3,Lost
22641,370,31,82,3,4,4,11,Loyal Users
23157,608,11,20,2,2,2,6,Lost
23226,414,46,86,3,5,4,12,Loyal Users
23576,966,6,12,2,1,1,4,Lost
23671,422,5,6,3,1,1,5,Casual Users
23747,11,126,636,5,5,5,15,Champions
23915,337,31,171,3,4,5,12,Loyal Users
23992,897,8,11,2,2,1,5,Lost
24097,2371,10,12,1,2,1,4,Lost
24561,266,45,141,3,4,4,11,Loyal Users
24798,5,100,464,5,5,5,15,Champions
24919,86,6,43,4,1,3,8,Promising
24995,4072,6,10,1,1,1,3,Lost
25166,250,16,47,3,3,3,9,Loyal Users
25303,1429,6,7,1,1,1,3,Lost
25366,871,10,23,2,2,2,6,Lost
25373,824,15,63,2,3,4,9,Casual Users
25395,281,15,146,3,3,4,10,Loyal Users
25604,394,5,16,3,1,2,6,Casual Users
25696,161,14,28,4,3,2,9,Loyal Users
25698,417,13,23,3,3,2,8,Loyal Users
25729,128,19,69,4,3,4,11,Loyal Users
25990,147,44,98,4,4,4,12,Champions
26430,92,27,56,4,4,3,11,Loyal Users
13739,1406,13,19,1,3,2,6,Casual Users
14164,1811,16,33,1,3,3,7,Casual Users
14231,69,7,10,5,2,1,8,Promising
14490,26,49,96,5,5,4,14,Champions
14494,407,20,52,3,3,3,9,Loyal Users
14627,2,56,135,5,5,4,14,Champions
14764,960,6,10,2,1,1,4,Lost
14780,1015,8,10,2,2,1,5,Lost
14867,103,26,138,4,4,4,12,Champions
15326,120,75,214,4,5,5,14,Champions
15710,136,49,89,4,5,4,13,Champions
15800,85,80,108,4,5,4,13,Champions
15919,580,8,16,2,2,2,6,Lost
16040,924,17,72,2,3,4,9,Casual Users
16062,2167,5,11,1,1,1,3,Lost
16171,112,73,145,4,5,4,13,Champions
16425,493,10,70,2,2,4,8,Lost
16566,757,12,16,2,3,2,7,Casual Users
17112,63,30,68,5,4,4,13,Champions
17153,107,8,61,4,2,3,9,Promising
17334,324,16,29,3,3,2,8,Loyal Users
17620,116,10,23,4,2,2,8,Promising
17674,114,78,308,4,5,5,14,Champions
18064,60,13,17,5,3,2,10,Loyal Users
18067,24,21,74,5,3,4,12,Loyal Users
18257,148,41,123,4,4,4,12,Champions
18329,179,44,97,3,4,4,11,Loyal Users
18386,126,34,52,4,4,3,11,Loyal Users
18678,1750,9,13,1,2,1,4,Lost
18925,1,42,145,5,4,4,13,Champions
18931,73,94,144,4,5,4,13,Champions
19150,147,8,9,4,2,1,7,Promising
19249,658,52,168,2,5,5,12,At Risk
19353,541,25,41,2,4,3,9,At Risk
19699,2122,5,9,1,1,1,3,Lost
19971,146,19,43,4,3,3,10,Loyal Users
20025,3597,11,16,1,2,2,5,Lost
20168,9,14,33,5,3,3,11,Loyal Users
20355,211,61,86,3,5,4,12,Loyal Users
20537,14,111,238,5,5,5,15,Champions
20594,25,15,50,5,3,3,11,Loyal Users
20684,1,36,72,5,4,4,13,Champions
20816,179,6,8,3,1,1,5,Casual Users
20919,1694,7,22,1,2,2,5,Lost
21277,86,77,187,4,5,5,14,Champions
21439,539,15,63,2,3,4,9,Casual Users
21864,762,28,97,2,4,4,10,At Risk
22035,590,5,10,2,1,1,4,Lost
22893,258,64,227,3,5,5,13,Loyal Users
22901,142,18,25,4,3,2,9,Loyal Users
23017,432,6,20,3,1,2,6,Casual Users
23134,522,5,19,2,1,2,5,Lost
23169,221,16,25,3,3,2,8,Loyal Users
23518,122,18,77,4,3,4,11,Loyal Users
23562,4951,12,20,1,3,2,6,Casual Users
24334,292,24,34,3,4,3,10,Loyal Users
24447,2,40,69,5,4,4,13,Champions
24483,1129,7,53,2,2,3,7,Lost
24976,5,19,61,5,3,3,11,Loyal Users
25312,114,58,117,4,5,4,13,Champions
25318,273,19,66,3,3,4,10,Loyal Users
25600,673,8,14,2,2,1,5,Lost
25641,2287,5,32,1,1,3,5,Lost
25646,4106,10,29,1,2,2,5,Lost
25721,272,14,37,3,3,3,9,Loyal Users
25893,985,11,27,2,2,2,6,Lost
25981,958,24,80,2,4,4,10,At Risk
26268,264,5,15,3,1,1,5,Casual Users
13627,222,46,71,3,5,4,12,Loyal Users
13678,459,14,92,3,3,4,10,Loyal Users
13700,53,11,21,5,2,2,9,Promising
13728,3,86,232,5,5,5,15,Champions
13857,600,13,14,2,3,1,6,Casual Users
14125,1083,11,21,2,2,2,6,Lost
14659,238,28,36,3,4,3,10,Loyal Users
14782,76,45,124,4,4,4,12,Champions
14803,335,79,209,3,5,5,13,Loyal Users
14915,1592,5,15,1,1,1,3,Lost
14947,5,22,49,5,4,3,12,Loyal Users
14996,1,116,404,5,5,5,15,Champions
15092,919,8,37,2,2,3,7,Lost
15176,56,25,41,5,4,3,12,Loyal Users
15453,1534,7,15,1,2,1,4,Lost
15653,2582,5,6,1,1,1,3,Lost
15676,135,47,135,4,5,4,13,Champions
15861,18,48,144,5,5,4,14,Champions
15944,20,24,46,5,4,3,12,Loyal Users
16291,6,118,311,5,5,5,15,Champions
16494,2034,6,8,1,1,1,3,Lost
16499,1691,8,12,1,2,1,4,Lost
16522,66,200,319,5,5,5,15,Champions
16715,2831,31,53,1,4,3,8,At Risk
16843,158,5,13,4,1,1,6,Promising
16911,142,21,34,4,3,3,10,Loyal Users
17060,822,6,33,2,1,3,6,Lost
17414,112,33,87,4,4,4,12,Champions
17701,121,33,91,4,4,4,12,Champions
17713,5549,10,11,1,2,1,4,Lost
18079,123,107,189,4,5,5,14,Champions
18086,15,117,466,5,5,5,15,Champions
18228,2866,7,10,1,2,1,4,Lost
18584,3220,12,36,1,3,3,7,Casual Users
18615,363,20,91,3,3,4,10,Loyal Users
18636,7,11,14,5,2,1,8,Promising
18939,1145,9,12,2,2,1,5,Lost
19117,269,15,193,3,3,5,11,Loyal Users
19487,75,24,35,4,4,3,11,Loyal Users
19524,242,39,68,3,4,4,11,Loyal Users
19907,5116,5,17,1,1,2,4,Lost
20188,1688,11,52,1,2,3,6,Lost
20241,254,18,56,3,3,3,9,Loyal Users
20284,1224,13,78,2,3,4,9,Casual Users
20330,146,163,305,4,5,5,14,Champions
20488,136,16,175,4,3,5,12,Loyal Users
20741,0,46,137,5,5,4,14,Champions
21064,632,11,49,2,2,3,7,Lost
21694,492,21,22,2,3,2,7,Casual Users
21817,120,25,78,4,4,4,12,Champions
21851,798,5,8,2,1,1,4,Lost
22048,880,7,14,2,2,1,5,Lost
22267,63,63,240,5,5,5,15,Champions
22396,447,10,28,3,2,2,7,Casual Users
22663,270,58,85,3,5,4,12,Loyal Users
23069,1365,14,33,1,3,3,7,Casual Users
23610,2,54,363,5,5,5,15,Champions
23880,86,17,76,4,3,4,11,Loyal Users
23936,70,48,93,4,5,4,13,Champions
24030,541,14,49,2,3,3,8,Casual Users
24229,1690,25,48,1,4,3,8,At Risk
24272,180,106,257,3,5,5,13,Loyal Users
24285,1288,33,63,1,4,4,9,At Risk
24368,807,5,62,2,1,3,6,Lost
24641,169,20,62,3,3,3,9,Loyal Users
24648,97,32,45,4,4,3,11,Loyal Users
25013,868,13,14,2,3,1,6,Casual Users
25110,2145,5,12,1,1,1,3,Lost
25310,2574,11,50,1,2,3,6,Lost
25364,410,16,20,3,3,2,8,Loyal Users
25609,105,11,51,4,2,3,9,Promising
25704,1412,5,10,1,1,1,3,Lost
25786,136,7,19,4,2,2,8,Promising
25920,3427,6,6,1,1,1,3,Lost
26022,694,14,18,2,3,2,7,Casual Users
13824,857,8,128,2,2,4,8,Lost
14241,969,24,56,2,4,3,9,At Risk
14411,30,79,504,5,5,5,15,Champions
14433,88,35,117,4,4,4,12,Champions
14806,720,28,42,2,4,3,9,At Risk
15350,2711,8,60,1,2,3,6,Lost
15414,1484,15,47,1,3,3,7,Casual Users
15664,1363,16,27,1,3,2,6,Casual Users
15949,2508,5,5,1,1,1,3,Lost
15992,2,23,103,5,4,4,13,Champions
16005,165,6,9,4,1,1,6,Promising
16123,101,38,72,4,4,4,12,Champions
16364,92,22,34,4,4,3,11,Loyal Users
16404,453,5,6,3,1,1,5,Casual Users
16646,797,10,12,2,2,1,5,Lost
17109,221,18,47,3,3,3,9,Loyal Users
17236,1,5,21,5,1,2,8,Promising
17533,1827,6,13,1,1,1,3,Lost
17752,669,11,16,2,2,2,6,Lost
17769,235,6,10,3,1,1,5,Casual Users
18355,722,9,57,2,2,3,7,Lost
18459,288,9,23,3,2,2,7,Casual Users
19140,3,16,120,5,3,4,12,Loyal Users
19176,5540,7,54,1,2,3,6,Lost
19181,608,7,11,2,2,1,5,Lost
19341,846,8,11,2,2,1,5,Lost
19350,1410,6,7,1,1,1,3,Lost
19399,743,12,24,2,3,2,7,Casual Users
19412,417,26,92,3,4,4,11,Loyal Users
19506,1000,26,111,2,4,4,10,At Risk
19805,405,6,22,3,1,2,6,Casual Users
20013,2154,10,41,1,2,3,6,Lost
20368,2600,17,78,1,3,4,8,Casual Users
20445,70,12,33,4,3,3,10,Loyal Users
21027,2731,9,11,1,2,1,4,Lost
21112,603,36,83,2,4,4,10,At Risk
21440,106,27,76,4,4,4,12,Champions
21638,465,16,32,3,3,3,9,Loyal Users
21718,253,34,94,3,4,4,11,Loyal Users
22286,192,46,116,3,5,4,12,Loyal Users
22422,1121,5,13,2,1,1,4,Lost
22611,1244,15,17,2,3,2,7,Casual Users
22871,217,17,28,3,3,2,8,Loyal Users
22956,527,5,12,2,1,1,4,Lost
23174,391,72,92,3,5,4,12,Loyal Users
23386,132,6,16,4,1,2,7,Promising
23647,960,29,98,2,4,4,10,At Risk
23651,355,11,34,3,2,3,8,Casual Users
23758,5870,5,30,1,1,2,4,Lost
23815,18,114,415,5,5,5,15,Champions
24255,710,6,12,2,1,1,4,Lost
24314,114,39,60,4,4,3,11,Loyal Users
24377,148,5,6,4,1,1,6,Promising
24517,20,15,30,5,3,2,10,Loyal Users
24840,416,32,96,3,4,4,11,Loyal Users
25028,43,55,95,5,5,4,14,Champions
25423,142,9,42,4,2,3,9,Promising
25506,1119,23,59,2,4,3,9,At Risk
25730,56,79,438,5,5,5,15,Champions
25877,138,67,317,4,5,5,14,Champions
25888,152,17,38,4,3,3,10,Loyal Users
26011,894,8,15,2,2,1,5,Lost
26014,245,66,297,3,5,5,13,Loyal Users
26024,1425,6,20,1,1,2,4,Lost
26033,317,5,9,3,1,1,5,Casual Users
26060,1410,24,70,1,4,4,9,At Risk
26063,700,6,7,2,1,1,4,Lost
13778,412,18,27,3,3,2,8,Loyal Users
13814,17,6,7,5,1,1,7,Promising
13843,99,10,68,4,2,4,10,Promising
13907,1104,11,15,2,2,1,5,Lost
14240,315,27,78,3,4,4,11,Loyal Users
14561,633,10,33,2,2,3,7,Lost
14684,705,8,42,2,2,3,7,Lost
14689,571,17,29,2,3,2,7,Casual Users
14708,42,140,391,5,5,5,15,Champions
15007,1,66,288,5,5,5,15,Champions
15301,169,67,95,3,5,4,12,Loyal Users
15533,8,34,97,5,4,4,13,Champions
15572,88,104,243,4,5,5,14,Champions
15828,286,25,58,3,4,3,10,Loyal Users
16029,65,155,319,5,5,5,15,Champions
16271,77,9,95,4,2,4,10,Promising
16318,57,104,275,5,5,5,15,Champions
16363,38,126,235,5,5,5,15,Champions
16415,128,29,50,4,4,3,11,Loyal Users
16548,1686,7,7,1,2,1,4,Lost
16629,2306,6,27,1,1,2,4,Lost
16677,4037,24,114,1,4,4,9,At Risk
17164,57,111,657,5,5,5,15,Champions
17231,1602,18,26,1,3,2,6,Casual Users
17279,5404,6,7,1,1,1,3,Lost
17469,1432,9,14,1,2,1,4,Lost
17971,476,10,39,2,2,3,7,Lost
18160,340,10,20,3,2,2,7,Casual Users
18223,1981,7,7,1,2,1,4,Lost
18351,212,20,63,3,3,4,10,Loyal Users
18435,134,79,176,4,5,5,14,Champions
18730,160,109,570,4,5,5,14,Champions
18734,1128,13,23,2,3,2,7,Casual Users
18770,69,19,22,5,3,2,10,Loyal Users
18903,8,15,21,5,3,2,10,Loyal Users
19275,2121,13,31,1,3,2,6,Casual Users
19489,2171,22,79,1,4,4,9,At Risk
19502,242,10,17,3,2,2,7,Casual Users
19726,30,17,59,5,3,3,11,Loyal Users
20332,280,105,141,3,5,4,12,Loyal Users
20367,656,8,14,2,2,1,5,Lost
20510,2170,7,14,1,2,1,4,Lost
20533,4,22,37,5,4,3,12,Loyal Users
20740,839,6,10,2,1,1,4,Lost
20791,117,10,11,4,2,1,7,Promising
21089,143,15,55,4,3,3,10,Loyal Users
21172,11,108,475,5,5,5,15,Champions
21611,129,38,126,4,4,4,12,Champions
21748,439,9,14,3,2,1,6,Casual Users
22453,22,13,44,5,3,3,11,Loyal Users
22460,2,35,44,5,4,3,12,Loyal Users
22601,289,6,14,3,1,1,5,Casual Users
23128,841,5,10,2,1,1,4,Lost
24040,420,23,64,3,4,4,11,Loyal Users
24246,130,6,11,4,1,1,6,Promising
24383,139,13,14,4,3,1,8,Loyal Users
24671,257,25,74,3,4,4,11,Loyal Users
24726,5,29,41,5,4,3,12,Loyal Users
24738,409,23,48,3,4,3,10,Loyal Users
24984,120,18,104,4,3,4,11,Loyal Users
25093,303,6,7,3,1,1,5,Casual Users
25271,120,51,137,4,5,4,13,Champions
25379,494,37,230,2,4,5,11,At Risk
25534,1818,15,104,1,3,4,8,Casual Users
25799,120,37,197,4,4,5,13,Champions
25890,86,10,55,4,2,3,9,Promising
25979,419,9,24,3,2,2,7,Casual Users
26414,1174,5,5,2,1,1,4,Lost
13900,426,10,18,3,2,2,7,Casual Users
14236,170,28,69,3,4,4,11,Loyal Users
15125,1126,22,71,2,4,4,10,At Risk
15343,7,5,20,5,1,2,8,Promising
15524,112,19,160,4,3,5,12,Loyal Users
15935,203,5,31,3,1,2,6,Casual Users
16054,2238,6,13,1,1,1,3,Lost
16065,708,7,14,2,2,1,5,Lost
16560,111,103,503,4,5,5,14,Champions
16700,232,20,30,3,3,2,8,Loyal Users
16722,18,40,237,5,4,5,14,Champions
16862,134,28,56,4,4,3,11,Loyal Users
17017,128,6,7,4,1,1,6,Promising
17162,704,17,152,2,3,5,10,Casual Users
17219,1369,5,8,1,1,1,3,Lost
17700,777,32,43,2,4,3,9,At Risk
17953,42,47,62,5,5,3,13,Loyal Users
18009,198,30,40,3,4,3,10,Loyal Users
18224,1703,5,19,1,1,2,4,Lost
18468,1,18,20,5,3,2,10,Loyal Users
18924,2433,5,9,1,1,1,3,Lost
18972,695,9,13,2,2,1,5,Lost
19190,114,9,140,4,2,4,10,Promising
19744,1,18,38,5,3,3,11,Loyal Users
19760,115,34,40,4,4,3,11,Loyal Users
19859,1876,5,23,1,1,2,4,Lost
20207,3142,8,22,1,2,2,5,Lost
21625,596,12,157,2,3,5,10,Casual Users
21969,2659,7,9,1,2,1,4,Lost
22070,16,83,262,5,5,5,15,Champions
22085,3298,5,5,1,1,1,3,Lost
22303,760,48,82,2,5,4,11,At Risk
22390,86,64,114,4,5,4,13,Champions
22449,132,58,97,4,5,4,13,Champions
22691,1018,8,16,2,2,2,6,Lost
23131,40,40,142,5,4,4,13,Champions
23155,949,46,200,2,5,5,12,At Risk
23453,2,20,242,5,3,5,13,Loyal Users
23573,764,10,19,2,2,2,6,Lost
23752,72,33,80,4,4,4,12,Champions
23773,21,42,150,5,4,5,14,Champions
23797,5002,7,18,1,2,2,5,Lost
23869,1718,9,13,1,2,1,4,Lost
24283,3626,5,12,1,1,1,3,Lost
24522,163,31,61,4,4,3,11,Loyal Users
24609,2555,11,14,1,2,1,4,Lost
24618,4679,19,38,1,3,3,7,Casual Users
24769,653,9,18,2,2,2,6,Lost
24794,2636,6,6,1,1,1,3,Lost
25185,4236,5,8,1,1,1,3,Lost
25279,483,12,54,2,3,3,8,Casual Users
25459,3469,7,27,1,2,2,5,Lost
25713,2005,10,10,1,2,1,4,Lost
25879,92,74,259,4,5,5,14,Champions
26125,337,33,87,3,4,4,11,Loyal Users
26235,136,27,59,4,4,3,11,Loyal Users
26439,296,8,9,3,2,1,6,Casual Users
26469,60,37,89,5,4,4,13,Champions
13672,202,130,284,3,5,5,13,Loyal Users
13804,5,30,184,5,4,5,14,Champions
13850,2219,6,12,1,1,1,3,Lost
14174,352,5,9,3,1,1,5,Casual Users
14255,89,23,192,4,4,5,13,Champions
14582,3,150,593,5,5,5,15,Champions
14641,228,7,9,3,2,1,6,Casual Users
14702,825,10,36,2,2,3,7,Lost
14747,81,57,167,4,5,5,14,Champions
15197,1529,20,44,1,3,3,7,Casual Users
15268,751,10,47,2,2,3,7,Lost
15595,88,227,747,4,5,5,14,Champions
15659,1002,12,56,2,3,3,8,Casual Users
15686,1064,15,42,2,3,3,8,Casual Users
15757,1547,7,9,1,2,1,4,Lost
16180,822,7,34,2,2,3,7,Lost
16290,171,77,269,3,5,5,13,Loyal Users
16357,2900,5,13,1,1,1,3,Lost
16362,2610,53,99,1,5,4,10,At Risk
16486,176,11,12,3,2,1,6,Casual Users
16606,1018,11,25,2,2,2,6,Lost
16957,3322,28,149,1,4,5,10,At Risk
16966,412,5,6,3,1,1,5,Casual Users
17140,7,53,115,5,5,4,14,Champions
17251,1426,35,112,1,4,4,9,At Risk
17293,184,48,136,3,5,4,12,Loyal Users
17690,2844,8,19,1,2,2,5,Lost
17842,356,6,30,3,1,2,6,Casual Users
18379,7,87,225,5,5,5,15,Champions
18570,3908,5,8,1,1,1,3,Lost
18628,828,11,29,2,2,2,6,Lost
18694,148,97,381,4,5,5,14,Champions
19059,2125,7,13,1,2,1,4,Lost
19112,1647,75,119,1,5,4,10,At Risk
19236,5537,5,13,1,1,1,3,Lost
19823,317,13,30,3,3,2,8,Loyal Users
20200,2138,15,30,1,3,2,6,Casual Users
20548,1555,9,25,1,2,2,5,Lost
20616,76,29,64,4,4,4,12,Champions
20667,2408,9,78,1,2,4,7,Lost
20994,117,34,70,4,4,4,12,Champions
21213,543,5,8,2,1,1,4,Lost
21888,568,7,9,2,2,1,5,Lost
21948,737,7,16,2,2,2,6,Lost
22157,225,165,341,3,5,5,13,Loyal Users
22427,222,22,63,3,4,4,11,Loyal Users
22506,97,21,93,4,3,4,11,Loyal Users
22759,27,71,253,5,5,5,15,Champions
22880,535,20,39,2,3,3,8,Casual Users
23238,698,17,27,2,3,2,7,Casual Users
23806,97,34,73,4,4,4,12,Champions
23835,694,5,9,2,1,1,4,Lost
24677,275,32,98,3,4,4,11,Loyal Users
24871,550,9,56,2,2,3,7,Lost
25061,139,17,20,4,3,2,9,Loyal Users
25164,851,8,25,2,2,2,6,Lost
25492,1361,5,6,1,1,1,3,Lost
25611,259,95,302,3,5,5,13,Loyal Users
25626,1668,7,15,1,2,1,4,Lost
25712,13,27,104,5,4,4,13,Champions
25845,411,9,41,3,2,3,8,Casual Users
25922,437,5,11,3,1,1,5,Casual Users
26177,2583,14,19,1,3,2,6,Casual Users
13716,17,9,35,5,2,3,10,Promising
13719,147,5,6,4,1,1,6,Promising
13940,802,5,24,2,1,2,5,Lost
14295,19,14,51,5,3,3,11,Loyal Users
14360,545,71,133,2,5,4,11,At Risk
14526,0,82,328,5,5,5,15,Champions
14550,166,51,336,3,5,5,13,Loyal Users
14672,271,33,70,3,4,4,11,Loyal Users
14873,582,17,36,2,3,3,8,Casual Users
15380,738,78,562,2,5,5,12,At Risk
15579,118,31,111,4,4,4,12,Champions
15620,101,31,129,4,4,4,12,Champions
15777,542,13,34,2,3,3,8,Casual Users
16009,1362,16,41,1,3,3,7,Casual Users
16034,539,9,55,2,2,3,7,Lost
16258,31,7,9,5,2,1,8,Promising
16617,28,40,69,5,4,4,13,Champions
16711,2110,12,29,1,3,2,6,Casual Users
16793,461,5,18,3,1,2,6,Casual Users
17173,274,17,46,3,3,3,9,Loyal Users
17202,1177,7,18,2,2,2,6,Lost
17431,109,55,212,4,5,5,14,Champions
18115,706,37,65,2,4,4,10,At Risk
18516,6,107,253,5,5,5,15,Champions
18723,667,15,71,2,3,4,9,Casual Users
18921,115,5,6,4,1,1,6,Promising
18974,108,44,127,4,4,4,12,Champions
19232,40,116,296,5,5,5,15,Champions
19299,586,8,22,2,2,2,6,Lost
19500,139,6,21,4,1,2,7,Promising
19746,3697,17,40,1,3,3,7,Casual Users
19905,539,12,29,2,3,2,7,Casual Users
20280,134,6,13,4,1,1,6,Promising
20489,645,6,42,2,1,3,6,Lost
20824,44,25,35,5,4,3,12,Loyal Users
20996,45,5,5,5,1,1,7,Promising
21028,2631,16,43,1,3,3,7,Casual Users
21114,2511,5,7,1,1,1,3,Lost
21461,12,75,104,5,5,4,14,Champions
21616,3806,7,15,1,2,1,4,Lost
21765,419,12,15,3,3,1,7,Loyal Users
21789,1600,6,7,1,1,1,3,Lost
21897,57,36,87,5,4,4,13,Champions
22071,152,10,13,4,2,1,7,Promising
22309,34,41,186,5,4,5,14,Champions
22376,473,29,60,2,4,3,9,At Risk
22378,670,5,9,2,1,1,4,Lost
22632,16,6,10,5,1,1,7,Promising
22769,74,13,60,4,3,3,10,Loyal Users
22830,986,15,34,2,3,3,8,Casual Users
22980,95,21,28,4,3,2,9,Loyal Users
23566,177,5,5,3,1,1,5,Casual Users
23867,2130,6,10,1,1,1,3,Lost
24087,234,48,93,3,5,4,12,Loyal Users
24497,862,8,8,2,2,1,5,Lost
24520,2775,12,26,1,3,2,6,Casual Users
24826,38,70,94,5,5,4,14,Champions
24973,272,111,346,3,5,5,13,Loyal Users
25015,1015,14,16,2,3,2,7,Casual Users
25018,253,14,31,3,3,2,8,Loyal Users
25041,1097,8,20,2,2,2,6,Lost
25205,3,128,805,5,5,5,15,Champions
25480,1,5,13,5,1,1,7,Promising
25608,293,9,22,3,2,2,7,Casual Users
25690,2287,6,7,1,1,1,3,Lost
25775,1563,7,8,1,2,1,4,Lost
25838,644,12,121,2,3,4,9,Casual Users
25857,1305,28,65,1,4,4,9,At Risk
26026,102,36,228,4,4,5,13,Champions
26271,8,85,272,5,5,5,15,Champions
26583,1517,13,21,1,3,2,6,Casual Users
26623,1143,10,14,2,2,1,5,Lost
26706,14,128,334,5,5,5,15,Champions
26708,19,27,139,5,4,4,13,Champions
26755,96,39,63,4,4,4,12,Champions
27484,416,20,25,3,3,2,8,Loyal Users
27760,2293,9,11,1,2,1,4,Lost
27974,726,5,7,2,1,1,4,Lost
28024,24,9,26,5,2,2,9,Promising
28088,137,28,46,4,4,3,11,Loyal Users
28124,390,26,34,3,4,3,10,Loyal Users
28146,84,52,95,4,5,4,13,Champions
28170,58,14,27,5,3,2,10,Loyal Users
28577,149,20,148,4,3,5,12,Loyal Users
28664,5073,6,8,1,1,1,3,Lost
28759,60,9,27,5,2,2,9,Promising
28836,65,107,186,5,5,5,15,Champions
29054,546,22,42,2,4,3,9,At Risk
29194,3696,17,25,1,3,2,6,Casual Users
29228,265,22,88,3,4,4,11,Loyal Users
29285,199,13,42,3,3,3,9,Loyal Users
29601,285,23,43,3,4,3,10,Loyal Users
29719,36,110,753,5,5,5,15,Champions
29744,2413,8,38,1,2,3,6,Lost
29814,1254,11,19,2,2,2,6,Lost
29834,125,19,54,4,3,3,10,Loyal Users
29894,1519,6,28,1,1,2,4,Lost
29993,25,99,785,5,5,5,15,Champions
30361,1146,11,13,2,2,1,5,Lost
30654,423,28,42,3,4,3,10,Loyal Users
30903,437,18,53,3,3,3,9,Loyal Users
30970,3280,6,8,1,1,1,3,Lost
31035,2935,11,53,1,2,3,6,Lost
31236,10,91,713,5,5,5,15,Champions
31261,423,18,30,3,3,2,8,Loyal Users
31367,4406,6,22,1,1,2,4,Lost
31528,234,83,245,3,5,5,13,Loyal Users
31912,69,62,129,5,5,4,14,Champions
31951,575,5,20,2,1,2,5,Lost
31983,814,14,28,2,3,2,7,Casual Users
32396,547,8,11,2,2,1,5,Lost
32414,10,107,223,5,5,5,15,Champions
32445,2232,5,5,1,1,1,3,Lost
32460,85,6,12,4,1,1,6,Promising
32539,39,7,16,5,2,2,9,Promising
32592,440,15,23,3,3,2,8,Loyal Users
32855,899,15,18,2,3,2,7,Casual Users
33375,4,30,101,5,4,4,13,Champions
33412,1045,12,14,2,3,1,6,Casual Users
33569,167,62,216,3,5,5,13,Loyal Users
33602,259,25,61,3,4,3,10,Loyal Users
33717,975,27,192,2,4,5,11,At Risk
33722,1026,18,181,2,3,5,10,Casual Users
33868,119,10,15,4,2,1,7,Promising
34061,295,13,135,3,3,4,10,Loyal Users
34234,1267,10,26,1,2,2,5,Lost
34239,579,22,87,2,4,4,10,At Risk
34759,413,31,36,3,4,3,10,Loyal Users
35071,548,9,21,2,2,2,6,Lost
35351,128,56,203,4,5,5,14,Champions
35361,40,47,268,5,5,5,15,Champions
35689,436,28,117,3,4,4,11,Loyal Users
35694,1415,9,11,1,2,1,4,Lost
35820,0,34,61,5,4,3,12,Loyal Users
35912,396,24,42,3,4,3,10,Loyal Users
35947,2109,16,28,1,3,2,6,Casual Users
35982,370,57,227,3,5,5,13,Loyal Users
36131,86,151,245,4,5,5,14,Champions
36224,120,22,77,4,4,4,12,Champions
36355,2094,5,17,1,1,2,4,Lost
36525,889,10,13,2,2,1,5,Lost
36538,90,68,198,4,5,5,14,Champions
37111,72,45,218,4,4,5,13,Champions
37146,150,49,117,4,5,4,13,Champions
37251,312,5,7,3,1,1,5,Casual Users
37263,850,29,107,2,4,4,10,At Risk
37307,738,11,16,2,2,2,6,Lost
37489,732,14,18,2,3,2,7,Casual Users
38153,29,71,492,5,5,5,15,Champions
38220,2586,5,9,1,1,1,3,Lost
38311,2632,14,45,1,3,3,7,Casual Users
38395,5061,6,14,1,1,1,3,Lost
38422,117,7,8,4,2,1,7,Promising
38723,660,26,33,2,4,3,9,At Risk
38758,1381,11,21,1,2,2,5,Lost
38868,365,15,53,3,3,3,9,Loyal Users
26544,529,42,114,2,4,4,10,At Risk
26699,116,39,148,4,4,5,13,Champions
26767,978,9,15,2,2,1,5,Lost
26787,5002,9,12,1,2,1,4,Lost
26801,628,9,9,2,2,1,5,Lost
26936,236,59,184,3,5,5,13,Loyal Users
27118,817,7,14,2,2,1,5,Lost
27129,273,5,15,3,1,1,5,Casual Users
27261,792,13,84,2,3,4,9,Casual Users
27888,128,19,29,4,3,2,9,Loyal Users
28298,1550,14,16,1,3,2,6,Casual Users
28883,1341,8,20,1,2,2,5,Lost
29058,1533,7,13,1,2,1,4,Lost
29075,23,48,199,5,5,5,15,Champions
29595,389,53,137,3,5,4,12,Loyal Users
29827,485,5,12,2,1,1,4,Lost
29950,168,26,70,3,4,4,11,Loyal Users
30183,129,73,219,4,5,5,14,Champions
30988,853,5,18,2,1,2,5,Lost
31118,1690,8,8,1,2,1,4,Lost
31301,1470,7,19,1,2,2,5,Lost
31352,60,21,39,5,3,3,11,Loyal Users
31680,60,189,408,5,5,5,15,Champions
31763,817,23,108,2,4,4,10,At Risk
31928,507,7,10,2,2,1,5,Lost
32304,3546,5,7,1,1,1,3,Lost
32891,1019,10,57,2,2,3,7,Lost
33221,106,55,112,4,5,4,13,Champions
33762,1985,5,24,1,1,2,4,Lost
33855,545,27,91,2,4,4,10,At Risk
34103,25,110,698,5,5,5,15,Champions
34275,238,51,151,3,5,5,13,Loyal Users
34591,99,126,272,4,5,5,14,Champions
34650,905,40,94,2,4,4,10,At Risk
34878,713,15,40,2,3,3,8,Casual Users
35450,273,60,223,3,5,5,13,Loyal Users
35654,558,9,18,2,2,2,6,Lost
35800,713,5,28,2,1,2,5,Lost
35868,86,13,37,4,3,3,10,Loyal Users
36106,330,14,62,3,3,3,9,Loyal Users
36312,4079,9,75,1,2,4,7,Lost
36583,354,17,27,3,3,2,8,Loyal Users
36655,51,109,167,5,5,5,15,Champions
36706,44,38,112,5,4,4,13,Champions
36783,1008,17,27,2,3,2,7,Casual Users
36982,668,7,25,2,2,2,6,Lost
37015,453,36,287,3,4,5,12,Loyal Users
37025,3653,8,31,1,2,2,5,Lost
37195,1892,7,9,1,2,1,4,Lost
37297,266,103,211,3,5,5,13,Loyal Users
37480,693,28,50,2,4,3,9,At Risk
37482,81,19,60,4,3,3,10,Loyal Users
37526,2,54,135,5,5,4,14,Champions
37668,5894,8,8,1,2,1,4,Lost
37669,415,7,63,3,2,4,9,Casual Users
37734,26,8,30,5,2,2,9,Promising
37832,149,38,91,4,4,4,12,Champions
38436,4,155,275,5,5,5,15,Champions
38562,929,10,20,2,2,2,6,Lost
38611,274,20,37,3,3,3,9,Loyal Users
38707,857,21,115,2,3,4,9,Casual Users
38806,150,11,31,4,2,2,8,Promising
39069,13,15,42,5,3,3,11,Loyal Users
39153,2738,7,10,1,2,1,4,Lost
39161,2209,18,60,1,3,3,7,Casual Users
26619,123,106,170,4,5,5,14,Champions
26646,947,7,30,2,2,2,6,Lost
27214,97,41,114,4,4,4,12,Champions
27266,625,7,29,2,2,2,6,Lost
27471,158,12,44,4,3,3,10,Loyal Users
27709,178,6,9,3,1,1,5,Casual Users
28316,6,41,74,5,4,4,13,Champions
28581,2703,30,66,1,4,4,9,At Risk
28871,3243,7,7,1,2,1,4,Lost
29022,191,27,50,3,4,3,10,Loyal Users
29109,1214,14,21,2,3,2,7,Casual Users
29177,78,83,254,4,5,5,14,Champions
29630,483,11,14,2,2,1,5,Lost
29942,718,13,18,2,3,2,7,Casual Users
30330,412,57,145,3,5,4,12,Loyal Users
30525,13,64,208,5,5,5,15,Champions
30547,82,38,218,4,4,5,13,Champions
30617,1598,10,25,1,2,2,5,Lost
31031,3474,40,71,1,4,4,9,At Risk
31285,199,51,214,3,5,5,13,Loyal Users
31350,189,7,15,3,2,1,6,Casual Users
31435,8,75,398,5,5,5,15,Champions
31834,100,7,7,4,2,1,7,Promising
32525,1,5,35,5,1,3,9,Promising
32560,119,34,48,4,4,3,11,Loyal Users
32648,123,42,190,4,4,5,13,Champions
32680,115,26,69,4,4,4,12,Champions
32871,97,81,140,4,5,4,13,Champions
32988,126,8,38,4,2,3,9,Promising
33118,669,7,32,2,2,3,7,Lost
33607,483,26,144,2,4,4,10,At Risk
34197,1058,10,32,2,2,3,7,Lost
34435,3,70,389,5,5,5,15,Champions
34488,380,6,10,3,1,1,5,Casual Users
34531,1150,6,21,2,1,2,5,Lost
34569,77,137,508,4,5,5,14,Champions
34602,986,12,12,2,3,1,6,Casual Users
34611,130,6,7,4,1,1,6,Promising
34697,983,30,106,2,4,4,10,At Risk
34713,1416,14,79,1,3,4,8,Casual Users
34870,120,16,42,4,3,3,10,Loyal Users
35044,5529,9,11,1,2,1,4,Lost
35399,452,31,62,3,4,3,10,Loyal Users
35632,1524,44,187,1,4,5,10,At Risk
35794,2,53,87,5,5,4,14,Champions
35988,69,28,154,5,4,5,14,Champions
36192,309,33,60,3,4,3,10,Loyal Users
36347,125,142,655,4,5,5,14,Champions
36468,9,28,56,5,4,3,12,Loyal Users
36591,4123,9,21,1,2,2,5,Lost
36819,369,29,47,3,4,3,10,Loyal Users
37006,120,57,274,4,5,5,14,Champions
37355,2083,6,9,1,1,1,3,Lost
37409,22,27,56,5,4,3,12,Loyal Users
37593,309,6,11,3,1,1,5,Casual Users
37657,1298,6,7,1,1,1,3,Lost
37768,29,43,105,5,4,4,13,Champions
37818,1087,6,18,2,1,2,5,Lost
38146,138,93,300,4,5,5,14,Champions
38152,65,77,449,5,5,5,15,Champions
38270,1647,5,21,1,1,2,4,Lost
38297,13,63,195,5,5,5,15,Champions
38582,707,34,79,2,4,4,10,At Risk
38607,63,15,47,5,3,3,11,Loyal Users
38615,66,140,348,5,5,5,15,Champions
38621,17,50,106,5,5,4,14,Champions
38656,407,7,8,3,2,1,6,Casual Users
38980,2001,13,23,1,3,2,6,Casual Users
39151,51,123,465,5,5,5,15,Champions
26736,87,74,117,4,5,4,13,Champions
26769,403,16,62,3,3,3,9,Loyal Users
27030,5,18,46,5,3,3,11,Loyal Users
27194,466,6,14,3,1,1,5,Casual Users
27255,71,81,230,4,5,5,14,Champions
27466,721,7,17,2,2,2,6,Lost
27480,2177,6,14,1,1,1,3,Lost
27602,839,6,7,2,1,1,4,Lost
27609,124,12,18,4,3,2,9,Loyal Users
27733,67,52,132,5,5,4,14,Champions
27856,68,54,94,5,5,4,14,Champions
27966,1867,14,14,1,3,1,5,Casual Users
27977,289,74,92,3,5,4,12,Loyal Users
28526,1443,8,51,1,2,3,6,Lost
28584,3392,10,16,1,2,2,5,Lost
28893,48,125,379,5,5,5,15,Champions
29225,581,19,29,2,3,2,7,Casual Users
29305,15,26,41,5,4,3,12,Loyal Users
29483,4374,8,29,1,2,2,5,Lost
29566,285,7,7,3,2,1,6,Casual Users
29811,26,121,530,5,5,5,15,Champions
29997,442,20,33,3,3,3,9,Loyal Users
30632,1985,31,52,1,4,3,8,At Risk
30802,409,41,110,3,4,4,11,Loyal Users
31076,94,10,19,4,2,2,8,Promising
31161,688,10,38,2,2,3,7,Lost
31275,877,7,9,2,2,1,5,Lost
31290,80,89,154,4,5,5,14,Champions
31380,78,41,415,4,4,5,13,Champions
31447,303,6,18,3,1,2,6,Casual Users
31543,52,12,50,5,3,3,11,Loyal Users
31689,179,44,112,3,4,4,11,Loyal Users
31759,217,19,24,3,3,2,8,Loyal Users
31872,125,7,43,4,2,3,9,Promising
31988,1114,6,7,2,1,1,4,Lost
32016,577,5,5,2,1,1,4,Lost
32102,451,6,8,3,1,1,5,Casual Users
32291,3,22,69,5,4,4,13,Champions
32554,697,30,52,2,4,3,9,At Risk
32622,16,244,381,5,5,5,15,Champions
32786,150,20,60,4,3,3,10,Loyal Users
32832,423,29,38,3,4,3,10,Loyal Users
33337,281,16,73,3,3,4,10,Loyal Users
33437,245,55,321,3,5,5,13,Loyal Users
33550,2764,6,29,1,1,2,4,Lost
33615,1849,9,19,1,2,2,5,Lost
33690,129,30,138,4,4,4,12,Champions
33987,1128,9,13,2,2,1,5,Lost
34029,41,105,212,5,5,5,15,Champions
34450,11,45,107,5,4,4,13,Champions
34489,49,148,418,5,5,5,15,Champions
34494,400,18,23,3,3,2,8,Loyal Users
34495,435,28,53,3,4,3,10,Loyal Users
34742,47,22,30,5,4,2,11,Loyal Users
35094,44,13,65,5,3,4,12,Loyal Users
35142,978,15,115,2,3,4,9,Casual Users
35184,92,5,16,4,1,2,7,Promising
35235,19,34,51,5,4,3,12,Loyal Users
35371,1986,5,9,1,1,1,3,Lost
35702,20,38,78,5,4,4,13,Champions
35713,115,30,39,4,4,3,11,Loyal Users
35927,4511,5,8,1,1,1,3,Lost
35950,315,10,14,3,2,1,6,Casual Users
36066,946,6,8,2,1,1,4,Lost
36069,95,10,27,4,2,2,8,Promising
36098,1579,6,18,1,1,2,4,Lost
36155,94,100,140,4,5,4,13,Champions
36559,294,6,8,3,1,1,5,Casual Users
37152,770,27,69,2,4,4,10,At Risk
37215,3550,5,8,1,1,1,3,Lost
37788,12,85,116,5,5,4,14,Champions
37864,1957,8,15,1,2,1,4,Lost
38139,2103,7,13,1,2,1,4,Lost
38150,1952,9,18,1,2,2,5,Lost
38298,121,52,111,4,5,4,13,Champions
38581,13,56,253,5,5,5,15,Champions
38651,1787,36,128,1,4,4,9,At Risk
38730,714,10,50,2,2,3,7,Lost
38910,17,56,294,5,5,5,15,Champions
39217,152,37,99,4,4,4,12,Champions
26480,130,11,23,4,2,2,8,Promising
26490,230,54,154,3,5,5,13,Loyal Users
26589,2558,47,222,1,5,5,11,At Risk
26893,19,102,502,5,5,5,15,Champions
26965,137,5,7,4,1,1,6,Promising
27042,162,17,25,4,3,2,9,Loyal Users
27228,1498,22,31,1,4,2,7,At Risk
27361,457,20,26,3,3,2,8,Loyal Users
27583,538,10,26,2,2,2,6,Lost
27633,2347,6,7,1,1,1,3,Lost
27683,974,7,12,2,2,1,5,Lost
27708,279,15,61,3,3,3,9,Loyal Users
27803,375,68,158,3,5,5,13,Loyal Users
27941,110,74,183,4,5,5,14,Champions
27978,106,73,225,4,5,5,14,Champions
28331,127,18,39,4,3,3,10,Loyal Users
28343,2295,32,66,1,4,4,9,At Risk
28392,11,57,97,5,5,4,14,Champions
28505,2444,8,10,1,2,1,4,Lost
28604,33,73,133,5,5,4,14,Champions
29061,50,9,18,5,2,2,9,Promising
29098,118,13,23,4,3,2,9,Loyal Users
29453,420,25,94,3,4,4,11,Loyal Users
29660,4399,5,13,1,1,1,3,Lost
29714,124,16,21,4,3,2,9,Loyal Users
30320,1229,5,24,2,1,2,5,Lost
30333,13,104,279,5,5,5,15,Champions
30751,32,95,447,5,5,5,15,Champions
30809,1286,14,22,1,3,2,6,Casual Users
30965,109,86,313,4,5,5,14,Champions
31014,115,47,262,4,5,5,14,Champions
31317,718,14,16,2,3,2,7,Casual Users
31381,127,12,68,4,3,4,11,Loyal Users
31646,424,6,16,3,1,2,6,Casual Users
31796,619,8,34,2,2,3,7,Lost
31821,630,7,14,2,2,1,5,Lost
32094,16,96,299,5,5,5,15,Champions
32296,167,27,111,3,4,4,11,Loyal Users
32489,1510,24,29,1,4,2,7,At Risk
32546,44,7,29,5,2,2,9,Promising
32804,299,19,171,3,3,5,11,Loyal Users
33197,579,15,65,2,3,4,9,Casual Users
33265,382,11,38,3,2,3,8,Casual Users
33484,3439,23,49,1,4,3,8,At Risk
33751,426,5,6,3,1,1,5,Casual Users
33854,845,5,18,2,1,2,5,Lost
33904,40,29,73,5,4,4,13,Champions
34195,829,10,29,2,2,2,6,Lost
34255,177,38,81,3,4,4,11,Loyal Users
34805,3881,12,31,1,3,2,6,Casual Users
35169,521,6,7,2,1,1,4,Lost
35188,22,55,94,5,5,4,14,Champions
35294,1535,7,38,1,2,3,6,Lost
35331,482,20,21,2,3,2,7,Casual Users
35355,538,7,12,2,2,1,5,Lost
35514,31,80,121,5,5,4,14,Champions
35593,614,14,35,2,3,3,8,Casual Users
35626,262,5,5,3,1,1,5,Casual Users
35756,120,7,47,4,2,3,9,Promising
35830,792,10,34,2,2,3,7,Lost
35901,2428,8,37,1,2,3,6,Lost
36100,511,50,282,2,5,5,12,At Risk
36533,709,11,11,2,2,1,5,Lost
36905,128,5,20,4,1,2,7,Promising
37036,113,14,65,4,3,4,11,Loyal Users
37056,273,90,137,3,5,4,12,Loyal Users
37175,1024,21,85,2,3,4,9,Casual Users
37679,113,35,175,4,4,5,13,Champions
38138,4161,5,31,1,1,2,4,Lost
38176,847,26,63,2,4,4,10,At Risk
38250,65,109,257,5,5,5,15,Champions
38308,253,6,8,3,1,1,5,Casual Users
38470,1811,15,51,1,3,3,7,Casual Users
38523,130,68,257,4,5,5,14,Champions
38728,81,7,9,4,2,1,7,Promising
38827,9,41,108,5,4,4,13,Champions
38883,441,54,187,3,5,5,13,Loyal Users
38908,7,58,114,5,5,4,14,Champions
38926,139,9,45,4,2,3,9,Promising
38946,62,28,65,5,4,4,13,Champions
39139,1727,10,14,1,2,1,4,Lost
39167,421,66,205,3,5,5,13,Loyal Users
26484,641,30,53,2,4,3,9,At Risk
26729,131,97,181,4,5,5,14,Champions
26746,7,13,24,5,3,2,10,Loyal Users
26921,106,76,297,4,5,5,14,Champions
26930,6,118,580,5,5,5,15,Champions
27015,25,19,64,5,3,4,12,Loyal Users
27657,142,52,113,4,5,4,13,Champions
27822,3729,7,7,1,2,1,4,Lost
29328,471,8,20,2,2,2,6,Lost
29960,30,92,190,5,5,5,15,Champions
30128,417,61,138,3,5,4,12,Loyal Users
30519,569,21,79,2,3,4,9,Casual Users
30540,76,21,32,4,3,3,10,Loyal Users
30541,500,6,35,2,1,3,6,Lost
30589,49,25,64,5,4,4,13,Champions
30745,620,20,45,2,3,3,8,Casual Users
30837,1464,5,5,1,1,1,3,Lost
31207,1627,14,47,1,3,3,7,Casual Users
31309,2,10,39,5,2,3,10,Promising
31434,26,15,34,5,3,3,11,Loyal Users
31631,15,19,101,5,3,4,12,Loyal Users
31697,691,14,18,2,3,2,7,Casual Users
32061,419,19,83,3,3,4,10,Loyal Users
32165,569,10,26,2,2,2,6,Lost
32199,724,20,145,2,3,4,9,Casual Users
32253,104,11,12,4,2,1,7,Promising
32290,288,28,140,3,4,4,11,Loyal Users
32473,133,142,396,4,5,5,14,Champions
32623,174,36,99,3,4,4,11,Loyal Users
32670,59,53,127,5,5,4,14,Champions
32923,672,15,22,2,3,2,7,Casual Users
32945,1963,14,81,1,3,4,8,Casual Users
33012,432,71,158,3,5,5,13,Loyal Users
33189,116,18,121,4,3,4,11,Loyal Users
33243,268,10,27,3,2,2,7,Casual Users
34011,4275,9,9,1,2,1,4,Lost
34098,157,71,196,4,5,5,14,Champions
34416,21,40,168,5,4,5,14,Champions
34780,256,12,15,3,3,1,7,Loyal Users
34823,284,29,49,3,4,3,10,Loyal Users
35348,573,9,25,2,2,2,6,Lost
35454,139,5,9,4,1,1,6,Promising
35595,134,5,17,4,1,2,7,Promising
36237,101,61,234,4,5,5,14,Champions
36357,4233,22,62,1,4,3,8,At Risk
36366,285,36,218,3,4,5,12,Loyal Users
36499,616,15,83,2,3,4,9,Casual Users
36626,4428,6,14,1,1,1,3,Lost
36649,308,17,31,3,3,2,8,Loyal Users
36759,681,15,73,2,3,4,9,Casual Users
36822,61,12,23,5,3,2,10,Loyal Users
36930,386,12,21,3,3,2,8,Loyal Users
37209,0,97,383,5,5,5,15,Champions
37308,14,40,69,5,4,4,13,Champions
37389,1012,5,14,2,1,1,4,Lost
37412,424,14,32,3,3,3,9,Loyal Users
37713,2155,24,64,1,4,4,9,At Risk
37777,835,8,24,2,2,2,6,Lost
37812,3457,6,19,1,1,2,4,Lost
37828,2800,9,17,1,2,2,5,Lost
37862,430,30,116,3,4,4,11,Loyal Users
38282,225,30,115,3,4,4,11,Loyal Users
38437,84,18,26,4,3,2,9,Loyal Users
38627,1288,26,40,1,4,3,8,At Risk
38810,424,19,67,3,3,4,10,Loyal Users
39000,0,48,140,5,5,4,14,Champions
39037,161,148,279,4,5,5,14,Champions
39092,3175,6,36,1,1,3,5,Lost
26913,25,58,588,5,5,5,15,Champions
26970,1156,5,6,2,1,1,4,Lost
27413,385,42,90,3,4,4,11,Loyal Users
27472,111,56,215,4,5,5,14,Champions
28114,5548,5,7,1,1,1,3,Lost
28147,276,18,54,3,3,3,9,Loyal Users
28177,1820,37,62,1,4,3,8,At Risk
28525,204,8,11,3,2,1,6,Casual Users
28778,165,5,5,4,1,1,6,Promising
29011,57,36,43,5,4,3,12,Loyal Users
29206,10,12,17,5,3,2,10,Loyal Users
29282,107,10,55,4,2,3,9,Promising
29503,106,76,207,4,5,5,14,Champions
29893,1,18,76,5,3,4,12,Loyal Users
30219,3,15,32,5,3,3,11,Loyal Users
30397,1945,10,34,1,2,3,6,Lost
30399,1413,10,82,1,2,4,7,Lost
30755,4258,5,18,1,1,2,4,Lost
31319,340,20,175,3,3,5,11,Loyal Users
31418,155,76,259,4,5,5,14,Champions
31498,213,19,40,3,3,3,9,Loyal Users
31537,1291,9,31,1,2,2,5,Lost
31574,3,43,89,5,4,4,13,Champions
31987,323,12,54,3,3,3,9,Loyal Users
31991,144,21,56,4,3,3,10,Loyal Users
32860,399,13,24,3,3,2,8,Loyal Users
32866,239,8,16,3,2,2,7,Casual Users
33200,3514,21,37,1,3,3,7,Casual Users
33465,59,27,72,5,4,4,13,Champions
33589,1999,7,8,1,2,1,4,Lost
33759,203,15,26,3,3,2,8,Loyal Users
33965,54,24,31,5,4,2,11,Loyal Users
33966,147,8,19,4,2,2,8,Promising
34167,3315,6,6,1,1,1,3,Lost
34177,21,38,122,5,4,4,13,Champions
34247,884,73,114,2,5,4,11,At Risk
35191,266,16,60,3,3,3,9,Loyal Users
35571,926,46,242,2,5,5,12,At Risk
35765,1868,10,43,1,2,3,6,Lost
35782,224,41,63,3,4,4,11,Loyal Users
35816,96,16,32,4,3,3,10,Loyal Users
36112,1297,6,8,1,1,1,3,Lost
36579,411,54,305,3,5,5,13,Loyal Users
36580,2946,5,7,1,1,1,3,Lost
36693,553,8,103,2,2,4,8,Lost
36733,1811,13,36,1,3,3,7,Casual Users
36935,167,27,196,3,4,5,12,Loyal Users
37162,2,11,37,5,2,3,10,Promising
37199,81,214,474,4,5,5,14,Champions
37265,35,83,513,5,5,5,15,Champions
37379,2882,9,11,1,2,1,4,Lost
37415,168,11,18,3,2,2,7,Casual Users
37497,449,50,72,3,5,4,12,Loyal Users
37530,8,88,132,5,5,4,14,Champions
37735,844,5,10,2,1,1,4,Lost
38063,132,32,131,4,4,4,12,Champions
38169,2654,6,8,1,1,1,3,Lost
38199,126,59,90,4,5,4,13,Champions
38235,3528,8,11,1,2,1,4,Lost
38357,1,17,27,5,3,2,10,Loyal Users
38427,216,52,189,3,5,5,13,Loyal Users
38438,661,22,206,2,4,5,11,At Risk
38452,51,94,296,5,5,5,15,Champions
38704,374,20,37,3,3,3,9,Loyal Users
38928,70,18,32,4,3,3,10,Loyal Users
39121,5,83,192,5,5,5,15,Champions
26635,119,7,11,4,2,1,7,Promising
26713,238,50,155,3,5,5,13,Loyal Users
26779,18,52,91,5,5,4,14,Champions
26796,579,9,15,2,2,1,5,Lost
27000,238,8,16,3,2,2,7,Casual Users
27144,3284,15,65,1,3,4,8,Casual Users
27159,688,16,73,2,3,4,9,Casual Users
27195,69,184,336,5,5,5,15,Champions
27538,86,198,493,4,5,5,14,Champions
28033,90,13,53,4,3,3,10,Loyal Users
28754,705,5,16,2,1,2,5,Lost
28905,2418,5,15,1,1,1,3,Lost
29583,156,8,8,4,2,1,7,Promising
29654,407,55,216,3,5,5,13,Loyal Users
29658,745,35,61,2,4,3,9,At Risk
29974,88,60,140,4,5,4,13,Champions
30004,107,9,26,4,2,2,8,Promising
30085,188,42,137,3,4,4,11,Loyal Users
30087,76,5,5,4,1,1,6,Promising
30295,5094,8,15,1,2,1,4,Lost
30606,232,11,21,3,2,2,7,Casual Users
30650,835,10,14,2,2,1,5,Lost
30721,2705,7,9,1,2,1,4,Lost
30811,408,23,79,3,4,4,11,Loyal Users
31364,116,35,133,4,4,4,12,Champions
31397,1101,7,17,2,2,2,6,Lost
31421,658,11,29,2,2,2,6,Lost
31438,589,13,35,2,3,3,8,Casual Users
31829,732,7,14,2,2,1,5,Lost
31873,225,127,286,3,5,5,13,Loyal Users
32644,2708,6,25,1,1,2,4,Lost
32906,18,159,275,5,5,5,15,Champions
33132,16,100,347,5,5,5,15,Champions
33354,4859,7,14,1,2,1,4,Lost
34132,1583,37,78,1,4,4,9,At Risk
34136,111,7,11,4,2,1,7,Promising
34179,190,41,189,3,4,5,12,Loyal Users
34290,15,111,386,5,5,5,15,Champions
34677,89,44,134,4,4,4,12,Champions
34690,232,23,79,3,4,4,11,Loyal Users
34712,612,12,66,2,3,4,9,Casual Users
34730,75,135,388,4,5,5,14,Champions
35653,162,16,22,4,3,2,9,Loyal Users
35792,1792,8,31,1,2,2,5,Lost
36055,80,34,129,4,4,4,12,Champions
36108,1,127,307,5,5,5,15,Champions
36162,19,28,43,5,4,3,12,Loyal Users
36629,65,62,88,5,5,4,14,Champions
37046,187,68,146,3,5,4,12,Loyal Users
37116,941,24,106,2,4,4,10,At Risk
37277,3021,5,23,1,1,2,4,Lost
37720,76,51,153,4,5,5,14,Champions
37906,812,111,282,2,5,5,12,At Risk
38041,4102,10,19,1,2,2,5,Lost
38254,2149,212,752,1,5,5,11,At Risk
38344,0,184,327,5,5,5,15,Champions
38435,1674,5,16,1,1,2,4,Lost
39169,4033,26,35,1,4,3,8,At Risk
39191,532,7,25,2,2,2,6,Lost
26500,2416,12,22,1,3,2,6,Casual Users
26528,1280,6,12,1,1,1,3,Lost
26636,474,35,65,2,4,4,10,At Risk
26992,31,11,37,5,2,3,10,Promising
27581,569,12,25,2,3,2,7,Casual Users
28057,116,21,43,4,3,3,10,Loyal Users
28829,72,82,220,4,5,5,14,Champions
28866,807,28,80,2,4,4,10,At Risk
29039,264,28,71,3,4,4,11,Loyal Users
29340,115,40,83,4,4,4,12,Champions
29469,1847,9,14,1,2,1,4,Lost
29746,671,7,9,2,2,1,5,Lost
30202,2260,6,26,1,1,2,4,Lost
30211,98,66,112,4,5,4,13,Champions
30250,6,32,62,5,4,3,12,Loyal Users
30264,103,26,363,4,4,5,13,Champions
30626,2242,5,6,1,1,1,3,Lost
30928,1519,5,11,1,1,1,3,Lost
30972,4,70,149,5,5,5,15,Champions
31345,10,72,199,5,5,5,15,Champions
31392,106,69,233,4,5,5,14,Champions
31456,0,41,145,5,4,4,13,Champions
32561,431,7,16,3,2,2,7,Casual Users
32826,118,148,387,4,5,5,14,Champions
33060,666,13,26,2,3,2,7,Casual Users
33359,254,43,226,3,4,5,12,Loyal Users
33369,52,44,221,5,4,5,14,Champions
33494,4,23,64,5,4,4,13,Champions
33780,39,32,119,5,4,4,13,Champions
34040,233,20,77,3,3,4,10,Loyal Users
34210,373,13,80,3,3,4,10,Loyal Users
34470,39,11,29,5,2,2,9,Promising
34815,450,39,60,3,4,3,10,Loyal Users
34817,4508,5,9,1,1,1,3,Lost
35043,3818,5,13,1,1,1,3,Lost
35408,852,37,88,2,4,4,10,At Risk
35905,365,5,5,3,1,1,5,Casual Users
36103,1645,23,84,1,4,4,9,At Risk
36130,73,20,50,4,3,3,10,Loyal Users
36147,735,11,21,2,2,2,6,Lost
36317,16,79,284,5,5,5,15,Champions
36476,384,27,132,3,4,4,11,Loyal Users
36523,2,97,244,5,5,5,15,Champions
36528,260,5,9,3,1,1,5,Casual Users
36554,18,41,99,5,4,4,13,Champions
36821,3747,9,9,1,2,1,4,Lost
36869,454,15,120,3,3,4,10,Loyal Users
36940,1678,10,25,1,2,2,5,Lost
36946,423,6,14,3,1,1,5,Casual Users
37343,2095,5,59,1,1,3,5,Lost
37618,102,52,102,4,5,4,13,Champions
37658,392,8,9,3,2,1,6,Casual Users
37845,126,66,111,4,5,4,13,Champions
38111,2510,17,19,1,3,2,6,Casual Users
38119,578,6,45,2,1,3,6,Lost
38600,676,18,33,2,3,3,8,Casual Users
38622,117,80,383,4,5,5,14,Champions
38776,138,55,146,4,5,4,13,Champions
39113,155,9,10,4,2,1,7,Promising
26561,4125,16,19,1,3,2,6,Casual Users
26778,533,42,56,2,4,3,9,At Risk
26820,173,38,87,3,4,4,11,Loyal Users
26831,79,78,609,4,5,5,14,Champions
27039,414,7,8,3,2,1,6,Casual Users
27055,159,14,16,4,3,2,9,Loyal Users
27229,1979,23,41,1,4,3,8,At Risk
27373,1150,25,130,2,4,4,10,At Risk
27456,1,30,98,5,4,4,13,Champions
27493,87,70,323,4,5,5,14,Champions
27738,347,9,79,3,2,4,9,Casual Users
28018,10,11,36,5,2,3,10,Promising
28094,94,110,396,4,5,5,14,Champions
28108,614,11,19,2,2,2,6,Lost
28640,9,119,291,5,5,5,15,Champions
28794,40,40,95,5,4,4,13,Champions
29239,71,65,575,4,5,5,14,Champions
29442,119,60,114,4,5,4,13,Champions
29653,196,7,40,3,2,3,8,Casual Users
29791,34,70,139,5,5,4,14,Champions
29891,90,46,198,4,5,5,14,Champions
30120,1696,22,27,1,4,2,7,At Risk
30141,113,19,62,4,3,3,10,Loyal Users
30148,38,10,97,5,2,4,11,Promising
30660,2408,9,9,1,2,1,4,Lost
30781,814,6,38,2,1,3,6,Lost
30880,133,12,19,4,3,2,9,Loyal Users
30960,5241,26,78,1,4,4,9,At Risk
30977,153,9,11,4,2,1,7,Promising
31047,1648,12,69,1,3,4,8,Casual Users
31172,418,6,25,3,1,2,6,Casual Users
31264,14,154,247,5,5,5,15,Champions
31288,1128,6,32,2,1,3,6,Lost
31581,136,17,37,4,3,3,10,Loyal Users
31848,117,14,14,4,3,1,8,Loyal Users
32260,222,8,28,3,2,2,7,Casual Users
32611,23,170,664,5,5,5,15,Champions
32736,325,8,13,3,2,1,6,Casual Users
32856,164,23,34,4,4,3,11,Loyal Users
33138,822,9,16,2,2,2,6,Lost
33403,6,198,709,5,5,5,15,Champions
33707,366,13,42,3,3,3,9,Loyal Users
33948,39,56,326,5,5,5,15,Champions
34330,142,6,10,4,1,1,6,Promising
34432,3624,19,78,1,3,4,8,Casual Users
34533,1822,10,40,1,2,3,6,Lost
34619,1304,20,57,1,3,3,7,Casual Users
34735,34,74,197,5,5,5,15,Champions
34887,1027,9,12,2,2,1,5,Lost
34943,872,9,13,2,2,1,5,Lost
35015,166,49,154,3,5,5,13,Loyal Users
35596,21,71,301,5,5,5,15,Champions
35899,280,10,48,3,2,3,8,Casual Users
36060,505,39,107,2,4,4,10,At Risk
36576,1203,17,91,2,3,4,9,Casual Users
36625,265,16,42,3,3,3,9,Loyal Users
36699,1636,13,41,1,3,3,7,Casual Users
36709,7,50,110,5,5,4,14,Champions
36724,107,11,37,4,2,3,9,Promising
36725,5,40,54,5,4,3,12,Loyal Users
36894,102,37,51,4,4,3,11,Loyal Users
37283,3981,5,11,1,1,1,3,Lost
37285,266,45,115,3,4,4,11,Loyal Users
37457,1746,8,25,1,2,2,5,Lost
37498,240,15,34,3,3,3,9,Loyal Users
37633,64,6,14,5,1,1,7,Promising
37767,198,77,189,3,5,5,13,Loyal Users
37883,1843,6,13,1,1,1,3,Lost
38010,1929,11,18,1,2,2,5,Lost
38052,692,6,86,2,1,4,7,Lost
38247,1714,11,28,1,2,2,5,Lost
38257,2348,20,26,1,3,2,6,Casual Users
38323,3039,9,18,1,2,2,5,Lost
38423,1426,6,8,1,1,1,3,Lost
38544,89,116,163,4,5,5,14,Champions
38757,1704,7,21,1,2,2,5,Lost
38786,16,8,22,5,2,2,9,Promising
38862,945,7,7,2,2,1,5,Lost
38904,133,20,48,4,3,3,10,Loyal Users
38911,1709,5,11,1,1,1,3,Lost
26518,338,23,29,3,4,2,9,Loyal Users
26539,546,22,24,2,4,2,8,At Risk
26548,269,20,42,3,3,3,9,Loyal Users
27128,158,34,66,4,4,4,12,Champions
27631,5548,7,23,1,2,2,5,Lost
27938,1345,15,33,1,3,3,7,Casual Users
27967,477,7,7,2,2,1,5,Lost
28064,649,11,43,2,2,3,7,Lost
28089,38,106,880,5,5,5,15,Champions
28568,708,11,39,2,2,3,7,Lost
28834,994,99,395,2,5,5,12,At Risk
28945,873,9,42,2,2,3,7,Lost
28953,113,35,86,4,4,4,12,Champions
28968,3806,5,9,1,1,1,3,Lost
29117,121,54,248,4,5,5,14,Champions
30136,216,68,159,3,5,5,13,Loyal Users
30345,2278,7,12,1,2,1,4,Lost
30813,49,64,402,5,5,5,15,Champions
31039,27,20,97,5,3,4,12,Loyal Users
31224,3701,29,102,1,4,4,9,At Risk
31254,0,53,145,5,5,4,14,Champions
31325,402,26,41,3,4,3,10,Loyal Users
31400,116,99,137,4,5,4,13,Champions
31694,11,60,413,5,5,5,15,Champions
32246,52,30,37,5,4,3,12,Loyal Users
32478,84,6,33,4,1,3,8,Promising
32572,59,121,297,5,5,5,15,Champions
32794,312,8,14,3,2,1,6,Casual Users
33141,1150,6,12,2,1,1,4,Lost
33301,2387,20,66,1,3,4,8,Casual Users
33726,3272,7,8,1,2,1,4,Lost
33804,251,13,47,3,3,3,9,Loyal Users
34097,409,7,7,3,2,1,6,Casual Users
34158,179,13,60,3,3,3,9,Loyal Users
34270,1410,6,10,1,1,1,3,Lost
34509,462,10,46,3,2,3,8,Casual Users
34729,477,23,54,2,4,3,9,At Risk
34828,112,5,12,4,1,1,6,Promising
35133,581,6,13,2,1,1,4,Lost
35252,243,98,163,3,5,5,13,Loyal Users
35507,526,40,61,2,4,3,9,At Risk
35554,65,44,100,5,4,4,13,Champions
35594,848,33,84,2,4,4,10,At Risk
35692,123,36,127,4,4,4,12,Champions
35701,158,13,36,4,3,3,10,Loyal Users
35917,263,23,63,3,4,4,11,Loyal Users
36074,1369,5,20,1,1,2,4,Lost
36143,39,103,370,5,5,5,15,Champions
36165,265,57,111,3,5,4,12,Loyal Users
36282,91,61,196,4,5,5,14,Champions
36562,62,25,122,5,4,4,13,Champions
36846,1570,5,6,1,1,1,3,Lost
37174,2541,9,9,1,2,1,4,Lost
37210,412,17,37,3,3,3,9,Loyal Users
37323,397,5,9,3,1,1,5,Casual Users
37359,101,19,72,4,3,4,11,Loyal Users
37361,144,24,82,4,4,4,12,Champions
37388,3031,16,42,1,3,3,7,Casual Users
37522,2644,6,14,1,1,1,3,Lost
37628,1489,15,29,1,3,2,6,Casual Users
37701,106,46,372,4,5,5,14,Champions
37858,707,8,32,2,2,3,7,Lost
37898,417,8,18,3,2,2,7,Casual Users
38049,1834,6,39,1,1,3,5,Lost
38425,248,11,52,3,2,3,8,Casual Users
38874,115,18,43,4,3,3,10,Loyal Users
39051,282,10,20,3,2,2,7,Casual Users
26529,3550,11,29,1,2,2,5,Lost
26553,40,66,229,5,5,5,15,Champions
26814,3554,5,8,1,1,1,3,Lost
26823,231,62,306,3,5,5,13,Loyal Users
27556,162,47,99,4,5,4,13,Champions
27745,977,14,75,2,3,4,9,Casual Users
28085,1841,6,17,1,1,2,4,Lost
28315,559,16,99,2,3,4,9,Casual Users
28320,237,38,231,3,4,5,12,Loyal Users
28346,222,9,70,3,2,4,9,Casual Users
28359,1279,5,7,1,1,1,3,Lost
28497,397,138,473,3,5,5,13,Loyal Users
28514,542,25,36,2,4,3,9,At Risk
28793,138,11,34,4,2,3,9,Promising
29274,1742,7,35,1,2,3,6,Lost
29387,4080,5,6,1,1,1,3,Lost
29647,4378,6,7,1,1,1,3,Lost
29715,4,12,21,5,3,2,10,Loyal Users
29945,10,23,44,5,4,3,12,Loyal Users
30218,4033,5,10,1,1,1,3,Lost
30238,2408,5,12,1,1,1,3,Lost
30438,147,19,24,4,3,2,9,Loyal Users
30586,407,29,69,3,4,4,11,Loyal Users
30952,3402,5,17,1,1,2,4,Lost
31293,1910,19,58,1,3,3,7,Casual Users
31556,94,5,7,4,1,1,6,Promising
31846,0,31,206,5,4,5,14,Champions
31921,40,22,34,5,4,3,12,Loyal Users
32109,4098,9,29,1,2,2,5,Lost
32672,73,71,215,4,5,5,14,Champions
33126,222,5,5,3,1,1,5,Casual Users
33431,122,12,33,4,3,3,10,Loyal Users
33489,293,55,235,3,5,5,13,Loyal Users
33554,580,13,27,2,3,2,7,Casual Users
34345,235,39,89,3,4,4,11,Loyal Users
34757,136,17,21,4,3,2,9,Loyal Users
34866,57,15,25,5,3,2,10,Loyal Users
35211,332,45,73,3,4,4,11,Loyal Users
35214,524,21,42,2,3,3,8,Casual Users
35503,11,5,6,5,1,1,7,Promising
35796,9,97,195,5,5,5,15,Champions
35865,811,11,15,2,2,1,5,Lost
36063,352,7,34,3,2,3,8,Casual Users
36154,1745,10,12,1,2,1,4,Lost
36187,405,19,51,3,3,3,9,Loyal Users
36296,1244,5,9,2,1,1,4,Lost
36400,3276,6,25,1,1,2,4,Lost
36507,583,44,60,2,4,3,9,At Risk
37026,150,46,245,4,5,5,14,Champions
37096,1055,17,148,2,3,5,10,Casual Users
37300,883,5,15,2,1,1,4,Lost
37328,1569,11,12,1,2,1,4,Lost
38124,682,21,28,2,3,2,7,Casual Users
38236,1519,18,24,1,3,2,6,Casual Users
38456,6,130,363,5,5,5,15,Champions
38647,132,55,143,4,5,4,13,Champions
38670,1,31,81,5,4,4,13,Champions
38769,537,11,34,2,2,3,7,Lost
38830,273,32,85,3,4,4,11,Loyal Users
38865,386,12,54,3,3,3,9,Loyal Users
38991,568,12,23,2,3,2,7,Casual Users
39038,4895,5,8,1,1,1,3,Lost
39040,1981,5,15,1,1,1,3,Lost
26501,1425,6,15,1,1,1,3,Lost
26630,1392,23,30,1,4,2,7,At Risk
26700,184,15,79,3,3,4,10,Loyal Users
26752,3841,5,26,1,1,2,4,Lost
27004,18,73,137,5,5,4,14,Champions
27396,36,88,123,5,5,4,14,Champions
27401,1672,20,64,1,3,4,8,Casual Users
27587,56,94,226,5,5,5,15,Champions
27780,689,12,18,2,3,2,7,Casual Users
29926,68,97,222,5,5,5,15,Champions
29967,1682,21,72,1,3,4,8,Casual Users
30006,1011,6,15,2,1,1,4,Lost
31122,100,14,29,4,3,2,9,Loyal Users
31203,127,10,22,4,2,2,8,Promising
31209,1,89,206,5,5,5,15,Champions
31371,292,28,112,3,4,4,11,Loyal Users
31758,297,10,16,3,2,2,7,Casual Users
31769,570,27,98,2,4,4,10,At Risk
31777,443,15,42,3,3,3,9,Loyal Users
32150,261,22,38,3,4,3,10,Loyal Users
32309,11,7,9,5,2,1,8,Promising
32410,51,66,106,5,5,4,14,Champions
32709,2105,14,52,1,3,3,7,Casual Users
32882,634,15,33,2,3,3,8,Casual Users
32940,98,29,71,4,4,4,12,Champions
33754,1712,10,32,1,2,3,6,Lost
33796,1829,5,15,1,1,1,3,Lost
33820,3228,47,106,1,5,4,10,At Risk
34467,1061,12,131,2,3,4,9,Casual Users
34989,1432,5,5,1,1,1,3,Lost
35112,11,40,98,5,4,4,13,Champions
35273,3540,7,18,1,2,2,5,Lost
35275,699,33,73,2,4,4,10,At Risk
35734,865,21,47,2,3,3,8,Casual Users
35855,4,24,44,5,4,3,12,Loyal Users
36222,82,89,210,4,5,5,14,Champions
36295,111,68,168,4,5,5,14,Champions
36447,310,110,245,3,5,5,13,Loyal Users
36510,102,51,220,4,5,5,14,Champions
36547,9,151,506,5,5,5,15,Champions
36549,7,68,662,5,5,5,15,Champions
36631,1470,5,8,1,1,1,3,Lost
36736,155,10,15,4,2,1,7,Promising
37018,15,32,132,5,4,4,13,Champions
37268,0,97,211,5,5,5,15,Champions
37472,510,41,92,2,4,4,10,At Risk
37790,544,7,11,2,2,1,5,Lost
37820,12,146,197,5,5,5,15,Champions
37956,244,48,159,3,5,5,13,Loyal Users
38128,273,25,89,3,4,4,11,Loyal Users
38159,22,12,28,5,3,2,10,Loyal Users
38214,298,11,15,3,2,1,6,Casual Users
38350,107,38,44,4,4,3,11,Loyal Users
38431,1544,6,6,1,1,1,3,Lost
38680,422,6,8,3,1,1,5,Casual Users
38727,2528,5,6,1,1,1,3,Lost
38801,221,8,53,3,2,3,8,Casual Users
38817,409,24,35,3,4,3,10,Loyal Users
26945,1125,6,18,2,1,2,5,Lost
27140,850,26,167,2,4,5,11,At Risk
27636,130,21,74,4,3,4,11,Loyal Users
28159,242,6,14,3,1,1,5,Casual Users
28246,292,6,11,3,1,1,5,Casual Users
28365,20,27,38,5,4,3,12,Loyal Users
28752,8,58,322,5,5,5,15,Champions
28952,142,5,15,4,1,1,6,Promising
29180,17,117,171,5,5,5,15,Champions
29220,235,107,380,3,5,5,13,Loyal Users
29365,1786,53,467,1,5,5,11,At Risk
29498,5,5,13,5,1,1,7,Promising
29525,497,21,25,2,3,2,7,Casual Users
30057,262,24,28,3,4,2,9,Loyal Users
30105,868,64,150,2,5,5,12,At Risk
30114,501,6,11,2,1,1,4,Lost
30123,267,16,57,3,3,3,9,Loyal Users
30189,590,14,36,2,3,3,8,Casual Users
30908,1384,6,9,1,1,1,3,Lost
30961,436,16,28,3,3,2,8,Loyal Users
30976,192,13,42,3,3,3,9,Loyal Users
31710,484,62,123,2,5,4,11,At Risk
32087,2404,10,17,1,2,2,5,Lost
32214,2926,5,16,1,1,2,4,Lost
32313,1204,14,27,2,3,2,7,Casual Users
32428,531,8,30,2,2,2,6,Lost
32750,123,51,108,4,5,4,13,Champions
32762,4804,12,13,1,3,1,5,Casual Users
32960,959,74,93,2,5,4,11,At Risk
33278,419,13,51,3,3,3,9,Loyal Users
33418,0,139,965,5,5,5,15,Champions
33761,97,119,479,4,5,5,14,Champions
33784,652,7,11,2,2,1,5,Lost
34232,295,24,90,3,4,4,11,Loyal Users
34305,65,22,41,5,4,3,12,Loyal Users
34344,12,94,452,5,5,5,15,Champions
34394,210,8,9,3,2,1,6,Casual Users
34515,930,19,24,2,3,2,7,Casual Users
34707,122,22,85,4,4,4,12,Champions
34763,180,16,24,3,3,2,8,Loyal Users
34813,2694,11,63,1,2,4,7,Lost
34925,1532,15,24,1,3,2,6,Casual Users
35041,735,22,67,2,4,4,10,At Risk
35099,5086,7,7,1,2,1,4,Lost
35266,2341,10,37,1,2,3,6,Lost
35369,1556,8,8,1,2,1,4,Lost
35536,15,42,117,5,4,4,13,Champions
35866,28,51,95,5,5,4,14,Champions
35896,173,26,65,3,4,4,11,Loyal Users
35951,2576,23,114,1,4,4,9,At Risk
36236,4127,5,7,1,1,1,3,Lost
36691,303,10,20,3,2,2,7,Casual Users
36817,12,160,405,5,5,5,15,Champions
36854,724,13,52,2,3,3,8,Casual Users
36887,567,22,70,2,4,4,10,At Risk
36898,9,51,102,5,5,4,14,Champions
36966,1127,22,84,2,4,4,10,At Risk
37092,713,5,6,2,1,1,4,Lost
37372,2199,35,42,1,4,3,8,At Risk
37705,5,11,38,5,2,3,10,Promising
37965,5855,21,34,1,3,3,7,Casual Users
38004,4412,6,49,1,1,3,5,Lost
38222,832,15,33,2,3,3,8,Casual Users
38451,379,22,35,3,4,3,10,Loyal Users
38712,41,161,349,5,5,5,15,Champions
38850,703,7,30,2,2,2,6,Lost
38934,884,21,47,2,3,3,8,Casual Users
39016,403,48,135,3,5,4,12,Loyal Users
39067,250,32,93,3,4,4,11,Loyal Users
39203,1,10,13,5,2,1,8,Promising
26937,1054,5,5,2,1,1,4,Lost
26972,161,45,77,4,4,4,12,Champions
27145,128,98,239,4,5,5,14,Champions
27314,213,5,5,3,1,1,5,Casual Users
27328,51,149,220,5,5,5,15,Champions
27594,37,9,25,5,2,2,9,Promising
28374,140,7,22,4,2,2,8,Promising
28464,21,100,245,5,5,5,15,Champions
28599,1022,10,16,2,2,2,6,Lost
28675,650,17,128,2,3,4,9,Casual Users
28686,434,46,63,3,5,4,12,Loyal Users
28719,112,9,13,4,2,1,7,Promising
28753,3864,8,25,1,2,2,5,Lost
29312,59,5,8,5,1,1,7,Promising
29323,273,83,399,3,5,5,13,Loyal Users
30026,156,8,19,4,2,2,8,Promising
30041,2765,5,16,1,1,2,4,Lost
30049,429,9,24,3,2,2,7,Casual Users
31162,166,31,49,3,4,3,10,Loyal Users
31287,82,9,13,4,2,1,7,Promising
31747,25,43,163,5,4,5,14,Champions
31756,86,52,111,4,5,4,13,Champions
32392,537,9,23,2,2,2,6,Lost
32482,2128,5,5,1,1,1,3,Lost
32515,104,9,52,4,2,3,9,Promising
32621,65,69,1052,5,5,5,15,Champions
32692,642,20,26,2,3,2,7,Casual Users
32706,909,13,19,2,3,2,7,Casual Users
33165,1134,54,226,2,5,5,12,At Risk
33346,2,101,341,5,5,5,15,Champions
33500,20,43,111,5,4,4,13,Champions
33816,1737,5,12,1,1,1,3,Lost
33895,300,22,25,3,4,2,9,Loyal Users
33922,325,9,11,3,2,1,6,Casual Users
33954,579,24,81,2,4,4,10,At Risk
34164,3702,5,62,1,1,3,5,Lost
34175,421,18,23,3,3,2,8,Loyal Users
34401,9,51,101,5,5,4,14,Champions
34570,2467,18,46,1,3,3,7,Casual Users
34993,124,52,71,4,5,4,13,Champions
35287,262,35,53,3,4,3,10,Loyal Users
35567,5472,11,25,1,2,2,5,Lost
35637,36,68,149,5,5,5,15,Champions
35954,86,97,306,4,5,5,14,Champions
36018,857,18,62,2,3,3,8,Casual Users
36430,47,6,9,5,1,1,7,Promising
36439,2846,5,20,1,1,2,4,Lost
36689,125,27,115,4,4,4,12,Champions
37484,3090,85,197,1,5,5,11,At Risk
37533,413,5,18,3,1,2,6,Casual Users
37589,1526,11,43,1,2,3,6,Lost
37989,339,16,30,3,3,2,8,Loyal Users
38315,3112,6,29,1,1,2,4,Lost
38341,2689,9,20,1,2,2,5,Lost
38347,231,20,25,3,3,2,8,Loyal Users
38625,1228,8,29,2,2,2,6,Lost
38840,112,63,144,4,5,4,13,Champions
38851,1,35,62,5,4,3,12,Loyal Users
38976,466,5,73,3,1,4,8,Casual Users
39005,1592,9,19,1,2,2,5,Lost
39046,407,19,21,3,3,2,8,Loyal Users
26687,715,7,54,2,2,3,7,Lost
27182,14,15,60,5,3,3,11,Loyal Users
27412,233,6,9,3,1,1,5,Casual Users
27741,430,24,31,3,4,2,9,Loyal Users
27748,341,8,47,3,2,3,8,Casual Users
27921,14,14,108,5,3,4,12,Loyal Users
27940,277,21,91,3,3,4,10,Loyal Users
28455,2721,6,6,1,1,1,3,Lost
28763,428,20,29,3,3,2,8,Loyal Users
28843,820,12,41,2,3,3,8,Casual Users
29046,75,65,183,4,5,5,14,Champions
29664,132,5,12,4,1,1,6,Promising
29735,1,65,105,5,5,4,14,Champions
30098,82,10,32,4,2,3,9,Promising
30467,384,8,12,3,2,1,6,Casual Users
30623,128,10,22,4,2,2,8,Promising
30995,27,98,209,5,5,5,15,Champions
31143,409,20,42,3,3,3,9,Loyal Users
31365,47,28,272,5,4,5,14,Champions
31573,2707,9,10,1,2,1,4,Lost
31899,48,85,629,5,5,5,15,Champions
32188,18,57,602,5,5,5,15,Champions
32547,832,15,34,2,3,3,8,Casual Users
32581,71,37,45,4,4,3,11,Loyal Users
32625,133,17,78,4,3,4,11,Loyal Users
32976,8,50,346,5,5,5,15,Champions
33008,423,38,236,3,4,5,12,Loyal Users
33271,2993,10,18,1,2,2,5,Lost
33474,737,5,5,2,1,1,4,Lost
33654,1003,11,28,2,2,2,6,Lost
33764,2281,7,12,1,2,1,4,Lost
33862,21,94,518,5,5,5,15,Champions
33917,405,17,63,3,3,4,10,Loyal Users
34263,123,8,22,4,2,2,8,Promising
34272,249,25,92,3,4,4,11,Loyal Users
34493,609,12,30,2,3,2,7,Casual Users
34607,736,11,26,2,2,2,6,Lost
35050,3523,6,9,1,1,1,3,Lost
35145,90,6,10,4,1,1,6,Promising
35153,0,79,263,5,5,5,15,Champions
35840,466,7,18,3,2,2,7,Casual Users
36292,1646,5,7,1,1,1,3,Lost
36298,844,15,46,2,3,3,8,Casual Users
36475,262,52,188,3,5,5,13,Loyal Users
36794,1512,11,69,1,2,4,7,Lost
36813,346,6,7,3,1,1,5,Casual Users
36883,151,11,31,4,2,2,8,Promising
36924,201,22,56,3,4,3,10,Loyal Users
36954,3248,24,37,1,4,3,8,At Risk
37004,626,18,27,2,3,2,7,Casual Users
37794,16,190,539,5,5,5,15,Champions
37918,15,91,292,5,5,5,15,Champions
38003,1152,9,10,2,2,1,5,Lost
38048,427,7,16,3,2,2,7,Casual Users
38164,127,43,101,4,4,4,12,Champions
38211,854,37,65,2,4,4,10,At Risk
38614,2571,8,10,1,2,1,4,Lost
38673,30,132,401,5,5,5,15,Champions
38679,1985,11,34,1,2,3,6,Lost
38915,140,7,22,4,2,2,8,Promising
38950,120,28,43,4,4,3,11,Loyal Users
39239,264,29,56,3,4,3,10,Loyal Users
27393,27,137,312,5,5,5,15,Champions
27537,2451,14,63,1,3,4,8,Casual Users
27645,1443,7,7,1,2,1,4,Lost
27894,816,15,35,2,3,3,8,Casual Users
27979,12,33,198,5,4,5,14,Champions
28002,4371,15,23,1,3,2,6,Casual Users
28569,272,13,15,3,3,1,7,Loyal Users
28598,7,55,228,5,5,5,15,Champions
29057,416,7,12,3,2,1,6,Casual Users
29088,145,67,210,4,5,5,14,Champions
29600,3851,5,13,1,1,1,3,Lost
29729,166,88,307,3,5,5,13,Loyal Users
29853,1811,7,15,1,2,1,4,Lost
30379,1834,5,5,1,1,1,3,Lost
30720,1326,40,185,1,4,5,10,At Risk
30761,69,102,313,5,5,5,15,Champions
30899,117,10,21,4,2,2,8,Promising
31455,714,7,12,2,2,1,5,Lost
31807,11,64,374,5,5,5,15,Champions
32021,1029,24,83,2,4,4,10,At Risk
32176,111,15,45,4,3,3,10,Loyal Users
32305,166,42,103,3,4,4,11,Loyal Users
32409,3556,5,7,1,1,1,3,Lost
32417,1819,13,165,1,3,5,9,Casual Users
32584,1778,34,115,1,4,4,9,At Risk
32859,2395,5,7,1,1,1,3,Lost
32890,120,21,67,4,3,4,11,Loyal Users
32908,167,14,38,3,3,3,9,Loyal Users
33061,1504,9,14,1,2,1,4,Lost
33150,1547,5,27,1,1,2,4,Lost
33177,29,42,140,5,4,4,13,Champions
33436,425,9,34,3,2,3,8,Casual Users
33524,455,6,18,3,1,2,6,Casual Users
33595,444,28,44,3,4,3,10,Loyal Users
33632,65,19,92,5,3,4,12,Loyal Users
33655,256,35,91,3,4,4,11,Loyal Users
33963,169,52,76,3,5,4,12,Loyal Users
34118,2112,6,15,1,1,1,3,Lost
34125,196,8,14,3,2,1,6,Casual Users
34599,560,58,145,2,5,4,11,At Risk
34645,2,41,50,5,4,3,12,Loyal Users
34819,759,22,39,2,4,3,9,At Risk
35067,1553,18,115,1,3,4,8,Casual Users
35141,40,51,177,5,5,5,15,Champions
35285,390,5,6,3,1,1,5,Casual Users
35445,182,72,152,3,5,5,13,Loyal Users
35449,106,26,54,4,4,3,11,Loyal Users
35633,1949,6,10,1,1,1,3,Lost
35670,115,18,53,4,3,3,10,Loyal Users
35722,855,10,77,2,2,4,8,Lost
35753,384,20,81,3,3,4,10,Loyal Users
35839,1579,6,6,1,1,1,3,Lost
36024,249,61,178,3,5,5,13,Loyal Users
36175,830,8,20,2,2,2,6,Lost
36512,7,27,159,5,4,5,14,Champions
36790,4,60,77,5,5,4,14,Champions
37008,177,9,48,3,2,3,8,Casual Users
37334,71,9,13,4,2,1,7,Promising
37434,2281,14,21,1,3,2,6,Casual Users
37925,303,37,87,3,4,4,11,Loyal Users
38255,3299,7,18,1,2,2,5,Lost
38471,2547,28,49,1,4,3,8,At Risk
38507,419,5,11,3,1,1,5,Casual Users
26647,364,34,74,3,4,4,11,Loyal Users
26859,2864,7,12,1,2,1,4,Lost
26919,4,126,433,5,5,5,15,Champions
26924,743,8,16,2,2,2,6,Lost
27253,111,65,196,4,5,5,14,Champions
27356,13,55,216,5,5,5,15,Champions
27646,309,16,44,3,3,3,9,Loyal Users
27684,51,142,329,5,5,5,15,Champions
27793,399,21,81,3,3,4,10,Loyal Users
28530,996,34,171,2,4,5,11,At Risk
29313,354,18,47,3,3,3,9,Loyal Users
29342,749,7,7,2,2,1,5,Lost
29426,4665,5,15,1,1,1,3,Lost
29575,94,15,25,4,3,2,9,Loyal Users
29608,253,15,23,3,3,2,8,Loyal Users
29768,234,102,409,3,5,5,13,Loyal Users
29896,575,6,24,2,1,2,5,Lost
30281,194,19,103,3,3,4,10,Loyal Users
30416,1154,5,10,2,1,1,4,Lost
30980,23,102,138,5,5,4,14,Champions
31157,7,42,235,5,4,5,14,Champions
31200,829,10,26,2,2,2,6,Lost
31237,831,8,23,2,2,2,6,Lost
31322,1123,13,22,2,3,2,7,Casual Users
31377,90,29,131,4,4,4,12,Champions
31419,422,74,134,3,5,4,12,Loyal Users
31787,994,10,24,2,2,2,6,Lost
32075,114,8,10,4,2,1,7,Promising
32267,115,68,347,4,5,5,14,Champions
32425,745,9,14,2,2,1,5,Lost
32636,887,5,5,2,1,1,4,Lost
32893,2421,13,33,1,3,3,7,Casual Users
32987,31,111,444,5,5,5,15,Champions
33264,65,124,319,5,5,5,15,Champions
33331,1415,7,7,1,2,1,4,Lost
33378,3469,17,30,1,3,2,6,Casual Users
33441,271,31,132,3,4,4,11,Loyal Users
33542,840,37,131,2,4,4,10,At Risk
33588,260,19,98,3,3,4,10,Loyal Users
33875,2008,6,10,1,1,1,3,Lost
34009,2950,7,70,1,2,4,7,Lost
34147,4361,6,11,1,1,1,3,Lost
34248,109,193,966,4,5,5,14,Champions
34460,683,10,28,2,2,2,6,Lost
34857,127,10,21,4,2,2,8,Promising
34947,10,49,174,5,5,5,15,Champions
35116,430,19,28,3,3,2,8,Loyal Users
35311,127,70,249,4,5,5,14,Champions
35419,123,26,181,4,4,5,13,Champions
35579,427,18,42,3,3,3,9,Loyal Users
35669,282,7,25,3,2,2,7,Casual Users
35752,285,9,19,3,2,2,7,Casual Users
35969,994,7,13,2,2,1,5,Lost
36026,22,56,139,5,5,4,14,Champions
36129,56,118,887,5,5,5,15,Champions
36167,21,11,30,5,2,2,9,Promising
36171,3839,5,8,1,1,1,3,Lost
36399,134,32,131,4,4,4,12,Champions
36423,413,22,84,3,4,4,11,Loyal Users
36481,242,6,8,3,1,1,5,Casual Users
36573,26,120,670,5,5,5,15,Champions
36726,2,7,13,5,2,1,8,Promising
36992,94,8,10,4,2,1,7,Promising
37517,88,34,45,4,4,3,11,Loyal Users
37599,2,16,51,5,3,3,11,Loyal Users
37796,1933,10,28,1,2,2,5,Lost
37825,1516,6,23,1,1,2,4,Lost
37859,148,26,38,4,4,3,11,Loyal Users
38098,461,15,33,3,3,3,9,Loyal Users
38121,434,8,19,3,2,2,7,Casual Users
38339,407,13,85,3,3,4,10,Loyal Users
38359,132,83,295,4,5,5,14,Champions
38902,105,16,30,4,3,2,9,Loyal Users
39058,916,12,58,2,3,3,8,Casual Users
39146,12,45,176,5,4,5,14,Champions
39168,2878,18,28,1,3,2,6,Casual Users
26555,437,11,13,3,2,1,6,Casual Users
26629,993,25,116,2,4,4,10,At Risk
27115,541,88,205,2,5,5,12,At Risk
27514,92,11,15,4,2,1,7,Promising
27632,3246,8,12,1,2,1,4,Lost
28050,126,62,97,4,5,4,13,Champions
28092,465,6,11,3,1,1,5,Casual Users
28412,2140,8,8,1,2,1,4,Lost
28767,35,12,17,5,3,2,10,Loyal Users
28997,280,29,140,3,4,4,11,Loyal Users
29139,123,11,21,4,2,2,8,Promising
29618,76,97,125,4,5,4,13,Champions
29868,410,33,248,3,4,5,12,Loyal Users
29905,5730,11,11,1,2,1,4,Lost
29943,704,11,31,2,2,2,6,Lost
29952,140,15,98,4,3,4,11,Loyal Users
30401,3643,9,13,1,2,1,4,Lost
30855,142,40,69,4,4,4,12,Champions
30870,62,6,11,5,1,1,7,Promising
30894,2637,7,17,1,2,2,5,Lost
30981,884,46,77,2,5,4,11,At Risk
31012,30,46,93,5,5,4,14,Champions
31046,128,75,226,4,5,5,14,Champions
31330,4050,12,50,1,3,3,7,Casual Users
31922,2879,8,27,1,2,2,5,Lost
32286,16,18,31,5,3,2,10,Loyal Users
32419,846,10,19,2,2,2,6,Lost
32431,430,30,39,3,4,3,10,Loyal Users
32787,568,5,15,2,1,1,4,Lost
32955,12,65,381,5,5,5,15,Champions
33239,48,130,519,5,5,5,15,Champions
33935,2062,7,9,1,2,1,4,Lost
34024,48,39,71,5,4,4,13,Champions
34137,873,11,34,2,2,3,7,Lost
34349,20,52,370,5,5,5,15,Champions
34382,410,46,92,3,5,4,12,Loyal Users
35401,14,91,252,5,5,5,15,Champions
35448,505,8,47,2,2,3,7,Lost
35457,99,6,6,4,1,1,6,Promising
35459,688,12,19,2,3,2,7,Casual Users
35995,127,72,169,4,5,5,14,Champions
36255,940,7,18,2,2,2,6,Lost
36380,1104,5,5,2,1,1,4,Lost
36445,1360,5,10,1,1,1,3,Lost
36483,530,38,79,2,4,4,10,At Risk
36487,310,18,53,3,3,3,9,Loyal Users
36627,146,140,201,4,5,5,14,Champions
37019,319,7,50,3,2,3,8,Casual Users
37399,240,27,47,3,4,3,10,Loyal Users
38137,532,7,22,2,2,2,6,Lost
38205,974,7,8,2,2,1,5,Lost
38352,2975,12,19,1,3,2,6,Casual Users
38402,783,12,60,2,3,3,8,Casual Users
38779,4378,5,15,1,1,1,3,Lost
39100,171,98,280,3,5,5,13,Loyal Users
39183,164,7,41,4,2,3,9,Promising
39208,4244,6,10,1,1,1,3,Lost
26676,126,9,14,4,2,1,7,Promising
26683,129,51,212,4,5,5,14,Champions
26989,628,14,67,2,3,4,9,Casual Users
27020,1834,10,41,1,2,3,6,Lost
27355,2984,37,76,1,4,4,9,At Risk
27573,63,39,253,5,4,5,14,Champions
28229,147,19,290,4,3,5,12,Loyal Users
28454,1634,10,15,1,2,1,4,Lost
28473,6,52,148,5,5,5,15,Champions
28511,48,38,107,5,4,4,13,Champions
28578,402,61,150,3,5,5,13,Loyal Users
28687,590,17,24,2,3,2,7,Casual Users
28716,163,93,180,4,5,5,14,Champions
28738,375,5,5,3,1,1,5,Casual Users
28782,930,16,76,2,3,4,9,Casual Users
28806,321,14,25,3,3,2,8,Loyal Users
29076,167,12,41,3,3,3,9,Loyal Users
29089,122,41,66,4,4,4,12,Champions
29350,227,6,13,3,1,1,5,Casual Users
29825,130,23,49,4,4,3,11,Loyal Users
29842,121,70,256,4,5,5,14,Champions
29861,298,14,34,3,3,3,9,Loyal Users
29866,125,17,63,4,3,4,11,Loyal Users
29878,987,5,10,2,1,1,4,Lost
29888,96,63,74,4,5,4,13,Champions
29921,214,22,156,3,4,5,12,Loyal Users
30134,18,67,100,5,5,4,14,Champions
30705,40,28,147,5,4,5,14,Champions
30793,132,12,46,4,3,3,10,Loyal Users
31033,92,6,27,4,1,2,7,Promising
31376,41,32,312,5,4,5,14,Champions
31480,1373,9,50,1,2,3,6,Lost
31653,1,72,369,5,5,5,15,Champions
32342,148,84,208,4,5,5,14,Champions
32501,0,111,467,5,5,5,15,Champions
32509,130,29,53,4,4,3,11,Loyal Users
32518,212,14,31,3,3,2,8,Loyal Users
32562,48,141,584,5,5,5,15,Champions
32831,1698,6,6,1,1,1,3,Lost
33683,110,72,277,4,5,5,14,Champions
33905,210,42,79,3,4,4,11,Loyal Users
34021,3041,5,15,1,1,1,3,Lost
34461,1166,11,26,2,2,2,6,Lost
34585,3,46,144,5,5,4,14,Champions
34693,288,8,28,3,2,2,7,Casual Users
34718,3562,5,5,1,1,1,3,Lost
34968,750,19,31,2,3,2,7,Casual Users
35852,1555,7,18,1,2,2,5,Lost
36048,225,40,297,3,4,5,12,Loyal Users
36327,30,50,355,5,5,5,15,Champions
37200,445,8,11,3,2,1,6,Casual Users
37330,123,5,35,4,1,3,8,Promising
37339,268,18,23,3,3,2,8,Loyal Users
37743,90,74,115,4,5,4,13,Champions
37971,7,30,46,5,4,3,12,Loyal Users
38060,1023,8,23,2,2,2,6,Lost
38142,365,26,36,3,4,3,10,Loyal Users
38155,141,82,388,4,5,5,14,Champions
38212,33,22,66,5,4,4,13,Champions
38534,200,146,326,3,5,5,13,Loyal Users
38886,1564,11,15,1,2,1,4,Lost
38916,85,51,89,4,5,4,13,Champions
39084,973,7,21,2,2,2,6,Lost
39163,1727,7,8,1,2,1,4,Lost
26910,2,99,307,5,5,5,15,Champions
26911,3219,11,16,1,2,2,5,Lost
26928,587,33,109,2,4,4,10,At Risk
26966,4229,6,6,1,1,1,3,Lost
27043,711,34,192,2,4,5,11,At Risk
27104,280,7,10,3,2,1,6,Casual Users
27111,90,58,122,4,5,4,13,Champions
27165,33,7,16,5,2,2,9,Promising
27344,4570,5,7,1,1,1,3,Lost
28049,1694,7,13,1,2,1,4,Lost
28376,126,6,7,4,1,1,6,Promising
28597,37,26,51,5,4,3,12,Loyal Users
28775,133,129,295,4,5,5,14,Champions
28809,120,122,257,4,5,5,14,Champions
28955,697,5,9,2,1,1,4,Lost
29006,108,84,211,4,5,5,14,Champions
29064,670,8,8,2,2,1,5,Lost
29160,277,36,149,3,4,5,12,Loyal Users
29401,84,25,91,4,4,4,12,Champions
29431,1974,11,19,1,2,2,5,Lost
29560,421,79,135,3,5,4,12,Loyal Users
29780,903,10,101,2,2,4,8,Lost
29947,9,186,439,5,5,5,15,Champions
30067,2476,6,22,1,1,2,4,Lost
30322,114,19,66,4,3,4,11,Loyal Users
30675,109,19,61,4,3,3,10,Loyal Users
30691,310,20,30,3,3,2,8,Loyal Users
30769,1282,7,12,1,2,1,4,Lost
30873,803,32,42,2,4,3,9,At Risk
31197,413,12,15,3,3,1,7,Loyal Users
31220,1103,8,160,2,2,5,9,Lost
31234,71,78,200,4,5,5,14,Champions
31509,3560,18,108,1,3,4,8,Casual Users
31907,2343,8,15,1,2,1,4,Lost
31936,164,47,114,4,5,4,13,Champions
31964,280,12,39,3,3,3,9,Loyal Users
32317,215,63,152,3,5,5,13,Loyal Users
32341,616,7,7,2,2,1,5,Lost
32403,16,71,99,5,5,4,14,Champions
32440,1452,23,30,1,4,2,7,At Risk
32564,2603,12,21,1,3,2,6,Casual Users
33154,120,13,31,4,3,2,9,Loyal Users
33180,337,17,41,3,3,3,9,Loyal Users
33256,78,22,64,4,4,4,12,Champions
33547,60,103,234,5,5,5,15,Champions
33686,378,6,12,3,1,1,5,Casual Users
33945,285,59,242,3,5,5,13,Loyal Users
34419,1063,10,65,2,2,4,8,Lost
34466,122,34,104,4,4,4,12,Champions
34647,719,17,18,2,3,2,7,Casual Users
34676,1880,5,63,1,1,4,6,Lost
34681,49,8,39,5,2,3,10,Promising
34691,212,11,139,3,2,4,9,Casual Users
34777,21,63,127,5,5,4,14,Champions
35000,246,50,195,3,5,5,13,Loyal Users
35039,289,67,217,3,5,5,13,Loyal Users
35529,1265,8,19,1,2,2,5,Lost
35635,70,38,111,4,4,4,12,Champions
36083,407,12,20,3,3,2,8,Loyal Users
36176,1398,14,27,1,3,2,6,Casual Users
36352,43,38,122,5,4,4,13,Champions
36454,117,14,120,4,3,4,11,Loyal Users
36694,88,15,33,4,3,3,10,Loyal Users
36773,422,35,64,3,4,4,11,Loyal Users
36880,276,36,192,3,4,5,12,Loyal Users
37037,2533,7,9,1,2,1,4,Lost
37369,511,15,30,2,3,2,7,Casual Users
37400,1122,14,88,2,3,4,9,Casual Users
37576,3,11,50,5,2,3,10,Promising
37615,432,17,89,3,3,4,10,Loyal Users
37732,2096,8,23,1,2,2,5,Lost
37857,737,5,6,2,1,1,4,Lost
37897,3515,26,61,1,4,3,8,At Risk
38127,122,93,162,4,5,5,14,Champions
38829,28,11,26,5,2,2,9,Promising
38849,93,105,215,4,5,5,14,Champions
39137,561,11,11,2,2,1,5,Lost
26728,3149,5,12,1,1,1,3,Lost
26830,432,62,159,3,5,5,13,Loyal Users
26915,1854,91,270,1,5,5,11,At Risk
27154,105,57,231,4,5,5,14,Champions
27694,5309,13,17,1,3,2,6,Casual Users
27853,14,124,355,5,5,5,15,Champions
27988,852,19,29,2,3,2,7,Casual Users
28063,16,103,400,5,5,5,15,Champions
28499,138,5,10,4,1,1,6,Promising
28671,4010,11,26,1,2,2,5,Lost
29049,2007,9,15,1,2,1,4,Lost
29223,405,59,137,3,5,4,12,Loyal Users
29522,323,6,8,3,1,1,5,Casual Users
30292,2337,6,25,1,1,2,4,Lost
30417,425,7,10,3,2,1,6,Casual Users
30889,3715,5,6,1,1,1,3,Lost
30942,140,26,87,4,4,4,12,Champions
30982,126,47,96,4,5,4,13,Champions
31103,2673,5,20,1,1,2,4,Lost
31124,182,25,110,3,4,4,11,Loyal Users
31281,108,15,23,4,3,2,9,Loyal Users
31405,44,85,137,5,5,4,14,Champions
31563,36,18,41,5,3,3,11,Loyal Users
31714,1979,7,11,1,2,1,4,Lost
31855,320,49,222,3,5,5,13,Loyal Users
32128,859,10,10,2,2,1,5,Lost
32173,473,27,43,2,4,3,9,At Risk
32357,689,6,10,2,1,1,4,Lost
32557,117,18,59,4,3,3,10,Loyal Users
33018,1783,13,21,1,3,2,6,Casual Users
33241,3222,5,26,1,1,2,4,Lost
33603,1463,17,17,1,3,2,6,Casual Users
33763,120,7,12,4,2,1,7,Promising
33819,1134,5,11,2,1,1,4,Lost
33821,452,6,21,3,1,2,6,Casual Users
33873,125,70,324,4,5,5,14,Champions
33943,876,7,79,2,2,4,8,Lost
34369,1098,7,8,2,2,1,5,Lost
34505,1238,5,5,2,1,1,4,Lost
34513,1476,7,8,1,2,1,4,Lost
34746,21,13,122,5,3,4,12,Loyal Users
34951,159,43,123,4,4,4,12,Champions
34970,85,41,63,4,4,4,12,Champions
35021,377,7,18,3,2,2,7,Casual Users
35079,2120,7,22,1,2,2,5,Lost
35249,12,38,108,5,4,4,13,Champions
35335,1270,12,78,1,3,4,8,Casual Users
35805,1095,10,16,2,2,2,6,Lost
35910,2128,32,90,1,4,4,9,At Risk
36025,2425,9,16,1,2,2,5,Lost
36058,597,6,10,2,1,1,4,Lost
36284,42,101,428,5,5,5,15,Champions
36418,378,26,47,3,4,3,10,Loyal Users
36489,539,40,57,2,4,3,9,At Risk
36613,4890,38,42,1,4,3,8,At Risk
36771,1430,10,16,1,2,2,5,Lost
36776,1252,13,31,2,3,2,7,Casual Users
36860,293,16,20,3,3,2,8,Loyal Users
37404,18,50,93,5,5,4,14,Champions
37536,106,11,31,4,2,2,8,Promising
37646,902,46,104,2,5,4,11,At Risk
37755,3888,5,25,1,1,2,4,Lost
37756,470,6,66,3,1,4,8,Casual Users
37849,139,56,209,4,5,5,14,Champions
37903,2250,5,7,1,1,1,3,Lost
37950,2548,13,31,1,3,2,6,Casual Users
38172,676,8,10,2,2,1,5,Lost
38290,269,5,23,3,1,2,6,Casual Users
38741,415,23,34,3,4,3,10,Loyal Users
38941,244,45,89,3,4,4,11,Loyal Users
38966,12,39,54,5,4,3,12,Loyal Users
39181,921,6,12,2,1,1,4,Lost
26710,231,91,107,3,5,4,12,Loyal Users
26754,128,6,10,4,1,1,6,Promising
26809,2637,8,86,1,2,4,7,Lost
27385,1012,17,40,2,3,3,8,Casual Users
27422,65,108,381,5,5,5,15,Champions
27449,46,68,243,5,5,5,15,Champions
27540,110,77,692,4,5,5,14,Champions
28242,2662,22,36,1,4,3,8,At Risk
28493,121,55,129,4,5,4,13,Champions
28673,156,31,56,4,4,3,11,Loyal Users
28913,4571,8,21,1,2,2,5,Lost
28928,15,9,17,5,2,2,9,Promising
29115,3156,15,23,1,3,2,6,Casual Users
29149,255,29,52,3,4,3,10,Loyal Users
29315,3200,11,19,1,2,2,5,Lost
29392,277,23,42,3,4,3,10,Loyal Users
29488,82,46,90,4,5,4,13,Champions
29626,112,40,76,4,4,4,12,Champions
29981,286,6,56,3,1,3,7,Casual Users
30010,231,17,43,3,3,3,9,Loyal Users
30055,2584,6,41,1,1,3,5,Lost
30146,1397,7,8,1,2,1,4,Lost
30293,2932,7,8,1,2,1,4,Lost
30306,19,118,243,5,5,5,15,Champions
30598,11,70,205,5,5,5,15,Champions
30738,42,63,195,5,5,5,15,Champions
30746,25,5,13,5,1,1,7,Promising
30779,1699,7,7,1,2,1,4,Lost
30783,237,12,27,3,3,2,8,Loyal Users
31037,867,5,9,2,1,1,4,Lost
31129,963,5,13,2,1,1,4,Lost
31553,1835,5,26,1,1,2,4,Lost
31669,420,18,45,3,3,3,9,Loyal Users
31748,421,48,73,3,5,4,12,Loyal Users
31839,128,25,48,4,4,3,11,Loyal Users
32047,36,19,78,5,3,4,12,Loyal Users
32284,4682,6,11,1,1,1,3,Lost
32598,227,8,18,3,2,2,7,Casual Users
32654,130,8,37,4,2,3,9,Promising
32682,15,35,120,5,4,4,13,Champions
33467,353,7,55,3,2,3,8,Casual Users
34036,90,16,32,4,3,3,10,Loyal Users
34192,0,5,6,5,1,1,7,Promising
34249,131,17,51,4,3,3,10,Loyal Users
34554,224,16,47,3,3,3,9,Loyal Users
35009,2915,15,22,1,3,2,6,Casual Users
35264,33,92,765,5,5,5,15,Champions
35283,531,43,138,2,4,4,10,At Risk
35370,124,81,314,4,5,5,14,Champions
35709,0,42,83,5,4,4,13,Champions
35829,1661,6,9,1,1,1,3,Lost
35943,725,12,28,2,3,2,7,Casual Users
36802,705,5,11,2,1,1,4,Lost
36870,847,5,13,2,1,1,4,Lost
36975,406,10,10,3,2,1,6,Casual Users
37376,546,9,11,2,2,1,5,Lost
37542,7,6,16,5,1,2,8,Promising
37811,358,16,27,3,3,2,8,Loyal Users
37998,123,11,21,4,2,2,8,Promising
38072,322,26,143,3,4,4,11,Loyal Users
38089,125,29,208,4,4,5,13,Champions
38147,151,41,288,4,4,5,13,Champions
38748,292,5,6,3,1,1,5,Casual Users
38920,216,8,16,3,2,2,7,Casual Users
38985,571,49,134,2,5,4,11,At Risk
26933,169,28,51,3,4,3,10,Loyal Users
27036,1106,5,6,2,1,1,4,Lost
27064,87,14,23,4,3,2,9,Loyal Users
27293,98,54,260,4,5,5,14,Champions
27560,6,16,31,5,3,2,10,Loyal Users
27642,270,22,78,3,4,4,11,Loyal Users
28248,632,31,72,2,4,4,10,At Risk
28253,15,18,58,5,3,3,11,Loyal Users
28373,2861,14,54,1,3,3,7,Casual Users
28485,520,39,167,2,4,5,11,At Risk
28575,2701,5,7,1,1,1,3,Lost
28976,879,5,11,2,1,1,4,Lost
29100,999,18,24,2,3,2,7,Casual Users
29457,137,28,45,4,4,3,11,Loyal Users
29547,15,26,68,5,4,4,13,Champions
30044,1417,5,30,1,1,2,4,Lost
30048,1879,5,11,1,1,1,3,Lost
30118,5147,44,114,1,4,4,9,At Risk
30639,5,47,218,5,5,5,15,Champions
31107,2793,6,9,1,1,1,3,Lost
31550,313,37,67,3,4,4,11,Loyal Users
31743,31,71,111,5,5,4,14,Champions
31823,1291,7,7,1,2,1,4,Lost
32189,59,42,206,5,4,5,14,Champions
32713,287,11,34,3,2,3,8,Casual Users
32968,63,111,350,5,5,5,15,Champions
33222,645,19,36,2,3,3,8,Casual Users
33429,394,64,401,3,5,5,13,Loyal Users
33480,257,11,20,3,2,2,7,Casual Users
33530,25,28,70,5,4,4,13,Champions
33673,656,12,100,2,3,4,9,Casual Users
33863,283,11,12,3,2,1,6,Casual Users
33937,0,10,51,5,2,3,10,Promising
34031,47,31,94,5,4,4,13,Champions
34284,5,174,310,5,5,5,15,Champions
34418,425,100,335,3,5,5,13,Loyal Users
34440,262,40,75,3,4,4,11,Loyal Users
34736,1,15,34,5,3,3,11,Loyal Users
34778,683,9,16,2,2,2,6,Lost
34825,1833,7,15,1,2,1,4,Lost
34924,689,20,38,2,3,3,8,Casual Users
35817,854,16,26,2,3,2,7,Casual Users
36460,853,5,8,2,1,1,4,Lost
36605,0,6,20,5,1,2,8,Promising
36716,579,11,24,2,2,2,6,Lost
36987,183,84,365,3,5,5,13,Loyal Users
37491,258,33,86,3,4,4,11,Loyal Users
37620,1431,5,10,1,1,1,3,Lost
38002,98,7,13,4,2,1,7,Promising
38022,165,17,23,4,3,2,9,Loyal Users
38274,240,11,18,3,2,2,7,Casual Users
38353,79,187,458,4,5,5,14,Champions
38782,388,84,216,3,5,5,13,Loyal Users
26614,1358,8,8,1,2,1,4,Lost
26739,27,27,133,5,4,4,13,Champions
26947,4887,7,23,1,2,2,5,Lost
27296,1717,29,55,1,4,3,8,At Risk
27782,81,15,49,4,3,3,10,Loyal Users
27837,802,5,21,2,1,2,5,Lost
28047,946,6,6,2,1,1,4,Lost
28098,118,32,72,4,4,4,12,Champions
28151,799,12,27,2,3,2,7,Casual Users
28689,548,25,34,2,4,3,9,At Risk
28874,373,24,91,3,4,4,11,Loyal Users
28984,75,61,152,4,5,5,14,Champions
29132,86,8,18,4,2,2,8,Promising
29190,246,31,150,3,4,5,12,Loyal Users
29191,564,12,28,2,3,2,7,Casual Users
29320,18,72,217,5,5,5,15,Champions
29464,748,38,69,2,4,4,10,At Risk
29619,10,126,353,5,5,5,15,Champions
29659,810,18,29,2,3,2,7,Casual Users
29849,1034,7,20,2,2,2,6,Lost
29862,284,49,143,3,5,4,12,Loyal Users
29927,405,43,156,3,4,5,12,Loyal Users
29932,590,7,40,2,2,3,7,Lost
29936,108,73,143,4,5,4,13,Champions
30217,490,39,169,2,4,5,11,At Risk
30538,121,57,228,4,5,5,14,Champions
30569,30,14,35,5,3,3,11,Loyal Users
30777,802,157,903,2,5,5,12,At Risk
30930,144,13,101,4,3,4,11,Loyal Users
30941,2402,6,7,1,1,1,3,Lost
31472,131,25,66,4,4,4,12,Champions
31969,39,11,20,5,2,2,9,Promising
32141,20,8,18,5,2,2,9,Promising
32314,2684,11,12,1,2,1,4,Lost
32328,1622,133,457,1,5,5,11,At Risk
32624,228,38,142,3,4,4,11,Loyal Users
33182,11,36,91,5,4,4,13,Champions
33319,134,8,13,4,2,1,7,Promising
33382,79,92,517,4,5,5,14,Champions
33591,1980,27,177,1,4,5,10,At Risk
33740,92,28,37,4,4,3,11,Loyal Users
34732,858,8,30,2,2,2,6,Lost
35034,153,52,141,4,5,4,13,Champions
35042,280,19,56,3,3,3,9,Loyal Users
35219,167,41,102,3,4,4,11,Loyal Users
35490,2757,5,6,1,1,1,3,Lost
35801,108,108,194,4,5,5,14,Champions
35975,102,25,73,4,4,4,12,Champions
36016,698,8,9,2,2,1,5,Lost
36198,974,40,89,2,4,4,10,At Risk
36353,4442,8,10,1,2,1,4,Lost
36508,138,42,192,4,4,5,13,Champions
36729,958,12,12,2,3,1,6,Casual Users
37148,245,14,32,3,3,3,9,Loyal Users
37481,165,8,43,4,2,3,9,Promising
37893,134,13,17,4,3,2,9,Loyal Users
38071,1029,7,33,2,2,3,7,Lost
38157,0,244,461,5,5,5,15,Champions
38336,36,10,23,5,2,2,9,Promising
38421,134,72,272,4,5,5,14,Champions
39070,412,13,16,3,3,2,8,Loyal Users
26543,1271,23,44,1,4,3,8,At Risk
26547,941,14,59,2,3,3,8,Casual Users
27060,374,5,5,3,1,1,5,Casual Users
27205,12,45,87,5,4,4,13,Champions
27332,438,19,38,3,3,3,9,Loyal Users
27441,368,9,11,3,2,1,6,Casual Users
27459,73,126,361,4,5,5,14,Champions
27515,132,36,74,4,4,4,12,Champions
27608,59,64,76,5,5,4,14,Champions
27964,5,26,62,5,4,3,12,Loyal Users
28023,70,75,90,4,5,4,13,Champions
28100,857,10,24,2,2,2,6,Lost
28153,151,29,55,4,4,3,11,Loyal Users
28180,0,115,553,5,5,5,15,Champions
28231,123,17,37,4,3,3,10,Loyal Users
28570,411,16,68,3,3,4,10,Loyal Users
28762,1501,14,40,1,3,3,7,Casual Users
28906,44,143,452,5,5,5,15,Champions
29002,107,86,603,4,5,5,14,Champions
29097,1267,12,12,1,3,1,5,Casual Users
29151,992,10,40,2,2,3,7,Lost
29417,116,23,36,4,4,3,11,Loyal Users
29472,2,49,344,5,5,5,15,Champions
29555,349,11,14,3,2,1,6,Casual Users
29698,264,39,94,3,4,4,11,Loyal Users
30355,422,11,15,3,2,1,6,Casual Users
30570,1,15,45,5,3,3,11,Loyal Users
30665,688,8,21,2,2,2,6,Lost
30666,867,27,32,2,4,3,9,At Risk
30749,93,10,19,4,2,2,8,Promising
30869,3279,10,15,1,2,1,4,Lost
31077,703,14,22,2,3,2,7,Casual Users
31095,275,13,37,3,3,3,9,Loyal Users
31332,276,18,62,3,3,3,9,Loyal Users
31348,365,37,174,3,4,5,12,Loyal Users
31594,3970,7,16,1,2,2,5,Lost
31929,172,6,7,3,1,1,5,Casual Users
32086,855,25,63,2,4,4,10,At Risk
32217,1146,12,30,2,3,2,7,Casual Users
32254,1882,20,90,1,3,4,8,Casual Users
32383,1801,8,12,1,2,1,4,Lost
32901,79,28,95,4,4,4,12,Champions
33100,11,11,57,5,2,3,10,Promising
33166,136,24,77,4,4,4,12,Champions
33206,210,71,170,3,5,5,13,Loyal Users
33230,265,12,17,3,3,2,8,Loyal Users
33367,30,62,335,5,5,5,15,Champions
33501,698,18,28,2,3,2,7,Casual Users
33650,135,16,81,4,3,4,11,Loyal Users
33679,20,178,743,5,5,5,15,Champions
34672,283,9,14,3,2,1,6,Casual Users
35076,260,55,162,3,5,5,13,Loyal Users
35455,3726,7,10,1,2,1,4,Lost
35546,140,7,16,4,2,2,8,Promising
35663,961,43,166,2,4,5,11,At Risk
35721,241,62,274,3,5,5,13,Loyal Users
35739,405,7,51,3,2,3,8,Casual Users
35861,707,46,124,2,5,4,11,At Risk
35942,566,8,9,2,2,1,5,Lost
36411,0,8,17,5,2,2,9,Promising
37194,1896,5,5,1,1,1,3,Lost
37217,30,10,48,5,2,3,10,Promising
37676,140,40,87,4,4,4,12,Champions
38186,1803,6,30,1,1,2,4,Lost
38608,304,9,28,3,2,2,7,Casual Users
26775,2726,8,11,1,2,1,4,Lost
26996,379,83,204,3,5,5,13,Loyal Users
27103,4259,9,17,1,2,2,5,Lost
28472,271,136,409,3,5,5,13,Loyal Users
28808,107,65,372,4,5,5,14,Champions
28881,3,40,126,5,4,4,13,Champions
29155,1419,8,14,1,2,1,4,Lost
29549,86,122,216,4,5,5,14,Champions
29609,1651,7,11,1,2,1,4,Lost
29809,568,5,9,2,1,1,4,Lost
29836,1074,14,66,2,3,4,9,Casual Users
29979,2465,5,13,1,1,1,3,Lost
30032,11,22,46,5,4,3,12,Loyal Users
30147,0,37,171,5,4,5,14,Champions
30335,1999,9,18,1,2,2,5,Lost
30465,2274,15,21,1,3,2,6,Casual Users
30517,103,19,92,4,3,4,11,Loyal Users
30603,3550,5,8,1,1,1,3,Lost
30828,43,156,425,5,5,5,15,Champions
31396,114,18,75,4,3,4,11,Loyal Users
31458,8,58,119,5,5,4,14,Champions
31596,601,77,554,2,5,5,12,At Risk
32330,238,8,33,3,2,3,8,Casual Users
32469,143,10,42,4,2,3,9,Promising
32535,67,15,17,5,3,2,10,Loyal Users
32848,78,40,196,4,4,5,13,Champions
33207,1229,7,13,2,2,1,5,Lost
33223,953,10,56,2,2,3,7,Lost
34166,1993,14,24,1,3,2,6,Casual Users
34441,2234,7,49,1,2,3,6,Lost
34548,557,13,50,2,3,3,8,Casual Users
34587,721,7,18,2,2,2,6,Lost
35527,1088,13,48,2,3,3,8,Casual Users
35876,420,10,20,3,2,2,7,Casual Users
36230,317,13,97,3,3,4,10,Loyal Users
36659,1131,7,12,2,2,1,5,Lost
36791,617,11,28,2,2,2,6,Lost
36807,173,46,275,3,5,5,13,Loyal Users
36895,1223,10,14,2,2,1,5,Lost
37247,2274,5,6,1,1,1,3,Lost
37596,115,10,19,4,2,2,8,Promising
37663,74,8,17,4,2,2,8,Promising
37872,392,28,77,3,4,4,11,Loyal Users
38426,415,12,75,3,3,4,10,Loyal Users
39219,738,11,36,2,2,3,7,Lost
26688,434,10,62,3,2,3,8,Casual Users
26949,470,24,107,3,4,4,11,Loyal Users
27603,436,7,9,3,2,1,6,Casual Users
27902,136,37,51,4,4,3,11,Loyal Users
27952,14,21,71,5,3,4,12,Loyal Users
28424,4435,5,5,1,1,1,3,Lost
28450,42,111,160,5,5,5,15,Champions
28513,4,34,149,5,4,5,14,Champions
28547,125,58,333,4,5,5,14,Champions
28898,428,5,17,3,1,2,6,Casual Users
28932,163,5,7,4,1,1,6,Promising
28951,58,30,117,5,4,4,13,Champions
28990,2009,11,164,1,2,5,8,Lost
29044,536,22,112,2,4,4,10,At Risk
29261,4419,11,25,1,2,2,5,Lost
29298,527,21,56,2,3,3,8,Casual Users
29763,2432,5,7,1,1,1,3,Lost
29795,409,22,57,3,4,3,10,Loyal Users
29877,0,141,408,5,5,5,15,Champions
30297,125,23,29,4,4,2,10,Loyal Users
30590,1394,17,17,1,3,2,6,Casual Users
31407,424,10,93,3,2,4,9,Casual Users
31533,120,49,83,4,5,4,13,Champions
31572,1474,5,11,1,1,1,3,Lost
31979,4689,5,73,1,1,4,6,Lost
32009,2,7,66,5,2,4,11,Promising
32103,991,8,9,2,2,1,5,Lost
32125,2696,26,94,1,4,4,9,At Risk
32367,17,53,94,5,5,4,14,Champions
32395,42,25,130,5,4,4,13,Champions
32683,830,22,84,2,4,4,10,At Risk
33076,143,5,33,4,1,3,8,Promising
33156,811,12,60,2,3,3,8,Casual Users
33777,108,29,65,4,4,4,12,Champions
34423,578,66,149,2,5,5,12,At Risk
35236,104,18,25,4,3,2,9,Loyal Users
35338,2769,7,46,1,2,3,6,Lost
35341,161,82,180,4,5,5,14,Champions
35568,132,33,62,4,4,3,11,Loyal Users
36206,1810,8,25,1,2,2,5,Lost
36214,37,123,550,5,5,5,15,Champions
36377,2227,19,47,1,3,3,7,Casual Users
37033,124,27,95,4,4,4,12,Champions
37207,4022,29,149,1,4,5,10,At Risk
37577,570,5,5,2,1,1,4,Lost
37738,2932,7,16,1,2,2,5,Lost
38034,156,39,221,4,4,5,13,Champions
38183,649,47,102,2,5,4,11,At Risk
38342,1385,8,45,1,2,3,6,Lost
38566,27,44,292,5,4,5,14,Champions
38702,20,14,38,5,3,3,11,Loyal Users
38761,870,5,7,2,1,1,4,Lost
38972,869,7,7,2,2,1,5,Lost
38986,437,7,11,3,2,1,6,Casual Users
26477,90,23,47,4,4,3,11,Loyal Users
26602,158,50,171,4,5,5,14,Champions
26705,790,23,53,2,4,3,9,At Risk
26824,2288,9,10,1,2,1,4,Lost
26927,394,33,74,3,4,4,11,Loyal Users
27050,299,23,28,3,4,2,9,Loyal Users
27354,165,90,544,4,5,5,14,Champions
27357,9,6,11,5,1,1,7,Promising
27374,16,8,59,5,2,3,10,Promising
28060,136,13,96,4,3,4,11,Loyal Users
28332,418,9,21,3,2,2,7,Casual Users
28372,5,117,511,5,5,5,15,Champions
28652,31,60,522,5,5,5,15,Champions
28856,370,65,155,3,5,5,13,Loyal Users
28948,257,16,47,3,3,3,9,Loyal Users
29518,262,8,55,3,2,3,8,Casual Users
29646,57,27,33,5,4,3,12,Loyal Users
29673,438,74,122,3,5,4,12,Loyal Users
29711,37,95,117,5,5,4,14,Champions
30106,22,202,665,5,5,5,15,Champions
30197,443,49,93,3,5,4,12,Loyal Users
30539,1983,5,10,1,1,1,3,Lost
30709,3543,10,33,1,2,3,6,Lost
31184,1148,6,9,2,1,1,4,Lost
31328,128,73,372,4,5,5,14,Champions
31399,253,42,64,3,4,4,11,Loyal Users
31423,145,78,248,4,5,5,14,Champions
31501,499,12,23,2,3,2,7,Casual Users
31630,1087,25,101,2,4,4,10,At Risk
31632,679,15,30,2,3,2,7,Casual Users
31798,1003,8,59,2,2,3,7,Lost
32033,7,69,145,5,5,4,14,Champions
32232,466,5,9,3,1,1,5,Casual Users
32662,1252,9,16,2,2,2,6,Lost
32678,8,49,315,5,5,5,15,Champions
33091,1699,10,42,1,2,3,6,Lost
33523,224,9,33,3,2,3,8,Casual Users
33561,27,170,522,5,5,5,15,Champions
33919,31,58,208,5,5,5,15,Champions
34299,102,40,142,4,4,4,12,Champions
34360,3452,8,8,1,2,1,4,Lost
34500,481,9,16,2,2,2,6,Lost
34748,9,26,252,5,4,5,14,Champions
35029,123,23,73,4,4,4,12,Champions
35033,214,13,31,3,3,2,8,Loyal Users
35102,60,52,384,5,5,5,15,Champions
35271,12,98,271,5,5,5,15,Champions
35391,758,13,57,2,3,3,8,Casual Users
35506,6,123,248,5,5,5,15,Champions
35535,697,7,24,2,2,2,6,Lost
35616,4850,8,9,1,2,1,4,Lost
35902,271,19,85,3,3,4,10,Loyal Users
36190,412,8,11,3,2,1,6,Casual Users
36251,226,25,62,3,4,3,10,Loyal Users
36257,399,34,41,3,4,3,10,Loyal Users
36267,424,11,36,3,2,3,8,Casual Users
36643,409,12,20,3,3,2,8,Loyal Users
36677,9,63,191,5,5,5,15,Champions
37040,526,10,43,2,2,3,7,Lost
37044,48,72,213,5,5,5,15,Champions
37068,4559,6,12,1,1,1,3,Lost
37115,403,29,77,3,4,4,11,Loyal Users
37448,1290,82,150,1,5,5,11,At Risk
37508,135,23,64,4,4,4,12,Champions
37750,3849,6,12,1,1,1,3,Lost
38430,3933,7,9,1,2,1,4,Lost
38475,126,26,149,4,4,5,13,Champions
38489,2187,6,49,1,1,3,5,Lost
38526,568,21,35,2,3,3,8,Casual Users
38959,33,207,369,5,5,5,15,Champions
26546,262,18,98,3,3,4,10,Loyal Users
26898,1574,9,47,1,2,3,6,Lost
26909,20,59,114,5,5,4,14,Champions
26986,0,99,268,5,5,5,15,Champions
27284,285,5,8,3,1,1,5,Casual Users
27891,1237,19,48,2,3,3,8,Casual Users
28631,508,16,18,2,3,2,7,Casual Users
29196,62,156,848,5,5,5,15,Champions
29420,604,5,9,2,1,1,4,Lost
30261,115,24,91,4,4,4,12,Champions
30272,303,14,23,3,3,2,8,Loyal Users
30339,1,66,165,5,5,5,15,Champions
30472,263,63,104,3,5,4,12,Loyal Users
30516,3273,10,18,1,2,2,5,Lost
30597,409,5,10,3,1,1,5,Casual Users
30730,90,16,52,4,3,3,10,Loyal Users
30736,3376,8,36,1,2,3,6,Lost
30786,3551,24,58,1,4,3,8,At Risk
30887,1684,13,14,1,3,1,5,Casual Users
30940,363,50,145,3,5,4,12,Loyal Users
31116,506,11,56,2,2,3,7,Lost
31134,1037,8,73,2,2,4,8,Lost
31326,1858,5,5,1,1,1,3,Lost
31990,247,47,451,3,5,5,13,Loyal Users
32781,579,35,194,2,4,5,11,At Risk
33090,2885,14,19,1,3,2,6,Casual Users
33400,116,28,62,4,4,3,11,Loyal Users
33476,689,5,16,2,1,2,5,Lost
33727,1135,8,25,2,2,2,6,Lost
34254,121,43,81,4,4,4,12,Champions
34831,0,89,315,5,5,5,15,Champions
35619,34,6,18,5,1,2,8,Promising
35636,290,13,94,3,3,4,10,Loyal Users
35665,2,82,427,5,5,5,15,Champions
35806,389,10,19,3,2,2,7,Casual Users
35926,299,14,26,3,3,2,8,Loyal Users
36062,1509,7,11,1,2,1,4,Lost
36226,96,126,637,4,5,5,14,Champions
36274,2534,31,91,1,4,4,9,At Risk
36600,2636,5,8,1,1,1,3,Lost
36690,3423,8,11,1,2,1,4,Lost
36934,8,183,458,5,5,5,15,Champions
36963,1269,15,70,1,3,4,8,Casual Users
37135,749,8,16,2,2,2,6,Lost
37551,1531,20,43,1,3,3,7,Casual Users
37624,212,7,16,3,2,2,7,Casual Users
37827,19,52,178,5,5,5,15,Champions
38409,102,114,293,4,5,5,14,Champions
38486,241,32,190,3,4,5,12,Loyal Users
26525,391,14,20,3,3,2,8,Loyal Users
27302,306,19,68,3,3,4,10,Loyal Users
27655,2527,5,5,1,1,1,3,Lost
27775,17,108,146,5,5,4,14,Champions
27883,254,7,19,3,2,2,7,Casual Users
28257,110,10,24,4,2,2,8,Promising
28947,120,75,209,4,5,5,14,Champions
28999,33,11,26,5,2,2,9,Promising
29086,3747,6,7,1,1,1,3,Lost
29263,3536,6,9,1,1,1,3,Lost
29491,1521,9,18,1,2,2,5,Lost
29688,1419,7,23,1,2,2,5,Lost
30007,121,51,158,4,5,5,14,Champions
30366,850,22,89,2,4,4,10,At Risk
30618,2127,8,11,1,2,1,4,Lost
31071,133,43,66,4,4,4,12,Champions
31092,3491,13,61,1,3,3,7,Casual Users
31171,50,84,375,5,5,5,15,Champions
31637,71,12,13,4,3,1,8,Loyal Users
31856,3094,6,24,1,1,2,4,Lost
32299,39,24,32,5,4,3,12,Loyal Users
32312,29,42,163,5,4,5,14,Champions
32514,1307,9,15,1,2,1,4,Lost
32663,883,7,10,2,2,1,5,Lost
32782,9,117,355,5,5,5,15,Champions
32837,12,71,309,5,5,5,15,Champions
32941,656,10,35,2,2,3,7,Lost
33086,384,13,22,3,3,2,8,Loyal Users
33213,78,149,217,4,5,5,14,Champions
33277,2247,7,17,1,2,2,5,Lost
33420,855,34,126,2,4,4,10,At Risk
33629,814,13,42,2,3,3,8,Casual Users
33912,476,12,92,2,3,4,9,Casual Users
33953,56,31,113,5,4,4,13,Champions
34010,238,9,9,3,2,1,6,Casual Users
34761,78,142,433,4,5,5,14,Champions
34789,605,22,53,2,4,3,9,At Risk
35382,345,8,100,3,2,4,9,Casual Users
35489,113,36,75,4,4,4,12,Champions
35601,233,7,17,3,2,2,7,Casual Users
35809,951,14,40,2,3,3,8,Casual Users
36168,120,20,25,4,3,2,9,Loyal Users
36408,1564,8,20,1,2,2,5,Lost
36464,462,10,18,3,2,2,7,Casual Users
36555,3314,8,47,1,2,3,6,Lost
36558,1849,6,7,1,1,1,3,Lost
36592,60,14,54,5,3,3,11,Loyal Users
36943,523,10,62,2,2,3,7,Lost
36972,1457,8,12,1,2,1,4,Lost
37160,95,24,32,4,4,3,11,Loyal Users
37356,1013,13,38,2,3,3,8,Casual Users
37528,1240,5,6,2,1,1,4,Lost
37556,3,53,347,5,5,5,15,Champions
37579,964,5,5,2,1,1,4,Lost
37586,1418,10,65,1,2,4,7,Lost
37591,21,107,247,5,5,5,15,Champions
37778,4,112,392,5,5,5,15,Champions
37854,126,67,196,4,5,5,14,Champions
38112,7,5,20,5,1,2,8,Promising
38258,662,6,8,2,1,1,4,Lost
38522,1159,6,17,2,1,2,5,Lost
38535,81,63,397,4,5,5,14,Champions
39027,972,9,11,2,2,1,5,Lost
26493,1671,5,5,1,1,1,3,Lost
26637,2258,65,152,1,5,5,11,At Risk
27054,611,19,39,2,3,3,8,Casual Users
27084,233,11,21,3,2,2,7,Casual Users
27256,1398,23,123,1,4,4,9,At Risk
27476,109,22,180,4,4,5,13,Champions
27487,136,43,231,4,4,5,13,Champions
27543,1416,61,318,1,5,5,11,At Risk
27628,751,6,6,2,1,1,4,Lost
27820,129,13,14,4,3,1,8,Loyal Users
27843,114,29,69,4,4,4,12,Champions
28014,3,43,77,5,4,4,13,Champions
28067,300,9,39,3,2,3,8,Casual Users
28542,373,20,54,3,3,3,9,Loyal Users
28580,43,63,134,5,5,4,14,Champions
28721,42,42,100,5,4,4,13,Champions
28729,7,78,314,5,5,5,15,Champions
28766,1116,6,18,2,1,2,5,Lost
28956,866,61,145,2,5,4,11,At Risk
29437,4409,5,44,1,1,3,5,Lost
29707,77,21,34,4,3,3,10,Loyal Users
29753,545,56,95,2,5,4,11,At Risk
29801,37,124,714,5,5,5,15,Champions
29847,4591,7,10,1,2,1,4,Lost
29957,4123,12,24,1,3,2,6,Casual Users
30400,148,10,39,4,2,3,9,Promising
31111,2044,7,14,1,2,1,4,Lost
31851,20,65,381,5,5,5,15,Champions
32118,110,6,9,4,1,1,6,Promising
32191,23,131,440,5,5,5,15,Champions
32892,167,19,34,3,3,3,9,Loyal Users
33107,698,6,9,2,1,1,4,Lost
33246,64,9,9,5,2,1,8,Promising
33255,374,16,35,3,3,3,9,Loyal Users
33333,965,7,10,2,2,1,5,Lost
33440,84,31,70,4,4,4,12,Champions
33725,612,15,17,2,3,2,7,Casual Users
34362,26,21,93,5,3,4,12,Loyal Users
34583,255,45,111,3,4,4,11,Loyal Users
36492,4,26,199,5,4,5,14,Champions
36567,54,33,56,5,4,3,12,Loyal Users
36648,752,5,31,2,1,2,5,Lost
36661,590,21,48,2,3,3,8,Casual Users
37449,400,9,15,3,2,1,6,Casual Users
37874,527,27,48,2,4,3,9,At Risk
38547,260,44,247,3,4,5,12,Loyal Users
38620,405,5,19,3,1,2,6,Casual Users
38853,3,56,219,5,5,5,15,Champions
39036,775,5,56,2,1,3,6,Lost
39059,1532,8,22,1,2,2,5,Lost
26853,593,10,13,2,2,1,5,Lost
26872,152,174,497,4,5,5,14,Champions
27258,2651,5,6,1,1,1,3,Lost
27513,7,39,112,5,4,4,13,Champions
27591,35,25,69,5,4,4,13,Champions
27823,659,20,47,2,3,3,8,Casual Users
28140,0,20,139,5,3,4,12,Loyal Users
28381,180,13,24,3,3,2,8,Loyal Users
28470,4855,5,17,1,1,2,4,Lost
28678,4455,7,33,1,2,3,6,Lost
28701,689,6,8,2,1,1,4,Lost
28732,405,13,21,3,3,2,8,Loyal Users
29084,277,25,108,3,4,4,11,Loyal Users
29459,4570,36,72,1,4,4,9,At Risk
29511,432,7,8,3,2,1,6,Casual Users
29772,30,34,169,5,4,5,14,Champions
29787,1156,7,26,2,2,2,6,Lost
29889,5,94,130,5,5,4,14,Champions
30079,1416,55,93,1,5,4,10,At Risk
30268,3972,29,117,1,4,4,9,At Risk
30503,375,53,388,3,5,5,13,Loyal Users
30756,119,6,34,4,1,3,8,Promising
30835,803,11,15,2,2,1,5,Lost
30844,751,17,82,2,3,4,9,Casual Users
31010,2688,5,14,1,1,1,3,Lost
31140,957,8,12,2,2,1,5,Lost
31241,2374,17,34,1,3,3,7,Casual Users
31249,11,17,38,5,3,3,11,Loyal Users
31295,1941,6,9,1,1,1,3,Lost
31341,79,5,14,4,1,1,6,Promising
31391,2428,12,48,1,3,3,7,Casual Users
31489,43,109,468,5,5,5,15,Champions
31599,829,25,48,2,4,3,9,At Risk
31832,435,5,6,3,1,1,5,Casual Users
31909,2005,11,24,1,2,2,5,Lost
31920,84,58,117,4,5,4,13,Champions
32000,2237,16,40,1,3,3,7,Casual Users
32840,165,57,152,4,5,5,14,Champions
32967,430,5,6,3,1,1,5,Casual Users
33112,280,7,53,3,2,3,8,Casual Users
33384,27,103,456,5,5,5,15,Champions
33688,2583,5,9,1,1,1,3,Lost
33835,137,69,168,4,5,5,14,Champions
34025,5735,10,12,1,2,1,4,Lost
34286,309,33,63,3,4,4,11,Loyal Users
34501,595,9,17,2,2,2,6,Lost
34537,2354,25,108,1,4,4,9,At Risk
34655,28,7,29,5,2,2,9,Promising
34802,2017,6,10,1,1,1,3,Lost
34847,653,11,48,2,2,3,7,Lost
34999,1299,6,8,1,1,1,3,Lost
35215,739,9,14,2,2,1,5,Lost
35241,17,134,492,5,5,5,15,Champions
35253,4,107,276,5,5,5,15,Champions
35516,830,16,39,2,3,3,8,Casual Users
35908,117,7,16,4,2,2,8,Promising
36046,293,5,6,3,1,1,5,Casual Users
36463,1537,18,31,1,3,2,6,Casual Users
36959,64,26,180,5,4,5,14,Champions
37373,3127,6,39,1,1,3,5,Lost
37565,24,100,129,5,5,4,14,Champions
37761,280,5,11,3,1,1,5,Casual Users
37836,75,59,100,4,5,4,13,Champions
38006,5225,30,106,1,4,4,9,At Risk
38549,65,31,113,5,4,4,13,Champions
38714,103,50,61,4,5,3,12,Loyal Users
39055,2128,6,37,1,1,3,5,Lost
39170,120,20,93,4,3,4,11,Loyal Users
39174,134,17,60,4,3,3,10,Loyal Users
26802,4492,10,15,1,2,1,4,Lost
27096,34,133,862,5,5,5,15,Champions
27338,1771,29,89,1,4,4,9,At Risk
27727,123,6,18,4,1,2,7,Promising
27847,1702,6,12,1,1,1,3,Lost
28001,3244,9,13,1,2,1,4,Lost
28422,3330,14,21,1,3,2,6,Casual Users
28622,577,10,22,2,2,2,6,Lost
29256,67,52,150,5,5,5,15,Champions
29458,3,173,291,5,5,5,15,Champions
29788,214,77,408,3,5,5,13,Loyal Users
29832,116,26,301,4,4,5,13,Champions
29903,261,42,84,3,4,4,11,Loyal Users
30121,114,78,262,4,5,5,14,Champions
30150,817,12,93,2,3,4,9,Casual Users
30215,43,131,240,5,5,5,15,Champions
30222,62,48,138,5,5,4,14,Champions
30311,2290,12,14,1,3,1,5,Casual Users
30316,286,24,87,3,4,4,11,Loyal Users
30498,1568,5,8,1,1,1,3,Lost
30557,281,16,20,3,3,2,8,Loyal Users
30716,676,8,21,2,2,2,6,Lost
30881,387,34,146,3,4,4,11,Loyal Users
30885,4540,5,8,1,1,1,3,Lost
31251,1551,21,28,1,3,2,6,Casual Users
31398,12,24,24,5,4,2,11,Loyal Users
31409,500,18,64,2,3,4,9,Casual Users
31457,1916,5,5,1,1,1,3,Lost
31467,2,107,188,5,5,5,15,Champions
31889,416,31,44,3,4,3,10,Loyal Users
31900,390,17,38,3,3,3,9,Loyal Users
32031,571,9,25,2,2,2,6,Lost
32264,27,56,259,5,5,5,15,Champions
32873,375,18,27,3,3,2,8,Loyal Users
33013,132,26,37,4,4,3,11,Loyal Users
33413,1143,5,12,2,1,1,4,Lost
33614,342,28,55,3,4,3,10,Loyal Users
33997,278,40,51,3,4,3,10,Loyal Users
34301,138,9,59,4,2,3,9,Promising
34336,172,33,49,3,4,3,10,Loyal Users
34978,1980,9,13,1,2,1,4,Lost
35052,119,32,65,4,4,4,12,Champions
35196,94,42,56,4,4,3,11,Loyal Users
35462,3356,30,47,1,4,3,8,At Risk
35565,406,8,9,3,2,1,6,Casual Users
35603,574,15,44,2,3,3,8,Casual Users
36023,1702,14,23,1,3,2,6,Casual Users
36789,1542,13,35,1,3,3,7,Casual Users
36862,85,17,150,4,3,5,12,Loyal Users
37074,725,7,8,2,2,1,5,Lost
37441,75,10,55,4,2,3,9,Promising
37519,4,53,60,5,5,3,13,Loyal Users
37847,1922,14,92,1,3,4,8,Casual Users
37946,531,38,163,2,4,5,11,At Risk
38092,2947,111,180,1,5,5,11,At Risk
38401,86,127,150,4,5,5,14,Champions
38551,514,17,64,2,3,4,9,Casual Users
38648,83,9,11,4,2,1,7,Promising
38942,3152,11,20,1,2,2,5,Lost
39001,103,99,727,4,5,5,14,Champions
39048,77,127,658,4,5,5,14,Champions
26497,88,41,122,4,4,4,12,Champions
26950,287,9,15,3,2,1,6,Casual Users
26954,109,8,9,4,2,1,7,Promising
27083,155,62,224,4,5,5,14,Champions
27494,84,26,33,4,4,3,11,Loyal Users
27692,137,8,9,4,2,1,7,Promising
27713,611,8,12,2,2,1,5,Lost
27789,167,8,27,3,2,2,7,Casual Users
27994,117,31,37,4,4,3,11,Loyal Users
28126,271,112,376,3,5,5,13,Loyal Users
28224,262,35,86,3,4,4,11,Loyal Users
28313,1016,26,69,2,4,4,10,At Risk
28544,127,95,279,4,5,5,14,Champions
28896,1,51,302,5,5,5,15,Champions
29141,388,38,177,3,4,5,12,Loyal Users
29189,258,56,151,3,5,5,13,Loyal Users
29338,692,9,27,2,2,2,6,Lost
29359,2938,6,19,1,1,2,4,Lost
29386,33,18,81,5,3,4,12,Loyal Users
29388,738,5,5,2,1,1,4,Lost
29704,59,169,413,5,5,5,15,Champions
29783,12,117,501,5,5,5,15,Champions
30584,2264,14,36,1,3,3,7,Casual Users
31415,22,75,176,5,5,5,15,Champions
31612,164,6,13,4,1,1,6,Promising
31688,10,10,18,5,2,2,9,Promising
31908,270,41,213,3,4,5,12,Loyal Users
31913,3469,10,20,1,2,2,5,Lost
32055,7,8,11,5,2,1,8,Promising
32556,97,10,23,4,2,2,8,Promising
32591,4125,27,46,1,4,3,8,At Risk
32835,28,12,51,5,3,3,11,Loyal Users
33045,512,65,309,2,5,5,12,At Risk
33129,10,55,223,5,5,5,15,Champions
33152,1373,15,32,1,3,3,7,Casual Users
33224,1801,9,17,1,2,2,5,Lost
33242,1028,5,10,2,1,1,4,Lost
33285,4926,6,12,1,1,1,3,Lost
33414,1436,14,17,1,3,2,6,Casual Users
33689,35,18,27,5,3,2,10,Loyal Users
33889,9,40,133,5,4,4,13,Champions
33918,71,64,186,4,5,5,14,Champions
34049,424,25,64,3,4,4,11,Loyal Users
34322,3701,15,40,1,3,3,7,Casual Users
34526,1897,15,22,1,3,2,6,Casual Users
34756,118,21,54,4,3,3,10,Loyal Users
34932,8,234,709,5,5,5,15,Champions
35014,394,33,70,3,4,4,11,Loyal Users
35087,2430,6,14,1,1,1,3,Lost
35505,1946,32,96,1,4,4,9,At Risk
35588,626,24,118,2,4,4,10,At Risk
35610,444,11,22,3,2,2,7,Casual Users
35823,23,48,91,5,5,4,14,Champions
35846,571,5,9,2,1,1,4,Lost
36314,131,52,239,4,5,5,14,Champions
36441,450,12,46,3,3,3,9,Loyal Users
36616,9,13,34,5,3,3,11,Loyal Users
36892,1281,5,6,1,1,1,3,Lost
36996,113,88,344,4,5,5,14,Champions
37021,24,118,229,5,5,5,15,Champions
37077,2556,28,51,1,4,3,8,At Risk
37444,557,10,24,2,2,2,6,Lost
37474,2271,7,14,1,2,1,4,Lost
37485,2020,7,8,1,2,1,4,Lost
38040,264,14,31,3,3,2,8,Loyal Users
38082,4,150,235,5,5,5,15,Champions
38410,651,5,33,2,1,3,6,Lost
38450,30,33,67,5,4,4,13,Champions
38897,368,38,112,3,4,4,11,Loyal Users
38978,2930,5,13,1,1,1,3,Lost
39071,3,37,86,5,4,4,13,Champions
39128,3381,5,7,1,1,1,3,Lost
27078,416,30,54,3,4,3,10,Loyal Users
27184,83,56,146,4,5,4,13,Champions
27539,1419,7,14,1,2,1,4,Lost
28071,3,200,344,5,5,5,15,Champions
28173,831,29,51,2,4,3,9,At Risk
28291,170,12,23,3,3,2,8,Loyal Users
28670,88,41,87,4,4,4,12,Champions
28847,317,48,312,3,5,5,13,Loyal Users
28929,1848,9,54,1,2,3,6,Lost
29277,504,17,40,2,3,3,8,Casual Users
29412,2552,31,49,1,4,3,8,At Risk
29422,270,16,58,3,3,3,9,Loyal Users
29461,1029,7,16,2,2,2,6,Lost
29732,1203,10,25,2,2,2,6,Lost
29779,18,116,338,5,5,5,15,Champions
30001,413,6,6,3,1,1,5,Casual Users
30159,240,11,33,3,2,3,8,Casual Users
30249,527,18,50,2,3,3,8,Casual Users
30267,20,40,85,5,4,4,13,Champions
30369,1136,7,8,2,2,1,5,Lost
30888,2474,46,240,1,5,5,11,At Risk
30962,34,118,268,5,5,5,15,Champions
31096,1132,20,54,2,3,3,8,Casual Users
31279,6,42,177,5,4,5,14,Champions
31282,118,60,366,4,5,5,14,Champions
31307,415,29,37,3,4,3,10,Loyal Users
31451,234,20,42,3,3,3,9,Loyal Users
31716,95,23,43,4,4,3,11,Loyal Users
31995,294,21,33,3,3,3,9,Loyal Users
32100,612,16,19,2,3,2,7,Casual Users
32272,114,25,71,4,4,4,12,Champions
32617,3604,7,11,1,2,1,4,Lost
32867,121,9,29,4,2,2,8,Promising
32883,1100,8,12,2,2,1,5,Lost
33275,294,42,139,3,4,4,11,Loyal Users
33794,118,11,42,4,2,3,9,Promising
33908,107,9,13,4,2,1,7,Promising
34614,160,10,18,4,2,2,8,Promising
34867,1056,9,36,2,2,3,7,Lost
34873,936,9,12,2,2,1,5,Lost
35019,138,53,124,4,5,4,13,Champions
35228,5632,5,15,1,1,1,3,Lost
35381,90,54,124,4,5,4,13,Champions
35583,2030,6,9,1,1,1,3,Lost
35836,52,9,16,5,2,2,9,Promising
36318,641,18,214,2,3,5,10,Casual Users
36467,333,22,69,3,4,4,11,Loyal Users
36482,72,7,35,4,2,3,9,Promising
36632,1703,25,58,1,4,3,8,At Risk
36654,107,46,67,4,5,4,13,Champions
36731,294,29,47,3,4,3,10,Loyal Users
37861,169,58,96,3,5,4,12,Loyal Users
37960,1421,8,11,1,2,1,4,Lost
38160,26,46,78,5,5,4,14,Champions
38738,33,56,93,5,5,4,14,Champions
38855,144,106,134,4,5,4,13,Champions
26712,148,27,83,4,4,4,12,Champions
26875,110,82,358,4,5,5,14,Champions
27066,288,27,104,3,4,4,11,Loyal Users
27483,1018,23,122,2,4,4,10,At Risk
27862,46,106,248,5,5,5,15,Champions
28068,361,35,48,3,4,3,10,Loyal Users
28115,147,74,207,4,5,5,14,Champions
28274,690,22,114,2,4,4,10,At Risk
28796,45,75,193,5,5,5,15,Champions
28892,529,12,43,2,3,3,8,Casual Users
29124,106,19,48,4,3,3,10,Loyal Users
29218,223,14,58,3,3,3,9,Loyal Users
29292,231,56,320,3,5,5,13,Loyal Users
29370,0,133,493,5,5,5,15,Champions
29574,1308,5,9,1,1,1,3,Lost
29712,9,9,32,5,2,3,10,Promising
30246,589,10,26,2,2,2,6,Lost
30343,4,173,289,5,5,5,15,Champions
30360,667,12,82,2,3,4,9,Casual Users
30624,718,9,12,2,2,1,5,Lost
30680,112,9,23,4,2,2,8,Promising
30799,246,5,29,3,1,2,6,Casual Users
30904,12,24,32,5,4,3,12,Loyal Users
30923,1997,62,355,1,5,5,11,At Risk
30945,40,27,43,5,4,3,12,Loyal Users
31259,2771,5,5,1,1,1,3,Lost
31625,2140,7,8,1,2,1,4,Lost
31645,270,18,75,3,3,4,10,Loyal Users
32071,59,16,42,5,3,3,11,Loyal Users
32074,0,126,410,5,5,5,15,Champions
32427,427,9,19,3,2,2,7,Casual Users
32642,59,29,59,5,4,3,12,Loyal Users
33753,3815,8,8,1,2,1,4,Lost
33800,101,12,25,4,3,2,9,Loyal Users
33994,1392,7,35,1,2,3,6,Lost
34102,127,93,160,4,5,5,14,Champions
34104,10,54,148,5,5,5,15,Champions
34639,3238,13,14,1,3,1,5,Casual Users
34893,3411,5,5,1,1,1,3,Lost
35162,5,75,505,5,5,5,15,Champions
35478,48,112,311,5,5,5,15,Champions
35504,43,68,361,5,5,5,15,Champions
35963,228,24,87,3,4,4,11,Loyal Users
36641,400,6,15,3,1,1,5,Casual Users
36674,84,45,88,4,4,4,12,Champions
37299,220,13,24,3,3,2,8,Loyal Users
37588,8,44,135,5,4,4,13,Champions
38173,40,55,72,5,5,4,14,Champions
38491,6,62,178,5,5,5,15,Champions
38706,2303,17,58,1,3,3,7,Casual Users
39093,654,5,12,2,1,1,4,Lost
39095,434,10,33,3,2,3,8,Casual Users
39143,233,5,10,3,1,1,5,Casual Users
39145,1546,11,17,1,2,2,5,Lost
39212,144,30,89,4,4,4,12,Champions
26474,3983,6,15,1,1,1,3,Lost
26904,2427,5,6,1,1,1,3,Lost
26944,288,38,71,3,4,4,11,Loyal Users
27105,125,62,294,4,5,5,14,Champions
27142,3000,5,8,1,1,1,3,Lost
27265,2567,6,13,1,1,1,3,Lost
27521,1352,16,28,1,3,2,6,Casual Users
27558,827,5,11,2,1,1,4,Lost
27834,7,6,8,5,1,1,7,Promising
28112,0,61,113,5,5,4,14,Champions
28157,286,50,123,3,5,4,12,Loyal Users
28234,828,5,5,2,1,1,4,Lost
28237,5,7,18,5,2,2,9,Promising
28503,54,50,129,5,5,4,14,Champions
30206,92,62,210,4,5,5,14,Champions
30419,2411,5,19,1,1,2,4,Lost
30588,29,31,75,5,4,4,13,Champions
30744,538,25,65,2,4,4,10,At Risk
31079,214,34,63,3,4,4,11,Loyal Users
31144,368,25,113,3,4,4,11,Loyal Users
31150,389,5,11,3,1,1,5,Casual Users
31235,1518,9,11,1,2,1,4,Lost
31406,15,87,168,5,5,5,15,Champions
31682,133,40,57,4,4,3,11,Loyal Users
32329,122,11,17,4,2,2,8,Promising
33383,149,8,42,4,2,3,9,Promising
33425,177,11,19,3,2,2,7,Casual Users
34293,63,59,129,5,5,4,14,Champions
34598,2291,6,12,1,1,1,3,Lost
34642,155,12,16,4,3,2,9,Loyal Users
34706,407,6,26,3,1,2,6,Casual Users
35024,131,15,64,4,3,4,11,Loyal Users
35174,457,142,483,3,5,5,13,Loyal Users
35330,2994,5,15,1,1,1,3,Lost
35402,103,6,25,4,1,2,7,Promising
35509,113,7,27,4,2,2,8,Promising
35786,78,24,140,4,4,4,12,Champions
35798,27,60,83,5,5,4,14,Champions
35864,155,20,31,4,3,2,9,Loyal Users
35945,56,27,77,5,4,4,13,Champions
35992,415,16,65,3,3,4,10,Loyal Users
36078,1810,7,15,1,2,1,4,Lost
36586,732,8,12,2,2,1,5,Lost
36734,14,124,244,5,5,5,15,Champions
36906,4538,10,41,1,2,3,6,Lost
36960,1807,13,24,1,3,2,6,Casual Users
36977,3014,8,8,1,2,1,4,Lost
37034,2,41,309,5,4,5,14,Champions
37107,2854,6,8,1,1,1,3,Lost
37609,2022,12,54,1,3,3,7,Casual Users
37675,105,11,32,4,2,3,9,Promising
37759,709,9,28,2,2,2,6,Lost
38279,63,61,253,5,5,5,15,Champions
38821,1770,12,20,1,3,2,6,Casual Users
39192,1815,6,14,1,1,1,3,Lost
26520,55,29,37,5,4,3,12,Loyal Users
26557,245,25,46,3,4,3,10,Loyal Users
26799,5816,5,34,1,1,3,5,Lost
26983,36,5,24,5,1,2,8,Promising
27041,33,8,9,5,2,1,8,Promising
27112,157,75,178,4,5,5,14,Champions
27226,2074,15,25,1,3,2,6,Casual Users
27295,251,50,81,3,5,4,12,Loyal Users
27378,29,17,42,5,3,3,11,Loyal Users
27585,1094,7,15,2,2,1,5,Lost
27734,88,28,66,4,4,4,12,Champions
27922,1189,5,9,2,1,1,4,Lost
27939,573,8,11,2,2,1,5,Lost
28036,2423,9,14,1,2,1,4,Lost
28099,138,5,13,4,1,1,6,Promising
28130,1863,6,13,1,1,1,3,Lost
28363,3850,12,12,1,3,1,5,Casual Users
28408,10,18,87,5,3,4,12,Loyal Users
28541,451,22,37,3,4,3,10,Loyal Users
29000,718,7,8,2,2,1,5,Lost
29462,676,26,64,2,4,4,10,At Risk
29570,2300,6,6,1,1,1,3,Lost
29722,1999,6,55,1,1,3,5,Lost
29737,274,42,97,3,4,4,11,Loyal Users
29745,248,26,130,3,4,4,11,Loyal Users
29873,2831,26,52,1,4,3,8,At Risk
29938,2131,7,11,1,2,1,4,Lost
29944,153,6,12,4,1,1,6,Promising
30000,704,5,7,2,1,1,4,Lost
30113,136,103,306,4,5,5,14,Champions
30144,87,6,32,4,1,3,8,Promising
30418,7,30,37,5,4,3,12,Loyal Users
30612,276,39,91,3,4,4,11,Loyal Users
30868,758,9,18,2,2,2,6,Lost
30992,6,13,13,5,3,1,9,Loyal Users
31008,272,7,9,3,2,1,6,Casual Users
31422,1644,11,38,1,2,3,6,Lost
31660,12,51,261,5,5,5,15,Champions
31722,295,5,12,3,1,1,5,Casual Users
31801,530,41,118,2,4,4,10,At Risk
31918,1001,7,32,2,2,3,7,Lost
31962,713,6,8,2,1,1,4,Lost
32536,2697,7,43,1,2,3,6,Lost
32570,55,48,160,5,5,5,15,Champions
32614,69,7,46,5,2,3,10,Promising
32853,380,24,33,3,4,3,10,Loyal Users
32980,29,51,218,5,5,5,15,Champions
33381,4,15,88,5,3,4,12,Loyal Users
33972,254,50,83,3,5,4,12,Loyal Users
34295,5272,5,11,1,1,1,3,Lost
34675,588,20,26,2,3,2,7,Casual Users
34795,845,26,92,2,4,4,10,At Risk
35675,211,8,83,3,2,4,9,Casual Users
35711,145,10,21,4,2,2,8,Promising
35928,1069,10,29,2,2,2,6,Lost
36114,11,59,113,5,5,4,14,Champions
36331,1433,6,11,1,1,1,3,Lost
36594,718,10,12,2,2,1,5,Lost
36668,1877,7,15,1,2,1,4,Lost
36727,626,14,57,2,3,3,8,Casual Users
36744,1077,7,7,2,2,1,5,Lost
36764,142,10,12,4,2,1,7,Promising
36984,45,41,72,5,4,4,13,Champions
37349,229,6,21,3,1,2,6,Casual Users
37622,2536,15,24,1,3,2,6,Casual Users
38227,450,41,99,3,4,4,11,Loyal Users
38291,19,27,584,5,4,5,14,Champions
38601,126,34,142,4,4,4,12,Champions
38663,562,8,27,2,2,2,6,Lost
38699,2518,19,29,1,3,2,6,Casual Users
38717,283,19,23,3,3,2,8,Loyal Users
38907,895,5,24,2,1,2,5,Lost
39135,215,6,14,3,1,1,5,Casual Users
39225,788,6,11,2,1,1,4,Lost
26554,1858,6,12,1,1,1,3,Lost
26565,118,53,130,4,5,4,13,Champions
26591,43,8,26,5,2,2,9,Promising
26840,246,5,6,3,1,1,5,Casual Users
26958,858,14,33,2,3,3,8,Casual Users
26976,4142,5,7,1,1,1,3,Lost
27007,574,36,71,2,4,4,10,At Risk
27379,2,24,55,5,4,3,12,Loyal Users
27477,1271,6,6,1,1,1,3,Lost
27667,2,167,380,5,5,5,15,Champions
27786,663,6,22,2,1,2,5,Lost
28015,388,118,381,3,5,5,13,Loyal Users
28075,864,51,155,2,5,5,12,At Risk
28255,2088,16,74,1,3,4,8,Casual Users
28712,2110,5,39,1,1,3,5,Lost
28760,1429,20,55,1,3,3,7,Casual Users
28814,119,85,259,4,5,5,14,Champions
28852,861,13,14,2,3,1,6,Casual Users
28916,128,23,39,4,4,3,11,Loyal Users
29052,3,88,465,5,5,5,15,Champions
29161,7,27,44,5,4,3,12,Loyal Users
29633,173,83,161,3,5,5,13,Loyal Users
29685,197,15,102,3,3,4,10,Loyal Users
30155,1109,21,125,2,3,4,9,Casual Users
30257,14,168,579,5,5,5,15,Champions
30269,119,19,27,4,3,2,9,Loyal Users
30552,129,7,9,4,2,1,7,Promising
30699,63,115,383,5,5,5,15,Champions
30832,90,93,295,4,5,5,14,Champions
31265,412,21,42,3,3,3,9,Loyal Users
31305,2540,47,96,1,5,4,10,At Risk
31734,1814,5,8,1,1,1,3,Lost
31795,535,11,28,2,2,2,6,Lost
31871,503,12,22,2,3,2,7,Casual Users
31959,3673,10,11,1,2,1,4,Lost
32145,31,47,127,5,5,4,14,Champions
32943,101,13,15,4,3,1,8,Loyal Users
32948,58,10,23,5,2,2,9,Promising
33050,1476,16,22,1,3,2,6,Casual Users
33055,83,13,114,4,3,4,11,Loyal Users
33116,22,46,102,5,5,4,14,Champions
33117,129,40,104,4,4,4,12,Champions
33283,110,78,150,4,5,5,14,Champions
33433,193,15,31,3,3,2,8,Loyal Users
33552,554,16,139,2,3,4,9,Casual Users
33560,11,57,228,5,5,5,15,Champions
33702,500,14,18,2,3,2,7,Casual Users
33730,107,30,147,4,4,5,13,Champions
33842,113,30,62,4,4,3,11,Loyal Users
33936,148,107,400,4,5,5,14,Champions
34047,585,29,88,2,4,4,10,At Risk
34148,17,138,208,5,5,5,15,Champions
34665,890,7,9,2,2,1,5,Lost
34764,339,63,198,3,5,5,13,Loyal Users
35040,93,12,33,4,3,3,10,Loyal Users
35128,293,7,7,3,2,1,6,Casual Users
35268,1127,7,29,2,2,2,6,Lost
35788,138,62,110,4,5,4,13,Champions
36120,745,12,77,2,3,4,9,Casual Users
36144,172,15,25,3,3,2,8,Loyal Users
36151,1011,12,19,2,3,2,7,Casual Users
36184,22,13,18,5,3,2,10,Loyal Users
36604,678,8,40,2,2,3,7,Lost
36687,1570,9,14,1,2,1,4,Lost
36721,1225,8,13,2,2,1,5,Lost
36903,2138,6,6,1,1,1,3,Lost
36980,39,85,260,5,5,5,15,Champions
36990,1773,16,49,1,3,3,7,Casual Users
37262,4538,16,19,1,3,2,6,Casual Users
37396,1575,6,8,1,1,1,3,Lost
37438,726,17,54,2,3,3,8,Casual Users
37684,157,10,16,4,2,2,8,Promising
37706,709,8,15,2,2,1,5,Lost
37902,2,9,23,5,2,2,9,Promising
37930,854,31,52,2,4,3,9,At Risk
38234,2250,13,18,1,3,2,6,Casual Users
38645,9,35,104,5,4,4,13,Champions
38803,60,75,756,5,5,5,15,Champions
38882,553,36,71,2,4,4,10,At Risk
38937,1746,8,8,1,2,1,4,Lost
38975,64,75,227,5,5,5,15,Champions
39213,1630,6,9,1,1,1,3,Lost
26481,198,20,26,3,3,2,8,Loyal Users
26846,1280,10,13,1,2,1,4,Lost
27108,2028,35,46,1,4,3,8,At Risk
27156,986,23,49,2,4,3,9,At Risk
27523,319,5,8,3,1,1,5,Casual Users
27600,230,8,25,3,2,2,7,Casual Users
27634,95,27,113,4,4,4,12,Champions
27746,154,34,82,4,4,4,12,Champions
27998,5584,8,8,1,2,1,4,Lost
28102,721,10,25,2,2,2,6,Lost
28487,101,13,21,4,3,2,9,Loyal Users
28596,247,25,46,3,4,3,10,Loyal Users
28610,419,11,114,3,2,4,9,Casual Users
28982,12,9,30,5,2,2,9,Promising
29069,1817,14,27,1,3,2,6,Casual Users
29095,56,35,68,5,4,4,13,Champions
29129,414,9,42,3,2,3,8,Casual Users
29382,855,12,21,2,3,2,7,Casual Users
29562,2258,5,33,1,1,3,5,Lost
29758,409,23,63,3,4,4,11,Loyal Users
30135,18,135,280,5,5,5,15,Champions
30278,69,31,118,5,4,4,13,Champions
30354,1888,8,74,1,2,4,7,Lost
30862,442,51,159,3,5,5,13,Loyal Users
30937,12,11,21,5,2,2,9,Promising
31252,232,21,36,3,3,3,9,Loyal Users
31493,29,97,235,5,5,5,15,Champions
31731,193,57,130,3,5,4,12,Loyal Users
31853,2115,8,31,1,2,2,5,Lost
32051,97,140,295,4,5,5,14,Champions
32192,159,63,277,4,5,5,14,Champions
32697,2604,8,18,1,2,2,5,Lost
32726,283,7,33,3,2,3,8,Casual Users
32839,293,57,224,3,5,5,13,Loyal Users
33399,90,66,108,4,5,4,13,Champions
33545,101,30,180,4,4,5,13,Champions
33563,977,22,33,2,4,3,9,At Risk
33604,11,38,123,5,4,4,13,Champions
33799,832,11,31,2,2,2,6,Lost
33995,1280,5,17,1,1,2,4,Lost
35207,1557,14,15,1,3,1,5,Casual Users
35467,709,5,5,2,1,1,4,Lost
35574,446,23,49,3,4,3,10,Loyal Users
36585,4715,10,31,1,2,2,5,Lost
36714,354,13,22,3,3,2,8,Loyal Users
37104,84,70,230,4,5,5,14,Champions
37155,279,27,109,3,4,4,11,Loyal Users
37538,3311,8,90,1,2,4,7,Lost
37582,235,43,90,3,4,4,11,Loyal Users
37765,963,6,11,2,1,1,4,Lost
37787,111,34,78,4,4,4,12,Champions
38165,1191,8,36,2,2,3,7,Lost
38444,90,10,75,4,2,4,10,Promising
38481,411,13,49,3,3,3,9,Loyal Users
38570,134,150,217,4,5,5,14,Champions
38697,272,13,16,3,3,2,8,Loyal Users
38734,1778,33,117,1,4,4,9,At Risk
39044,445,8,14,3,2,1,6,Casual Users
26701,1,20,25,5,3,2,10,Loyal Users
26720,3879,5,5,1,1,1,3,Lost
27238,225,159,357,3,5,5,13,Loyal Users
27264,2139,12,24,1,3,2,6,Casual Users
27309,110,5,16,4,1,2,7,Promising
27765,174,10,15,3,2,1,6,Casual Users
27872,249,56,130,3,5,4,12,Loyal Users
28031,2153,14,15,1,3,1,5,Casual Users
28361,133,16,29,4,3,2,9,Loyal Users
28741,2474,5,30,1,1,2,4,Lost
28813,31,51,323,5,5,5,15,Champions
28970,15,25,145,5,4,4,13,Champions
29242,351,5,35,3,1,3,7,Casual Users
29268,166,5,41,3,1,3,7,Casual Users
29308,856,19,36,2,3,3,8,Casual Users
29362,282,22,154,3,4,5,12,Loyal Users
29368,119,42,81,4,4,4,12,Champions
29419,844,5,14,2,1,1,4,Lost
30193,3299,7,31,1,2,2,5,Lost
30431,59,30,177,5,4,5,14,Champions
30495,140,59,259,4,5,5,14,Champions
30594,88,97,230,4,5,5,14,Champions
30692,430,7,46,3,2,3,8,Casual Users
31023,3452,18,18,1,3,2,6,Casual Users
31027,4585,8,9,1,2,1,4,Lost
31126,130,43,72,4,4,4,12,Champions
31225,538,28,59,2,4,3,9,At Risk
31291,2183,6,10,1,1,1,3,Lost
31395,856,28,40,2,4,3,9,At Risk
31468,410,15,68,3,3,4,10,Loyal Users
31482,3672,13,43,1,3,3,7,Casual Users
33003,2661,5,30,1,1,2,4,Lost
33083,153,7,10,4,2,1,7,Promising
33260,5,42,248,5,4,5,14,Champions
33483,406,10,24,3,2,2,7,Casual Users
33640,2618,24,34,1,4,3,8,At Risk
33697,616,11,34,2,2,3,7,Lost
33791,275,8,22,3,2,2,7,Casual Users
34407,722,20,68,2,3,4,9,Casual Users
34990,1281,16,54,1,3,3,7,Casual Users
35138,329,9,9,3,2,1,6,Casual Users
35233,2,130,374,5,5,5,15,Champions
35614,140,135,195,4,5,5,14,Champions
35948,3196,11,38,1,2,3,6,Lost
36220,886,5,6,2,1,1,4,Lost
36611,1,92,283,5,5,5,15,Champions
36620,432,25,96,3,4,4,11,Loyal Users
36717,4731,5,5,1,1,1,3,Lost
37193,315,13,24,3,3,2,8,Loyal Users
37638,277,13,31,3,3,2,8,Loyal Users
37710,4,101,222,5,5,5,15,Champions
37881,1259,24,52,1,4,3,8,At Risk
38007,430,11,65,3,2,4,9,Casual Users
38039,471,8,16,2,2,2,6,Lost
38123,2,66,505,5,5,5,15,Champions
38658,1531,7,72,1,2,4,7,Lost
39019,1,130,708,5,5,5,15,Champions
39026,129,29,61,4,4,3,11,Loyal Users
39231,561,44,206,2,4,5,11,At Risk
26586,65,103,298,5,5,5,15,Champions
26876,2348,7,26,1,2,2,5,Lost
27225,2475,13,39,1,3,3,7,Casual Users
27232,0,40,155,5,4,5,14,Champions
27240,306,32,54,3,4,3,10,Loyal Users
27242,3965,6,8,1,1,1,3,Lost
27512,2966,27,40,1,4,3,8,At Risk
27652,92,73,181,4,5,5,14,Champions
27787,2121,10,14,1,2,1,4,Lost
28749,102,6,27,4,1,2,7,Promising
28963,56,51,264,5,5,5,15,Champions
28980,80,9,39,4,2,3,9,Promising
29467,1849,10,40,1,2,3,6,Lost
29531,15,47,203,5,5,5,15,Champions
29716,425,9,13,3,2,1,6,Casual Users
30014,86,29,127,4,4,4,12,Champions
30036,416,19,54,3,3,3,9,Loyal Users
30165,24,86,277,5,5,5,15,Champions
30353,1262,19,28,1,3,2,6,Casual Users
31055,24,59,321,5,5,5,15,Champions
31168,40,7,29,5,2,2,9,Promising
31373,785,5,34,2,1,3,6,Lost
31410,625,20,176,2,3,5,10,Casual Users
31859,134,88,349,4,5,5,14,Champions
31927,3225,7,12,1,2,1,4,Lost
32149,254,12,19,3,3,2,8,Loyal Users
32881,386,10,24,3,2,2,7,Casual Users
32971,32,147,546,5,5,5,15,Champions
33311,1426,8,32,1,2,3,6,Lost
34331,102,68,186,4,5,5,14,Champions
34529,132,48,128,4,5,4,13,Champions
34772,209,32,58,3,4,3,10,Loyal Users
34788,326,37,72,3,4,4,11,Loyal Users
34895,123,18,28,4,3,2,9,Loyal Users
34964,428,8,53,3,2,3,8,Casual Users
35151,92,33,61,4,4,3,11,Loyal Users
35304,189,40,61,3,4,3,10,Loyal Users
35345,24,7,36,5,2,3,10,Promising
35352,746,34,58,2,4,3,9,At Risk
35366,115,25,37,4,4,3,11,Loyal Users
35592,8,10,16,5,2,2,9,Promising
35720,135,150,297,4,5,5,14,Champions
35763,2334,8,14,1,2,1,4,Lost
35970,1581,42,58,1,4,3,8,At Risk
36117,18,117,764,5,5,5,15,Champions
36685,424,72,168,3,5,5,13,Loyal Users
36958,995,5,5,2,1,1,4,Lost
37133,358,15,72,3,3,4,10,Loyal Users
37256,117,6,31,4,1,2,7,Promising
37916,3082,8,16,1,2,2,5,Lost
37979,5452,5,5,1,1,1,3,Lost
37996,112,36,65,4,4,4,12,Champions
38215,993,26,46,2,4,3,9,At Risk
38345,149,97,285,4,5,5,14,Champions
38873,4,42,128,5,4,4,13,Champions
39178,272,31,57,3,4,3,10,Loyal Users
26685,259,54,196,3,5,5,13,Loyal Users
27185,579,25,40,2,4,3,9,At Risk
27442,1,20,37,5,3,3,11,Loyal Users
28491,824,18,38,2,3,3,8,Casual Users
28609,367,118,287,3,5,5,13,Loyal Users
28925,46,39,90,5,4,4,13,Champions
28942,1416,7,36,1,2,3,6,Lost
28964,962,14,24,2,3,2,7,Casual Users
29237,65,56,475,5,5,5,15,Champions
29336,703,7,14,2,2,1,5,Lost
29400,633,10,30,2,2,2,6,Lost
29456,11,27,64,5,4,4,13,Champions
29542,912,6,14,2,1,1,4,Lost
29728,49,100,187,5,5,5,15,Champions
29820,426,22,82,3,4,4,11,Loyal Users
31353,25,41,210,5,4,5,14,Champions
31359,25,20,55,5,3,3,11,Loyal Users
31461,848,6,8,2,1,1,4,Lost
31739,1969,32,46,1,4,3,8,At Risk
31876,934,7,57,2,2,3,7,Lost
31914,420,55,134,3,5,4,12,Loyal Users
32131,568,18,75,2,3,4,9,Casual Users
32236,1589,5,5,1,1,1,3,Lost
32429,423,12,24,3,3,2,8,Loyal Users
32437,4403,5,16,1,1,2,4,Lost
32551,13,124,226,5,5,5,15,Champions
32630,251,6,13,3,1,1,5,Casual Users
32929,1435,8,21,1,2,2,5,Lost
33014,2317,16,33,1,3,3,7,Casual Users
33051,5,57,101,5,5,4,14,Champions
33059,29,17,69,5,3,4,12,Loyal Users
33340,1512,5,11,1,1,1,3,Lost
33368,265,15,40,3,3,3,9,Loyal Users
33497,262,6,16,3,1,2,6,Casual Users
33516,599,10,16,2,2,2,6,Lost
33827,824,55,166,2,5,5,12,At Risk
34241,587,5,20,2,1,2,5,Lost
34404,82,64,117,4,5,4,13,Champions
34545,87,36,87,4,4,4,12,Champions
34608,132,5,19,4,1,2,7,Promising
34709,190,10,15,3,2,1,6,Casual Users
34921,127,21,36,4,3,3,10,Loyal Users
35243,1615,13,64,1,3,4,8,Casual Users
36321,144,5,8,4,1,1,6,Promising
36361,10,21,29,5,3,2,10,Loyal Users
36568,157,26,96,4,4,4,12,Champions
36615,376,5,9,3,1,1,5,Casual Users
36825,2665,16,71,1,3,4,8,Casual Users
37085,2140,6,7,1,1,1,3,Lost
37123,3,30,92,5,4,4,13,Champions
37425,304,6,17,3,1,2,6,Casual Users
37685,2029,9,21,1,2,2,5,Lost
37967,1906,6,41,1,1,3,5,Lost
38252,5,74,145,5,5,4,14,Champions
38303,407,15,31,3,3,2,8,Loyal Users
38857,825,7,30,2,2,2,6,Lost
39144,82,30,89,4,4,4,12,Champions
26866,5418,8,41,1,2,3,6,Lost
27327,395,11,14,3,2,1,6,Casual Users
27380,1619,16,30,1,3,2,6,Casual Users
27542,1219,8,13,2,2,1,5,Lost
27704,2247,7,10,1,2,1,4,Lost
27799,378,16,30,3,3,2,8,Loyal Users
27908,744,5,67,2,1,4,7,Lost
27917,143,5,19,4,1,2,7,Promising
28030,667,8,10,2,2,1,5,Lost
28212,50,48,67,5,5,4,14,Champions
28262,4278,7,15,1,2,1,4,Lost
28636,453,7,8,3,2,1,6,Casual Users
28714,1601,14,33,1,3,3,7,Casual Users
29047,421,8,16,3,2,2,7,Casual Users
29174,2072,11,22,1,2,2,5,Lost
29676,3974,7,7,1,2,1,4,Lost
29954,1294,8,21,1,2,2,5,Lost
30008,322,9,11,3,2,1,6,Casual Users
30050,1122,32,83,2,4,4,10,At Risk
30145,114,20,51,4,3,3,10,Loyal Users
30462,1734,9,19,1,2,2,5,Lost
30577,259,10,11,3,2,1,6,Casual Users
30653,575,33,71,2,4,4,10,At Risk
30752,116,14,20,4,3,2,9,Loyal Users
31080,544,7,14,2,2,1,5,Lost
31167,422,10,13,3,2,1,6,Casual Users
31679,4548,7,22,1,2,2,5,Lost
31736,42,83,515,5,5,5,15,Champions
31768,95,16,40,4,3,3,10,Loyal Users
31818,176,52,91,3,5,4,12,Loyal Users
32142,393,38,74,3,4,4,11,Loyal Users
32184,422,5,29,3,1,2,6,Casual Users
33445,1,89,849,5,5,5,15,Champions
33581,2142,5,12,1,1,1,3,Lost
33636,166,13,29,3,3,2,8,Loyal Users
33670,1407,17,29,1,3,2,6,Casual Users
33927,3,21,25,5,3,2,10,Loyal Users
33934,120,104,370,4,5,5,14,Champions
34265,6,55,255,5,5,5,15,Champions
34640,132,25,89,4,4,4,12,Champions
35320,3032,5,5,1,1,1,3,Lost
35384,130,120,327,4,5,5,14,Champions
35498,23,35,72,5,4,4,13,Champions
35849,323,136,485,3,5,5,13,Loyal Users
36372,1845,14,27,1,3,2,6,Casual Users
36386,1673,10,24,1,2,2,5,Lost
36553,130,22,48,4,4,3,11,Loyal Users
36723,724,6,16,2,1,2,5,Lost
36845,140,44,143,4,4,4,12,Champions
37120,85,34,51,4,4,3,11,Loyal Users
37132,6,131,446,5,5,5,15,Champions
37149,968,14,27,2,3,2,7,Casual Users
37292,294,58,547,3,5,5,13,Loyal Users
37316,29,8,27,5,2,2,9,Promising
37421,365,18,40,3,3,3,9,Loyal Users
37571,566,10,52,2,2,3,7,Lost
37698,90,30,65,4,4,4,12,Champions
37978,2661,13,52,1,3,3,7,Casual Users
38136,831,14,46,2,3,3,8,Casual Users
38185,435,11,42,3,2,3,8,Casual Users
38284,181,32,85,3,4,4,11,Loyal Users
38294,3483,6,6,1,1,1,3,Lost
38800,391,37,55,3,4,3,10,Loyal Users
38843,372,29,128,3,4,4,11,Loyal Users
38846,112,9,12,4,2,1,7,Promising
38951,5645,9,22,1,2,2,5,Lost
39017,1092,16,54,2,3,3,8,Casual Users
39122,375,10,15,3,2,1,6,Casual Users
26660,284,13,28,3,3,2,8,Loyal Users
26663,218,15,26,3,3,2,8,Loyal Users
26977,382,6,14,3,1,1,5,Casual Users
27382,2051,13,19,1,3,2,6,Casual Users
27784,485,31,53,2,4,3,9,At Risk
28462,5626,8,30,1,2,2,5,Lost
28539,99,6,26,4,1,2,7,Promising
28704,162,29,73,4,4,4,12,Champions
29027,146,50,133,4,5,4,13,Champions
29377,1539,7,7,1,2,1,4,Lost
29681,112,50,136,4,5,4,13,Champions
29973,311,9,11,3,2,1,6,Casual Users
30097,312,31,49,3,4,3,10,Loyal Users
30131,1948,5,14,1,1,1,3,Lost
30605,813,8,35,2,2,3,7,Lost
30953,30,14,34,5,3,3,11,Loyal Users
31386,16,23,74,5,4,4,13,Champions
31813,16,11,18,5,2,2,9,Promising
32001,24,44,96,5,4,4,13,Champions
32042,50,82,397,5,5,5,15,Champions
32057,36,66,194,5,5,5,15,Champions
32147,99,14,29,4,3,2,9,Loyal Users
32219,549,7,15,2,2,1,5,Lost
32245,11,5,8,5,1,1,7,Promising
32319,191,17,18,3,3,2,8,Loyal Users
32346,356,29,39,3,4,3,10,Loyal Users
32847,1367,10,18,1,2,2,5,Lost
32889,28,7,9,5,2,1,8,Promising
32905,245,7,9,3,2,1,6,Casual Users
32969,1450,5,5,1,1,1,3,Lost
33072,374,15,20,3,3,2,8,Loyal Users
33347,171,44,196,3,4,5,12,Loyal Users
33892,238,14,19,3,3,2,8,Loyal Users
34243,169,107,215,3,5,5,13,Loyal Users
34555,307,8,11,3,2,1,6,Casual Users
34969,784,12,20,2,3,2,7,Casual Users
35224,4291,8,16,1,2,2,5,Lost
35403,350,51,103,3,5,4,12,Loyal Users
35608,1013,7,30,2,2,2,6,Lost
35741,12,8,10,5,2,1,8,Promising
36260,4069,9,10,1,2,1,4,Lost
36401,957,26,35,2,4,3,9,At Risk
36503,109,7,8,4,2,1,7,Promising
36530,95,79,127,4,5,4,13,Champions
37083,2501,6,26,1,1,2,4,Lost
37417,57,10,64,5,2,4,11,Promising
37616,26,11,43,5,2,3,10,Promising
37837,134,16,86,4,3,4,11,Loyal Users
37896,257,8,17,3,2,2,7,Casual Users
38042,1620,5,15,1,1,1,3,Lost
38373,1540,6,29,1,1,2,4,Lost
38893,2,115,305,5,5,5,15,Champions
39011,94,90,389,4,5,5,14,Champions
39022,568,26,120,2,4,4,10,At Risk
39054,441,14,17,3,3,2,8,Loyal Users
39085,403,6,10,3,1,1,5,Casual Users
26578,868,9,14,2,2,1,5,Lost
26703,126,7,7,4,2,1,7,Promising
26768,11,56,362,5,5,5,15,Champions
27428,3,64,292,5,5,5,15,Champions
28227,40,94,777,5,5,5,15,Champions
28962,146,12,51,4,3,3,10,Loyal Users
29051,1999,124,399,1,5,5,11,At Risk
29275,5,7,31,5,2,2,9,Promising
29408,15,39,57,5,4,3,12,Loyal Users
29741,238,64,86,3,5,4,12,Loyal Users
29899,1160,28,31,2,4,2,8,At Risk
29923,1692,13,51,1,3,3,7,Casual Users
30259,2277,10,25,1,2,2,5,Lost
30315,872,21,100,2,3,4,9,Casual Users
30563,962,54,207,2,5,5,12,At Risk
30631,265,41,58,3,4,3,10,Loyal Users
31208,87,128,322,4,5,5,14,Champions
31479,33,60,703,5,5,5,15,Champions
31525,182,27,44,3,4,3,10,Loyal Users
31627,424,6,12,3,1,1,5,Casual Users
31948,3958,34,90,1,4,4,9,At Risk
32522,1419,17,85,1,3,4,8,Casual Users
32818,172,50,213,3,5,5,13,Loyal Users
32851,114,13,53,4,3,3,10,Loyal Users
32869,141,7,20,4,2,2,8,Promising
33140,379,41,68,3,4,4,11,Loyal Users
33281,853,8,12,2,2,1,5,Lost
33451,2453,6,8,1,1,1,3,Lost
33631,593,58,305,2,5,5,12,At Risk
33923,250,5,31,3,1,2,6,Casual Users
34046,225,28,62,3,4,3,10,Loyal Users
34056,7,135,288,5,5,5,15,Champions
34225,1671,18,41,1,3,3,7,Casual Users
34793,17,73,291,5,5,5,15,Champions
34862,50,6,9,5,1,1,7,Promising
34952,695,17,20,2,3,2,7,Casual Users
34961,17,67,115,5,5,4,14,Champions
35085,12,78,532,5,5,5,15,Champions
35110,1483,42,150,1,4,5,10,At Risk
35540,965,20,50,2,3,3,8,Casual Users
35747,15,61,230,5,5,5,15,Champions
36038,3,123,569,5,5,5,15,Champions
36346,710,13,23,2,3,2,7,Casual Users
36651,1173,11,44,2,2,3,7,Lost
36739,2,113,608,5,5,5,15,Champions
36805,77,77,223,4,5,5,14,Champions
36947,948,6,11,2,1,1,4,Lost
37178,3949,14,26,1,3,2,6,Casual Users
37179,373,8,12,3,2,1,6,Casual Users
37198,1876,15,29,1,3,2,6,Casual Users
37422,875,19,36,2,3,3,8,Casual Users
37983,694,5,13,2,1,1,4,Lost
38512,327,6,10,3,1,1,5,Casual Users
38666,834,26,52,2,4,3,9,At Risk
38885,3441,18,24,1,3,2,6,Casual Users
38912,1096,23,50,2,4,3,9,At Risk
38969,2097,11,21,1,2,2,5,Lost
27065,30,16,102,5,3,4,12,Loyal Users
27308,1695,5,26,1,1,2,4,Lost
27984,3862,9,44,1,2,3,6,Lost
28093,134,8,20,4,2,2,8,Promising
28420,12,11,58,5,2,3,10,Promising
28627,1355,7,20,1,2,2,5,Lost
29070,216,32,71,3,4,4,11,Loyal Users
29552,142,126,283,4,5,5,14,Champions
29670,424,7,13,3,2,1,6,Casual Users
29840,520,12,12,2,3,1,6,Casual Users
29841,6,24,120,5,4,4,13,Champions
29917,117,47,88,4,5,4,13,Champions
30357,299,55,149,3,5,5,13,Loyal Users
30455,151,101,155,4,5,5,14,Champions
30927,81,84,204,4,5,5,14,Champions
31063,1627,32,53,1,4,3,8,At Risk
31088,546,19,31,2,3,2,7,Casual Users
31558,822,35,93,2,4,4,10,At Risk
31615,569,6,13,2,1,1,4,Lost
31667,276,77,107,3,5,4,12,Loyal Users
31784,37,132,275,5,5,5,15,Champions
32218,104,55,110,4,5,4,13,Champions
32362,125,51,160,4,5,5,14,Champions
32553,603,8,21,2,2,2,6,Lost
32580,2349,44,91,1,4,4,9,At Risk
32657,9,35,73,5,4,4,13,Champions
32707,16,15,16,5,3,2,10,Loyal Users
33123,5192,5,12,1,1,1,3,Lost
33739,88,8,15,4,2,1,7,Promising
33797,584,7,59,2,2,3,7,Lost
33831,343,14,32,3,3,3,9,Loyal Users
34107,915,15,89,2,3,4,9,Casual Users
34217,8,79,424,5,5,5,15,Champions
34425,120,8,34,4,2,3,9,Promising
34476,26,75,341,5,5,5,15,Champions
35078,1434,7,32,1,2,3,6,Lost
35218,501,15,31,2,3,2,7,Casual Users
35318,871,19,44,2,3,3,8,Casual Users
35471,118,7,18,4,2,2,8,Promising
35688,12,99,367,5,5,5,15,Champions
35736,1418,6,29,1,1,2,4,Lost
35886,426,44,104,3,4,4,11,Loyal Users
35909,9,15,82,5,3,4,12,Loyal Users
36127,2643,9,14,1,2,1,4,Lost
36333,74,125,236,4,5,5,14,Champions
36358,3877,12,27,1,3,2,6,Casual Users
36522,2671,9,16,1,2,2,5,Lost
36564,2413,6,7,1,1,1,3,Lost
36577,575,6,9,2,1,1,4,Lost
36646,10,44,141,5,4,4,13,Champions
36770,79,26,46,4,4,3,11,Loyal Users
37041,227,26,68,3,4,4,11,Loyal Users
37554,2448,5,5,1,1,1,3,Lost
37671,86,55,205,4,5,5,14,Champions
37714,122,5,7,4,1,1,6,Promising
38151,5460,5,9,1,1,1,3,Lost
38272,1670,5,44,1,1,3,5,Lost
38276,139,61,144,4,5,4,13,Champions
38472,12,23,56,5,4,3,12,Loyal Users
38509,526,15,28,2,3,2,7,Casual Users
38602,114,165,463,4,5,5,14,Champions
38632,103,44,114,4,4,4,12,Champions
38739,2364,5,46,1,1,3,5,Lost
38790,804,8,13,2,2,1,5,Lost
38828,129,19,33,4,3,3,10,Loyal Users
38923,274,92,172,3,5,5,13,Loyal Users
26726,2418,9,9,1,2,1,4,Lost
26967,149,7,11,4,2,1,7,Promising
27252,78,62,136,4,5,4,13,Champions
27281,70,112,339,4,5,5,14,Champions
27996,373,31,48,3,4,3,10,Loyal Users
28336,406,32,90,3,4,4,11,Loyal Users
28477,761,8,17,2,2,2,6,Lost
28709,391,32,37,3,4,3,10,Loyal Users
28969,1269,11,14,1,2,1,4,Lost
29252,1921,14,19,1,3,2,6,Casual Users
29273,429,18,47,3,3,3,9,Loyal Users
29281,505,7,10,2,2,1,5,Lost
29571,2704,13,14,1,3,1,5,Casual Users
29623,677,6,59,2,1,3,6,Lost
30428,2396,13,35,1,3,3,7,Casual Users
30762,619,20,48,2,3,3,8,Casual Users
30831,370,22,32,3,4,3,10,Loyal Users
31024,252,5,21,3,1,2,6,Casual Users
31146,493,27,66,2,4,4,10,At Risk
31481,257,27,105,3,4,4,11,Loyal Users
31808,1717,6,11,1,1,1,3,Lost
31934,7,119,242,5,5,5,15,Champions
31958,1555,33,56,1,4,3,8,At Risk
32056,35,8,11,5,2,1,8,Promising
32121,2896,5,12,1,1,1,3,Lost
32320,1715,8,8,1,2,1,4,Lost
32452,25,55,182,5,5,5,15,Champions
32455,672,10,30,2,2,2,6,Lost
32534,81,113,376,4,5,5,14,Champions
32573,677,27,63,2,4,4,10,At Risk
32686,454,6,43,3,1,3,7,Casual Users
32823,805,35,147,2,4,5,11,At Risk
32863,21,58,106,5,5,4,14,Champions
32942,156,18,27,4,3,2,9,Loyal Users
34059,668,5,6,2,1,1,4,Lost
34075,306,15,26,3,3,2,8,Loyal Users
34304,269,52,61,3,5,3,11,Loyal Users
34612,67,64,123,5,5,4,14,Champions
34752,2650,6,9,1,1,1,3,Lost
34891,33,27,75,5,4,4,13,Champions
35254,92,24,46,4,4,3,11,Loyal Users
35263,6,98,231,5,5,5,15,Champions
35290,0,14,22,5,3,2,10,Loyal Users
35291,409,18,48,3,3,3,9,Loyal Users
35411,295,42,155,3,4,5,12,Loyal Users
35804,154,20,169,4,3,5,12,Loyal Users
36123,9,5,17,5,1,2,8,Promising
36697,236,54,105,3,5,4,12,Loyal Users
36941,5,75,295,5,5,5,15,Champions
37001,7,157,795,5,5,5,15,Champions
37144,243,74,131,3,5,4,12,Loyal Users
37184,75,16,76,4,3,4,11,Loyal Users
37583,11,243,400,5,5,5,15,Champions
37627,14,84,420,5,5,5,15,Champions
37722,2719,5,24,1,1,2,4,Lost
38066,600,11,14,2,2,1,5,Lost
38935,1424,5,6,1,1,1,3,Lost
38999,727,50,176,2,5,5,12,At Risk
39078,38,21,138,5,3,4,12,Loyal Users
39175,4442,9,15,1,2,1,4,Lost
26579,1543,7,13,1,2,1,4,Lost
26584,147,57,92,4,5,4,13,Champions
27835,113,9,10,4,2,1,7,Promising
27871,203,66,154,3,5,5,13,Loyal Users
28160,374,36,99,3,4,4,11,Loyal Users
28241,1190,26,105,2,4,4,10,At Risk
28501,1675,7,8,1,2,1,4,Lost
29213,15,23,41,5,4,3,12,Loyal Users
29309,12,65,186,5,5,5,15,Champions
29742,33,12,29,5,3,2,10,Loyal Users
30060,297,51,208,3,5,5,13,Loyal Users
30143,288,59,109,3,5,4,12,Loyal Users
30413,420,13,21,3,3,2,8,Loyal Users
30877,106,22,35,4,4,3,11,Loyal Users
30917,574,10,14,2,2,1,5,Lost
32175,256,11,18,3,2,2,7,Casual Users
32251,2288,5,12,1,1,1,3,Lost
32693,58,54,106,5,5,4,14,Champions
32829,1850,11,56,1,2,3,6,Lost
33033,2439,9,41,1,2,3,6,Lost
33291,433,15,19,3,3,2,8,Loyal Users
33298,483,28,175,2,4,5,11,At Risk
33329,410,76,112,3,5,4,12,Loyal Users
33355,458,40,108,3,4,4,11,Loyal Users
33898,1720,14,23,1,3,2,6,Casual Users
33900,1812,15,26,1,3,2,6,Casual Users
33981,543,51,232,2,5,5,12,At Risk
34117,9,50,150,5,5,5,15,Champions
34207,1427,14,25,1,3,2,6,Casual Users
34313,691,5,26,2,1,2,5,Lost
34503,311,14,29,3,3,2,8,Loyal Users
34791,1168,5,33,2,1,3,6,Lost
35129,334,9,11,3,2,1,6,Casual Users
35406,5,7,35,5,2,3,10,Promising
35915,1027,30,43,2,4,3,9,At Risk
36161,1384,5,35,1,1,3,5,Lost
36213,3,115,247,5,5,5,15,Champions
36704,1188,7,8,2,2,1,5,Lost
36747,295,18,29,3,3,2,8,Loyal Users
36995,701,25,128,2,4,4,10,At Risk
37213,394,8,20,3,2,2,7,Casual Users
37377,256,13,19,3,3,2,8,Loyal Users
37488,1800,7,11,1,2,1,4,Lost
37852,105,17,73,4,3,4,11,Loyal Users
37879,1692,10,29,1,2,2,5,Lost
38036,2422,9,31,1,2,2,5,Lost
38606,257,14,56,3,3,3,9,Loyal Users
38929,918,7,21,2,2,2,6,Lost
26668,112,84,264,4,5,5,14,Champions
26684,15,31,39,5,4,3,12,Loyal Users
26998,9,77,217,5,5,5,15,Champions
27189,531,30,129,2,4,4,10,At Risk
27490,384,22,51,3,4,3,10,Loyal Users
27653,2836,19,59,1,3,3,7,Casual Users
27969,171,12,20,3,3,2,8,Loyal Users
27991,6,100,270,5,5,5,15,Champions
28103,599,39,88,2,4,4,10,At Risk
28200,118,9,22,4,2,2,8,Promising
28232,231,7,34,3,2,3,8,Casual Users
28243,6,60,200,5,5,5,15,Champions
28350,942,17,59,2,3,3,8,Casual Users
28532,4597,5,17,1,1,2,4,Lost
29582,247,34,105,3,4,4,11,Loyal Users
29632,246,5,8,3,1,1,5,Casual Users
29635,47,65,270,5,5,5,15,Champions
29784,2414,7,9,1,2,1,4,Lost
29890,473,14,65,2,3,4,9,Casual Users
30232,10,33,71,5,4,4,13,Champions
30458,3269,8,12,1,2,1,4,Lost
30534,581,39,85,2,4,4,10,At Risk
30549,548,23,44,2,4,3,9,At Risk
30559,4423,5,18,1,1,2,4,Lost
30969,233,23,96,3,4,4,11,Loyal Users
31029,204,42,99,3,4,4,11,Loyal Users
31510,206,26,38,3,4,3,10,Loyal Users
31538,193,54,84,3,5,4,12,Loyal Users
31735,526,37,81,2,4,4,10,At Risk
31791,1467,7,37,1,2,3,6,Lost
32062,5,95,269,5,5,5,15,Champions
32134,39,12,27,5,3,2,10,Loyal Users
32220,2087,6,6,1,1,1,3,Lost
32517,359,9,142,3,2,4,9,Casual Users
33065,407,56,133,3,5,4,12,Loyal Users
33137,637,24,60,2,4,3,9,At Risk
33175,5,60,153,5,5,5,15,Champions
33187,4123,10,10,1,2,1,4,Lost
33212,101,61,404,4,5,5,14,Champions
33426,938,5,17,2,1,2,5,Lost
33611,266,13,14,3,3,1,7,Loyal Users
33682,547,38,147,2,4,5,11,At Risk
33729,259,21,48,3,3,3,9,Loyal Users
34014,1812,6,9,1,1,1,3,Lost
34030,23,106,301,5,5,5,15,Champions
34131,179,12,22,3,3,2,8,Loyal Users
34212,422,9,23,3,2,2,7,Casual Users
34487,16,136,297,5,5,5,15,Champions
34539,1108,5,5,2,1,1,4,Lost
34589,107,47,240,4,5,5,14,Champions
34749,87,9,29,4,2,2,8,Promising
34835,608,59,342,2,5,5,12,At Risk
35003,1023,70,288,2,5,5,12,At Risk
35239,53,22,65,5,4,4,13,Champions
35437,124,19,105,4,3,4,11,Loyal Users
35652,1129,17,28,2,3,2,7,Casual Users
35672,91,11,38,4,2,3,9,Promising
35725,30,59,159,5,5,5,15,Champions
35986,156,85,555,4,5,5,14,Champions
36009,399,12,18,3,3,2,8,Loyal Users
36035,128,33,106,4,4,4,12,Champions
36420,1732,12,25,1,3,2,6,Casual Users
36983,283,7,9,3,2,1,6,Casual Users
37331,153,147,409,4,5,5,14,Champions
37351,3150,22,88,1,4,4,9,At Risk
37666,1094,13,21,2,3,2,7,Casual Users
37691,5,98,373,5,5,5,15,Champions
37822,531,10,20,2,2,2,6,Lost
38102,2568,6,6,1,1,1,3,Lost
38105,2129,23,41,1,4,3,8,At Risk
38834,691,80,106,2,5,4,11,At Risk
26506,935,6,14,2,1,1,4,Lost
26727,37,19,103,5,3,4,12,Loyal Users
26810,2591,7,22,1,2,2,5,Lost
27099,1121,15,110,2,3,4,9,Casual Users
27259,93,5,10,4,1,1,6,Promising
27406,1663,6,15,1,1,1,3,Lost
27522,3172,6,15,1,1,1,3,Lost
27651,1146,10,14,2,2,1,5,Lost
28069,412,5,5,3,1,1,5,Casual Users
28132,74,31,67,4,4,4,12,Champions
28163,415,10,11,3,2,1,6,Casual Users
28217,4411,5,8,1,1,1,3,Lost
28219,732,8,20,2,2,2,6,Lost
28294,170,20,28,3,3,2,8,Loyal Users
28566,19,50,100,5,5,4,14,Champions
28710,534,5,17,2,1,2,5,Lost
28933,414,7,22,3,2,2,7,Casual Users
29041,1646,5,16,1,1,2,4,Lost
29439,1820,7,53,1,2,3,6,Lost
29550,1705,13,39,1,3,3,7,Casual Users
29592,129,19,21,4,3,2,9,Loyal Users
29826,110,40,129,4,4,4,12,Champions
29961,1173,12,12,2,3,1,6,Casual Users
30033,3,64,108,5,5,4,14,Champions
30263,343,9,14,3,2,1,6,Casual Users
30407,871,13,35,2,3,3,8,Casual Users
30918,384,44,338,3,4,5,12,Loyal Users
30983,17,5,47,5,1,3,9,Promising
31453,1490,7,17,1,2,2,5,Lost
31502,243,28,110,3,4,4,11,Loyal Users
31514,442,34,48,3,4,3,10,Loyal Users
31552,2410,13,22,1,3,2,6,Casual Users
31568,405,9,70,3,2,4,9,Casual Users
31589,383,35,44,3,4,3,10,Loyal Users
31618,976,39,176,2,4,5,11,At Risk
32705,117,25,43,4,4,3,11,Loyal Users
32745,695,5,15,2,1,1,4,Lost
32954,1407,11,16,1,2,2,5,Lost
33317,117,60,103,4,5,4,13,Champions
33469,295,31,59,3,4,3,10,Loyal Users
34032,3460,5,17,1,1,2,4,Lost
34037,3951,7,13,1,2,1,4,Lost
34171,149,48,503,4,5,5,14,Champions
34256,133,67,181,4,5,5,14,Champions
34316,133,54,293,4,5,5,14,Champions
34479,54,105,294,5,5,5,15,Champions
34586,61,94,357,5,5,5,15,Champions
35431,144,28,77,4,4,4,12,Champions
35627,275,20,94,3,3,4,10,Loyal Users
35643,75,14,53,4,3,3,10,Loyal Users
35691,3011,6,15,1,1,1,3,Lost
36034,1290,12,14,1,3,1,5,Casual Users
36239,586,12,20,2,3,2,7,Casual Users
36810,135,22,83,4,4,4,12,Champions
36997,127,8,24,4,2,2,8,Promising
37181,573,8,20,2,2,2,6,Lost
37301,3489,7,29,1,2,2,5,Lost
37557,144,38,72,4,4,4,12,Champions
38166,6076,5,5,1,1,1,3,Lost
38278,127,83,289,4,5,5,14,Champions
38863,5892,5,25,1,1,2,4,Lost
38973,2769,6,16,1,1,2,4,Lost
39195,20,56,178,5,5,5,15,Champions
26607,118,46,236,4,5,5,14,Champions
27126,2,72,117,5,5,4,14,Champions
27399,2129,7,22,1,2,2,5,Lost
27429,417,26,214,3,4,5,12,Loyal Users
27948,12,75,154,5,5,5,15,Champions
28414,1123,5,17,2,1,2,5,Lost
28438,282,36,83,3,4,4,11,Loyal Users
28482,249,39,164,3,4,5,12,Loyal Users
29266,280,20,28,3,3,2,8,Loyal Users
29334,1505,10,23,1,2,2,5,Lost
29440,291,16,153,3,3,5,11,Loyal Users
29451,310,5,9,3,1,1,5,Casual Users
29852,121,18,36,4,3,3,10,Loyal Users
29991,92,18,124,4,3,4,11,Loyal Users
30524,68,6,6,5,1,1,7,Promising
31231,24,62,404,5,5,5,15,Champions
31439,502,29,173,2,4,5,11,At Risk
31728,4170,6,13,1,1,1,3,Lost
31733,824,12,36,2,3,3,8,Casual Users
31857,694,8,10,2,2,1,5,Lost
31950,0,83,469,5,5,5,15,Champions
32231,6,30,108,5,4,4,13,Champions
32274,305,44,91,3,4,4,11,Loyal Users
32398,96,14,18,4,3,2,9,Loyal Users
32520,309,32,37,3,4,3,10,Loyal Users
32588,203,5,26,3,1,2,6,Casual Users
32589,5699,10,20,1,2,2,5,Lost
32595,7,128,485,5,5,5,15,Champions
32752,486,44,63,2,4,4,10,At Risk
33228,280,12,35,3,3,3,9,Loyal Users
33677,3,105,256,5,5,5,15,Champions
33903,2523,5,6,1,1,1,3,Lost
34140,1440,9,14,1,2,1,4,Lost
34153,3706,6,16,1,1,2,4,Lost
34172,107,17,48,4,3,3,10,Loyal Users
34236,903,10,11,2,2,1,5,Lost
34445,940,36,89,2,4,4,10,At Risk
34491,1643,9,20,1,2,2,5,Lost
34567,270,58,229,3,5,5,13,Loyal Users
34744,1,59,207,5,5,5,15,Champions
34827,237,13,70,3,3,4,10,Loyal Users
34973,153,6,9,4,1,1,6,Promising
35053,2011,6,36,1,1,3,5,Lost
35247,34,89,161,5,5,5,15,Champions
35385,19,49,211,5,5,5,15,Champions
35443,160,14,83,4,3,4,11,Loyal Users
35936,2401,16,31,1,3,2,6,Casual Users
36396,169,8,14,3,2,1,6,Casual Users
37314,1403,8,13,1,2,1,4,Lost
37614,410,21,190,3,3,5,11,Loyal Users
37626,1537,13,28,1,3,2,6,Casual Users
37648,540,26,60,2,4,3,9,At Risk
37681,1536,9,52,1,2,3,6,Lost
37871,79,73,251,4,5,5,14,Champions
38484,119,12,28,4,3,2,9,Loyal Users
38557,1674,14,16,1,3,2,6,Casual Users
38593,1463,19,39,1,3,3,7,Casual Users
38635,2224,13,32,1,3,3,7,Casual Users
38661,193,6,7,3,1,1,5,Casual Users
38760,1696,10,31,1,2,2,5,Lost
26473,18,92,177,5,5,5,15,Champions
26675,1141,6,7,2,1,1,4,Lost
26721,4780,8,8,1,2,1,4,Lost
26912,91,38,74,4,4,4,12,Champions
27452,537,8,44,2,2,3,7,Lost
27509,6,51,145,5,5,4,14,Champions
27552,3128,8,12,1,2,1,4,Lost
27728,245,12,27,3,3,2,8,Loyal Users
27743,275,111,264,3,5,5,13,Loyal Users
28198,5,52,133,5,5,4,14,Champions
28911,1832,8,11,1,2,1,4,Lost
29113,445,69,218,3,5,5,13,Loyal Users
29335,153,10,27,4,2,2,8,Promising
30469,65,80,135,5,5,4,14,Champions
30583,2508,7,9,1,2,1,4,Lost
30938,1123,5,30,2,1,2,5,Lost
31541,428,9,17,3,2,2,7,Casual Users
31579,101,27,80,4,4,4,12,Champions
31602,71,63,135,4,5,4,13,Champions
31681,37,15,30,5,3,2,10,Loyal Users
31785,305,17,36,3,3,3,9,Loyal Users
31904,109,79,155,4,5,5,14,Champions
31906,1096,5,9,2,1,1,4,Lost
32225,611,14,20,2,3,2,7,Casual Users
32772,403,9,12,3,2,1,6,Casual Users
33021,3481,10,13,1,2,1,4,Lost
33448,1122,6,10,2,1,1,4,Lost
33549,440,11,30,3,2,2,7,Casual Users
33641,1542,10,22,1,2,2,5,Lost
33840,2948,5,6,1,1,1,3,Lost
33988,236,6,10,3,1,1,5,Casual Users
34050,287,14,32,3,3,3,9,Loyal Users
34095,57,18,22,5,3,2,10,Loyal Users
34129,16,52,155,5,5,5,15,Champions
34543,82,188,301,4,5,5,14,Champions
35092,4423,7,13,1,2,1,4,Lost
35177,342,16,16,3,3,2,8,Loyal Users
35312,2577,5,14,1,1,1,3,Lost
35977,1617,33,56,1,4,3,8,At Risk
36012,40,160,722,5,5,5,15,Champions
36039,16,142,298,5,5,5,15,Champions
36080,67,74,98,5,5,4,14,Champions
36181,1276,12,71,1,3,4,8,Casual Users
37031,2614,6,8,1,1,1,3,Lost
37145,154,54,121,4,5,4,13,Champions
37245,2427,5,29,1,1,2,4,Lost
37724,127,5,14,4,1,1,6,Promising
38032,2048,20,32,1,3,3,7,Casual Users
38088,1580,9,20,1,2,2,5,Lost
38944,1407,19,48,1,3,3,7,Casual Users
39029,5102,22,83,1,4,4,9,At Risk
26886,12,48,95,5,5,4,14,Champions
27199,1128,6,7,2,1,1,4,Lost
27267,769,7,16,2,2,2,6,Lost
27286,9,89,393,5,5,5,15,Champions
27403,47,6,7,5,1,1,7,Promising
27407,114,8,16,4,2,2,8,Promising
27503,120,35,119,4,4,4,12,Champions
27518,408,8,12,3,2,1,6,Casual Users
28481,94,107,218,4,5,5,14,Champions
28537,2483,5,8,1,1,1,3,Lost
28556,474,35,98,2,4,4,10,At Risk
28582,2417,23,61,1,4,3,8,At Risk
29029,332,32,59,3,4,3,10,Loyal Users
29224,590,15,34,2,3,3,8,Casual Users
29235,1933,7,7,1,2,1,4,Lost
29743,102,55,131,4,5,4,13,Champions
29907,68,9,29,5,2,2,9,Promising
30228,553,8,16,2,2,2,6,Lost
30313,115,46,87,4,5,4,13,Champions
30542,144,79,266,4,5,5,14,Champions
30700,13,27,44,5,4,3,12,Loyal Users
30816,113,54,110,4,5,4,13,Champions
30878,19,15,24,5,3,2,10,Loyal Users
31072,837,26,36,2,4,3,9,At Risk
31372,66,38,158,5,4,5,14,Champions
31394,50,122,403,5,5,5,15,Champions
31511,83,35,52,4,4,3,11,Loyal Users
31621,118,19,40,4,3,3,10,Loyal Users
31824,101,51,95,4,5,4,13,Champions
32080,76,56,239,4,5,5,14,Champions
32426,3560,7,22,1,2,2,5,Lost
32661,90,201,557,4,5,5,14,Champions
32817,2446,7,49,1,2,3,6,Lost
33032,440,6,7,3,1,1,5,Casual Users
33292,255,34,119,3,4,4,11,Loyal Users
33387,28,32,112,5,4,4,13,Champions
33405,250,7,8,3,2,1,6,Casual Users
33466,72,50,292,4,5,5,14,Champions
33745,700,11,21,2,2,2,6,Lost
33885,507,35,55,2,4,3,9,At Risk
33951,78,41,63,4,4,4,12,Champions
33986,3156,11,18,1,2,2,5,Lost
36092,94,53,203,4,5,5,14,Champions
36186,4849,7,36,1,2,3,6,Lost
36253,26,29,183,5,4,5,14,Champions
36302,1144,14,90,2,3,4,9,Casual Users
36682,56,20,86,5,3,4,12,Loyal Users
36923,1341,7,23,1,2,2,5,Lost
37000,592,14,36,2,3,3,8,Casual Users
37009,4961,14,46,1,3,3,7,Casual Users
37075,110,15,94,4,3,4,11,Loyal Users
37281,944,11,17,2,2,2,6,Lost
37447,2488,17,28,1,3,2,6,Casual Users
37853,110,22,66,4,4,4,12,Champions
37908,272,7,10,3,2,1,6,Casual Users
38208,851,11,37,2,2,3,7,Lost
38539,671,7,29,2,2,2,6,Lost
38552,1828,21,39,1,3,3,7,Casual Users
38638,1145,9,20,2,2,2,6,Lost
38642,535,9,12,2,2,1,5,Lost
38919,2,67,134,5,5,4,14,Champions
39014,658,22,70,2,4,4,10,At Risk
39094,1664,5,11,1,1,1,3,Lost
26594,138,110,358,4,5,5,14,Champions
26879,34,14,38,5,3,3,11,Loyal Users
26991,31,35,112,5,4,4,13,Champions
27044,0,9,15,5,2,1,8,Promising
27171,3098,6,7,1,1,1,3,Lost
27246,124,33,127,4,4,4,12,Champions
27277,2234,5,6,1,1,1,3,Lost
27339,237,6,41,3,1,3,7,Casual Users
27498,572,10,20,2,2,2,6,Lost
28087,430,10,15,3,2,1,6,Casual Users
28387,462,5,26,3,1,2,6,Casual Users
28500,4,93,222,5,5,5,15,Champions
28850,57,90,189,5,5,5,15,Champions
28882,567,12,77,2,3,4,9,Casual Users
29159,290,24,70,3,4,4,11,Loyal Users
29215,1118,17,37,2,3,3,8,Casual Users
29287,352,35,84,3,4,4,11,Loyal Users
29751,110,135,401,4,5,5,14,Champions
30298,692,5,9,2,1,1,4,Lost
30433,422,6,10,3,1,1,5,Casual Users
30735,2322,7,8,1,2,1,4,Lost
30884,409,15,17,3,3,2,8,Loyal Users
30902,1086,6,9,2,1,1,4,Lost
30971,106,41,96,4,4,4,12,Champions
31004,403,7,7,3,2,1,6,Casual Users
31049,270,8,9,3,2,1,6,Casual Users
31486,1264,15,25,1,3,2,6,Casual Users
31684,1165,77,290,2,5,5,12,At Risk
31957,848,17,28,2,3,2,7,Casual Users
32166,1915,5,7,1,1,1,3,Lost
32632,1203,6,16,2,1,2,5,Lost
32845,317,26,92,3,4,4,11,Loyal Users
32875,6,101,146,5,5,4,14,Champions
32982,28,177,637,5,5,5,15,Champions
33087,7,191,363,5,5,5,15,Champions
33093,1307,18,71,1,3,4,8,Casual Users
33308,698,5,19,2,1,2,5,Lost
33733,798,28,58,2,4,3,9,At Risk
33852,1801,7,9,1,2,1,4,Lost
33867,981,10,38,2,2,3,7,Lost
33921,2169,6,10,1,1,1,3,Lost
33971,171,17,36,3,3,3,9,Loyal Users
34083,5441,6,6,1,1,1,3,Lost
34084,316,12,48,3,3,3,9,Loyal Users
34708,96,43,75,4,4,4,12,Champions
34945,160,9,10,4,2,1,7,Promising
35047,112,41,159,4,4,5,13,Champions
35170,799,8,25,2,2,2,6,Lost
35482,67,52,233,5,5,5,15,Champions
35496,42,93,313,5,5,5,15,Champions
35511,312,5,27,3,1,2,6,Casual Users
35538,4,156,873,5,5,5,15,Champions
35683,1280,29,40,1,4,3,8,At Risk
35818,4705,7,9,1,2,1,4,Lost
36363,863,5,24,2,1,2,5,Lost
36412,275,16,45,3,3,3,9,Loyal Users
36589,2554,10,29,1,2,2,5,Lost
36804,130,67,157,4,5,5,14,Champions
36964,15,49,96,5,5,4,14,Champions
37228,260,48,60,3,5,3,11,Loyal Users
37431,3428,5,5,1,1,1,3,Lost
37889,1546,32,50,1,4,3,8,At Risk
38117,1572,43,93,1,4,4,9,At Risk
38156,3721,12,16,1,3,2,6,Casual Users
38228,3434,8,16,1,2,2,5,Lost
38309,11,110,167,5,5,5,15,Champions
38554,274,71,390,3,5,5,13,Loyal Users
38669,99,37,84,4,4,4,12,Champions
38861,849,16,20,2,3,2,7,Casual Users
26842,668,7,28,2,2,2,6,Lost
26863,958,6,8,2,1,1,4,Lost
26869,1036,7,15,2,2,1,5,Lost
27023,396,14,39,3,3,3,9,Loyal Users
27123,149,39,126,4,4,4,12,Champions
27454,272,21,41,3,3,3,9,Loyal Users
27479,229,46,65,3,5,4,12,Loyal Users
27502,402,47,80,3,5,4,12,Loyal Users
27596,124,40,104,4,4,4,12,Champions
27770,947,26,45,2,4,3,9,At Risk
28040,207,16,27,3,3,2,8,Loyal Users
28065,535,10,31,2,2,2,6,Lost
28110,122,11,30,4,2,2,8,Promising
28127,432,12,14,3,3,1,7,Loyal Users
28456,142,20,50,4,3,3,10,Loyal Users
28527,246,17,87,3,3,4,10,Loyal Users
28632,726,13,38,2,3,3,8,Casual Users
28699,1038,13,20,2,3,2,7,Casual Users
28730,157,45,50,4,4,3,11,Loyal Users
28869,9,43,127,5,4,4,13,Champions
28934,1863,19,81,1,3,4,8,Casual Users
29147,2663,6,12,1,1,1,3,Lost
29175,107,10,20,4,2,2,8,Promising
29354,248,9,13,3,2,1,6,Casual Users
29912,1109,5,18,2,1,2,5,Lost
30054,2717,5,16,1,1,2,4,Lost
30375,13,37,86,5,4,4,13,Champions
30484,16,184,506,5,5,5,15,Champions
30627,115,6,14,4,1,1,6,Promising
30871,248,6,8,3,1,1,5,Casual Users
31006,3,28,133,5,4,4,13,Champions
31142,93,85,243,4,5,5,14,Champions
31202,2290,6,12,1,1,1,3,Lost
31270,270,18,113,3,3,4,10,Loyal Users
32739,1137,5,5,2,1,1,4,Lost
33252,130,24,92,4,4,4,12,Champions
33475,169,81,131,3,5,4,12,Loyal Users
33564,120,23,47,4,4,3,11,Loyal Users
33665,412,8,8,3,2,1,6,Casual Users
33694,1185,24,35,2,4,3,9,At Risk
33946,154,89,160,4,5,5,14,Champions
34058,285,65,272,3,5,5,13,Loyal Users
34085,3280,12,13,1,3,1,5,Casual Users
34114,1580,6,6,1,1,1,3,Lost
34261,584,10,13,2,2,1,5,Lost
34341,8,147,342,5,5,5,15,Champions
34368,1127,9,17,2,2,2,6,Lost
35130,614,5,10,2,1,1,4,Lost
35172,1407,12,87,1,3,4,8,Casual Users
35208,83,19,26,4,3,2,9,Loyal Users
35389,606,5,9,2,1,1,4,Lost
35415,122,10,40,4,2,3,9,Promising
36076,406,39,118,3,4,4,11,Loyal Users
36374,533,8,37,2,2,3,7,Lost
37380,89,88,332,4,5,5,14,Champions
37464,3,97,142,5,5,4,14,Champions
37471,3545,10,15,1,2,1,4,Lost
37581,1541,11,20,1,2,2,5,Lost
37688,1010,31,52,2,4,3,9,At Risk
37900,616,12,58,2,3,3,8,Casual Users
38108,1689,10,27,1,2,2,5,Lost
38194,266,11,15,3,2,1,6,Casual Users
38305,1015,41,228,2,4,5,11,At Risk
38653,122,28,117,4,4,4,12,Champions
38876,113,83,201,4,5,5,14,Champions
39190,1281,22,86,1,4,4,9,At Risk
26732,195,15,83,3,3,4,10,Loyal Users
27005,241,68,125,3,5,4,12,Loyal Users
27756,969,19,29,2,3,2,7,Casual Users
27910,1383,5,11,1,1,1,3,Lost
28340,1069,17,33,2,3,3,8,Casual Users
28567,2,13,14,5,3,1,9,Loyal Users
28643,94,14,47,4,3,3,10,Loyal Users
28801,208,11,24,3,2,2,7,Casual Users
28927,129,25,76,4,4,4,12,Champions
28994,4,23,36,5,4,3,12,Loyal Users
29438,1,98,197,5,5,5,15,Champions
29897,13,40,113,5,4,4,13,Champions
30023,122,98,388,4,5,5,14,Champions
30086,38,249,576,5,5,5,15,Champions
30209,1440,6,10,1,1,1,3,Lost
30648,117,18,77,4,3,4,11,Loyal Users
30678,39,5,13,5,1,1,7,Promising
30703,1298,23,49,1,4,3,8,At Risk
31335,125,17,98,4,3,4,11,Loyal Users
31491,882,11,16,2,2,2,6,Lost
31678,90,23,77,4,4,4,12,Champions
31738,15,38,65,5,4,4,13,Champions
32008,5551,8,57,1,2,3,6,Lost
32493,1073,56,124,2,5,4,11,At Risk
32719,2832,8,15,1,2,1,4,Lost
32974,3308,5,5,1,1,1,3,Lost
33004,75,43,84,4,4,4,12,Champions
33041,3106,26,61,1,4,3,8,At Risk
33257,672,6,8,2,1,1,4,Lost
33669,434,21,104,3,3,4,10,Loyal Users
33931,283,21,52,3,3,3,9,Loyal Users
34001,4830,6,11,1,1,1,3,Lost
34333,321,8,8,3,2,1,6,Casual Users
35183,263,187,387,3,5,5,13,Loyal Users
35541,3682,5,28,1,1,2,4,Lost
35698,9,29,45,5,4,3,12,Loyal Users
36088,106,124,697,4,5,5,14,Champions
36208,137,6,6,4,1,1,6,Promising
36223,137,7,43,4,2,3,9,Promising
36262,14,56,100,5,5,4,14,Champions
36337,3662,25,87,1,4,4,9,At Risk
36438,42,20,81,5,3,4,12,Loyal Users
36442,138,25,86,4,4,4,12,Champions
36524,3428,5,10,1,1,1,3,Lost
36574,113,5,9,4,1,1,6,Promising
36738,135,17,94,4,3,4,11,Loyal Users
36888,836,9,14,2,2,1,5,Lost
37053,166,7,18,3,2,2,7,Casual Users
37478,177,40,196,3,4,5,12,Loyal Users
37505,692,8,27,2,2,2,6,Lost
37915,763,7,95,2,2,4,8,Lost
37974,3716,10,50,1,2,3,6,Lost
38329,11,152,423,5,5,5,15,Champions
38759,530,7,35,2,2,3,7,Lost
39119,60,35,183,5,4,5,14,Champions
27107,3,88,131,5,5,4,14,Champions
27227,2120,6,7,1,1,1,3,Lost
27742,122,104,145,4,5,4,13,Champions
27777,5290,10,10,1,2,1,4,Lost
28172,2186,5,6,1,1,1,3,Lost
28348,2971,8,8,1,2,1,4,Lost
28822,330,45,49,3,4,3,10,Loyal Users
29270,945,29,57,2,4,3,9,At Risk
29399,293,13,15,3,3,1,7,Loyal Users
29559,2550,5,20,1,1,2,4,Lost
29701,0,96,138,5,5,4,14,Champions
29706,11,15,20,5,3,2,10,Loyal Users
30066,600,8,10,2,2,1,5,Lost
30168,70,33,139,4,4,4,12,Champions
30231,537,7,12,2,2,1,5,Lost
30287,3604,5,23,1,1,2,4,Lost
30694,19,36,47,5,4,3,12,Loyal Users
30714,33,7,11,5,2,1,8,Promising
30725,838,62,161,2,5,5,12,At Risk
30913,118,5,13,4,1,1,6,Promising
30936,3,10,15,5,2,1,8,Promising
30948,2707,11,17,1,2,2,5,Lost
31147,139,9,14,4,2,1,7,Promising
31292,996,13,24,2,3,2,7,Casual Users
31424,136,15,24,4,3,2,9,Loyal Users
31542,2592,5,16,1,1,2,4,Lost
31545,27,34,87,5,4,4,13,Champions
31586,13,76,144,5,5,4,14,Champions
31663,3449,5,10,1,1,1,3,Lost
31677,97,47,180,4,5,5,14,Champions
32307,75,26,173,4,4,5,13,Champions
32500,224,42,275,3,4,5,12,Loyal Users
32503,90,63,381,4,5,5,14,Champions
32516,3263,8,14,1,2,1,4,Lost
33039,313,85,306,3,5,5,13,Loyal Users
33442,2849,14,41,1,3,3,7,Casual Users
33577,436,67,254,3,5,5,13,Loyal Users
33830,688,112,274,2,5,5,12,At Risk
33894,662,12,87,2,3,4,9,Casual Users
34277,3200,7,12,1,2,1,4,Lost
34309,103,14,39,4,3,3,10,Loyal Users
34436,32,5,10,5,1,1,7,Promising
34550,4,98,189,5,5,5,15,Champions
34634,2148,5,22,1,1,2,4,Lost
34716,121,14,98,4,3,4,11,Loyal Users
34892,6,58,241,5,5,5,15,Champions
34919,2829,8,8,1,2,1,4,Lost
35113,203,7,33,3,2,3,8,Casual Users
35353,606,33,50,2,4,3,9,At Risk
35552,90,75,220,4,5,5,14,Champions
35680,578,9,15,2,2,1,5,Lost
36288,544,11,26,2,2,2,6,Lost
36308,103,24,60,4,4,3,11,Loyal Users
36517,1815,5,23,1,1,2,4,Lost
36861,16,28,82,5,4,4,13,Champions
36882,0,66,236,5,5,5,15,Champions
36985,4451,6,6,1,1,1,3,Lost
37414,924,6,12,2,1,1,4,Lost
38000,1,172,566,5,5,5,15,Champions
38001,574,25,73,2,4,4,10,At Risk
38097,70,82,144,4,5,4,13,Champions
38387,159,54,150,4,5,5,14,Champions
38393,614,20,53,2,3,3,8,Casual Users
38674,934,100,233,2,5,5,12,At Risk
38795,2239,9,10,1,2,1,4,Lost
39082,112,31,132,4,4,4,12,Champions
39097,1070,49,94,2,5,4,11,At Risk
39123,104,17,33,4,3,3,10,Loyal Users
26566,31,40,173,5,4,5,14,Champions
26621,520,35,77,2,4,4,10,At Risk
26765,127,7,10,4,2,1,7,Promising
27263,287,6,47,3,1,3,7,Casual Users
27740,148,15,49,4,3,3,10,Loyal Users
28417,1377,6,28,1,1,2,4,Lost
28774,1,138,381,5,5,5,15,Champions
28918,563,30,84,2,4,4,10,At Risk
29121,15,41,278,5,4,5,14,Champions
29246,711,13,16,2,3,2,7,Casual Users
29369,81,30,98,4,4,4,12,Champions
29374,442,11,22,3,2,2,7,Casual Users
29424,48,58,270,5,5,5,15,Champions
29554,154,95,257,4,5,5,14,Champions
29775,18,109,217,5,5,5,15,Champions
30027,128,62,140,4,5,4,13,Champions
30107,3,24,38,5,4,3,12,Loyal Users
30175,79,100,234,4,5,5,14,Champions
30459,1466,8,41,1,2,3,6,Lost
30613,541,18,57,2,3,3,8,Casual Users
30641,3404,8,10,1,2,1,4,Lost
31017,5852,8,32,1,2,3,6,Lost
31084,367,34,86,3,4,4,11,Loyal Users
31505,840,6,9,2,1,1,4,Lost
31830,1076,6,33,2,1,3,6,Lost
32159,11,5,14,5,1,1,7,Promising
32247,258,7,15,3,2,1,6,Casual Users
32389,131,17,34,4,3,3,10,Loyal Users
32549,3203,21,112,1,3,4,8,Casual Users
32922,2556,5,6,1,1,1,3,Lost
33162,372,23,43,3,4,3,10,Loyal Users
33215,824,6,13,2,1,1,4,Lost
33471,20,100,197,5,5,5,15,Champions
33575,1994,6,25,1,1,2,4,Lost
33731,129,86,144,4,5,4,13,Champions
33999,0,122,322,5,5,5,15,Champions
34000,243,17,33,3,3,3,9,Loyal Users
34201,12,7,25,5,2,2,9,Promising
34202,1725,9,63,1,2,4,7,Lost
34287,1994,6,23,1,1,2,4,Lost
34298,997,9,9,2,2,1,5,Lost
34463,1054,11,23,2,2,2,6,Lost
34592,406,27,68,3,4,4,11,Loyal Users
34775,290,37,47,3,4,3,10,Loyal Users
35031,655,17,107,2,3,4,9,Casual Users
35206,117,43,109,4,4,4,12,Champions
35726,821,5,14,2,1,1,4,Lost
35859,76,7,27,4,2,2,8,Promising
36064,183,45,277,3,4,5,12,Loyal Users
36644,2953,12,31,1,3,2,6,Casual Users
36753,392,37,54,3,4,3,10,Loyal Users
37136,3344,5,7,1,1,1,3,Lost
37176,908,19,48,2,3,3,8,Casual Users
37192,304,11,55,3,2,3,8,Casual Users
37223,14,144,633,5,5,5,15,Champions
37514,44,24,184,5,4,5,14,Champions
37670,37,57,181,5,5,5,15,Champions
37719,9,123,240,5,5,5,15,Champions
38162,2717,5,7,1,1,1,3,Lost
38504,697,6,7,2,1,1,4,Lost
38556,502,5,8,2,1,1,4,Lost
38678,864,12,47,2,3,3,8,Casual Users
38681,877,16,66,2,3,4,9,Casual Users
38890,72,51,152,4,5,5,14,Champions
39101,133,5,10,4,1,1,6,Promising
39179,81,125,518,4,5,5,14,Champions
26541,3656,8,32,1,2,3,6,Lost
26744,1532,25,225,1,4,5,10,At Risk
26805,7,15,45,5,3,3,11,Loyal Users
27342,2121,5,7,1,1,1,3,Lost
27630,18,21,42,5,3,3,11,Loyal Users
27757,73,17,36,4,3,3,10,Loyal Users
27800,319,29,51,3,4,3,10,Loyal Users
27804,371,41,84,3,4,4,11,Loyal Users
28226,883,6,16,2,1,2,5,Lost
28695,566,31,178,2,4,5,11,At Risk
28787,66,46,75,5,5,4,14,Champions
28816,20,94,221,5,5,5,15,Champions
28991,809,5,17,2,1,2,5,Lost
29494,4425,7,21,1,2,2,5,Lost
29703,13,13,73,5,3,4,12,Loyal Users
29717,247,36,215,3,4,5,12,Loyal Users
29844,36,5,14,5,1,1,7,Promising
29911,971,6,6,2,1,1,4,Lost
29983,1133,10,27,2,2,2,6,Lost
30015,703,12,48,2,3,3,8,Casual Users
30300,42,91,188,5,5,5,15,Champions
31315,133,21,32,4,3,3,10,Loyal Users
31473,1029,7,8,2,2,1,5,Lost
31827,126,23,51,4,4,3,11,Loyal Users
31865,128,234,570,4,5,5,14,Champions
32673,480,42,84,2,4,4,10,At Risk
32912,141,17,99,4,3,4,11,Loyal Users
33193,88,6,6,4,1,1,6,Promising
33349,123,20,80,4,3,4,11,Loyal Users
33505,720,7,16,2,2,2,6,Lost
33529,1069,8,47,2,2,3,7,Lost
33801,242,48,100,3,5,4,12,Loyal Users
33811,187,17,65,3,3,4,10,Loyal Users
33856,2432,8,16,1,2,2,5,Lost
34086,1022,7,10,2,2,1,5,Lost
34485,2414,7,21,1,2,2,5,Lost
34656,36,92,495,5,5,5,15,Champions
34666,73,107,346,4,5,5,14,Champions
34992,810,11,61,2,2,3,7,Lost
35284,108,16,75,4,3,4,11,Loyal Users
35452,102,7,14,4,2,1,7,Promising
35826,293,27,43,3,4,3,10,Loyal Users
35940,658,12,12,2,3,1,6,Casual Users
36136,12,29,38,5,4,3,12,Loyal Users
36286,130,178,328,4,5,5,14,Champions
36622,5,25,56,5,4,3,12,Loyal Users
36784,14,17,34,5,3,3,11,Loyal Users
36811,691,30,197,2,4,5,11,At Risk
37747,107,24,107,4,4,4,12,Champions
37868,547,29,50,2,4,3,9,At Risk
38363,449,13,23,3,3,2,8,Loyal Users
38461,27,12,240,5,3,5,13,Loyal Users
26492,363,8,20,3,2,2,7,Casual Users
26517,244,8,9,3,2,1,6,Casual Users
26858,1956,5,9,1,1,1,3,Lost
27098,3,140,263,5,5,5,15,Champions
27273,5,33,121,5,4,4,13,Champions
27324,98,26,31,4,4,2,10,Loyal Users
27640,224,48,268,3,5,5,13,Loyal Users
27663,133,15,28,4,3,2,9,Loyal Users
28214,269,18,35,3,3,3,9,Loyal Users
28509,5864,6,7,1,1,1,3,Lost
28617,27,11,29,5,2,2,9,Promising
28641,2000,14,57,1,3,3,7,Casual Users
28924,1125,29,72,2,4,4,10,At Risk
29053,133,9,11,4,2,1,7,Promising
29188,3983,6,10,1,1,1,3,Lost
29557,997,5,7,2,1,1,4,Lost
29578,87,23,28,4,4,2,10,Loyal Users
29603,153,14,131,4,3,4,11,Loyal Users
29724,368,8,23,3,2,2,7,Casual Users
29835,109,115,341,4,5,5,14,Champions
30363,47,48,297,5,5,5,15,Champions
30411,733,20,25,2,3,2,7,Casual Users
30686,531,14,50,2,3,3,8,Casual Users
30690,72,23,135,4,4,4,12,Champions
30698,739,10,16,2,2,2,6,Lost
30824,8,139,880,5,5,5,15,Champions
31191,231,17,57,3,3,3,9,Loyal Users
31311,99,49,98,4,5,4,13,Champions
31408,862,28,62,2,4,3,9,At Risk
31444,863,9,11,2,2,1,5,Lost
31641,0,18,27,5,3,2,10,Loyal Users
32015,36,21,24,5,3,2,10,Loyal Users
32538,140,26,92,4,4,4,12,Champions
32728,3658,8,9,1,2,1,4,Lost
32790,425,6,17,3,1,2,6,Casual Users
32854,271,30,118,3,4,4,11,Loyal Users
33125,675,5,7,2,1,1,4,Lost
33267,24,80,329,5,5,5,15,Champions
33566,568,186,902,2,5,5,12,At Risk
33728,107,44,209,4,4,5,13,Champions
33841,15,51,458,5,5,5,15,Champions
33879,170,79,128,3,5,4,12,Loyal Users
33897,4,55,406,5,5,5,15,Champions
34096,1369,7,9,1,2,1,4,Lost
34588,13,50,290,5,5,5,15,Champions
34807,902,17,36,2,3,3,8,Casual Users
35410,117,19,21,4,3,2,9,Loyal Users
35911,156,15,38,4,3,3,10,Loyal Users
35924,1667,6,8,1,1,1,3,Lost
36146,370,21,40,3,3,3,9,Loyal Users
36328,134,45,96,4,4,4,12,Champions
36356,569,7,7,2,2,1,5,Lost
36465,1958,10,23,1,2,2,5,Lost
36470,113,26,43,4,4,3,11,Loyal Users
36750,730,11,20,2,2,2,6,Lost
36775,124,8,27,4,2,2,8,Promising
36793,530,5,9,2,1,1,4,Lost
37003,9,81,217,5,5,5,15,Champions
37309,275,6,15,3,1,1,5,Casual Users
37619,161,27,118,4,4,4,12,Champions
38419,10,137,368,5,5,5,15,Champions
38773,77,20,54,4,3,3,10,Loyal Users
26590,20,24,166,5,4,5,14,Champions
26615,233,48,92,3,5,4,12,Loyal Users
26873,86,95,276,4,5,5,14,Champions
26988,6,65,321,5,5,5,15,Champions
27058,408,5,7,3,1,1,5,Casual Users
27116,1695,7,13,1,2,1,4,Lost
27333,132,97,127,4,5,4,13,Champions
27418,113,13,33,4,3,3,10,Loyal Users
27802,4278,22,30,1,4,2,7,At Risk
27819,62,31,118,5,4,4,13,Champions
28265,140,96,526,4,5,5,14,Champions
28561,117,18,29,4,3,2,9,Loyal Users
28873,412,8,40,3,2,3,8,Casual Users
28937,174,16,35,3,3,3,9,Loyal Users
29013,846,12,14,2,3,1,6,Casual Users
29262,2416,10,47,1,2,3,6,Lost
29512,414,11,28,3,2,2,7,Casual Users
29887,518,16,31,2,3,2,7,Casual Users
29968,1713,13,21,1,3,2,6,Casual Users
30058,6,151,563,5,5,5,15,Champions
30073,28,41,151,5,4,5,14,Champions
30377,142,26,57,4,4,3,11,Loyal Users
30897,409,22,61,3,4,3,10,Loyal Users
30987,243,8,17,3,2,2,7,Casual Users
31068,211,15,36,3,3,3,9,Loyal Users
31286,5570,6,6,1,1,1,3,Lost
31490,144,52,122,4,5,4,13,Champions
31956,106,9,24,4,2,2,8,Promising
32129,136,11,15,4,2,1,7,Promising
32387,130,6,36,4,1,3,8,Promising
32494,681,19,159,2,3,5,10,Casual Users
32658,30,212,434,5,5,5,15,Champions
32838,225,36,60,3,4,3,10,Loyal Users
32914,266,7,9,3,2,1,6,Casual Users
32950,1727,7,12,1,2,1,4,Lost
32991,5123,6,8,1,1,1,3,Lost
33016,103,7,11,4,2,1,7,Promising
33164,67,96,421,5,5,5,15,Champions
33531,158,27,52,4,4,3,11,Loyal Users
33659,1376,43,151,1,4,5,10,At Risk
34071,3,73,297,5,5,5,15,Champions
34358,125,43,210,4,4,5,13,Champions
35150,1141,12,80,2,3,4,9,Casual Users
35248,566,26,52,2,4,3,9,At Risk
35256,1294,7,18,1,2,2,5,Lost
35342,361,30,38,3,4,3,10,Loyal Users
35933,648,5,30,2,1,2,5,Lost
35980,10,15,25,5,3,2,10,Loyal Users
36170,39,85,309,5,5,5,15,Champions
36276,3239,6,6,1,1,1,3,Lost
36452,3704,21,54,1,3,3,7,Casual Users
36551,92,34,144,4,4,4,12,Champions
36570,14,87,154,5,5,5,15,Champions
36623,271,18,57,3,3,3,9,Loyal Users
37088,459,27,57,3,4,3,10,Loyal Users
37143,549,12,28,2,3,2,7,Casual Users
37289,1643,7,42,1,2,3,6,Lost
37366,46,113,198,5,5,5,15,Champions
37678,1991,19,62,1,3,3,7,Casual Users
38407,86,14,20,4,3,2,9,Loyal Users
26513,182,46,98,3,5,4,12,Loyal Users
26750,3,60,116,5,5,4,14,Champions
27035,3262,6,6,1,1,1,3,Lost
27135,9,69,272,5,5,5,15,Champions
27146,5871,6,10,1,1,1,3,Lost
27654,839,15,33,2,3,3,8,Casual Users
27936,74,31,48,4,4,3,11,Loyal Users
28077,1985,7,30,1,2,2,5,Lost
28490,133,8,12,4,2,1,7,Promising
28650,538,57,78,2,5,4,11,At Risk
28694,60,46,204,5,5,5,15,Champions
28698,88,56,83,4,5,4,13,Champions
29520,140,17,114,4,3,4,11,Loyal Users
29540,307,23,40,3,4,3,10,Loyal Users
29588,214,39,61,3,4,3,10,Loyal Users
29667,115,52,104,4,5,4,13,Champions
30436,1,58,209,5,5,5,15,Champions
30647,1777,6,12,1,1,1,3,Lost
30850,1543,7,36,1,2,3,6,Lost
31383,132,36,126,4,4,4,12,Champions
31740,683,5,6,2,1,1,4,Lost
31893,2479,5,14,1,1,1,3,Lost
32729,527,29,45,2,4,3,9,At Risk
33098,817,9,27,2,2,2,6,Lost
33205,2436,8,21,1,2,2,5,Lost
33217,119,68,214,4,5,5,14,Champions
33280,1449,8,10,1,2,1,4,Lost
33327,268,6,24,3,1,2,6,Casual Users
33628,36,56,101,5,5,4,14,Champions
33714,2443,9,35,1,2,3,6,Lost
34233,1240,5,44,2,1,3,6,Lost
34448,590,39,89,2,4,4,10,At Risk
34482,615,13,17,2,3,2,7,Casual Users
34876,1657,8,72,1,2,4,7,Lost
35260,3278,7,7,1,2,1,4,Lost
35528,114,6,19,4,1,2,7,Promising
35925,4,47,102,5,5,4,14,Champions
36022,216,56,321,3,5,5,13,Loyal Users
36135,91,74,231,4,5,5,14,Champions
36844,30,18,21,5,3,2,10,Loyal Users
37124,2857,8,18,1,2,2,5,Lost
37509,301,7,17,3,2,2,7,Casual Users
37789,458,12,32,3,3,3,9,Loyal Users
38067,272,14,23,3,3,2,8,Loyal Users
38275,958,7,13,2,2,1,5,Lost
38322,82,160,527,4,5,5,14,Champions
38794,2567,7,11,1,2,1,4,Lost
38940,274,13,47,3,3,3,9,Loyal Users
39042,366,15,17,3,3,2,8,Loyal Users
39109,1507,77,240,1,5,5,11,At Risk
26478,1705,5,42,1,1,3,5,Lost
26704,420,58,289,3,5,5,13,Loyal Users
26725,290,6,7,3,1,1,5,Casual Users
26889,222,37,73,3,4,4,11,Loyal Users
27125,123,8,28,4,2,2,8,Promising
27297,1725,13,92,1,3,4,8,Casual Users
27377,17,46,284,5,5,5,15,Champions
27381,1574,5,5,1,1,1,3,Lost
27489,1191,9,85,2,2,4,8,Lost
27660,465,5,12,3,1,1,5,Casual Users
27954,1110,25,102,2,4,4,10,At Risk
28254,250,39,98,3,4,4,11,Loyal Users
28449,140,23,35,4,4,3,11,Loyal Users
28592,305,5,6,3,1,1,5,Casual Users
28857,25,21,63,5,3,4,12,Loyal Users
29166,1970,7,9,1,2,1,4,Lost
29697,657,10,49,2,2,3,7,Lost
29812,156,50,159,4,5,5,14,Champions
30492,80,61,298,4,5,5,14,Champions
30827,407,48,95,3,5,4,12,Loyal Users
30935,407,144,276,3,5,5,13,Loyal Users
31121,180,26,54,3,4,3,10,Loyal Users
31145,3,14,25,5,3,2,10,Loyal Users
31245,386,6,6,3,1,1,5,Casual Users
31362,134,10,15,4,2,1,7,Promising
31443,322,49,160,3,5,5,13,Loyal Users
31580,137,35,54,4,4,3,11,Loyal Users
31603,1151,13,36,2,3,3,8,Casual Users
31790,2,91,248,5,5,5,15,Champions
31923,75,85,393,4,5,5,14,Champions
32209,944,10,81,2,2,4,8,Lost
32259,393,40,110,3,4,4,11,Loyal Users
32301,217,7,21,3,2,2,7,Casual Users
32532,1559,9,22,1,2,2,5,Lost
32659,204,75,125,3,5,4,12,Loyal Users
32827,37,8,16,5,2,2,9,Promising
33092,377,8,14,3,2,1,6,Casual Users
33233,152,44,210,4,4,5,13,Champions
33247,1025,34,349,2,4,5,11,At Risk
33266,158,37,141,4,4,4,12,Champions
33443,1099,15,54,2,3,3,8,Casual Users
33534,27,66,163,5,5,5,15,Champions
33985,157,18,65,4,3,4,11,Loyal Users
34575,77,27,54,4,4,3,11,Loyal Users
34824,1853,5,8,1,1,1,3,Lost
35171,1395,11,21,1,2,2,5,Lost
35314,8,5,32,5,1,3,9,Promising
35606,384,7,8,3,2,1,6,Casual Users
35679,883,18,68,2,3,4,9,Casual Users
35733,427,23,44,3,4,3,10,Loyal Users
36020,418,44,71,3,4,4,11,Loyal Users
36247,63,112,415,5,5,5,15,Champions
36425,2030,6,8,1,1,1,3,Lost
36457,2910,6,18,1,1,2,4,Lost
36712,25,30,56,5,4,3,12,Loyal Users
36847,2281,15,27,1,3,2,6,Casual Users
37222,400,44,65,3,4,4,11,Loyal Users
37537,1422,11,16,1,2,2,5,Lost
37632,392,14,46,3,3,3,9,Loyal Users
37718,124,19,25,4,3,2,9,Loyal Users
37814,735,34,171,2,4,5,11,At Risk
38377,2,34,95,5,4,4,13,Champions
38460,5,15,17,5,3,2,10,Loyal Users
38564,29,6,24,5,1,2,8,Promising
38578,126,30,130,4,4,4,12,Champions
38732,118,45,95,4,4,4,12,Champions
38918,56,46,191,5,5,5,15,Champions
39227,1589,12,65,1,3,4,8,Casual Users
26536,364,16,29,3,3,2,8,Loyal Users
26759,115,22,31,4,4,2,10,Loyal Users
26922,132,18,42,4,3,3,10,Loyal Users
26939,2387,7,30,1,2,2,5,Lost
27106,112,10,15,4,2,1,7,Promising
27181,18,70,312,5,5,5,15,Champions
27391,433,12,76,3,3,4,10,Loyal Users
27557,747,34,64,2,4,4,10,At Risk
27816,14,56,114,5,5,4,14,Champions
28517,7,72,139,5,5,4,14,Champions
28917,30,10,50,5,2,3,10,Promising
28986,117,7,50,4,2,3,9,Promising
29293,357,60,97,3,5,4,12,Loyal Users
29447,85,212,522,4,5,5,14,Champions
29822,249,9,42,3,2,3,8,Casual Users
29962,75,43,118,4,4,4,12,Champions
30095,140,9,10,4,2,1,7,Promising
30274,3132,9,9,1,2,1,4,Lost
30512,49,48,125,5,5,4,14,Champions
30599,2442,8,12,1,2,1,4,Lost
30764,248,42,116,3,4,4,11,Loyal Users
30791,1588,10,19,1,2,2,5,Lost
30916,452,22,77,3,4,4,11,Loyal Users
31025,112,80,642,4,5,5,14,Champions
31082,849,12,48,2,3,3,8,Casual Users
31164,2676,30,151,1,4,5,10,At Risk
31605,126,29,113,4,4,4,12,Champions
31847,42,9,16,5,2,2,9,Promising
31886,279,8,44,3,2,3,8,Casual Users
32380,1432,11,15,1,2,1,4,Lost
32577,52,127,611,5,5,5,15,Champions
32607,239,6,12,3,1,1,5,Casual Users
32802,105,10,24,4,2,2,8,Promising
33142,60,110,386,5,5,5,15,Champions
33159,466,5,5,3,1,1,5,Casual Users
33324,310,11,22,3,2,2,7,Casual Users
33557,2820,8,19,1,2,2,5,Lost
33870,118,64,388,4,5,5,14,Champions
34017,256,11,18,3,2,2,7,Casual Users
34128,1797,6,8,1,1,1,3,Lost
34133,108,103,605,4,5,5,14,Champions
34200,1681,18,87,1,3,4,8,Casual Users
34860,80,92,141,4,5,4,13,Champions
34955,1184,7,50,2,2,3,7,Lost
35046,784,8,20,2,2,2,6,Lost
35063,43,9,46,5,2,3,10,Promising
35433,13,22,96,5,4,4,13,Champions
35783,284,20,126,3,3,4,10,Loyal Users
36019,71,99,323,4,5,5,14,Champions
36042,493,12,76,2,3,4,9,Casual Users
36128,69,84,542,5,5,5,15,Champions
36520,128,35,66,4,4,4,12,Champions
36911,181,9,12,3,2,1,6,Casual Users
36928,543,15,36,2,3,3,8,Casual Users
36939,235,30,87,3,4,4,11,Loyal Users
36998,609,10,35,2,2,3,7,Lost
37032,323,5,5,3,1,1,5,Casual Users
37072,4891,8,48,1,2,3,6,Lost
37362,3663,18,18,1,3,2,6,Casual Users
37374,464,25,186,3,4,5,12,Loyal Users
37411,141,21,91,4,3,4,11,Loyal Users
37428,401,48,147,3,5,5,13,Loyal Users
37783,240,59,151,3,5,5,13,Loyal Users
37920,432,18,184,3,3,5,11,Loyal Users
38197,311,32,51,3,4,3,10,Loyal Users
38721,5566,5,5,1,1,1,3,Lost
38872,2,75,158,5,5,5,15,Champions
39081,120,48,246,4,5,5,14,Champions
39177,103,9,12,4,2,1,7,Promising
26483,39,45,187,5,4,5,14,Champions
27031,3,204,430,5,5,5,15,Champions
27063,987,7,16,2,2,2,6,Lost
27307,1682,18,183,1,3,5,9,Casual Users
27580,109,84,398,4,5,5,14,Champions
27606,588,62,222,2,5,5,12,At Risk
27965,3856,7,14,1,2,1,4,Lost
28017,23,58,155,5,5,5,15,Champions
28096,235,37,126,3,4,4,11,Loyal Users
28548,2135,8,20,1,2,2,5,Lost
28688,722,64,68,2,5,4,11,At Risk
28788,150,82,131,4,5,4,13,Champions
28855,1120,6,103,2,1,4,7,Lost
29055,697,7,7,2,2,1,5,Lost
29251,351,7,27,3,2,2,7,Casual Users
30303,527,5,10,2,1,1,4,Lost
30383,1449,15,21,1,3,2,6,Casual Users
30637,2129,38,160,1,4,5,10,At Risk
30664,6,120,206,5,5,5,15,Champions
30765,2229,6,8,1,1,1,3,Lost
30821,2844,6,10,1,1,1,3,Lost
30985,2272,13,15,1,3,1,5,Casual Users
31043,28,8,63,5,2,4,11,Promising
31153,55,226,525,5,5,5,15,Champions
31477,664,8,11,2,2,1,5,Lost
32197,688,20,38,2,3,3,8,Casual Users
32204,217,50,63,3,5,4,12,Loyal Users
32385,2307,12,52,1,3,3,7,Casual Users
33131,1211,21,52,2,3,3,8,Casual Users
33421,937,14,18,2,3,2,7,Casual Users
33973,76,106,310,4,5,5,14,Champions
34328,394,12,16,3,3,2,8,Loyal Users
34413,15,79,191,5,5,5,15,Champions
34421,25,29,55,5,4,3,12,Loyal Users
34525,33,46,432,5,5,5,15,Champions
34568,3672,6,16,1,1,2,4,Lost
34879,1440,16,24,1,3,2,6,Casual Users
35007,1389,9,17,1,2,2,5,Lost
35182,1,12,106,5,3,4,12,Loyal Users
35375,273,10,18,3,2,2,7,Casual Users
35560,128,9,12,4,2,1,7,Promising
36172,4633,5,10,1,1,1,3,Lost
36443,97,104,257,4,5,5,14,Champions
36565,261,35,88,3,4,4,11,Loyal Users
36762,31,33,76,5,4,4,13,Champions
36853,129,31,65,4,4,4,12,Champions
37099,151,18,30,4,3,2,9,Loyal Users
37246,361,30,51,3,4,3,10,Loyal Users
37353,128,10,25,4,2,2,8,Promising
37398,365,84,206,3,5,5,13,Loyal Users
37776,104,24,62,4,4,3,11,Loyal Users
37802,166,19,48,3,3,3,9,Loyal Users
38286,127,76,287,4,5,5,14,Champions
38623,4,13,40,5,3,3,11,Loyal Users
38649,2139,8,8,1,2,1,4,Lost
38733,71,55,424,4,5,5,14,Champions
38836,331,26,78,3,4,4,11,Loyal Users
26649,3973,106,124,1,5,4,10,At Risk
26664,3,25,30,5,4,2,11,Loyal Users
27172,440,152,261,3,5,5,13,Loyal Users
27352,212,16,25,3,3,2,8,Loyal Users
27722,1539,14,19,1,3,2,6,Casual Users
27897,147,13,65,4,3,4,11,Loyal Users
27912,708,6,15,2,1,1,4,Lost
27935,715,9,34,2,2,3,7,Lost
28021,112,30,58,4,4,3,11,Loyal Users
28083,129,7,13,4,2,1,7,Promising
28207,709,13,18,2,3,2,7,Casual Users
28558,1724,25,73,1,4,4,9,At Risk
28658,147,20,45,4,3,3,10,Loyal Users
29207,24,66,271,5,5,5,15,Champions
29870,1985,8,33,1,2,3,6,Lost
29980,656,36,126,2,4,4,10,At Risk
30178,139,27,46,4,4,3,11,Loyal Users
30244,452,6,23,3,1,2,6,Casual Users
30912,33,17,51,5,3,3,11,Loyal Users
30979,897,7,14,2,2,1,5,Lost
31020,129,45,77,4,4,4,12,Champions
31267,24,107,230,5,5,5,15,Champions
31549,111,169,290,4,5,5,14,Champions
31700,49,150,248,5,5,5,15,Champions
31815,3,49,96,5,5,4,14,Champions
32024,645,9,19,2,2,2,6,Lost
32287,2576,7,7,1,2,1,4,Lost
32412,878,7,20,2,2,2,6,Lost
32439,531,5,14,2,1,1,4,Lost
32533,797,36,118,2,4,4,10,At Risk
32903,4015,19,53,1,3,3,7,Casual Users
32910,133,34,87,4,4,4,12,Champions
33114,242,14,65,3,3,4,10,Loyal Users
33274,742,6,10,2,1,1,4,Lost
33352,987,9,41,2,2,3,7,Lost
33518,35,29,42,5,4,3,12,Loyal Users
33616,20,44,261,5,4,5,14,Champions
33647,281,5,6,3,1,1,5,Casual Users
34185,379,24,44,3,4,3,10,Loyal Users
34306,4375,5,20,1,1,2,4,Lost
34849,2,83,158,5,5,5,15,Champions
34881,381,20,26,3,3,2,8,Loyal Users
34960,383,95,205,3,5,5,13,Loyal Users
35192,18,11,18,5,2,2,9,Promising
35432,1246,14,24,2,3,2,7,Casual Users
35508,128,24,119,4,4,4,12,Champions
35513,270,47,167,3,5,5,13,Loyal Users
35609,181,32,144,3,4,4,11,Loyal Users
35649,4,25,79,5,4,4,13,Champions
35700,14,118,353,5,5,5,15,Champions
35803,1177,7,14,2,2,1,5,Lost
36031,620,33,81,2,4,4,10,At Risk
36973,18,99,302,5,5,5,15,Champions
37060,27,54,237,5,5,5,15,Champions
37101,358,55,112,3,5,4,12,Loyal Users
37119,2081,5,5,1,1,1,3,Lost
37524,1341,10,72,1,2,4,7,Lost
37566,101,96,610,4,5,5,14,Champions
37686,426,5,31,3,1,2,6,Casual Users
37689,291,11,33,3,2,3,8,Casual Users
38281,114,69,221,4,5,5,14,Champions
38921,55,10,23,5,2,2,9,Promising
39008,164,67,225,4,5,5,14,Champions
39045,5035,7,18,1,2,2,5,Lost
26743,1649,10,31,1,2,2,5,Lost
27016,65,49,149,5,5,5,15,Champions
27150,572,18,23,2,3,2,7,Casual Users
27221,171,44,131,3,4,4,11,Loyal Users
27254,183,27,68,3,4,4,11,Loyal Users
27638,345,87,413,3,5,5,13,Loyal Users
27673,1673,6,7,1,1,1,3,Lost
27678,190,63,100,3,5,4,12,Loyal Users
27685,2533,13,26,1,3,2,6,Casual Users
27947,176,5,12,3,1,1,5,Casual Users
28000,1300,38,61,1,4,3,8,At Risk
28286,234,39,84,3,4,4,11,Loyal Users
28428,120,9,17,4,2,2,8,Promising
28595,395,6,7,3,1,1,5,Casual Users
28639,305,8,16,3,2,2,7,Casual Users
28972,0,29,214,5,4,5,14,Champions
29024,1436,6,11,1,1,1,3,Lost
29094,203,10,18,3,2,2,7,Casual Users
29244,100,76,226,4,5,5,14,Champions
29353,86,6,8,4,1,1,6,Promising
29710,0,85,223,5,5,5,15,Champions
29879,102,45,256,4,4,5,13,Champions
30308,1818,9,16,1,2,2,5,Lost
30329,117,7,12,4,2,1,7,Promising
30430,39,110,419,5,5,5,15,Champions
30576,850,7,14,2,2,1,5,Lost
30701,602,16,50,2,3,3,8,Casual Users
30856,104,72,278,4,5,5,14,Champions
31230,141,9,24,4,2,2,8,Promising
31520,410,14,20,3,3,2,8,Loyal Users
31567,44,5,6,5,1,1,7,Promising
31624,664,44,180,2,4,5,11,At Risk
31802,1459,18,20,1,3,2,6,Casual Users
31814,131,11,82,4,2,4,10,Promising
31999,127,43,100,4,4,4,12,Champions
32157,3003,5,8,1,1,1,3,Lost
32303,4726,5,7,1,1,1,3,Lost
32333,151,24,92,4,4,4,12,Champions
32421,724,17,36,2,3,3,8,Casual Users
32862,121,32,79,4,4,4,12,Champions
32930,60,11,11,5,2,1,8,Promising
33037,1093,11,22,2,2,2,6,Lost
33048,1577,17,188,1,3,5,9,Casual Users
33058,1850,17,42,1,3,3,7,Casual Users
33201,21,74,357,5,5,5,15,Champions
33209,96,20,37,4,3,3,10,Loyal Users
33296,36,54,74,5,5,4,14,Champions
33350,8,118,494,5,5,5,15,Champions
33456,1004,18,26,2,3,2,7,Casual Users
33462,20,197,498,5,5,5,15,Champions
33651,120,38,120,4,4,4,12,Champions
33824,148,7,16,4,2,2,8,Promising
34100,746,9,22,2,2,2,6,Lost
34411,196,22,88,3,4,4,11,Loyal Users
34443,431,5,12,3,1,1,5,Casual Users
34449,281,11,14,3,2,1,6,Casual Users
34483,120,48,180,4,5,5,14,Champions
34497,1142,5,68,2,1,4,7,Lost
34622,27,94,149,5,5,5,15,Champions
34753,305,24,80,3,4,4,11,Loyal Users
34776,2462,5,13,1,1,1,3,Lost
34810,3457,12,37,1,3,3,7,Casual Users
34859,77,5,5,4,1,1,6,Promising
35143,1275,22,79,1,4,4,9,At Risk
35265,802,9,16,2,2,2,6,Lost
35324,245,24,68,3,4,4,11,Loyal Users
35380,82,38,101,4,4,4,12,Champions
35438,107,22,118,4,4,4,12,Champions
35534,304,25,134,3,4,4,11,Loyal Users
35961,4759,15,28,1,3,2,6,Casual Users
36082,111,62,247,4,5,5,14,Champions
36200,673,5,24,2,1,2,5,Lost
36459,723,10,18,2,2,2,6,Lost
36667,1117,27,183,2,4,5,11,At Risk
36741,115,82,142,4,5,4,13,Champions
36795,436,13,52,3,3,3,9,Loyal Users
36809,101,25,325,4,4,5,13,Champions
36945,220,42,154,3,4,5,12,Loyal Users
37151,19,47,236,5,5,5,15,Champions
37511,80,8,77,4,2,4,10,Promising
37953,171,49,78,3,5,4,12,Loyal Users
38081,1775,6,7,1,1,1,3,Lost
38154,38,22,33,5,4,3,12,Loyal Users
38230,44,31,70,5,4,4,13,Champions
38261,560,5,9,2,1,1,4,Lost
38268,667,13,98,2,3,4,9,Casual Users
38483,75,154,775,4,5,5,14,Champions
38513,1542,9,9,1,2,1,4,Lost
38617,10,35,63,5,4,4,13,Champions
38671,1541,6,15,1,1,1,3,Lost
38700,2,117,239,5,5,5,15,Champions
38768,1810,29,100,1,4,4,9,At Risk
38781,93,73,332,4,5,5,14,Champions
38867,5488,5,43,1,1,3,5,Lost
38954,199,51,199,3,5,5,13,Loyal Users
39065,3901,5,5,1,1,1,3,Lost
39130,2809,10,40,1,2,3,6,Lost
26642,370,19,94,3,3,4,10,Loyal Users
26681,886,8,21,2,2,2,6,Lost
26735,176,11,131,3,2,4,9,Casual Users
26903,12,53,114,5,5,4,14,Champions
26918,242,35,104,3,4,4,11,Loyal Users
27285,228,14,21,3,3,2,8,Loyal Users
27345,3222,9,31,1,2,2,5,Lost
27532,1416,9,10,1,2,1,4,Lost
27563,2872,8,28,1,2,2,5,Lost
27568,521,10,16,2,2,2,6,Lost
27604,2219,15,97,1,3,4,8,Casual Users
27635,285,6,8,3,1,1,5,Casual Users
27664,42,23,30,5,4,2,11,Loyal Users
28677,162,22,41,4,4,3,11,Loyal Users
28705,128,13,72,4,3,4,11,Loyal Users
28960,1426,5,7,1,1,1,3,Lost
29158,2265,18,25,1,3,2,6,Casual Users
29337,1,18,97,5,3,4,12,Loyal Users
29349,806,6,15,2,1,1,4,Lost
29558,1303,6,11,1,1,1,3,Lost
29661,2066,25,65,1,4,4,9,At Risk
29856,28,5,35,5,1,3,9,Promising
30002,728,5,17,2,1,2,5,Lost
30421,6,105,251,5,5,5,15,Champions
30710,420,13,17,3,3,2,8,Loyal Users
30966,380,35,245,3,4,5,12,Loyal Users
31176,695,27,45,2,4,3,9,At Risk
31379,9,80,221,5,5,5,15,Champions
31535,2288,39,70,1,4,4,9,At Risk
31930,25,177,540,5,5,5,15,Champions
32241,550,5,36,2,1,3,6,Lost
32294,288,6,8,3,1,1,5,Casual Users
32511,179,23,57,3,4,3,10,Loyal Users
32815,82,39,86,4,4,4,12,Champions
32849,10,140,366,5,5,5,15,Champions
32993,12,81,138,5,5,4,14,Champions
33062,242,11,19,3,2,2,7,Casual Users
33178,1415,6,10,1,1,1,3,Lost
33186,147,14,20,4,3,2,9,Loyal Users
33194,545,10,15,2,2,1,5,Lost
33335,134,19,44,4,3,3,10,Loyal Users
33704,669,9,25,2,2,2,6,Lost
33785,233,12,32,3,3,3,9,Loyal Users
33958,674,6,10,2,1,1,4,Lost
34785,3284,18,27,1,3,2,6,Casual Users
34799,131,34,118,4,4,4,12,Champions
34995,2118,5,47,1,1,3,5,Lost
35058,186,27,43,3,4,3,10,Loyal Users
35059,27,54,144,5,5,4,14,Champions
35185,18,78,335,5,5,5,15,Champions
35246,3420,12,53,1,3,3,7,Casual Users
35288,1574,12,19,1,3,2,6,Casual Users
35524,95,76,146,4,5,4,13,Champions
35922,30,50,63,5,5,4,14,Champions
35964,523,11,17,2,2,2,6,Lost
36177,1006,14,48,2,3,3,8,Casual Users
36252,3,104,837,5,5,5,15,Champions
36732,1,46,201,5,5,5,15,Champions
36863,167,29,55,3,4,3,10,Loyal Users
36889,1093,6,12,2,1,1,4,Lost
36969,792,52,109,2,5,4,11,At Risk
37384,571,9,13,2,2,1,5,Lost
37391,3663,11,47,1,2,3,6,Lost
37443,167,16,39,3,3,3,9,Loyal Users
37492,97,30,125,4,4,4,12,Champions
37504,173,87,150,3,5,5,13,Loyal Users
38340,9,18,24,5,3,2,10,Loyal Users
38468,5138,6,7,1,1,1,3,Lost
38573,306,13,20,3,3,2,8,Loyal Users
39023,120,53,155,4,5,5,14,Champions
26698,303,21,27,3,3,2,8,Loyal Users
26771,273,12,25,3,3,2,8,Loyal Users
26855,415,25,79,3,4,4,11,Loyal Users
26942,1562,7,11,1,2,1,4,Lost
27109,102,26,58,4,4,3,11,Loyal Users
27117,1253,9,14,2,2,1,5,Lost
27198,1414,9,24,1,2,2,5,Lost
27230,20,8,9,5,2,1,8,Promising
27402,277,36,138,3,4,4,11,Loyal Users
27622,146,19,77,4,3,4,11,Loyal Users
28025,89,15,92,4,3,4,11,Loyal Users
28091,12,11,42,5,2,3,10,Promising
28111,3082,6,7,1,1,1,3,Lost
28141,438,26,85,3,4,4,11,Loyal Users
28329,1468,57,83,1,5,4,10,At Risk
28398,145,55,320,4,5,5,14,Champions
28691,1461,15,36,1,3,3,7,Casual Users
29185,398,9,16,3,2,2,7,Casual Users
29738,119,10,63,4,2,4,10,Promising
29790,326,44,216,3,4,5,12,Loyal Users
30154,219,17,55,3,3,3,9,Loyal Users
30180,1659,6,12,1,1,1,3,Lost
30201,1779,6,18,1,1,2,4,Lost
30591,118,58,85,4,5,4,13,Champions
31073,424,25,30,3,4,2,9,Loyal Users
31091,55,36,77,5,4,4,13,Champions
31152,69,68,281,5,5,5,15,Champions
31687,961,9,13,2,2,1,5,Lost
31986,163,145,348,4,5,5,14,Champions
32163,128,52,295,4,5,5,14,Champions
32360,2700,13,17,1,3,2,6,Casual Users
32405,160,29,42,4,4,3,11,Loyal Users
32430,634,32,219,2,4,5,11,At Risk
32599,117,32,67,4,4,4,12,Champions
32637,223,24,88,3,4,4,11,Loyal Users
32714,7,14,21,5,3,2,10,Loyal Users
32796,82,14,56,4,3,3,10,Loyal Users
32907,3,86,138,5,5,4,14,Champions
33122,173,9,15,3,2,1,6,Casual Users
33145,643,27,88,2,4,4,10,At Risk
33184,304,15,29,3,3,2,8,Loyal Users
33398,729,10,11,2,2,1,5,Lost
33982,411,43,73,3,4,4,11,Loyal Users
34090,3,120,178,5,5,5,15,Champions
34334,175,130,195,3,5,5,13,Loyal Users
34422,532,10,12,2,2,1,5,Lost
34452,718,75,167,2,5,5,12,At Risk
34698,24,17,36,5,3,3,11,Loyal Users
35240,1103,8,9,2,2,1,5,Lost
35272,807,13,46,2,3,3,8,Casual Users
35543,418,20,40,3,3,3,9,Loyal Users
35767,541,25,42,2,4,3,9,At Risk
35985,326,54,173,3,5,5,13,Loyal Users
36210,1877,9,29,1,2,2,5,Lost
36241,127,81,121,4,5,4,13,Champions
36305,130,122,425,4,5,5,14,Champions
36315,146,86,290,4,5,5,14,Champions
36343,505,17,20,2,3,2,7,Casual Users
36394,383,40,94,3,4,4,11,Loyal Users
36440,383,6,7,3,1,1,5,Casual Users
36584,311,70,237,3,5,5,13,Loyal Users
36678,1183,7,13,2,2,1,5,Lost
36857,94,50,138,4,5,4,13,Champions
36865,37,17,53,5,3,3,11,Loyal Users
36910,1318,9,63,1,2,4,7,Lost
37086,161,8,17,4,2,2,8,Promising
37295,3354,7,8,1,2,1,4,Lost
37348,589,94,191,2,5,5,12,At Risk
37436,453,9,17,3,2,2,7,Casual Users
37463,934,5,7,2,1,1,4,Lost
37737,10,45,131,5,4,4,13,Champions
37899,432,32,47,3,4,3,10,Loyal Users
38528,1105,14,34,2,3,3,8,Casual Users
38735,13,82,150,5,5,5,15,Champions
38858,56,12,13,5,3,1,9,Loyal Users
38994,0,61,181,5,5,5,15,Champions
39021,3593,6,7,1,1,1,3,Lost
39104,4848,7,15,1,2,1,4,Lost
39117,1,54,141,5,5,4,14,Champions
26588,54,6,14,5,1,1,7,Promising
26741,6,21,72,5,3,4,12,Loyal Users
26794,918,13,40,2,3,3,8,Casual Users
26848,84,94,226,4,5,5,14,Champions
27160,1260,12,12,1,3,1,5,Casual Users
27197,1495,19,65,1,3,4,8,Casual Users
27386,761,29,39,2,4,3,9,At Risk
27661,4116,11,15,1,2,1,4,Lost
27758,1084,6,9,2,1,1,4,Lost
28221,453,18,82,3,3,4,10,Loyal Users
28228,250,24,44,3,4,3,10,Loyal Users
28235,16,24,62,5,4,3,12,Loyal Users
28910,139,8,12,4,2,1,7,Promising
29031,28,83,149,5,5,5,15,Champions
29289,2446,12,16,1,3,2,6,Casual Users
29329,67,36,147,5,4,5,14,Champions
29339,640,22,37,2,4,3,9,At Risk
29602,976,13,54,2,3,3,8,Casual Users
29918,1710,21,45,1,3,3,7,Casual Users
30063,18,38,237,5,4,5,14,Champions
30109,403,12,16,3,3,2,8,Loyal Users
30117,949,22,68,2,4,4,10,At Risk
30177,265,6,17,3,1,2,6,Casual Users
30286,553,6,26,2,1,2,5,Lost
30288,1398,7,8,1,2,1,4,Lost
30667,572,8,9,2,2,1,5,Lost
30728,2414,5,5,1,1,1,3,Lost
30939,646,5,7,2,1,1,4,Lost
31165,3,79,103,5,5,4,14,Champions
31229,2966,5,5,1,1,1,3,Lost
31351,191,42,66,3,4,4,11,Loyal Users
31826,271,35,303,3,4,5,12,Loyal Users
31963,1866,8,11,1,2,1,4,Lost
32155,4068,10,18,1,2,2,5,Lost
32160,1018,5,6,2,1,1,4,Lost
32270,261,23,64,3,4,4,11,Loyal Users
32548,1077,10,14,2,2,1,5,Lost
32816,672,56,256,2,5,5,12,At Risk
33007,30,25,206,5,4,5,14,Champions
33036,521,48,172,2,5,5,12,At Risk
33415,446,31,62,3,4,3,10,Loyal Users
33586,134,10,27,4,2,2,8,Promising
34143,16,20,32,5,3,3,11,Loyal Users
34259,19,85,332,5,5,5,15,Champions
34365,472,13,24,2,3,2,7,Casual Users
34703,2549,5,37,1,1,3,5,Lost
35420,940,6,15,2,1,1,4,Lost
35523,849,11,37,2,2,3,7,Lost
35715,144,58,161,4,5,5,14,Champions
35812,3815,7,25,1,2,2,5,Lost
36787,275,13,32,3,3,3,9,Loyal Users
36974,2851,9,11,1,2,1,4,Lost
37020,169,7,9,3,2,1,6,Casual Users
37938,23,39,47,5,4,3,12,Loyal Users
37941,715,6,12,2,1,1,4,Lost
38365,371,24,41,3,4,3,10,Loyal Users
38654,4503,6,14,1,1,1,3,Lost
39004,1571,6,15,1,1,1,3,Lost
39116,1419,6,12,1,1,1,3,Lost
26737,406,6,14,3,1,1,5,Casual Users
27222,417,17,34,3,3,3,9,Loyal Users
27312,1394,6,8,1,1,1,3,Lost
27559,148,59,147,4,5,5,14,Champions
27730,46,166,958,5,5,5,15,Champions
27763,694,6,8,2,1,1,4,Lost
27839,27,95,221,5,5,5,15,Champions
28244,383,107,165,3,5,5,13,Loyal Users
28489,837,6,31,2,1,2,5,Lost
28601,1726,5,8,1,1,1,3,Lost
28941,1104,10,12,2,2,1,5,Lost
29257,726,6,12,2,1,1,4,Lost
29357,121,10,16,4,2,2,8,Promising
29663,99,24,36,4,4,3,11,Loyal Users
30558,84,52,95,4,5,4,13,Champions
30621,54,94,155,5,5,5,15,Champions
30673,161,32,68,4,4,4,12,Champions
31523,380,17,47,3,3,3,9,Loyal Users
31863,172,8,12,3,2,1,6,Casual Users
32183,6,24,44,5,4,3,12,Loyal Users
32261,312,48,92,3,5,4,12,Loyal Users
32627,150,14,92,4,3,4,11,Loyal Users
33160,31,15,20,5,3,2,10,Loyal Users
33245,1295,9,41,1,2,3,6,Lost
33424,318,45,87,3,4,4,11,Loyal Users
33535,13,147,338,5,5,5,15,Champions
33836,5864,7,13,1,2,1,4,Lost
33976,75,52,164,4,5,5,14,Champions
34481,62,6,13,5,1,1,7,Promising
34528,120,12,27,4,3,2,9,Loyal Users
34699,9,30,54,5,4,3,12,Loyal Users
34779,2122,7,10,1,2,1,4,Lost
34806,5,177,329,5,5,5,15,Champions
34976,440,11,16,3,2,2,7,Casual Users
35051,414,23,32,3,4,3,10,Loyal Users
35083,127,37,125,4,4,4,12,Champions
35274,672,7,7,2,2,1,5,Lost
35319,118,78,222,4,5,5,14,Champions
35439,85,109,343,4,5,5,14,Champions
35453,409,12,47,3,3,3,9,Loyal Users
35518,259,25,80,3,4,4,11,Loyal Users
35545,7,34,92,5,4,4,13,Champions
35640,879,97,192,2,5,5,12,At Risk
35776,9,54,216,5,5,5,15,Champions
35894,546,7,13,2,2,1,5,Lost
36061,907,13,14,2,3,1,6,Casual Users
36217,659,60,80,2,5,4,11,At Risk
36335,3957,11,37,1,2,3,6,Lost
36561,35,5,14,5,1,1,7,Promising
36832,125,67,131,4,5,4,13,Champions
37250,35,68,326,5,5,5,15,Champions
37327,2008,33,161,1,4,5,10,At Risk
37392,704,11,74,2,2,4,8,Lost
38135,926,8,27,2,2,2,6,Lost
38442,3,35,83,5,4,4,13,Champions
39196,65,49,246,5,5,5,15,Champions
39211,207,6,30,3,1,2,6,Casual Users
26672,172,25,46,3,4,3,10,Loyal Users
26716,706,11,69,2,2,4,8,Lost
26774,3,28,59,5,4,3,12,Loyal Users
26981,106,94,308,4,5,5,14,Champions
27072,406,43,291,3,4,5,12,Loyal Users
27445,569,30,61,2,4,3,9,At Risk
27464,353,20,44,3,3,3,9,Loyal Users
27759,398,11,19,3,2,2,7,Casual Users
27792,139,16,23,4,3,2,9,Loyal Users
27899,409,22,40,3,4,3,10,Loyal Users
28037,1022,5,7,2,1,1,4,Lost
28247,468,16,34,3,3,3,9,Loyal Users
28295,157,49,121,4,5,4,13,Champions
28411,929,9,47,2,2,3,7,Lost
28413,832,21,59,2,3,3,8,Casual Users
28724,5523,14,61,1,3,3,7,Casual Users
28726,17,6,10,5,1,1,7,Promising
29102,595,5,11,2,1,1,4,Lost
29254,1421,6,11,1,1,1,3,Lost
29521,1087,11,44,2,2,3,7,Lost
29662,25,131,270,5,5,5,15,Champions
30092,645,5,7,2,1,1,4,Lost
31056,3566,5,5,1,1,1,3,Lost
31262,112,5,14,4,1,1,6,Promising
31571,33,6,43,5,1,3,9,Promising
31854,25,11,17,5,2,2,9,Promising
31972,2810,8,17,1,2,2,5,Lost
32053,29,118,359,5,5,5,15,Champions
32143,844,13,30,2,3,2,7,Casual Users
32263,312,8,9,3,2,1,6,Casual Users
32374,92,122,707,4,5,5,14,Champions
32550,3398,8,10,1,2,1,4,Lost
32571,49,15,77,5,3,4,12,Loyal Users
32994,174,97,577,3,5,5,13,Loyal Users
33052,712,5,9,2,1,1,4,Lost
33406,1261,10,11,1,2,1,4,Lost
33657,1939,16,19,1,3,2,6,Casual Users
33956,67,31,207,5,4,5,14,Champions
34070,1283,8,10,1,2,1,4,Lost
34111,96,107,182,4,5,5,14,Champions
34178,288,5,7,3,1,1,5,Casual Users
34214,2444,7,9,1,2,1,4,Lost
34221,42,27,54,5,4,3,12,Loyal Users
34357,112,29,154,4,4,5,13,Champions
34560,407,9,12,3,2,1,6,Casual Users
34590,18,64,114,5,5,4,14,Champions
34769,11,55,125,5,5,4,14,Champions
34979,690,9,10,2,2,1,5,Lost
35181,137,36,76,4,4,4,12,Champions
35310,1040,25,52,2,4,3,9,At Risk
35551,118,18,27,4,3,2,9,Loyal Users
35638,2116,5,10,1,1,1,3,Lost
35645,1,144,491,5,5,5,15,Champions
35889,1152,7,30,2,2,2,6,Lost
36093,581,18,35,2,3,3,8,Casual Users
36232,2122,6,47,1,1,3,5,Lost
36416,100,17,34,4,3,3,10,Loyal Users
36495,20,22,69,5,4,4,13,Champions
37002,243,10,49,3,2,3,8,Casual Users
37238,576,9,11,2,2,1,5,Lost
37357,196,21,29,3,3,2,8,Loyal Users
37381,292,5,9,3,1,1,5,Casual Users
37661,644,7,77,2,2,4,8,Lost
37805,3776,6,12,1,1,1,3,Lost
37980,493,7,10,2,2,1,5,Lost
38292,409,7,13,3,2,1,6,Casual Users
38713,137,39,99,4,4,4,12,Champions
39166,682,15,74,2,3,4,9,Casual Users
26896,1,63,97,5,5,4,14,Champions
27133,696,5,5,2,1,1,4,Lost
27151,101,17,61,4,3,3,10,Loyal Users
27629,149,43,97,4,4,4,12,Champions
27829,119,18,108,4,3,4,11,Loyal Users
28058,415,62,238,3,5,5,13,Loyal Users
28166,470,13,22,3,3,2,8,Loyal Users
28199,435,7,27,3,2,2,7,Casual Users
28437,31,72,125,5,5,4,14,Champions
28560,233,76,310,3,5,5,13,Loyal Users
28693,2249,16,21,1,3,2,6,Casual Users
29023,279,43,136,3,4,4,11,Loyal Users
29197,3543,5,19,1,1,2,4,Lost
29523,1872,6,15,1,1,1,3,Lost
29556,126,15,24,4,3,2,9,Loyal Users
29625,119,32,109,4,4,4,12,Champions
29949,391,5,25,3,1,2,6,Casual Users
30126,1684,5,20,1,1,2,4,Lost
30334,15,173,383,5,5,5,15,Champions
30384,144,5,9,4,1,1,6,Promising
30464,37,120,335,5,5,5,15,Champions
30702,115,54,77,4,5,4,13,Champions
30739,147,19,41,4,3,3,10,Loyal Users
30785,279,34,54,3,4,3,10,Loyal Users
30867,121,32,53,4,4,3,11,Loyal Users
30990,3673,8,36,1,2,3,6,Lost
31038,154,84,281,4,5,5,14,Champions
31137,47,27,97,5,4,4,13,Champions
31166,211,5,8,3,1,1,5,Casual Users
31347,29,17,19,5,3,2,10,Loyal Users
31647,252,86,189,3,5,5,13,Loyal Users
31880,3549,6,10,1,1,1,3,Lost
32393,1835,15,52,1,3,3,7,Casual Users
32424,1286,17,31,1,3,2,6,Casual Users
32436,103,14,15,4,3,1,8,Loyal Users
32443,104,89,346,4,5,5,14,Champions
32456,658,6,10,2,1,1,4,Lost
32698,702,38,54,2,4,3,9,At Risk
32761,362,29,44,3,4,3,10,Loyal Users
33044,880,13,56,2,3,3,8,Casual Users
33111,408,5,17,3,1,2,6,Casual Users
33578,411,7,20,3,2,2,7,Casual Users
33678,244,25,49,3,4,3,10,Loyal Users
33716,348,6,17,3,1,2,6,Casual Users
33808,23,33,56,5,4,3,12,Loyal Users
34188,42,87,264,5,5,5,15,Champions
34219,7,10,41,5,2,3,10,Promising
34582,1751,7,11,1,2,1,4,Lost
34725,2745,7,7,1,2,1,4,Lost
35127,431,115,177,3,5,5,13,Loyal Users
35213,48,6,27,5,1,2,8,Promising
35483,242,11,49,3,2,3,8,Casual Users
35487,3985,6,25,1,1,2,4,Lost
35494,1445,5,14,1,1,1,3,Lost
35757,793,5,6,2,1,1,4,Lost
35890,152,14,29,4,3,2,9,Loyal Users
36221,4665,14,44,1,3,3,7,Casual Users
37029,154,75,329,4,5,5,14,Champions
37318,94,30,65,4,4,4,12,Champions
37808,39,32,55,5,4,3,12,Loyal Users
37850,665,7,7,2,2,1,5,Lost
37942,411,23,93,3,4,4,11,Loyal Users
38148,1978,10,94,1,2,4,7,Lost
38313,4201,7,21,1,2,2,5,Lost
38403,555,6,10,2,1,1,4,Lost
38499,152,22,80,4,4,4,12,Champions
38646,126,33,140,4,4,4,12,Champions
38979,118,34,69,4,4,4,12,Champions
26494,977,37,60,2,4,3,9,At Risk
26549,414,64,71,3,5,4,12,Loyal Users
26581,4086,5,38,1,1,3,5,Lost
26923,3978,28,81,1,4,4,9,At Risk
26926,2093,8,24,1,2,2,5,Lost
26994,348,40,88,3,4,4,11,Loyal Users
27567,4452,6,10,1,1,1,3,Lost
27615,251,8,35,3,2,3,8,Casual Users
27750,187,9,32,3,2,3,8,Casual Users
27895,455,13,14,3,3,1,7,Loyal Users
28107,1406,8,15,1,2,1,4,Lost
28204,81,65,132,4,5,4,13,Champions
28287,418,11,13,3,2,1,6,Casual Users
28425,482,8,21,2,2,2,6,Lost
28844,117,53,204,4,5,5,14,Champions
28915,907,20,29,2,3,2,7,Casual Users
29351,242,6,15,3,1,1,5,Casual Users
29629,390,20,21,3,3,2,8,Loyal Users
29785,683,6,11,2,1,1,4,Lost
29831,7,133,423,5,5,5,15,Champions
29920,249,52,195,3,5,5,13,Loyal Users
30021,5423,9,42,1,2,3,6,Lost
30437,276,11,23,3,2,2,7,Casual Users
30452,115,36,66,4,4,4,12,Champions
30521,446,7,11,3,2,1,6,Casual Users
30523,92,140,189,4,5,5,14,Champions
30578,285,37,87,3,4,4,11,Loyal Users
30615,259,5,10,3,1,1,5,Casual Users
30656,423,16,29,3,3,2,8,Loyal Users
31123,714,22,34,2,4,3,9,At Risk
31308,45,26,35,5,4,3,12,Loyal Users
31354,111,5,9,4,1,1,6,Promising
32113,1246,7,12,2,2,1,5,Lost
32206,1411,6,8,1,1,1,3,Lost
32593,765,24,80,2,4,4,10,At Risk
32769,772,9,33,2,2,3,7,Lost
32842,446,30,63,3,4,4,11,Loyal Users
33078,45,112,440,5,5,5,15,Champions
33503,1390,5,9,1,1,1,3,Lost
33539,27,92,200,5,5,5,15,Champions
33774,99,24,59,4,4,3,11,Loyal Users
34054,132,30,73,4,4,4,12,Champions
34189,81,9,21,4,2,2,8,Promising
34273,1625,10,18,1,2,2,5,Lost
34561,53,32,74,5,4,4,13,Champions
34872,129,15,23,4,3,2,9,Loyal Users
35317,112,23,92,4,4,4,12,Champions
35378,443,6,17,3,1,2,6,Casual Users
35737,519,11,25,2,2,2,6,Lost
36040,96,19,45,4,3,3,10,Loyal Users
36073,7,71,244,5,5,5,15,Champions
36152,132,14,51,4,3,3,10,Loyal Users
36248,21,60,214,5,5,5,15,Champions
36287,148,12,15,4,3,1,8,Loyal Users
36313,2738,7,7,1,2,1,4,Lost
36393,327,22,46,3,4,3,10,Loyal Users
36449,149,12,51,4,3,3,10,Loyal Users
37340,31,10,31,5,2,2,9,Promising
37407,273,9,12,3,2,1,6,Casual Users
37835,377,14,33,3,3,3,9,Loyal Users
37935,2406,26,124,1,4,4,9,At Risk
37968,1970,9,14,1,2,1,4,Lost
38095,290,32,50,3,4,3,10,Loyal Users
38101,115,14,15,4,3,1,8,Loyal Users
38346,5479,8,92,1,2,4,7,Lost
38415,650,20,61,2,3,3,8,Casual Users
38633,2430,10,41,1,2,3,6,Lost
26680,1180,6,8,2,1,1,4,Lost
27166,696,7,19,2,2,2,6,Lost
27176,18,48,78,5,5,4,14,Champions
27527,123,5,13,4,1,1,6,Promising
27736,843,16,29,2,3,2,7,Casual Users
27881,162,51,177,4,5,5,14,Champions
28594,1421,6,13,1,1,1,3,Lost
28669,102,104,267,4,5,5,14,Champions
28672,135,13,19,4,3,2,9,Loyal Users
28819,287,8,20,3,2,2,7,Casual Users
29172,8,121,246,5,5,5,15,Champions
29267,43,101,230,5,5,5,15,Champions
29810,1076,18,81,2,3,4,9,Casual Users
29816,1552,14,24,1,3,2,6,Casual Users
29906,2130,9,16,1,2,2,5,Lost
30497,614,9,26,2,2,2,6,Lost
30922,28,33,69,5,4,4,13,Champions
31179,105,18,60,4,3,3,10,Loyal Users
31314,1021,7,47,2,2,3,7,Lost
31366,158,66,186,4,5,5,14,Champions
31611,843,9,13,2,2,1,5,Lost
32530,17,83,110,5,5,4,14,Champions
32894,93,6,38,4,1,3,8,Promising
33070,1955,5,12,1,1,1,3,Lost
33323,427,35,156,3,4,5,12,Loyal Users
33551,844,14,45,2,3,3,8,Casual Users
33736,2285,22,36,1,4,3,8,At Risk
33857,13,39,147,5,4,5,14,Champions
33896,65,63,319,5,5,5,15,Champions
34250,1996,5,11,1,1,1,3,Lost
34617,135,47,134,4,5,4,13,Champions
34743,164,24,49,4,4,3,11,Loyal Users
34754,129,18,88,4,3,4,11,Loyal Users
35244,52,191,381,5,5,5,15,Champions
35555,3545,7,30,1,2,2,5,Lost
35577,1725,5,9,1,1,1,3,Lost
35832,2594,5,36,1,1,3,5,Lost
35883,531,55,147,2,5,5,12,At Risk
35891,221,8,10,3,2,1,6,Casual Users
36211,227,25,133,3,4,4,11,Loyal Users
36271,1949,17,35,1,3,3,7,Casual Users
36283,61,51,161,5,5,5,15,Champions
36488,10,112,604,5,5,5,15,Champions
36569,248,59,80,3,5,4,12,Loyal Users
36665,52,9,10,5,2,1,8,Promising
36761,1710,9,35,1,2,3,6,Lost
36763,532,5,6,2,1,1,4,Lost
36833,1112,10,19,2,2,2,6,Lost
36839,93,19,41,4,3,3,10,Loyal Users
36867,9,88,348,5,5,5,15,Champions
37069,131,13,21,4,3,2,9,Loyal Users
37487,178,37,154,3,4,5,12,Loyal Users
37913,151,39,382,4,4,5,13,Champions
38400,10,31,89,5,4,4,13,Champions
38609,505,34,112,2,4,4,10,At Risk
38616,148,64,83,4,5,4,13,Champions
26618,1396,15,98,1,3,4,8,Casual Users
26792,124,15,49,4,3,3,10,Loyal Users
26833,385,17,62,3,3,3,9,Loyal Users
26943,11,133,539,5,5,5,15,Champions
26955,1087,23,29,2,4,2,8,At Risk
27389,252,144,340,3,5,5,13,Loyal Users
27524,74,64,112,4,5,4,13,Champions
27680,435,31,43,3,4,3,10,Loyal Users
27885,15,6,8,5,1,1,7,Promising
28192,5,7,12,5,2,1,8,Promising
28280,2409,7,11,1,2,1,4,Lost
28445,755,26,74,2,4,4,10,At Risk
28448,121,26,89,4,4,4,12,Champions
28764,1247,6,22,2,1,2,5,Lost
28768,304,37,86,3,4,4,11,Loyal Users
28772,124,71,134,4,5,4,13,Champions
28825,38,73,361,5,5,5,15,Champions
28878,175,32,202,3,4,5,12,Loyal Users
28895,455,20,41,3,3,3,9,Loyal Users
29119,2187,5,14,1,1,1,3,Lost
29413,343,69,109,3,5,4,12,Loyal Users
29470,1411,20,42,1,3,3,7,Casual Users
29474,753,30,104,2,4,4,10,At Risk
29585,4121,7,11,1,2,1,4,Lost
30302,1135,29,81,2,4,4,10,At Risk
30406,541,36,74,2,4,4,10,At Risk
30610,237,14,19,3,3,2,8,Loyal Users
30668,1688,11,50,1,2,3,6,Lost
30914,257,73,279,3,5,5,13,Loyal Users
31232,104,38,343,4,4,5,13,Champions
31441,307,47,69,3,5,4,12,Loyal Users
31588,3038,6,12,1,1,1,3,Lost
31657,24,39,193,5,4,5,14,Champions
31864,130,45,100,4,4,4,12,Champions
32110,253,54,270,3,5,5,13,Loyal Users
32116,367,7,23,3,2,2,7,Casual Users
32224,408,5,5,3,1,1,5,Casual Users
32800,1107,12,104,2,3,4,9,Casual Users
32900,851,10,55,2,2,3,7,Lost
33029,3693,7,31,1,2,2,5,Lost
33095,156,49,82,4,5,4,13,Champions
33108,160,118,173,4,5,5,14,Champions
33153,420,16,155,3,3,5,11,Loyal Users
33334,1278,6,48,1,1,3,5,Lost
33598,17,38,77,5,4,4,13,Champions
33709,2732,5,12,1,1,1,3,Lost
33915,2212,23,29,1,4,2,7,At Risk
33990,119,10,21,4,2,2,8,Promising
34323,3816,5,10,1,1,1,3,Lost
34361,2128,5,17,1,1,2,4,Lost
34985,531,7,14,2,2,1,5,Lost
35104,263,118,321,3,5,5,13,Loyal Users
35289,869,8,27,2,2,2,6,Lost
35456,2999,9,31,1,2,2,5,Lost
35916,0,56,178,5,5,5,15,Champions
36116,654,8,10,2,2,1,5,Lost
36304,831,15,169,2,3,5,10,Casual Users
36942,75,109,162,4,5,5,14,Champions
37326,1577,13,24,1,3,2,6,Casual Users
37395,1599,12,13,1,3,1,5,Casual Users
37469,129,27,48,4,4,3,11,Loyal Users
37770,104,31,43,4,4,3,11,Loyal Users
37839,775,29,90,2,4,4,10,At Risk
37901,93,13,41,4,3,3,10,Loyal Users
38094,440,10,12,3,2,1,6,Casual Users
38485,1990,5,20,1,1,2,4,Lost
38492,26,18,65,5,3,4,12,Loyal Users
38498,200,28,36,3,4,3,10,Loyal Users
38964,3210,9,54,1,2,3,6,Lost
39142,1111,8,13,2,2,1,5,Lost
27180,408,8,15,3,2,1,6,Casual Users
27349,3811,5,7,1,1,1,3,Lost
27353,2414,5,14,1,1,1,3,Lost
27576,12,48,144,5,5,4,14,Champions
27752,227,67,71,3,5,4,12,Loyal Users
28113,246,6,6,3,1,1,5,Casual Users
28314,286,30,46,3,4,3,10,Loyal Users
28436,604,49,67,2,5,4,11,At Risk
28467,2630,6,6,1,1,1,3,Lost
28608,24,34,56,5,4,3,12,Loyal Users
28707,2106,5,7,1,1,1,3,Lost
28830,544,20,214,2,3,5,10,Casual Users
28875,253,34,54,3,4,3,10,Loyal Users
29067,219,84,231,3,5,5,13,Loyal Users
29136,597,12,43,2,3,3,8,Casual Users
29533,153,8,34,4,2,3,9,Promising
29773,1119,14,68,2,3,4,9,Casual Users
30056,1,26,76,5,4,4,13,Champions
30127,539,6,10,2,1,1,4,Lost
30166,437,17,60,3,3,3,9,Loyal Users
30344,8,19,21,5,3,2,10,Loyal Users
30526,59,15,75,5,3,4,12,Loyal Users
30858,531,58,92,2,5,4,11,At Risk
30866,3153,5,6,1,1,1,3,Lost
30892,235,11,101,3,2,4,9,Casual Users
31016,1015,7,42,2,2,3,7,Lost
31182,121,66,269,4,5,5,14,Champions
31253,3660,8,13,1,2,1,4,Lost
31651,1226,5,13,2,1,1,4,Lost
31704,1683,13,25,1,3,2,6,Casual Users
31932,4569,5,5,1,1,1,3,Lost
31996,413,24,32,3,4,3,10,Loyal Users
32190,268,24,32,3,4,3,10,Loyal Users
32559,7,124,449,5,5,5,15,Champions
32715,92,25,77,4,4,4,12,Champions
32760,151,10,36,4,2,3,9,Promising
32870,1286,6,6,1,1,1,3,Lost
33148,1264,15,17,1,3,2,6,Casual Users
33151,935,8,52,2,2,3,7,Lost
33172,17,105,387,5,5,5,15,Champions
33202,82,6,48,4,1,3,8,Promising
33219,35,38,205,5,4,5,14,Champions
33253,0,134,667,5,5,5,15,Champions
33449,1562,19,54,1,3,3,7,Casual Users
33618,159,185,326,4,5,5,14,Champions
33668,3132,5,8,1,1,1,3,Lost
33960,241,47,105,3,5,4,12,Loyal Users
34081,36,105,250,5,5,5,15,Champions
34240,842,25,40,2,4,3,9,At Risk
34648,128,18,73,4,3,4,11,Loyal Users
34705,579,29,66,2,4,4,10,At Risk
34739,538,28,89,2,4,4,10,At Risk
35564,92,66,151,4,5,5,14,Champions
35879,2116,22,91,1,4,4,9,At Risk
35887,1094,23,69,2,4,4,10,At Risk
35931,31,5,38,5,1,3,9,Promising
36056,4842,18,26,1,3,2,6,Casual Users
36501,19,69,211,5,5,5,15,Champions
37142,30,8,11,5,2,1,8,Promising
37545,130,84,346,4,5,5,14,Champions
37549,1407,15,19,1,3,2,6,Casual Users
37608,110,70,215,4,5,5,14,Champions
37634,194,15,25,3,3,2,8,Loyal Users
38057,471,11,54,2,2,3,7,Lost
38355,1407,24,41,1,4,3,8,At Risk
38445,147,24,42,4,4,3,11,Loyal Users
26576,714,10,21,2,2,2,6,Lost
26616,188,9,22,3,2,2,7,Casual Users
26882,130,23,106,4,4,4,12,Champions
26897,181,6,11,3,1,1,5,Casual Users
27934,754,22,56,2,4,3,9,At Risk
28007,1246,6,10,2,1,1,4,Lost
28129,2977,13,17,1,3,2,6,Casual Users
28187,1428,14,20,1,3,2,6,Casual Users
28344,406,11,15,3,2,1,6,Casual Users
28357,120,10,62,4,2,3,9,Promising
29025,2008,7,11,1,2,1,4,Lost
29634,27,25,147,5,4,5,14,Champions
29643,970,56,85,2,5,4,11,At Risk
29857,12,22,56,5,4,3,12,Loyal Users
29992,424,8,9,3,2,1,6,Casual Users
30024,18,98,502,5,5,5,15,Champions
30069,8,27,95,5,4,4,13,Champions
30564,1282,20,30,1,3,2,6,Casual Users
30875,527,6,16,2,1,2,5,Lost
30968,73,60,229,4,5,5,14,Champions
31838,23,21,45,5,3,3,11,Loyal Users
32007,1356,8,20,1,2,2,5,Lost
32250,106,123,239,4,5,5,14,Champions
32335,1646,7,14,1,2,1,4,Lost
32471,4311,5,11,1,1,1,3,Lost
32774,12,27,158,5,4,5,14,Champions
32843,35,30,135,5,4,4,13,Champions
33101,3,54,194,5,5,5,15,Champions
33276,20,35,74,5,4,4,13,Champions
33460,2063,12,15,1,3,1,5,Casual Users
33782,827,11,32,2,2,3,7,Lost
33802,266,6,15,3,1,1,5,Casual Users
34381,504,37,80,2,4,4,10,At Risk
34389,11,90,131,5,5,4,14,Champions
34618,74,131,646,4,5,5,14,Champions
34711,118,6,20,4,1,2,7,Promising
35124,402,11,16,3,2,2,7,Casual Users
35300,122,115,240,4,5,5,14,Champions
35587,1114,7,17,2,2,2,6,Lost
35827,2754,18,46,1,3,3,7,Casual Users
36126,2,24,124,5,4,4,13,Champions
36150,602,26,44,2,4,3,9,At Risk
36323,113,15,98,4,3,4,11,Loyal Users
36824,15,19,120,5,3,4,12,Loyal Users
36926,235,5,13,3,1,1,5,Casual Users
37183,418,69,166,3,5,5,13,Loyal Users
37324,422,9,44,3,2,3,8,Casual Users
37494,265,8,52,3,2,3,8,Casual Users
37838,804,14,57,2,3,3,8,Casual Users
37912,563,7,27,2,2,2,6,Lost
38446,3175,64,102,1,5,4,10,At Risk
38992,10,37,137,5,4,4,13,Champions
39202,978,8,22,2,2,2,6,Lost
27170,4540,8,13,1,2,1,4,Lost
27244,62,11,13,5,2,1,8,Promising
27367,1473,5,12,1,1,1,3,Lost
27383,3741,6,14,1,1,1,3,Lost
27866,2800,5,6,1,1,1,3,Lost
28164,37,79,300,5,5,5,15,Champions
28613,32,27,41,5,4,3,12,Loyal Users
28684,2,63,120,5,5,4,14,Champions
28700,407,12,25,3,3,2,8,Loyal Users
28770,440,22,43,3,4,3,10,Loyal Users
29543,1158,21,60,2,3,3,8,Casual Users
29624,195,111,184,3,5,5,13,Loyal Users
29913,137,6,7,4,1,1,6,Promising
30122,828,26,83,2,4,4,10,At Risk
30227,94,118,348,4,5,5,14,Champions
30374,28,6,13,5,1,1,7,Promising
30518,3826,16,65,1,3,4,8,Casual Users
30636,233,18,52,3,3,3,9,Loyal Users
31163,48,69,148,5,5,5,15,Champions
31559,1554,7,11,1,2,1,4,Lost
31562,271,6,12,3,1,1,5,Casual Users
31754,151,45,223,4,4,5,13,Champions
31884,4550,5,7,1,1,1,3,Lost
32273,106,24,71,4,4,4,12,Champions
32582,2723,6,8,1,1,1,3,Lost
32773,223,18,78,3,3,4,10,Loyal Users
33353,874,9,26,2,2,2,6,Lost
33498,1378,31,143,1,4,4,9,At Risk
33600,1098,8,12,2,2,1,5,Lost
33605,296,23,73,3,4,4,11,Loyal Users
33883,135,57,259,4,5,5,14,Champions
33926,1516,40,87,1,4,4,9,At Risk
34154,531,25,93,2,4,4,10,At Risk
34174,691,50,116,2,5,4,11,At Risk
34605,319,56,247,3,5,5,13,Loyal Users
34644,24,63,357,5,5,5,15,Champions
34692,104,28,104,4,4,4,12,Champions
34871,816,26,145,2,4,4,10,At Risk
34903,273,17,70,3,3,4,10,Loyal Users
35074,71,13,60,4,3,3,10,Loyal Users
35799,541,5,15,2,1,1,4,Lost
36203,1959,5,20,1,1,2,4,Lost
36345,566,11,15,2,2,1,5,Lost
36426,139,37,98,4,4,4,12,Champions
36572,448,12,28,3,3,2,8,Loyal Users
36601,2421,8,28,1,2,2,5,Lost
36818,101,48,108,4,5,4,13,Champions
37218,529,6,8,2,1,1,4,Lost
37229,6,24,51,5,4,3,12,Loyal Users
37424,9,35,65,5,4,4,13,Champions
37515,280,10,32,3,2,3,8,Casual Users
37523,199,53,217,3,5,5,13,Loyal Users
37525,2,56,125,5,5,4,14,Champions
38028,30,5,11,5,1,1,7,Promising
38237,434,47,147,3,5,5,13,Loyal Users
26785,433,79,445,3,5,5,13,Loyal Users
26790,1281,7,10,1,2,1,4,Lost
27425,27,83,419,5,5,5,15,Champions
27528,832,27,41,2,4,3,9,At Risk
27755,1338,6,6,1,1,1,3,Lost
28027,1465,7,7,1,2,1,4,Lost
28137,508,32,116,2,4,4,10,At Risk
28162,111,69,200,4,5,5,14,Champions
28263,2817,15,31,1,3,2,6,Casual Users
28758,149,5,26,4,1,2,7,Promising
28899,130,60,346,4,5,5,14,Champions
29306,3,62,112,5,5,4,14,Champions
29481,260,58,90,3,5,4,12,Loyal Users
29484,104,140,536,4,5,5,14,Champions
29759,86,15,59,4,3,3,10,Loyal Users
29805,0,92,725,5,5,5,15,Champions
29948,1151,10,18,2,2,2,6,Lost
30030,9,30,214,5,4,5,14,Champions
30336,466,6,18,3,1,2,6,Casual Users
30362,238,15,127,3,3,4,10,Loyal Users
30392,181,28,137,3,4,4,11,Loyal Users
30723,247,18,60,3,3,3,9,Loyal Users
30807,113,58,128,4,5,4,13,Champions
31021,5001,10,30,1,2,2,5,Lost
31074,263,10,32,3,2,3,8,Casual Users
31089,775,8,23,2,2,2,6,Lost
31306,208,11,26,3,2,2,7,Casual Users
31338,384,5,8,3,1,1,5,Casual Users
31483,40,40,55,5,4,3,12,Loyal Users
31590,2708,21,28,1,3,2,6,Casual Users
31683,81,100,260,4,5,5,14,Champions
31718,158,28,55,4,4,3,11,Loyal Users
32065,4984,17,19,1,3,2,6,Casual Users
32168,1849,16,23,1,3,2,6,Casual Users
32298,4326,31,45,1,4,3,8,At Risk
32375,854,21,50,2,3,3,8,Casual Users
32390,704,18,23,2,3,2,7,Casual Users
32540,76,5,10,4,1,1,6,Promising
32643,155,10,28,4,2,2,8,Promising
32666,28,9,20,5,2,2,9,Promising
32898,101,32,131,4,4,4,12,Champions
33495,386,22,112,3,4,4,11,Loyal Users
33637,458,22,43,3,4,3,10,Loyal Users
34695,2,71,125,5,5,4,14,Champions
34914,101,38,95,4,4,4,12,Champions
35270,1484,5,27,1,1,2,4,Lost
35280,119,13,19,4,3,2,9,Loyal Users
35286,12,178,415,5,5,5,15,Champions
35586,4015,8,37,1,2,3,6,Lost
35634,226,34,181,3,4,5,12,Loyal Users
35848,72,22,234,4,4,5,13,Champions
35893,115,100,710,4,5,5,14,Champions
36191,346,60,77,3,5,4,12,Loyal Users
36294,643,16,34,2,3,3,8,Casual Users
36410,305,37,51,3,4,3,10,Loyal Users
36491,6100,11,11,1,2,1,4,Lost
36696,174,26,92,3,4,4,11,Loyal Users
36843,2735,8,16,1,2,2,5,Lost
36876,200,130,270,3,5,5,13,Loyal Users
36932,5,168,561,5,5,5,15,Champions
37350,3514,10,21,1,2,2,5,Lost
37418,255,8,9,3,2,1,6,Casual Users
37437,127,15,78,4,3,4,11,Loyal Users
37563,254,16,69,3,3,4,10,Loyal Users
38206,120,35,153,4,4,5,13,Champions
38335,1870,9,19,1,2,2,5,Lost
38385,133,58,392,4,5,5,14,Champions
38580,1652,7,11,1,2,1,4,Lost
38746,119,17,38,4,3,3,10,Loyal Users
38753,38,11,25,5,2,2,9,Promising
38785,1866,6,32,1,1,3,5,Lost
38958,2757,11,46,1,2,3,6,Lost
39031,118,33,97,4,4,4,12,Champions
39062,15,162,240,5,5,5,15,Champions
26496,569,8,16,2,2,2,6,Lost
26867,121,67,495,4,5,5,14,Champions
26974,1787,9,11,1,2,1,4,Lost
26982,134,9,107,4,2,4,10,Promising
27091,203,59,225,3,5,5,13,Loyal Users
27209,56,113,346,5,5,5,15,Champions
27299,123,5,24,4,1,2,7,Promising
27845,48,60,322,5,5,5,15,Champions
27889,531,6,74,2,1,4,7,Lost
28342,101,56,321,4,5,5,14,Champions
28681,23,8,16,5,2,2,9,Promising
29265,4155,9,9,1,2,1,4,Lost
29389,153,11,14,4,2,1,7,Promising
29429,3423,5,5,1,1,1,3,Lost
29479,94,20,42,4,3,3,10,Loyal Users
29620,3095,5,19,1,1,2,4,Lost
29965,402,13,13,3,3,1,7,Loyal Users
30090,168,12,31,3,3,2,8,Loyal Users
30191,219,8,33,3,2,3,8,Casual Users
30798,508,5,21,2,1,2,5,Lost
31044,641,17,25,2,3,2,7,Casual Users
31445,1425,8,15,1,2,1,4,Lost
31452,1293,10,24,1,2,2,5,Lost
31953,129,11,32,4,2,3,9,Promising
31989,841,8,15,2,2,1,5,Lost
32040,2089,6,8,1,1,1,3,Lost
32082,118,15,51,4,3,3,10,Loyal Users
32130,81,20,34,4,3,3,10,Loyal Users
32187,2558,7,32,1,2,3,6,Lost
32528,3304,5,8,1,1,1,3,Lost
32660,3,118,559,5,5,5,15,Champions
32734,697,27,92,2,4,4,10,At Risk
32742,108,28,60,4,4,3,11,Loyal Users
32799,304,25,58,3,4,3,10,Loyal Users
32806,723,7,16,2,2,2,6,Lost
32807,782,11,33,2,2,3,7,Lost
32846,134,20,50,4,3,3,10,Loyal Users
34264,1122,6,13,2,1,1,4,Lost
34986,4,35,52,5,4,3,12,Loyal Users
35075,3413,7,17,1,2,2,5,Lost
35156,568,7,20,2,2,2,6,Lost
35216,105,9,33,4,2,3,9,Promising
35424,1431,14,22,1,3,2,6,Casual Users
35825,26,36,61,5,4,3,12,Loyal Users
35921,13,36,65,5,4,4,13,Champions
36104,219,5,8,3,1,1,5,Casual Users
36107,151,44,124,4,4,4,12,Champions
36588,130,24,63,4,4,4,12,Champions
36662,149,99,560,4,5,5,14,Champions
37435,267,35,204,3,4,5,12,Loyal Users
37454,1416,19,32,1,3,3,7,Casual Users
37667,54,52,193,5,5,5,15,Champions
37923,24,79,357,5,5,5,15,Champions
37931,311,8,8,3,2,1,6,Casual Users
38058,425,9,29,3,2,2,7,Casual Users
38114,821,7,10,2,2,1,5,Lost
38216,1158,5,27,2,1,2,5,Lost
38433,87,5,8,4,1,1,6,Promising
26485,2237,7,7,1,2,1,4,Lost
26562,1255,10,25,2,2,2,6,Lost
26610,163,32,98,4,4,4,12,Champions
26650,204,10,87,3,2,4,9,Casual Users
26709,873,10,14,2,2,1,5,Lost
26877,2850,39,79,1,4,4,9,At Risk
27019,131,8,14,4,2,1,7,Promising
27161,126,11,22,4,2,2,8,Promising
27404,2929,5,12,1,1,1,3,Lost
27506,1218,14,17,2,3,2,7,Casual Users
27584,416,16,24,3,3,2,8,Loyal Users
27681,837,10,29,2,2,2,6,Lost
27919,1592,169,484,1,5,5,11,At Risk
28034,867,10,14,2,2,1,5,Lost
28249,116,18,89,4,3,4,11,Loyal Users
28366,738,5,13,2,1,1,4,Lost
28789,113,20,45,4,3,3,10,Loyal Users
28811,150,28,118,4,4,4,12,Champions
29116,358,48,162,3,5,5,13,Loyal Users
29153,1020,93,181,2,5,5,12,At Risk
29797,122,82,304,4,5,5,14,Champions
30325,291,6,9,3,1,1,5,Casual Users
30565,87,39,147,4,4,5,13,Champions
30864,22,10,28,5,2,2,9,Promising
30951,421,31,199,3,4,5,12,Loyal Users
31042,96,60,124,4,5,4,13,Champions
31135,120,13,39,4,3,3,10,Loyal Users
31139,567,21,37,2,3,3,8,Casual Users
31158,1979,6,10,1,1,1,3,Lost
31819,649,20,63,2,3,4,9,Casual Users
32060,498,90,183,2,5,5,12,At Risk
32262,44,79,192,5,5,5,15,Champions
32292,353,8,23,3,2,2,7,Casual Users
32365,43,91,252,5,5,5,15,Champions
32743,3837,9,51,1,2,3,6,Lost
32822,1,40,82,5,4,4,13,Champions
33214,9,12,21,5,3,2,10,Loyal Users
33302,245,5,5,3,1,1,5,Casual Users
33370,2,126,610,5,5,5,15,Champions
33371,67,73,293,5,5,5,15,Champions
33478,1127,5,5,2,1,1,4,Lost
33559,1867,5,5,1,1,1,3,Lost
33732,78,38,128,4,4,4,12,Champions
33823,452,158,486,3,5,5,13,Loyal Users
34044,138,99,398,4,5,5,14,Champions
34473,1462,26,78,1,4,4,9,At Risk
34905,1025,36,67,2,4,4,10,At Risk
35407,90,113,564,4,5,5,14,Champions
35659,3606,7,18,1,2,2,5,Lost
35778,2464,7,15,1,2,1,4,Lost
35828,3737,5,9,1,1,1,3,Lost
36017,1108,213,696,2,5,5,12,At Risk
36228,21,43,205,5,4,5,14,Champions
36231,253,14,22,3,3,2,8,Loyal Users
36373,1123,9,38,2,2,3,7,Lost
36624,4,53,95,5,5,4,14,Champions
36828,695,7,22,2,2,2,6,Lost
36904,578,50,260,2,5,5,12,At Risk
37393,295,31,68,3,4,4,11,Loyal Users
37467,103,31,97,4,4,4,12,Champions
37631,65,53,146,5,5,4,14,Champions
37636,637,30,79,2,4,4,10,At Risk
38018,4010,5,7,1,1,1,3,Lost
38029,236,22,40,3,4,3,10,Loyal Users
38310,2,27,119,5,4,4,13,Champions
38516,580,14,20,2,3,2,7,Casual Users
38880,1,8,22,5,2,2,9,Promising
38900,130,55,127,4,5,4,13,Champions
26510,3106,5,5,1,1,1,3,Lost
26613,413,11,106,3,2,4,9,Casual Users
26789,990,13,13,2,3,1,6,Casual Users
26854,2436,39,95,1,4,4,9,At Risk
26964,1352,11,26,1,2,2,5,Lost
27137,485,14,50,2,3,3,8,Casual Users
27410,116,12,66,4,3,4,11,Loyal Users
27719,44,24,66,5,4,4,13,Champions
27729,111,24,108,4,4,4,12,Champions
27776,683,7,10,2,2,1,5,Lost
28708,88,87,475,4,5,5,14,Champions
28723,2266,6,30,1,1,2,4,Lost
28996,460,56,125,3,5,4,12,Loyal Users
29210,7,66,154,5,5,5,15,Champions
29762,225,28,32,3,4,3,10,Loyal Users
29910,574,12,17,2,3,2,7,Casual Users
30035,1535,6,8,1,1,1,3,Lost
30368,340,9,29,3,2,2,7,Casual Users
30385,2140,19,48,1,3,3,7,Casual Users
30898,34,27,62,5,4,3,12,Loyal Users
30911,957,23,50,2,4,3,9,At Risk
31257,628,17,29,2,3,2,7,Casual Users
31304,1413,29,37,1,4,3,8,At Risk
31529,709,6,7,2,1,1,4,Lost
31561,26,44,178,5,4,5,14,Champions
31866,4449,6,13,1,1,1,3,Lost
32034,100,82,500,4,5,5,14,Champions
32767,380,8,14,3,2,1,6,Casual Users
33472,406,22,125,3,4,4,11,Loyal Users
33492,136,6,9,4,1,1,6,Promising
33710,1,48,166,5,5,5,15,Champions
34008,12,48,142,5,5,4,14,Champions
34258,3055,76,222,1,5,5,11,At Risk
34431,32,138,347,5,5,5,15,Champions
34486,2146,15,39,1,3,3,7,Casual Users
34574,1086,13,22,2,3,2,7,Casual Users
34657,27,124,395,5,5,5,15,Champions
34998,382,46,186,3,5,5,13,Loyal Users
35082,0,17,100,5,3,4,12,Loyal Users
35088,168,13,47,3,3,3,9,Loyal Users
35306,77,13,21,4,3,2,9,Loyal Users
35321,3313,7,26,1,2,2,5,Lost
35621,0,99,542,5,5,5,15,Champions
35791,2662,6,32,1,1,3,5,Lost
36001,78,119,230,4,5,5,14,Champions
36132,325,78,272,3,5,5,13,Loyal Users
36178,327,18,32,3,3,3,9,Loyal Users
36859,722,11,14,2,2,1,5,Lost
37010,171,5,11,3,1,1,5,Casual Users
37319,205,7,8,3,2,1,6,Casual Users
37544,46,41,86,5,4,4,13,Champions
38008,7,54,311,5,5,5,15,Champions
38508,86,40,159,4,4,5,13,Champions
38743,5084,5,8,1,1,1,3,Lost
38889,29,68,94,5,5,4,14,Champions
26806,1414,9,18,1,2,2,5,Lost
27079,2136,5,7,1,1,1,3,Lost
27085,1724,24,50,1,4,3,8,At Risk
27914,264,9,90,3,2,4,9,Casual Users
28022,245,17,35,3,3,3,9,Loyal Users
28261,2121,5,9,1,1,1,3,Lost
28441,439,6,16,3,1,2,6,Casual Users
28769,19,94,664,5,5,5,15,Champions
28786,329,45,185,3,4,5,12,Loyal Users
29015,69,45,209,5,4,5,14,Champions
29034,22,106,239,5,5,5,15,Champions
29059,2447,13,14,1,3,1,5,Casual Users
29288,833,6,7,2,1,1,4,Lost
29371,94,21,23,4,3,2,9,Loyal Users
29642,527,7,18,2,2,2,6,Lost
30184,118,8,18,4,2,2,8,Promising
30239,260,26,38,3,4,3,10,Loyal Users
30943,420,13,33,3,3,3,9,Loyal Users
31013,65,156,342,5,5,5,15,Champions
31034,69,29,87,5,4,4,13,Champions
31062,1454,14,40,1,3,3,7,Casual Users
31064,15,13,27,5,3,2,10,Loyal Users
31106,265,69,201,3,5,5,13,Loyal Users
31428,242,5,5,3,1,1,5,Casual Users
31810,5791,8,41,1,2,3,6,Lost
31894,3599,5,12,1,1,1,3,Lost
32098,63,50,91,5,5,4,14,Champions
32310,14,35,148,5,4,5,14,Champions
32641,41,6,7,5,1,1,7,Promising
32708,834,10,10,2,2,1,5,Lost
32958,652,8,31,2,2,2,6,Lost
32992,2168,5,5,1,1,1,3,Lost
33676,102,25,75,4,4,4,12,Champions
33859,97,6,9,4,1,1,6,Promising
34478,1272,5,22,1,1,2,4,Lost
34520,391,28,39,3,4,3,10,Loyal Users
35336,1900,25,95,1,4,4,9,At Risk
35631,123,26,47,4,4,3,11,Loyal Users
35716,322,12,32,3,3,3,9,Loyal Users
35723,3643,5,7,1,1,1,3,Lost
36199,528,20,27,2,3,2,7,Casual Users
36628,77,9,15,4,2,1,7,Promising
36728,13,37,143,5,4,4,13,Champions
36885,176,6,9,3,1,1,5,Casual Users
37038,86,10,20,4,2,2,8,Promising
37288,66,119,702,5,5,5,15,Champions
37561,414,23,88,3,4,4,11,Loyal Users
37652,222,6,10,3,1,1,5,Casual Users
37952,809,15,50,2,3,3,8,Casual Users
38005,245,189,363,3,5,5,13,Loyal Users
38015,3,16,109,5,3,4,12,Loyal Users
38027,293,6,10,3,1,1,5,Casual Users
38178,574,11,11,2,2,1,5,Lost
38376,170,58,109,3,5,4,12,Loyal Users
38432,297,14,34,3,3,3,9,Loyal Users
38659,219,24,118,3,4,4,11,Loyal Users
38796,842,7,20,2,2,2,6,Lost
38811,781,42,174,2,4,5,11,At Risk
38864,83,7,18,4,2,2,8,Promising
26568,3174,6,18,1,1,2,4,Lost
26761,151,48,106,4,5,4,13,Champions
26914,492,14,50,2,3,3,8,Casual Users
27186,101,61,188,4,5,5,14,Champions
27551,361,15,30,3,3,2,8,Loyal Users
27688,421,9,17,3,2,2,7,Casual Users
27791,16,43,151,5,4,5,14,Champions
27851,372,5,5,3,1,1,5,Casual Users
27858,683,46,88,2,5,4,11,At Risk
28119,20,57,108,5,5,4,14,Champions
28233,1,34,48,5,4,3,12,Loyal Users
28250,3168,8,11,1,2,1,4,Lost
28642,45,31,35,5,4,3,12,Loyal Users
29314,2,50,180,5,5,5,15,Champions
29709,1537,5,7,1,1,1,3,Lost
29720,421,29,89,3,4,4,11,Loyal Users
29884,133,20,183,4,3,5,12,Loyal Users
30013,694,10,51,2,2,3,7,Lost
30059,10,18,51,5,3,3,11,Loyal Users
30187,396,67,133,3,5,4,12,Loyal Users
30348,566,11,56,2,2,3,7,Lost
30381,76,13,34,4,3,3,10,Loyal Users
30500,9,16,77,5,3,4,12,Loyal Users
30865,21,19,53,5,3,3,11,Loyal Users
30882,73,7,13,4,2,1,7,Promising
30890,421,13,51,3,3,3,9,Loyal Users
31138,2847,6,15,1,1,1,3,Lost
31149,134,28,85,4,4,4,12,Champions
31431,17,9,29,5,2,2,9,Promising
31640,409,19,47,3,3,3,9,Loyal Users
31698,90,10,70,4,2,4,10,Promising
31732,142,13,57,4,3,3,10,Loyal Users
31878,706,9,18,2,2,2,6,Lost
31933,84,38,74,4,4,4,12,Champions
32049,59,55,342,5,5,5,15,Champions
32076,478,16,26,2,3,2,7,Casual Users
32295,1421,5,12,1,1,1,3,Lost
32694,320,23,58,3,4,3,10,Loyal Users
32766,779,18,30,2,3,2,7,Casual Users
33514,36,27,142,5,4,4,13,Champions
33658,28,31,98,5,4,4,13,Champions
33695,136,10,59,4,2,3,9,Promising
34375,95,61,127,4,5,4,13,Champions
34839,15,28,75,5,4,4,13,Champions
35091,1445,13,21,1,3,2,6,Casual Users
35512,182,11,44,3,2,3,8,Casual Users
35625,8,34,229,5,4,5,14,Champions
36054,827,31,84,2,4,4,10,At Risk
36521,109,64,102,4,5,4,13,Champions
36539,82,5,12,4,1,1,6,Promising
36976,2136,6,6,1,1,1,3,Lost
37087,515,8,24,2,2,2,6,Lost
38099,264,10,12,3,2,1,6,Casual Users
38126,18,134,389,5,5,5,15,Champions
38193,1274,18,52,1,3,3,7,Casual Users
38591,222,34,72,3,4,4,11,Loyal Users
38696,360,10,17,3,2,2,7,Casual Users
38709,58,126,459,5,5,5,15,Champions
38895,721,56,200,2,5,5,12,At Risk
38963,89,51,106,4,5,4,13,Champions
39076,163,51,407,4,5,5,14,Champions
39173,6,14,37,5,3,3,11,Loyal Users
26770,18,38,229,5,4,5,14,Champions
26812,836,52,113,2,5,4,11,At Risk
27217,538,6,8,2,1,1,4,Lost
27247,22,57,201,5,5,5,15,Champions
27887,0,144,485,5,5,5,15,Champions
27986,2027,8,12,1,2,1,4,Lost
28138,151,18,31,4,3,2,9,Loyal Users
28439,531,6,55,2,1,3,6,Lost
28494,140,8,17,4,2,2,8,Promising
28543,56,101,567,5,5,5,15,Champions
28555,587,11,17,2,2,2,6,Lost
29092,106,14,23,4,3,2,9,Loyal Users
29316,1084,12,24,2,3,2,7,Casual Users
29385,132,18,52,4,3,3,10,Loyal Users
29565,140,79,216,4,5,5,14,Champions
29748,867,11,53,2,2,3,7,Lost
30046,1264,24,77,1,4,4,9,At Risk
30214,1783,10,115,1,2,4,7,Lost
30236,76,127,399,4,5,5,14,Champions
30481,1684,14,107,1,3,4,8,Casual Users
30545,2110,6,11,1,1,1,3,Lost
30585,18,21,155,5,3,5,13,Loyal Users
30905,642,7,17,2,2,2,6,Lost
31531,3437,6,12,1,1,1,3,Lost
31539,53,56,225,5,5,5,15,Champions
31540,695,7,15,2,2,1,5,Lost
31654,165,26,35,4,4,3,11,Loyal Users
31841,1097,7,22,2,2,2,6,Lost
32154,2849,5,7,1,1,1,3,Lost
32288,761,8,32,2,2,3,7,Lost
32373,534,41,114,2,4,4,10,At Risk
32464,8,26,43,5,4,3,12,Loyal Users
32652,5,20,68,5,3,4,12,Loyal Users
32703,195,90,241,3,5,5,13,Loyal Users
32805,476,18,48,2,3,3,8,Casual Users
32956,3707,7,21,1,2,2,5,Lost
32972,488,75,610,2,5,5,12,At Risk
33328,6,24,39,5,4,3,12,Loyal Users
33806,982,8,38,2,2,3,7,Lost
33876,28,77,183,5,5,5,15,Champions
33975,27,100,446,5,5,5,15,Champions
34374,7,54,161,5,5,5,15,Champions
34385,296,6,20,3,1,2,6,Casual Users
34458,7,27,53,5,4,3,12,Loyal Users
34714,1128,7,11,2,2,1,5,Lost
34928,840,25,81,2,4,4,10,At Risk
34991,131,5,21,4,1,2,7,Promising
35115,156,5,6,4,1,1,6,Promising
35313,6,77,520,5,5,5,15,Champions
35475,44,131,1080,5,5,5,15,Champions
35658,5998,6,16,1,1,2,4,Lost
36540,163,19,44,4,3,3,10,Loyal Users
36816,2,107,770,5,5,5,15,Champions
36830,1538,15,69,1,3,4,8,Casual Users
37005,1483,7,8,1,2,1,4,Lost
37064,278,15,26,3,3,2,8,Loyal Users
37103,587,13,20,2,3,2,7,Casual Users
37164,432,50,147,3,5,5,13,Loyal Users
37180,775,7,7,2,2,1,5,Lost
37190,474,20,92,2,3,4,9,Casual Users
37208,108,96,181,4,5,5,14,Champions
37259,264,5,13,3,1,1,5,Casual Users
37547,1839,20,124,1,3,4,8,Casual Users
37894,3095,7,11,1,2,1,4,Lost
37990,76,59,101,4,5,4,13,Champions
38019,33,9,18,5,2,2,9,Promising
38055,1822,9,14,1,2,1,4,Lost
38356,2551,6,98,1,1,4,6,Lost
38443,69,95,216,5,5,5,15,Champions
38480,700,8,50,2,2,3,7,Lost
38490,280,46,155,3,5,5,13,Loyal Users
38558,101,20,41,4,3,3,10,Loyal Users
38749,3,92,357,5,5,5,15,Champions
26515,2533,8,10,1,2,1,4,Lost
26667,12,10,14,5,2,1,8,Promising
26740,650,16,25,2,3,2,7,Casual Users
27141,1456,10,17,1,2,2,5,Lost
27426,284,9,13,3,2,1,6,Casual Users
27526,3468,7,15,1,2,1,4,Lost
27958,4,16,35,5,3,3,11,Loyal Users
28134,30,20,103,5,3,4,12,Loyal Users
28305,592,64,216,2,5,5,12,At Risk
28327,138,24,86,4,4,4,12,Champions
28367,877,24,52,2,4,3,9,At Risk
28587,2138,5,6,1,1,1,3,Lost
28853,419,27,168,3,4,5,12,Loyal Users
28865,225,45,87,3,4,4,11,Loyal Users
29026,144,59,126,4,5,4,13,Champions
29241,53,42,278,5,4,5,14,Champions
29279,64,60,140,5,5,4,14,Champions
29302,1306,27,46,1,4,3,8,At Risk
29402,0,176,593,5,5,5,15,Champions
29505,3032,5,6,1,1,1,3,Lost
30016,833,58,82,2,5,4,11,At Risk
30089,121,10,43,4,2,3,9,Promising
30174,208,10,67,3,2,4,9,Casual Users
30382,1530,10,22,1,2,2,5,Lost
30408,432,6,35,3,1,3,7,Casual Users
30449,845,8,23,2,2,2,6,Lost
30453,118,37,106,4,4,4,12,Champions
30582,119,17,33,4,3,3,10,Loyal Users
31045,82,36,75,4,4,4,12,Champions
31196,1508,5,20,1,1,2,4,Lost
31210,91,14,23,4,3,2,9,Loyal Users
31685,688,8,10,2,2,1,5,Lost
31788,1549,8,26,1,2,2,5,Lost
31789,142,74,116,4,5,4,13,Champions
31797,1440,5,8,1,1,1,3,Lost
32022,20,37,93,5,4,4,13,Champions
32054,28,64,353,5,5,5,15,Champions
32629,29,120,484,5,5,5,15,Champions
32861,835,29,51,2,4,3,9,At Risk
32915,63,40,235,5,4,5,14,Champions
33054,1239,5,5,2,1,1,4,Lost
33113,359,11,141,3,2,4,9,Casual Users
33361,286,41,145,3,4,4,11,Loyal Users
33434,578,8,8,2,2,1,5,Lost
33887,1368,29,71,1,4,4,9,At Risk
34184,8,14,31,5,3,2,10,Loyal Users
34310,12,8,9,5,2,1,8,Promising
34549,129,32,145,4,4,4,12,Champions
34615,2601,14,64,1,3,4,8,Casual Users
34685,806,6,7,2,1,1,4,Lost
34984,265,15,29,3,3,2,8,Loyal Users
35667,307,32,73,3,4,4,11,Loyal Users
35833,2551,8,33,1,2,3,6,Lost
35957,683,10,50,2,2,3,7,Lost
36382,1312,5,11,1,1,1,3,Lost
36798,459,12,58,3,3,3,9,Loyal Users
36864,65,36,199,5,4,5,14,Champions
37252,411,19,29,3,3,2,8,Loyal Users
37458,142,7,19,4,2,2,8,Promising
37870,258,35,48,3,4,3,10,Loyal Users
37951,38,37,134,5,4,4,13,Champions
37969,8,75,330,5,5,5,15,Champions
38009,366,81,574,3,5,5,13,Loyal Users
38331,492,15,23,2,3,2,7,Casual Users
38388,5295,9,18,1,2,2,5,Lost
38924,1,99,180,5,5,5,15,Champions
39009,230,78,141,3,5,4,12,Loyal Users
39186,835,7,55,2,2,3,7,Lost
26572,135,73,94,4,5,4,13,Champions
26670,278,26,44,3,4,3,10,Loyal Users
26968,143,31,55,4,4,3,11,Loyal Users
27122,989,6,7,2,1,1,4,Lost
27306,624,9,10,2,2,1,5,Lost
27362,20,71,268,5,5,5,15,Champions
27715,132,45,104,4,4,4,12,Champions
27825,51,32,108,5,4,4,13,Champions
27876,580,11,24,2,2,2,6,Lost
27999,551,13,15,2,3,1,6,Casual Users
28051,420,41,114,3,4,4,11,Loyal Users
28203,400,10,34,3,2,3,8,Casual Users
28220,1848,6,15,1,1,1,3,Lost
28339,568,18,24,2,3,2,7,Casual Users
28375,43,9,33,5,2,3,10,Promising
28427,362,22,47,3,4,3,10,Loyal Users
28480,5,184,437,5,5,5,15,Champions
29014,33,68,257,5,5,5,15,Champions
29436,221,67,357,3,5,5,13,Loyal Users
29604,3031,6,8,1,1,1,3,Lost
30070,33,104,434,5,5,5,15,Champions
30447,151,32,52,4,4,3,11,Loyal Users
30707,178,8,19,3,2,2,7,Casual Users
30920,663,13,51,2,3,3,8,Casual Users
31000,422,29,98,3,4,4,11,Loyal Users
31327,548,17,61,2,3,3,8,Casual Users
31331,890,12,16,2,3,2,7,Casual Users
31336,1244,7,14,2,2,1,5,Lost
31566,83,58,349,4,5,5,14,Champions
32030,82,50,251,4,5,5,14,Champions
32058,833,6,30,2,1,2,5,Lost
32107,161,31,133,4,4,4,12,Champions
32177,10,58,208,5,5,5,15,Champions
32381,6,21,23,5,3,2,10,Loyal Users
32616,2,7,15,5,2,1,8,Promising
32857,162,55,171,4,5,5,14,Champions
32947,1126,9,14,2,2,1,5,Lost
33038,55,160,607,5,5,5,15,Champions
33127,748,9,23,2,2,2,6,Lost
33644,837,8,10,2,2,1,5,Lost
33795,18,97,296,5,5,5,15,Champions
34139,139,119,286,4,5,5,14,Champions
34455,1688,7,15,1,2,1,4,Lost
34510,2688,5,6,1,1,1,3,Lost
34660,31,87,170,5,5,5,15,Champions
34741,113,87,165,4,5,5,14,Champions
34829,1598,14,53,1,3,3,7,Casual Users
34913,162,12,46,4,3,3,10,Loyal Users
35281,1466,9,26,1,2,2,5,Lost
35807,710,11,19,2,2,2,6,Lost
36094,196,62,138,3,5,4,12,Loyal Users
36360,1829,5,20,1,1,2,4,Lost
36929,147,20,36,4,3,3,10,Loyal Users
37311,82,65,119,4,5,4,13,Champions
37613,1867,9,12,1,2,1,4,Lost
38087,406,13,19,3,3,2,8,Loyal Users
38775,3,155,270,5,5,5,15,Champions
38960,1413,5,6,1,1,1,3,Lost
39061,5141,11,18,1,2,2,5,Lost
26652,941,10,38,2,2,3,7,Lost
26654,134,15,17,4,3,2,9,Loyal Users
26851,1101,11,24,2,2,2,6,Lost
27370,135,79,380,4,5,5,14,Champions
27397,4994,11,32,1,2,3,6,Lost
27732,1133,25,28,2,4,2,8,At Risk
28416,1711,10,18,1,2,2,5,Lost
28471,42,33,119,5,4,4,13,Champions
28907,1123,19,47,2,3,3,8,Casual Users
28993,267,16,75,3,3,4,10,Loyal Users
29181,3799,12,31,1,3,2,6,Casual Users
29260,1064,11,43,2,2,3,7,Lost
29534,301,42,184,3,4,5,12,Loyal Users
29589,549,6,11,2,1,1,4,Lost
29684,132,12,15,4,3,1,8,Loyal Users
30075,153,6,9,4,1,1,6,Promising
30137,44,92,516,5,5,5,15,Champions
30291,402,15,48,3,3,3,9,Loyal Users
30506,280,12,44,3,3,3,9,Loyal Users
30544,72,107,611,4,5,5,14,Champions
31244,101,47,136,4,5,4,13,Champions
31316,179,5,8,3,1,1,5,Casual Users
31720,2797,5,7,1,1,1,3,Lost
31761,5,6,10,5,1,1,7,Promising
31781,471,27,168,2,4,5,11,At Risk
31949,2998,5,6,1,1,1,3,Lost
31993,139,11,50,4,2,3,9,Promising
32316,59,77,289,5,5,5,15,Champions
32378,405,11,15,3,2,1,6,Casual Users
32634,5303,8,10,1,2,1,4,Lost
33034,4274,11,12,1,2,1,4,Lost
33042,1133,9,15,2,2,1,5,Lost
33236,973,11,23,2,2,2,6,Lost
33270,347,7,11,3,2,1,6,Casual Users
33373,135,19,36,4,3,3,10,Loyal Users
33454,830,9,20,2,2,2,6,Lost
33565,7,151,343,5,5,5,15,Champions
34121,621,26,58,2,4,3,9,At Risk
34218,1157,43,77,2,4,4,10,At Risk
34278,130,8,8,4,2,1,7,Promising
34377,4519,6,8,1,1,1,3,Lost
34715,72,20,41,4,3,3,10,Loyal Users
35223,31,86,219,5,5,5,15,Champions
35480,0,103,444,5,5,5,15,Champions
35676,769,15,16,2,3,2,7,Casual Users
35743,105,54,200,4,5,5,14,Champions
35831,132,63,104,4,5,4,13,Champions
36215,27,91,288,5,5,5,15,Champions
36351,610,41,62,2,4,3,9,At Risk
36453,95,31,70,4,4,4,12,Champions
36695,228,29,40,3,4,3,10,Loyal Users
36879,5365,5,12,1,1,1,3,Lost
36944,108,16,88,4,3,4,11,Loyal Users
37601,388,32,92,3,4,4,11,Loyal Users
37766,40,36,159,5,4,5,14,Champions
37795,26,23,82,5,4,4,13,Champions
37880,126,45,199,4,4,5,13,Champions
37911,116,6,6,4,1,1,6,Promising
38131,11,87,259,5,5,5,15,Champions
38231,1132,12,16,2,3,2,7,Casual Users
38302,416,6,7,3,1,1,5,Casual Users
38637,2,37,175,5,4,5,14,Champions
38774,225,27,179,3,4,5,12,Loyal Users
38971,147,22,59,4,4,3,11,Loyal Users
39108,1898,10,21,1,2,2,5,Lost
39215,82,138,302,4,5,5,14,Champions
26625,1437,9,17,1,2,2,5,Lost
26633,861,13,82,2,3,4,9,Casual Users
26948,82,6,15,4,1,1,6,Promising
26995,2409,6,25,1,1,2,4,Lost
27251,810,12,14,2,3,1,6,Casual Users
27283,431,17,26,3,3,2,8,Loyal Users
27348,3554,5,6,1,1,1,3,Lost
27582,686,7,37,2,2,3,7,Lost
27595,3,33,61,5,4,3,12,Loyal Users
27731,252,19,36,3,3,3,9,Loyal Users
27931,156,15,19,4,3,2,9,Loyal Users
28039,171,15,157,3,3,5,11,Loyal Users
28117,200,37,77,3,4,4,11,Loyal Users
28202,3042,9,14,1,2,1,4,Lost
28337,802,9,34,2,2,3,7,Lost
28453,548,29,43,2,4,3,9,At Risk
28540,2117,10,51,1,2,3,6,Lost
28733,42,111,230,5,5,5,15,Champions
28858,238,57,301,3,5,5,13,Loyal Users
29427,1708,11,28,1,2,2,5,Lost
29727,2305,11,11,1,2,1,4,Lost
29871,5,61,102,5,5,4,14,Champions
29882,121,52,247,4,5,5,14,Champions
30074,389,32,112,3,4,4,11,Loyal Users
30229,499,106,243,2,5,5,12,At Risk
30434,5868,5,5,1,1,1,3,Lost
30838,32,109,665,5,5,5,15,Champions
30839,1,32,102,5,4,4,13,Champions
30886,541,17,22,2,3,2,7,Casual Users
31001,991,22,30,2,4,2,8,At Risk
31222,1260,11,32,1,2,3,6,Lost
31534,416,8,22,3,2,2,7,Casual Users
31664,329,7,33,3,2,3,8,Casual Users
32003,819,8,82,2,2,4,8,Lost
32069,414,10,40,3,2,3,8,Casual Users
32300,28,7,38,5,2,3,10,Promising
32481,428,65,467,3,5,5,13,Loyal Users
32758,20,12,12,5,3,1,9,Loyal Users
32964,1563,6,28,1,1,2,4,Lost
32985,229,27,35,3,4,3,10,Loyal Users
33130,1970,8,16,1,2,2,5,Lost
33191,7,146,601,5,5,5,15,Champions
33379,264,29,78,3,4,4,11,Loyal Users
33479,13,42,137,5,4,4,13,Champions
34152,2107,7,10,1,2,1,4,Lost
34459,850,61,136,2,5,4,11,At Risk
34683,2745,5,23,1,1,2,4,Lost
34997,409,6,82,3,1,4,8,Casual Users
35426,69,58,83,5,5,4,14,Champions
35569,28,10,12,5,2,1,8,Promising
35622,768,18,18,2,3,2,7,Casual Users
35650,414,9,71,3,2,4,9,Casual Users
35746,1151,6,9,2,1,1,4,Lost
36037,4618,6,55,1,1,3,5,Lost
36529,5525,13,51,1,3,3,7,Casual Users
36537,2087,5,9,1,1,1,3,Lost
36808,2935,36,169,1,4,5,10,At Risk
37188,4521,10,26,1,2,2,5,Lost
37240,1398,7,10,1,2,1,4,Lost
37282,2246,7,36,1,2,3,6,Lost
37450,79,186,393,4,5,5,14,Champions
37637,2105,7,20,1,2,2,5,Lost
37985,1042,7,7,2,2,1,5,Lost
38271,110,11,23,4,2,2,8,Promising
38462,643,20,38,2,3,3,8,Casual Users
38665,1079,13,27,2,3,2,7,Casual Users
38809,3242,8,21,1,2,2,5,Lost
39220,174,5,5,3,1,1,5,Casual Users
26504,216,27,55,3,4,3,10,Loyal Users
26604,32,5,33,5,1,3,9,Promising
26693,291,5,9,3,1,1,5,Casual Users
26772,61,16,24,5,3,2,10,Loyal Users
26953,144,12,45,4,3,3,10,Loyal Users
27271,976,7,18,2,2,2,6,Lost
27519,527,26,130,2,4,4,10,At Risk
27904,2270,5,10,1,1,1,3,Lost
27949,449,5,8,3,1,1,5,Casual Users
28122,85,53,108,4,5,4,13,Champions
29107,272,11,26,3,2,2,7,Casual Users
29304,1159,13,27,2,3,2,7,Casual Users
29544,5,85,348,5,5,5,15,Champions
29978,112,66,140,4,5,4,13,Champions
30101,531,6,17,2,1,2,5,Lost
30139,149,51,69,4,5,4,13,Champions
30176,25,18,22,5,3,2,10,Loyal Users
30432,2,22,53,5,4,3,12,Loyal Users
30572,424,5,11,3,1,1,5,Casual Users
30619,120,58,119,4,5,4,13,Champions
30687,57,57,279,5,5,5,15,Champions
31110,2229,8,67,1,2,4,7,Lost
31211,706,16,50,2,3,3,8,Casual Users
31278,442,6,16,3,1,2,6,Casual Users
31390,15,88,382,5,5,5,15,Champions
31822,552,5,7,2,1,1,4,Lost
31882,544,17,57,2,3,3,8,Casual Users
32089,270,12,54,3,3,3,9,Loyal Users
32691,98,9,16,4,2,2,8,Promising
32695,460,11,15,3,2,1,6,Casual Users
32751,684,6,12,2,1,1,4,Lost
33143,94,57,314,4,5,5,14,Champions
33259,156,12,29,4,3,2,9,Loyal Users
33290,2147,12,56,1,3,3,7,Casual Users
33684,3069,5,8,1,1,1,3,Lost
33861,831,14,47,2,3,3,8,Casual Users
34220,2,141,529,5,5,5,15,Champions
34291,11,75,232,5,5,5,15,Champions
34406,164,46,145,4,5,4,13,Champions
34572,482,6,10,2,1,1,4,Lost
34784,334,13,24,3,3,2,8,Loyal Users
34861,365,13,52,3,3,3,9,Loyal Users
35180,928,9,14,2,2,1,5,Lost
35305,1928,6,18,1,1,2,4,Lost
35838,647,14,31,2,3,2,7,Casual Users
35854,125,32,65,4,4,4,12,Champions
36070,5,60,206,5,5,5,15,Champions
36330,1555,9,27,1,2,2,5,Lost
36367,3447,8,17,1,2,2,5,Lost
36650,3732,5,5,1,1,1,3,Lost
36672,3,6,11,5,1,1,7,Promising
36850,104,64,279,4,5,5,14,Champions
36901,98,15,27,4,3,2,9,Loyal Users
36967,2836,5,7,1,1,1,3,Lost
37078,1268,19,61,1,3,3,7,Casual Users
37214,99,78,172,4,5,5,14,Champions
37410,2106,9,15,1,2,1,4,Lost
37948,8,102,534,5,5,5,15,Champions
38467,972,18,39,2,3,3,8,Casual Users
38726,1121,9,28,2,2,2,6,Lost
38859,829,30,72,2,4,4,10,At Risk
38957,230,82,189,3,5,5,13,Loyal Users
39285,950,9,22,2,2,2,6,Lost
39432,349,143,430,3,5,5,13,Loyal Users
40011,26,24,168,5,4,5,14,Champions
40107,549,5,16,2,1,2,5,Lost
40335,546,9,16,2,2,2,6,Lost
40383,1458,8,8,1,2,1,4,Lost
40386,1692,12,15,1,3,1,5,Casual Users
40515,101,16,44,4,3,3,10,Loyal Users
40574,1108,6,10,2,1,1,4,Lost
40653,75,131,274,4,5,5,14,Champions
41409,62,109,280,5,5,5,15,Champions
41575,124,22,36,4,4,3,11,Loyal Users
41751,20,33,62,5,4,3,12,Loyal Users
41890,82,10,16,4,2,2,8,Promising
41946,12,126,404,5,5,5,15,Champions
41988,8,76,213,5,5,5,15,Champions
42373,791,11,35,2,2,3,7,Lost
42468,135,21,107,4,3,4,11,Loyal Users
42635,1989,10,27,1,2,2,5,Lost
42834,8,34,140,5,4,4,13,Champions
43103,418,5,5,3,1,1,5,Casual Users
43302,1969,10,67,1,2,4,7,Lost
43527,63,42,76,5,4,4,13,Champions
43688,1395,5,10,1,1,1,3,Lost
43714,251,13,23,3,3,2,8,Loyal Users
43852,2525,7,25,1,2,2,5,Lost
43935,111,52,90,4,5,4,13,Champions
44022,14,52,126,5,5,4,14,Champions
44358,29,35,88,5,4,4,13,Champions
44437,844,6,15,2,1,1,4,Lost
44596,143,8,17,4,2,2,8,Promising
44822,15,12,29,5,3,2,10,Loyal Users
44906,1144,11,21,2,2,2,6,Lost
45011,9,51,76,5,5,4,14,Champions
45307,826,8,15,2,2,1,5,Lost
45341,285,10,14,3,2,1,6,Casual Users
45615,1357,7,58,1,2,3,6,Lost
46266,1699,6,9,1,1,1,3,Lost
46465,589,6,10,2,1,1,4,Lost
46521,5,154,208,5,5,5,15,Champions
46943,87,93,334,4,5,5,14,Champions
46952,549,9,11,2,2,1,5,Lost
46994,104,84,151,4,5,5,14,Champions
47084,2556,7,24,1,2,2,5,Lost
47217,3484,6,33,1,1,3,5,Lost
47283,12,56,221,5,5,5,15,Champions
47501,718,14,22,2,3,2,7,Casual Users
47711,25,84,217,5,5,5,15,Champions
48254,353,15,51,3,3,3,9,Loyal Users
48398,549,20,53,2,3,3,8,Casual Users
48510,2,143,256,5,5,5,15,Champions
48875,424,45,74,3,4,4,11,Loyal Users
49308,459,7,11,3,2,1,6,Casual Users
49331,28,6,27,5,1,2,8,Promising
49717,19,51,69,5,5,4,14,Champions
49855,405,49,100,3,5,4,12,Loyal Users
50223,871,31,52,2,4,3,9,At Risk
50348,387,73,305,3,5,5,13,Loyal Users
50353,23,24,177,5,4,5,14,Champions
51123,347,26,52,3,4,3,10,Loyal Users
51393,218,45,155,3,4,5,12,Loyal Users
51415,2545,5,21,1,1,2,4,Lost
51595,5405,21,26,1,3,2,6,Casual Users
51607,126,69,184,4,5,5,14,Champions
39460,579,57,113,2,5,4,11,At Risk
39513,1201,21,33,2,3,3,8,Casual Users
39582,422,5,5,3,1,1,5,Casual Users
39597,4194,29,68,1,4,4,9,At Risk
40021,415,5,12,3,1,1,5,Casual Users
40199,393,51,210,3,5,5,13,Loyal Users
40332,122,11,17,4,2,2,8,Promising
40439,0,27,68,5,4,4,13,Champions
40542,5,25,151,5,4,5,14,Champions
40687,425,14,37,3,3,3,9,Loyal Users
40893,1998,5,17,1,1,2,4,Lost
40900,725,11,20,2,2,2,6,Lost
41175,1787,16,54,1,3,3,7,Casual Users
41265,2010,8,8,1,2,1,4,Lost
41704,2127,13,26,1,3,2,6,Casual Users
41887,241,7,28,3,2,2,7,Casual Users
42304,427,8,13,3,2,1,6,Casual Users
42348,64,16,128,5,3,4,12,Loyal Users
43256,91,30,129,4,4,4,12,Champions
43270,422,11,18,3,2,2,7,Casual Users
43359,84,11,32,4,2,3,9,Promising
43588,6,33,106,5,4,4,13,Champions
43690,96,9,13,4,2,1,7,Promising
43741,47,15,48,5,3,3,11,Loyal Users
43921,330,59,126,3,5,4,12,Loyal Users
44141,150,50,146,4,5,4,13,Champions
44321,689,10,173,2,2,5,9,Lost
45183,11,49,119,5,5,4,14,Champions
45622,58,5,7,5,1,1,7,Promising
45630,2242,9,56,1,2,3,6,Lost
45634,423,5,5,3,1,1,5,Casual Users
46108,2165,5,11,1,1,1,3,Lost
46147,203,32,122,3,4,4,11,Loyal Users
46209,303,16,38,3,3,3,9,Loyal Users
46255,181,12,15,3,3,1,7,Loyal Users
46448,126,7,24,4,2,2,8,Promising
46491,118,35,154,4,4,5,13,Champions
46778,1229,14,43,2,3,3,8,Casual Users
46938,884,23,92,2,4,4,10,At Risk
47211,3583,8,21,1,2,2,5,Lost
47268,663,14,22,2,3,2,7,Casual Users
47300,1042,8,47,2,2,3,7,Lost
47497,39,104,533,5,5,5,15,Champions
47900,247,41,182,3,4,5,12,Loyal Users
47935,784,19,52,2,3,3,8,Casual Users
48206,20,11,42,5,2,3,10,Promising
48345,127,28,88,4,4,4,12,Champions
48686,154,22,162,4,4,5,13,Champions
48711,696,11,32,2,2,3,7,Lost
48780,4885,7,16,1,2,2,5,Lost
49197,4316,8,8,1,2,1,4,Lost
49449,276,45,77,3,4,4,11,Loyal Users
49476,128,13,32,4,3,3,10,Loyal Users
49699,542,11,20,2,2,2,6,Lost
49869,48,5,23,5,1,2,8,Promising
50451,150,12,16,4,3,2,9,Loyal Users
50546,141,11,18,4,2,2,8,Promising
50581,161,6,43,4,1,3,8,Promising
50732,31,8,73,5,2,4,11,Promising
50954,130,196,309,4,5,5,14,Champions
51142,399,5,22,3,1,2,6,Casual Users
51388,102,32,125,4,4,4,12,Champions
51433,577,6,33,2,1,3,6,Lost
51454,4299,7,28,1,2,2,5,Lost
51622,136,20,51,4,3,3,10,Loyal Users
51801,449,7,37,3,2,3,8,Casual Users
51927,64,57,114,5,5,4,14,Champions
52133,3454,5,11,1,1,1,3,Lost
52264,402,60,131,3,5,4,12,Loyal Users
39433,95,116,170,4,5,5,14,Champions
39742,422,11,37,3,2,3,8,Casual Users
39788,473,5,10,2,1,1,4,Lost
39867,1062,8,41,2,2,3,7,Lost
39977,572,25,48,2,4,3,9,At Risk
40578,2441,19,173,1,3,5,9,Casual Users
40631,713,10,36,2,2,3,7,Lost
41126,4,32,125,5,4,4,13,Champions
41496,442,8,19,3,2,2,7,Casual Users
41696,214,13,99,3,3,4,10,Loyal Users
41913,412,13,24,3,3,2,8,Loyal Users
42102,95,44,88,4,4,4,12,Champions
42613,181,21,62,3,3,3,9,Loyal Users
42926,151,5,21,4,1,2,7,Promising
43010,11,20,75,5,3,4,12,Loyal Users
43370,193,24,76,3,4,4,11,Loyal Users
43938,13,9,18,5,2,2,9,Promising
44205,90,91,239,4,5,5,14,Champions
44398,440,31,58,3,4,3,10,Loyal Users
44553,133,8,10,4,2,1,7,Promising
44884,908,16,60,2,3,3,8,Casual Users
45054,2155,10,86,1,2,4,7,Lost
45211,1079,9,28,2,2,2,6,Lost
45731,1396,11,15,1,2,1,4,Lost
46306,477,33,89,2,4,4,10,At Risk
46362,54,175,497,5,5,5,15,Champions
46555,132,7,13,4,2,1,7,Promising
46608,3297,15,41,1,3,3,7,Casual Users
46781,1280,131,305,1,5,5,11,At Risk
46818,1018,33,48,2,4,3,9,At Risk
46819,670,5,5,2,1,1,4,Lost
47231,1533,5,11,1,1,1,3,Lost
47496,459,5,63,3,1,4,8,Casual Users
47573,5,51,281,5,5,5,15,Champions
47753,5231,10,11,1,2,1,4,Lost
48035,10,155,496,5,5,5,15,Champions
48244,18,89,239,5,5,5,15,Champions
48316,253,34,242,3,4,5,12,Loyal Users
48838,113,115,411,4,5,5,14,Champions
48880,697,18,55,2,3,3,8,Casual Users
48942,0,83,259,5,5,5,15,Champions
48979,898,5,13,2,1,1,4,Lost
49101,7,10,40,5,2,3,10,Promising
49503,177,43,119,3,4,4,11,Loyal Users
49686,100,35,58,4,4,3,11,Loyal Users
49748,3284,5,6,1,1,1,3,Lost
50021,33,15,29,5,3,2,10,Loyal Users
50090,434,32,62,3,4,3,10,Loyal Users
50320,301,170,305,3,5,5,13,Loyal Users
50340,623,21,227,2,3,5,10,Casual Users
50343,995,12,44,2,3,3,8,Casual Users
50792,1506,5,25,1,1,2,4,Lost
50847,12,8,13,5,2,1,8,Promising
51022,67,42,481,5,4,5,14,Champions
51243,132,7,46,4,2,3,9,Promising
51640,461,12,20,3,3,2,8,Loyal Users
51914,5977,10,36,1,2,3,6,Lost
52100,978,13,22,2,3,2,7,Casual Users
52288,892,5,6,2,1,1,4,Lost
52338,14,107,518,5,5,5,15,Champions
39671,1426,5,15,1,1,1,3,Lost
39827,2024,20,40,1,3,3,7,Casual Users
40132,271,23,46,3,4,3,10,Loyal Users
40165,113,59,437,4,5,5,14,Champions
40256,139,5,17,4,1,2,7,Promising
40261,696,12,18,2,3,2,7,Casual Users
40677,95,12,14,4,3,1,8,Loyal Users
40824,669,10,16,2,2,2,6,Lost
41037,385,6,24,3,1,2,6,Casual Users
41085,419,12,27,3,3,2,8,Loyal Users
41141,271,36,40,3,4,3,10,Loyal Users
41530,389,14,28,3,3,2,8,Loyal Users
42397,363,12,13,3,3,1,7,Loyal Users
42754,5,91,152,5,5,5,15,Champions
42942,613,7,130,2,2,4,8,Lost
43108,37,49,155,5,5,5,15,Champions
43109,39,32,149,5,4,5,14,Champions
43260,99,41,48,4,4,3,11,Loyal Users
43307,126,7,12,4,2,1,7,Promising
44505,125,6,17,4,1,2,7,Promising
44588,46,21,38,5,3,3,11,Loyal Users
44595,127,21,43,4,3,3,10,Loyal Users
44623,106,50,264,4,5,5,14,Champions
44653,284,38,82,3,4,4,11,Loyal Users
44691,2237,10,10,1,2,1,4,Lost
44740,297,6,17,3,1,2,6,Casual Users
44776,144,114,438,4,5,5,14,Champions
44792,36,36,94,5,4,4,13,Champions
45027,575,10,16,2,2,2,6,Lost
45030,174,42,66,3,4,4,11,Loyal Users
45127,1472,12,88,1,3,4,8,Casual Users
45151,236,78,314,3,5,5,13,Loyal Users
45621,404,8,47,3,2,3,8,Casual Users
45628,1,132,395,5,5,5,15,Champions
45769,81,100,190,4,5,5,14,Champions
45895,540,6,11,2,1,1,4,Lost
45962,88,81,204,4,5,5,14,Champions
45978,8,41,141,5,4,4,13,Champions
46030,10,49,61,5,5,3,13,Loyal Users
46423,47,66,474,5,5,5,15,Champions
46971,1437,11,34,1,2,3,6,Lost
47013,1429,6,8,1,1,1,3,Lost
47622,131,31,98,4,4,4,12,Champions
47671,965,23,131,2,4,4,10,At Risk
47766,43,194,329,5,5,5,15,Champions
48127,357,17,22,3,3,2,8,Loyal Users
48308,344,15,91,3,3,4,10,Loyal Users
48401,4288,17,18,1,3,2,6,Casual Users
48623,157,40,196,4,4,5,13,Champions
48795,1039,6,51,2,1,3,6,Lost
49171,4,86,508,5,5,5,15,Champions
49429,1132,7,14,2,2,1,5,Lost
49607,29,26,254,5,4,5,14,Champions
49662,132,148,537,4,5,5,14,Champions
49668,791,58,163,2,5,5,12,At Risk
49696,541,5,15,2,1,1,4,Lost
49814,146,13,24,4,3,2,9,Loyal Users
50202,20,39,194,5,4,5,14,Champions
50309,2319,5,6,1,1,1,3,Lost
50610,368,37,77,3,4,4,11,Loyal Users
50612,124,19,42,4,3,3,10,Loyal Users
50754,256,7,16,3,2,2,7,Casual Users
50803,8,19,54,5,3,3,11,Loyal Users
50963,2008,13,31,1,3,2,6,Casual Users
51086,459,5,6,3,1,1,5,Casual Users
51455,310,8,14,3,2,1,6,Casual Users
51629,348,19,56,3,3,3,9,Loyal Users
39259,447,12,106,3,3,4,10,Loyal Users
39357,181,23,33,3,4,3,10,Loyal Users
39696,543,12,154,2,3,5,10,Casual Users
39721,4506,17,29,1,3,2,6,Casual Users
39832,47,104,382,5,5,5,15,Champions
39859,110,15,32,4,3,3,10,Loyal Users
39903,5280,12,33,1,3,3,7,Casual Users
39971,1496,13,46,1,3,3,7,Casual Users
40292,360,31,96,3,4,4,11,Loyal Users
40459,1900,10,26,1,2,2,5,Lost
40670,675,7,56,2,2,3,7,Lost
40799,106,57,273,4,5,5,14,Champions
40912,289,44,136,3,4,4,11,Loyal Users
41068,3,34,154,5,4,5,14,Champions
41623,424,14,39,3,3,3,9,Loyal Users
41768,3538,20,62,1,3,3,7,Casual Users
41821,56,5,8,5,1,1,7,Promising
41838,103,17,54,4,3,3,10,Loyal Users
42132,595,5,27,2,1,2,5,Lost
42167,724,6,38,2,1,3,6,Lost
42172,1118,39,261,2,4,5,11,At Risk
42349,368,11,16,3,2,2,7,Casual Users
42381,100,10,24,4,2,2,8,Promising
42540,287,17,43,3,3,3,9,Loyal Users
42589,72,58,149,4,5,5,14,Champions
42609,94,10,14,4,2,1,7,Promising
42817,606,6,6,2,1,1,4,Lost
43007,439,5,12,3,1,1,5,Casual Users
43286,225,6,34,3,1,3,7,Casual Users
43540,14,150,552,5,5,5,15,Champions
44630,1693,8,11,1,2,1,4,Lost
44807,410,14,39,3,3,3,9,Loyal Users
44942,4574,14,17,1,3,2,6,Casual Users
45043,357,14,45,3,3,3,9,Loyal Users
45227,729,9,37,2,2,3,7,Lost
45629,735,36,175,2,4,5,11,At Risk
45783,420,11,20,3,2,2,7,Casual Users
46217,20,41,147,5,4,5,14,Champions
46274,91,131,595,4,5,5,14,Champions
46974,38,31,49,5,4,3,12,Loyal Users
46980,700,5,13,2,1,1,4,Lost
47263,112,32,211,4,4,5,13,Champions
47434,3669,5,5,1,1,1,3,Lost
47457,2641,42,64,1,4,4,9,At Risk
47655,14,30,299,5,4,5,14,Champions
47664,171,16,29,3,3,2,8,Loyal Users
47744,1809,5,22,1,1,2,4,Lost
47799,1232,5,5,2,1,1,4,Lost
48482,458,23,83,3,4,4,11,Loyal Users
48729,33,122,359,5,5,5,15,Champions
48908,2740,5,8,1,1,1,3,Lost
49241,171,59,114,3,5,4,12,Loyal Users
49310,435,22,45,3,4,3,10,Loyal Users
49329,315,6,18,3,1,2,6,Casual Users
49405,37,7,15,5,2,1,8,Promising
49650,1392,5,15,1,1,1,3,Lost
49692,423,11,17,3,2,2,7,Casual Users
49713,11,31,109,5,4,4,13,Champions
49882,988,12,13,2,3,1,6,Casual Users
50155,128,9,57,4,2,3,9,Promising
50516,1428,5,11,1,1,1,3,Lost
50584,2844,21,61,1,3,3,7,Casual Users
51127,615,25,64,2,4,4,10,At Risk
51156,129,31,80,4,4,4,12,Champions
51350,18,73,136,5,5,4,14,Champions
51514,251,51,73,3,5,4,12,Loyal Users
51769,59,56,317,5,5,5,15,Champions
52071,221,67,78,3,5,4,12,Loyal Users
52239,575,5,9,2,1,1,4,Lost
52262,2035,5,6,1,1,1,3,Lost
39409,1271,16,21,1,3,2,6,Casual Users
39420,4,47,81,5,5,4,14,Champions
39487,959,32,46,2,4,3,9,At Risk
39488,106,55,153,4,5,5,14,Champions
39769,232,32,65,3,4,4,11,Loyal Users
39787,89,9,49,4,2,3,9,Promising
40391,467,13,21,3,3,2,8,Loyal Users
40590,878,7,19,2,2,2,6,Lost
40655,144,86,105,4,5,4,13,Champions
40821,47,34,310,5,4,5,14,Champions
41065,752,11,13,2,2,1,5,Lost
41114,84,23,52,4,4,3,11,Loyal Users
41477,115,9,25,4,2,2,8,Promising
41780,83,24,43,4,4,3,11,Loyal Users
41788,4011,5,11,1,1,1,3,Lost
41827,80,35,77,4,4,4,12,Champions
41845,16,20,77,5,3,4,12,Loyal Users
42280,320,15,108,3,3,4,10,Loyal Users
42550,1883,8,14,1,2,1,4,Lost
42661,99,55,251,4,5,5,14,Champions
42666,964,68,100,2,5,4,11,At Risk
43177,174,29,43,3,4,3,10,Loyal Users
43675,15,83,168,5,5,5,15,Champions
43689,267,10,21,3,2,2,7,Casual Users
44354,234,41,107,3,4,4,11,Loyal Users
44543,264,39,220,3,4,5,12,Loyal Users
44636,1477,6,16,1,1,2,4,Lost
44819,3,74,168,5,5,5,15,Champions
45019,168,9,32,3,2,3,8,Casual Users
45248,1835,7,13,1,2,1,4,Lost
45337,3581,5,25,1,1,2,4,Lost
45627,309,9,15,3,2,1,6,Casual Users
45754,1817,5,6,1,1,1,3,Lost
45822,424,6,13,3,1,1,5,Casual Users
45850,1419,9,30,1,2,2,5,Lost
45891,124,28,112,4,4,4,12,Champions
46070,420,31,59,3,4,3,10,Loyal Users
46374,407,76,99,3,5,4,12,Loyal Users
46479,686,22,34,2,4,3,9,At Risk
46483,557,28,124,2,4,4,10,At Risk
46887,2,39,55,5,4,3,12,Loyal Users
46916,631,76,211,2,5,5,12,At Risk
47250,569,7,27,2,2,2,6,Lost
47455,430,19,47,3,3,3,9,Loyal Users
48109,26,7,9,5,2,1,8,Promising
48192,281,7,40,3,2,3,8,Casual Users
48451,851,16,38,2,3,3,8,Casual Users
48502,102,51,200,4,5,5,14,Champions
48530,177,10,66,3,2,4,9,Casual Users
48872,851,15,31,2,3,2,7,Casual Users
48997,706,18,123,2,3,4,9,Casual Users
49043,214,60,263,3,5,5,13,Loyal Users
49181,411,77,213,3,5,5,13,Loyal Users
49678,676,12,13,2,3,1,6,Casual Users
49767,5,48,181,5,5,5,15,Champions
49828,1688,9,9,1,2,1,4,Lost
49914,77,68,225,4,5,5,14,Champions
50393,119,40,77,4,4,4,12,Champions
50526,71,70,383,4,5,5,14,Champions
50616,3847,7,10,1,2,1,4,Lost
50846,311,6,28,3,1,2,6,Casual Users
51099,379,24,48,3,4,3,10,Loyal Users
51214,110,74,139,4,5,4,13,Champions
51306,788,17,40,2,3,3,8,Casual Users
51408,119,59,151,4,5,5,14,Champions
51594,12,31,122,5,4,4,13,Champions
51631,1819,6,7,1,1,1,3,Lost
51783,825,6,19,2,1,2,5,Lost
51979,3873,5,10,1,1,1,3,Lost
52060,694,9,58,2,2,3,7,Lost
52107,422,14,15,3,3,1,7,Loyal Users
52195,1,58,233,5,5,5,15,Champions
52315,226,15,30,3,3,2,8,Loyal Users
39517,108,47,124,4,5,4,13,Champions
40016,96,35,120,4,4,4,12,Champions
40032,5225,5,20,1,1,2,4,Lost
40131,2279,16,23,1,3,2,6,Casual Users
40496,262,27,70,3,4,4,11,Loyal Users
40503,2416,7,10,1,2,1,4,Lost
40945,23,27,198,5,4,5,14,Champions
40970,107,58,96,4,5,4,13,Champions
41817,25,13,45,5,3,3,11,Loyal Users
41849,225,20,55,3,3,3,9,Loyal Users
41924,235,5,12,3,1,1,5,Casual Users
42310,214,14,29,3,3,2,8,Loyal Users
42430,1704,12,52,1,3,3,7,Casual Users
42506,1401,9,19,1,2,2,5,Lost
42545,1095,11,17,2,2,2,6,Lost
42727,90,48,110,4,5,4,13,Champions
42735,191,16,30,3,3,2,8,Loyal Users
42780,120,5,11,4,1,1,6,Promising
42988,694,20,40,2,3,3,8,Casual Users
43045,123,21,24,4,3,2,9,Loyal Users
43212,2652,6,11,1,1,1,3,Lost
43411,2040,18,22,1,3,2,6,Casual Users
43925,851,19,207,2,3,5,10,Casual Users
45196,2417,6,49,1,1,3,5,Lost
45677,542,12,45,2,3,3,8,Casual Users
45684,867,8,31,2,2,2,6,Lost
45868,4,21,92,5,3,4,12,Loyal Users
45975,57,5,6,5,1,1,7,Promising
46074,135,11,14,4,2,1,7,Promising
46130,1487,24,31,1,4,2,7,At Risk
46149,3,19,52,5,3,3,11,Loyal Users
46167,167,77,337,3,5,5,13,Loyal Users
46347,800,8,15,2,2,1,5,Lost
46442,749,14,25,2,3,2,7,Casual Users
46450,970,7,18,2,2,2,6,Lost
46477,239,8,9,3,2,1,6,Casual Users
46693,453,18,77,3,3,4,10,Loyal Users
46801,2413,12,14,1,3,1,5,Casual Users
46852,2137,34,59,1,4,3,8,At Risk
47116,1854,7,18,1,2,2,5,Lost
47178,7,6,10,5,1,1,7,Promising
47666,40,14,28,5,3,2,10,Loyal Users
47983,473,5,9,2,1,1,4,Lost
48065,152,72,661,4,5,5,14,Champions
48191,292,82,149,3,5,5,13,Loyal Users
48233,108,5,9,4,1,1,6,Promising
48234,426,6,32,3,1,3,7,Casual Users
48289,989,20,31,2,3,2,7,Casual Users
48309,13,38,92,5,4,4,13,Champions
48409,464,5,10,3,1,1,5,Casual Users
48488,163,94,401,4,5,5,14,Champions
49182,632,23,42,2,4,3,9,At Risk
49202,171,30,59,3,4,3,10,Loyal Users
49267,117,24,174,4,4,5,13,Champions
49318,17,17,41,5,3,3,11,Loyal Users
50106,0,28,101,5,4,4,13,Champions
50190,98,7,9,4,2,1,7,Promising
50405,0,29,71,5,4,4,13,Champions
50417,863,11,35,2,2,3,7,Lost
50814,3123,6,19,1,1,2,4,Lost
51377,1464,10,56,1,2,3,6,Lost
51743,246,72,90,3,5,4,12,Loyal Users
52080,1629,8,8,1,2,1,4,Lost
52214,3421,5,7,1,1,1,3,Lost
39300,446,60,150,3,5,5,13,Loyal Users
40665,1368,6,8,1,1,1,3,Lost
40758,4955,24,53,1,4,3,8,At Risk
40796,1954,10,10,1,2,1,4,Lost
40892,24,33,148,5,4,5,14,Champions
41011,258,37,60,3,4,3,10,Loyal Users
41095,524,15,75,2,3,4,9,Casual Users
41102,3783,19,20,1,3,2,6,Casual Users
41164,502,8,38,2,2,3,7,Lost
41285,7,43,77,5,4,4,13,Champions
41326,1841,15,18,1,3,2,6,Casual Users
41418,31,10,27,5,2,2,9,Promising
41510,809,6,9,2,1,1,4,Lost
41814,81,15,28,4,3,2,9,Loyal Users
42119,10,50,133,5,5,4,14,Champions
42129,1048,6,29,2,1,2,5,Lost
42202,43,22,87,5,4,4,13,Champions
42235,38,11,75,5,2,4,11,Promising
42270,271,81,335,3,5,5,13,Loyal Users
42644,87,45,76,4,4,4,12,Champions
42675,430,16,29,3,3,2,8,Loyal Users
43084,295,16,42,3,3,3,9,Loyal Users
43106,1866,9,9,1,2,1,4,Lost
43409,248,62,149,3,5,5,13,Loyal Users
43499,1022,6,28,2,1,2,5,Lost
43801,1137,7,14,2,2,1,5,Lost
43943,74,38,157,4,4,5,13,Champions
44123,133,58,321,4,5,5,14,Champions
44309,408,15,34,3,3,3,9,Loyal Users
44644,14,116,367,5,5,5,15,Champions
45215,1847,5,14,1,1,1,3,Lost
45251,735,16,50,2,3,3,8,Casual Users
45394,106,37,117,4,4,4,12,Champions
45781,113,7,11,4,2,1,7,Promising
46076,4666,7,14,1,2,1,4,Lost
46172,56,27,189,5,4,5,14,Champions
46210,366,6,12,3,1,1,5,Casual Users
46366,135,11,74,4,2,4,10,Promising
46579,82,113,565,4,5,5,14,Champions
46586,16,6,9,5,1,1,7,Promising
46739,2402,5,44,1,1,3,5,Lost
46752,707,6,10,2,1,1,4,Lost
47159,42,24,72,5,4,4,13,Champions
47233,1120,22,109,2,4,4,10,At Risk
47242,140,38,54,4,4,3,11,Loyal Users
47606,1512,7,14,1,2,1,4,Lost
48238,101,64,233,4,5,5,14,Champions
48342,42,21,64,5,3,4,12,Loyal Users
48599,13,104,324,5,5,5,15,Champions
48804,354,12,14,3,3,1,7,Loyal Users
49070,603,33,72,2,4,4,10,At Risk
49094,1690,5,20,1,1,2,4,Lost
49453,2513,5,12,1,1,1,3,Lost
49769,1262,22,52,1,4,3,8,At Risk
49919,95,19,65,4,3,4,11,Loyal Users
49937,122,13,94,4,3,4,11,Loyal Users
50461,472,12,44,2,3,3,8,Casual Users
50518,405,17,28,3,3,2,8,Loyal Users
50617,2,70,259,5,5,5,15,Champions
50903,892,56,87,2,5,4,11,At Risk
51407,431,18,28,3,3,2,8,Loyal Users
51920,111,12,22,4,3,2,9,Loyal Users
51949,417,26,62,3,4,3,10,Loyal Users
51959,409,96,349,3,5,5,13,Loyal Users
52218,411,30,98,3,4,4,11,Loyal Users
52246,1124,36,45,2,4,3,9,At Risk
39310,3011,5,9,1,1,1,3,Lost
39550,73,35,209,4,4,5,13,Champions
39621,8,33,66,5,4,4,13,Champions
39951,564,10,87,2,2,4,8,Lost
40203,567,6,7,2,1,1,4,Lost
40253,436,7,22,3,2,2,7,Casual Users
40254,98,65,171,4,5,5,14,Champions
40343,1958,20,49,1,3,3,7,Casual Users
40600,118,60,336,4,5,5,14,Champions
41185,2985,6,41,1,1,3,5,Lost
41615,2820,7,27,1,2,2,5,Lost
42537,127,23,89,4,4,4,12,Champions
43140,19,24,111,5,4,4,13,Champions
43194,270,6,102,3,1,4,8,Casual Users
43386,109,26,76,4,4,4,12,Champions
43401,67,6,17,5,1,2,8,Promising
43419,806,33,44,2,4,3,9,At Risk
43522,119,12,67,4,3,4,11,Loyal Users
43821,1368,5,5,1,1,1,3,Lost
44224,676,10,13,2,2,1,5,Lost
44441,411,15,104,3,3,4,10,Loyal Users
44913,3387,18,36,1,3,3,7,Casual Users
45085,119,99,134,4,5,4,13,Champions
45111,464,7,10,3,2,1,6,Casual Users
45324,585,20,58,2,3,3,8,Casual Users
45398,1412,7,7,1,2,1,4,Lost
45995,710,6,11,2,1,1,4,Lost
46063,440,27,65,3,4,4,11,Loyal Users
46420,2160,17,17,1,3,2,6,Casual Users
46433,654,6,6,2,1,1,4,Lost
46708,479,35,54,2,4,3,9,At Risk
46722,2624,8,10,1,2,1,4,Lost
46784,2041,65,289,1,5,5,11,At Risk
46909,143,65,246,4,5,5,14,Champions
46954,38,54,290,5,5,5,15,Champions
47097,11,52,370,5,5,5,15,Champions
47337,35,99,157,5,5,5,15,Champions
47618,832,5,7,2,1,1,4,Lost
47682,124,22,89,4,4,4,12,Champions
47806,20,81,167,5,5,5,15,Champions
47989,137,36,181,4,4,5,13,Champions
48078,29,11,109,5,2,4,11,Promising
48195,13,64,166,5,5,5,15,Champions
48549,3,42,102,5,4,4,13,Champions
49076,15,81,369,5,5,5,15,Champions
49122,123,10,25,4,2,2,8,Promising
49325,266,6,11,3,1,1,5,Casual Users
49377,245,8,17,3,2,2,7,Casual Users
49851,942,11,44,2,2,3,7,Lost
50108,72,99,284,4,5,5,14,Champions
50629,113,17,118,4,3,4,11,Loyal Users
50876,1997,12,14,1,3,1,5,Casual Users
50899,3389,6,24,1,1,2,4,Lost
51071,2925,6,34,1,1,3,5,Lost
51209,90,92,465,4,5,5,14,Champions
51373,317,8,17,3,2,2,7,Casual Users
52143,920,9,10,2,2,1,5,Lost
40008,52,39,403,5,4,5,14,Champions
40258,2055,10,26,1,2,2,5,Lost
40493,8,54,107,5,5,4,14,Champions
40849,42,51,91,5,5,4,14,Champions
41419,4,38,70,5,4,4,13,Champions
41990,1099,6,19,2,1,2,5,Lost
42177,424,9,9,3,2,1,6,Casual Users
42533,41,19,44,5,3,3,11,Loyal Users
42783,137,5,5,4,1,1,6,Promising
43946,233,45,225,3,4,5,12,Loyal Users
44095,1149,22,29,2,4,2,8,At Risk
44159,880,14,30,2,3,2,7,Casual Users
44203,660,7,9,2,2,1,5,Lost
44557,1577,11,14,1,2,1,4,Lost
44859,4772,5,7,1,1,1,3,Lost
44979,2157,9,51,1,2,3,6,Lost
45069,268,48,84,3,5,4,12,Loyal Users
45292,1499,6,6,1,1,1,3,Lost
45777,1022,24,40,2,4,3,9,At Risk
45802,690,24,68,2,4,4,10,At Risk
45991,1823,21,236,1,3,5,9,Casual Users
45999,448,37,140,3,4,4,11,Loyal Users
46049,149,18,38,4,3,3,10,Loyal Users
46601,1710,5,14,1,1,1,3,Lost
46908,55,22,46,5,4,3,12,Loyal Users
47238,2,20,115,5,3,4,12,Loyal Users
47712,1415,26,59,1,4,3,8,At Risk
47724,9,52,332,5,5,5,15,Champions
47751,179,6,13,3,1,1,5,Casual Users
47834,848,10,25,2,2,2,6,Lost
48102,5,17,49,5,3,3,11,Loyal Users
48403,1834,5,5,1,1,1,3,Lost
48662,4038,7,7,1,2,1,4,Lost
48805,110,84,261,4,5,5,14,Champions
49061,13,28,58,5,4,3,12,Loyal Users
49106,901,40,40,2,4,3,9,At Risk
49425,334,29,52,3,4,3,10,Loyal Users
49435,380,11,15,3,2,1,6,Casual Users
49712,281,10,68,3,2,4,9,Casual Users
49809,1845,9,16,1,2,2,5,Lost
50624,531,18,36,2,3,3,8,Casual Users
50685,262,18,32,3,3,3,9,Loyal Users
51095,1821,5,5,1,1,1,3,Lost
51501,956,6,28,2,1,2,5,Lost
39385,60,14,58,5,3,3,11,Loyal Users
39525,191,9,69,3,2,4,9,Casual Users
39717,679,11,72,2,2,4,8,Lost
39929,260,66,320,3,5,5,13,Loyal Users
39930,426,31,57,3,4,3,10,Loyal Users
40061,91,20,31,4,3,2,9,Loyal Users
40585,208,13,151,3,3,5,11,Loyal Users
40658,868,12,27,2,3,2,7,Casual Users
40736,2108,7,24,1,2,2,5,Lost
40946,3282,5,7,1,1,1,3,Lost
41556,2,104,231,5,5,5,15,Champions
41725,41,78,257,5,5,5,15,Champions
41738,4378,6,9,1,1,1,3,Lost
41832,90,9,60,4,2,3,9,Promising
42033,593,11,43,2,2,3,7,Lost
42391,988,12,63,2,3,4,9,Casual Users
42777,146,27,86,4,4,4,12,Champions
42958,12,26,55,5,4,3,12,Loyal Users
43018,1561,5,7,1,1,1,3,Lost
43190,2633,12,21,1,3,2,6,Casual Users
43458,547,8,11,2,2,1,5,Lost
43474,15,87,113,5,5,4,14,Champions
43953,6139,5,23,1,1,2,4,Lost
44008,422,9,20,3,2,2,7,Casual Users
44018,132,34,136,4,4,4,12,Champions
44111,11,138,447,5,5,5,15,Champions
44148,1147,14,45,2,3,3,8,Casual Users
44211,812,18,72,2,3,4,9,Casual Users
44234,1,11,13,5,2,1,8,Promising
44407,1280,5,5,1,1,1,3,Lost
44428,7,63,134,5,5,4,14,Champions
44522,697,51,267,2,5,5,12,At Risk
44570,2689,8,21,1,2,2,5,Lost
44766,724,6,13,2,1,1,4,Lost
44949,106,136,679,4,5,5,14,Champions
44968,863,26,107,2,4,4,10,At Risk
44995,24,80,202,5,5,5,15,Champions
45026,1462,8,13,1,2,1,4,Lost
45367,303,22,99,3,4,4,11,Loyal Users
46011,90,158,410,4,5,5,14,Champions
46506,9,31,220,5,4,5,14,Champions
46546,279,6,8,3,1,1,5,Casual Users
46759,822,57,355,2,5,5,12,At Risk
46833,122,47,216,4,5,5,14,Champions
46851,16,20,30,5,3,2,10,Loyal Users
46886,108,41,74,4,4,4,12,Champions
46929,95,12,26,4,3,2,9,Loyal Users
47246,3423,6,22,1,1,2,4,Lost
47272,3003,5,15,1,1,1,3,Lost
47320,211,10,16,3,2,2,7,Casual Users
47346,8,33,159,5,4,5,14,Champions
47372,0,107,696,5,5,5,15,Champions
47471,543,5,23,2,1,2,5,Lost
47774,132,21,26,4,3,2,9,Loyal Users
47866,1,96,137,5,5,4,14,Champions
47987,3230,13,20,1,3,2,6,Casual Users
48145,3320,7,7,1,2,1,4,Lost
48659,2118,9,29,1,2,2,5,Lost
49051,135,5,10,4,1,1,6,Promising
49251,4550,5,11,1,1,1,3,Lost
49345,2086,5,26,1,1,2,4,Lost
49790,263,26,32,3,4,3,10,Loyal Users
50483,148,43,336,4,4,5,13,Champions
50747,1963,5,8,1,1,1,3,Lost
50994,1,39,196,5,4,5,14,Champions
51036,1274,105,206,1,5,5,11,At Risk
51091,3306,6,11,1,1,1,3,Lost
51194,3222,5,13,1,1,1,3,Lost
51321,114,22,61,4,4,3,11,Loyal Users
51418,197,10,56,3,2,3,8,Casual Users
51536,65,72,156,5,5,5,15,Champions
51754,6,36,42,5,4,3,12,Loyal Users
52137,127,7,27,4,2,2,8,Promising
52297,536,5,27,2,1,2,5,Lost
39445,97,20,67,4,3,4,11,Loyal Users
39681,562,7,19,2,2,2,6,Lost
39790,263,38,70,3,4,4,11,Loyal Users
39852,342,9,27,3,2,2,7,Casual Users
40739,56,16,20,5,3,2,10,Loyal Users
41207,74,41,149,4,4,5,13,Champions
41275,1542,6,26,1,1,2,4,Lost
41281,140,11,26,4,2,2,8,Promising
41552,4,68,247,5,5,5,15,Champions
41577,18,20,31,5,3,2,10,Loyal Users
41639,195,58,98,3,5,4,12,Loyal Users
41647,336,7,25,3,2,2,7,Casual Users
42017,2422,7,23,1,2,2,5,Lost
42024,971,38,272,2,4,5,11,At Risk
42178,92,46,69,4,5,4,13,Champions
42187,1849,7,9,1,2,1,4,Lost
42317,1583,48,369,1,5,5,11,At Risk
42358,456,95,450,3,5,5,13,Loyal Users
42520,18,11,14,5,2,1,8,Promising
42546,24,36,75,5,4,4,13,Champions
42623,289,6,11,3,1,1,5,Casual Users
42824,104,25,59,4,4,3,11,Loyal Users
42890,5425,26,47,1,4,3,8,At Risk
43747,85,129,537,4,5,5,14,Champions
43799,2131,18,26,1,3,2,6,Casual Users
44142,109,82,267,4,5,5,14,Champions
44316,311,7,9,3,2,1,6,Casual Users
44472,412,7,45,3,2,3,8,Casual Users
44515,978,24,96,2,4,4,10,At Risk
44601,166,10,26,3,2,2,7,Casual Users
44777,7,26,213,5,4,5,14,Champions
44941,50,11,26,5,2,2,9,Promising
45266,3275,12,21,1,3,2,6,Casual Users
45427,475,5,17,2,1,2,5,Lost
45650,103,10,15,4,2,1,7,Promising
45713,78,5,9,4,1,1,6,Promising
46238,822,8,36,2,2,3,7,Lost
46339,4696,5,7,1,1,1,3,Lost
46340,0,52,196,5,5,5,15,Champions
46685,1107,30,35,2,4,3,9,At Risk
46757,583,6,20,2,1,2,5,Lost
47102,5,46,104,5,5,4,14,Champions
47129,839,8,27,2,2,2,6,Lost
47252,2417,14,46,1,3,3,7,Casual Users
47310,12,70,202,5,5,5,15,Champions
47415,30,6,48,5,1,3,9,Promising
47506,44,100,112,5,5,4,14,Champions
47597,1035,6,14,2,1,1,4,Lost
47614,22,23,66,5,4,4,13,Champions
48076,3321,5,9,1,1,1,3,Lost
48077,969,20,117,2,3,4,9,Casual Users
48174,1739,8,20,1,2,2,5,Lost
48352,21,27,35,5,4,3,12,Loyal Users
48789,5,108,663,5,5,5,15,Champions
49442,2865,17,69,1,3,4,8,Casual Users
50292,844,5,10,2,1,1,4,Lost
50349,131,6,13,4,1,1,6,Promising
50641,1534,15,116,1,3,4,8,Casual Users
50905,524,24,130,2,4,4,10,At Risk
50918,546,9,43,2,2,3,7,Lost
51031,148,9,35,4,2,3,9,Promising
51372,141,9,30,4,2,2,8,Promising
51571,815,5,21,2,1,2,5,Lost
51994,326,18,76,3,3,4,10,Loyal Users
52130,76,119,371,4,5,5,14,Champions
39400,69,19,61,5,3,3,11,Loyal Users
39427,714,10,15,2,2,1,5,Lost
39476,7,137,397,5,5,5,15,Champions
39626,722,7,20,2,2,2,6,Lost
39641,1807,7,9,1,2,1,4,Lost
39716,92,21,43,4,3,3,10,Loyal Users
39916,15,82,265,5,5,5,15,Champions
40110,853,5,15,2,1,1,4,Lost
40238,6,109,362,5,5,5,15,Champions
40276,1007,12,29,2,3,2,7,Casual Users
40288,706,24,78,2,4,4,10,At Risk
40423,145,51,94,4,5,4,13,Champions
40482,10,115,520,5,5,5,15,Champions
40513,116,31,49,4,4,3,11,Loyal Users
40528,230,13,35,3,3,3,9,Loyal Users
40889,1659,7,8,1,2,1,4,Lost
41203,496,6,27,2,1,2,5,Lost
41399,28,10,36,5,2,3,10,Promising
41911,200,21,34,3,3,3,9,Loyal Users
41978,96,11,23,4,2,2,8,Promising
42020,2291,21,65,1,3,4,8,Casual Users
42184,2701,7,9,1,2,1,4,Lost
42260,402,5,11,3,1,1,5,Casual Users
42773,272,17,27,3,3,2,8,Loyal Users
42977,1514,6,11,1,1,1,3,Lost
43149,130,26,53,4,4,3,11,Loyal Users
43384,13,10,19,5,2,2,9,Promising
43504,24,52,98,5,5,4,14,Champions
43891,52,8,14,5,2,1,8,Promising
44093,428,99,172,3,5,5,13,Loyal Users
44102,68,7,14,5,2,1,8,Promising
44139,129,5,13,4,1,1,6,Promising
44370,837,36,209,2,4,5,11,At Risk
44470,109,8,14,4,2,1,7,Promising
44545,572,18,61,2,3,3,8,Casual Users
44620,233,10,25,3,2,2,7,Casual Users
44631,1215,11,17,2,2,2,6,Lost
44669,29,11,41,5,2,3,10,Promising
45182,3861,6,8,1,1,1,3,Lost
45224,3443,6,6,1,1,1,3,Lost
45274,56,51,430,5,5,5,15,Champions
45815,119,125,175,4,5,5,14,Champions
45955,4,7,25,5,2,2,9,Promising
46166,184,19,44,3,3,3,9,Loyal Users
46170,25,176,842,5,5,5,15,Champions
46280,20,20,78,5,3,4,12,Loyal Users
47044,5,12,16,5,3,2,10,Loyal Users
47951,0,33,132,5,4,4,13,Champions
48565,14,14,30,5,3,2,10,Loyal Users
48871,87,77,134,4,5,4,13,Champions
49036,673,13,18,2,3,2,7,Casual Users
49328,4282,5,6,1,1,1,3,Lost
49807,304,10,11,3,2,1,6,Casual Users
49890,59,79,447,5,5,5,15,Champions
49963,184,66,572,3,5,5,13,Loyal Users
50034,5823,5,5,1,1,1,3,Lost
50284,1581,6,32,1,1,3,5,Lost
50354,73,206,317,4,5,5,14,Champions
50359,544,25,116,2,4,4,10,At Risk
50402,2900,7,19,1,2,2,5,Lost
50509,2572,12,21,1,3,2,6,Casual Users
51224,1116,5,8,2,1,1,4,Lost
51510,62,61,245,5,5,5,15,Champions
51820,1766,8,9,1,2,1,4,Lost
51844,1701,7,9,1,2,1,4,Lost
51911,241,66,146,3,5,4,12,Loyal Users
52109,51,107,208,5,5,5,15,Champions
52110,3546,23,48,1,4,3,8,At Risk
52275,735,14,39,2,3,3,8,Casual Users
39351,1255,5,5,2,1,1,4,Lost
40164,348,8,11,3,2,1,6,Casual Users
40295,91,32,108,4,4,4,12,Champions
40315,4803,8,20,1,2,2,5,Lost
40547,120,53,77,4,5,4,13,Champions
40647,63,9,21,5,2,2,9,Promising
40707,148,5,31,4,1,2,7,Promising
41006,44,110,565,5,5,5,15,Champions
41231,1975,6,8,1,1,1,3,Lost
41369,142,6,15,4,1,1,6,Promising
41389,393,43,268,3,4,5,12,Loyal Users
41539,323,57,190,3,5,5,13,Loyal Users
41772,1997,14,34,1,3,3,7,Casual Users
42107,1516,5,7,1,1,1,3,Lost
42181,22,5,8,5,1,1,7,Promising
42231,12,46,82,5,5,4,14,Champions
42671,55,78,277,5,5,5,15,Champions
42733,2633,7,14,1,2,1,4,Lost
42755,25,132,720,5,5,5,15,Champions
42807,23,31,46,5,4,3,12,Loyal Users
42826,2,33,84,5,4,4,13,Champions
43072,30,13,25,5,3,2,10,Loyal Users
43239,1281,5,9,1,1,1,3,Lost
43274,149,7,9,4,2,1,7,Promising
43443,262,30,56,3,4,3,10,Loyal Users
43738,6033,8,22,1,2,2,5,Lost
43978,2402,6,35,1,1,3,5,Lost
44379,708,10,19,2,2,2,6,Lost
44430,154,5,15,4,1,1,6,Promising
44552,941,9,12,2,2,1,5,Lost
44882,724,11,25,2,2,2,6,Lost
44911,302,7,18,3,2,2,7,Casual Users
44964,37,69,145,5,5,4,14,Champions
45016,2729,8,19,1,2,2,5,Lost
45046,133,44,306,4,4,5,13,Champions
45053,26,21,44,5,3,3,11,Loyal Users
45062,2,80,277,5,5,5,15,Champions
45377,121,117,478,4,5,5,14,Champions
45432,439,7,27,3,2,2,7,Casual Users
45606,42,38,96,5,4,4,13,Champions
45789,302,24,33,3,4,3,10,Loyal Users
45907,1,23,94,5,4,4,13,Champions
47149,5272,11,21,1,2,2,5,Lost
47183,442,89,416,3,5,5,13,Loyal Users
47209,124,44,170,4,4,5,13,Champions
47302,101,31,223,4,4,5,13,Champions
47507,2425,8,52,1,2,3,6,Lost
47856,320,18,41,3,3,3,9,Loyal Users
48426,9,130,312,5,5,5,15,Champions
49040,2336,5,19,1,1,2,4,Lost
49226,388,15,17,3,3,2,8,Loyal Users
49825,702,5,16,2,1,2,5,Lost
49901,956,53,119,2,5,4,11,At Risk
49924,183,8,29,3,2,2,7,Casual Users
50121,1092,31,47,2,4,3,9,At Risk
50686,825,9,18,2,2,2,6,Lost
51047,1787,5,44,1,1,3,5,Lost
51075,92,11,30,4,2,2,8,Promising
51750,28,61,127,5,5,4,14,Champions
51971,2730,7,21,1,2,2,5,Lost
52128,139,34,62,4,4,3,11,Loyal Users
39253,257,5,10,3,1,1,5,Casual Users
39266,87,25,54,4,4,3,11,Loyal Users
39479,1237,8,20,2,2,2,6,Lost
39555,384,32,64,3,4,4,11,Loyal Users
39879,105,46,117,4,5,4,13,Champions
39932,3831,10,18,1,2,2,5,Lost
40146,115,56,100,4,5,4,13,Champions
40157,357,67,334,3,5,5,13,Loyal Users
40187,28,110,347,5,5,5,15,Champions
40310,729,16,37,2,3,3,8,Casual Users
40320,2261,26,29,1,4,2,7,At Risk
40469,4,167,316,5,5,5,15,Champions
40608,5,26,89,5,4,4,13,Champions
40890,17,73,215,5,5,5,15,Champions
40973,135,91,143,4,5,4,13,Champions
40987,56,67,270,5,5,5,15,Champions
41270,171,38,135,3,4,4,11,Loyal Users
42031,1108,14,22,2,3,2,7,Casual Users
42637,287,5,13,3,1,1,5,Casual Users
42833,164,5,19,4,1,2,7,Promising
43057,65,49,78,5,5,4,14,Champions
43085,1586,27,41,1,4,3,8,At Risk
43417,162,34,82,4,4,4,12,Champions
43561,101,11,66,4,2,4,10,Promising
43604,29,77,229,5,5,5,15,Champions
43774,65,72,197,5,5,5,15,Champions
44193,436,9,15,3,2,1,6,Casual Users
44282,432,7,12,3,2,1,6,Casual Users
44292,221,23,60,3,4,3,10,Loyal Users
44720,252,33,111,3,4,4,11,Loyal Users
44735,146,24,198,4,4,5,13,Champions
44846,1101,200,615,2,5,5,12,At Risk
45068,455,13,60,3,3,3,9,Loyal Users
45566,110,56,160,4,5,5,14,Champions
45828,43,22,65,5,4,4,13,Champions
45829,195,45,90,3,4,4,11,Loyal Users
46073,6,51,88,5,5,4,14,Champions
46087,58,15,25,5,3,2,10,Loyal Users
46314,118,39,130,4,4,4,12,Champions
46577,566,11,35,2,2,3,7,Lost
46797,75,6,13,4,1,1,6,Promising
46840,27,35,57,5,4,3,12,Loyal Users
46880,308,39,53,3,4,3,10,Loyal Users
46932,959,6,10,2,1,1,4,Lost
47068,413,39,117,3,4,4,11,Loyal Users
47103,5,126,430,5,5,5,15,Champions
47588,64,8,25,5,2,2,9,Promising
48190,420,22,39,3,4,3,10,Loyal Users
48235,109,36,162,4,4,5,13,Champions
48285,20,85,439,5,5,5,15,Champions
48435,1168,17,18,2,3,2,7,Casual Users
48438,4311,8,18,1,2,2,5,Lost
48737,110,75,141,4,5,4,13,Champions
49096,14,57,180,5,5,5,15,Champions
49157,108,30,58,4,4,3,11,Loyal Users
49352,277,14,60,3,3,3,9,Loyal Users
49355,306,14,21,3,3,2,8,Loyal Users
49485,2406,6,10,1,1,1,3,Lost
49521,555,25,40,2,4,3,9,At Risk
49664,92,62,285,4,5,5,14,Champions
49862,1320,15,40,1,3,3,7,Casual Users
50286,120,83,191,4,5,5,14,Champions
50804,2822,7,9,1,2,1,4,Lost
50884,2153,11,27,1,2,2,5,Lost
51003,90,39,108,4,4,4,12,Champions
51386,227,38,73,3,4,4,11,Loyal Users
51659,428,76,204,3,5,5,13,Loyal Users
51854,744,9,45,2,2,3,7,Lost
51996,2148,5,17,1,1,2,4,Lost
52253,1003,6,7,2,1,1,4,Lost
39333,64,75,365,5,5,5,15,Champions
39532,81,34,94,4,4,4,12,Champions
39674,422,15,36,3,3,3,9,Loyal Users
39830,3871,20,34,1,3,3,7,Casual Users
39982,74,71,396,4,5,5,14,Champions
40456,246,41,306,3,4,5,12,Loyal Users
40477,28,54,293,5,5,5,15,Champions
40767,1134,19,26,2,3,2,7,Casual Users
40847,2414,7,63,1,2,4,7,Lost
41239,1264,58,102,1,5,4,10,At Risk
41360,149,9,17,4,2,2,8,Promising
41885,266,23,98,3,4,4,11,Loyal Users
42067,1,184,442,5,5,5,15,Champions
43025,929,6,7,2,1,1,4,Lost
43208,77,166,1123,4,5,5,14,Champions
43231,266,6,12,3,1,1,5,Casual Users
43455,570,7,27,2,2,2,6,Lost
43590,169,15,37,3,3,3,9,Loyal Users
43751,287,5,15,3,1,1,5,Casual Users
44362,68,81,140,5,5,4,14,Champions
44401,1422,8,23,1,2,2,5,Lost
44536,79,34,90,4,4,4,12,Champions
44637,292,11,31,3,2,2,7,Casual Users
44697,9,20,82,5,3,4,12,Loyal Users
44756,568,6,13,2,1,1,4,Lost
44936,421,9,118,3,2,4,9,Casual Users
44967,10,32,97,5,4,4,13,Champions
44997,16,115,197,5,5,5,15,Champions
45089,88,91,375,4,5,5,14,Champions
45333,6,36,150,5,4,5,14,Champions
45457,225,9,257,3,2,5,10,Casual Users
45481,335,8,63,3,2,4,9,Casual Users
45699,13,22,118,5,4,4,13,Champions
46248,2735,6,14,1,1,1,3,Lost
46267,2874,5,26,1,1,2,4,Lost
46310,690,35,132,2,4,4,10,At Risk
46523,93,18,88,4,3,4,11,Loyal Users
46591,66,25,251,5,4,5,14,Champions
46629,3189,8,14,1,2,1,4,Lost
46870,71,21,105,4,3,4,11,Loyal Users
46949,497,7,103,2,2,4,8,Lost
47154,109,10,28,4,2,2,8,Promising
47179,16,59,106,5,5,4,14,Champions
47332,15,50,207,5,5,5,15,Champions
47399,1708,8,16,1,2,2,5,Lost
47648,2632,11,15,1,2,1,4,Lost
48015,1,63,325,5,5,5,15,Champions
48071,771,5,16,2,1,2,5,Lost
48380,122,37,56,4,4,3,11,Loyal Users
48460,76,95,225,4,5,5,14,Champions
48494,1673,8,24,1,2,2,5,Lost
48742,850,14,22,2,3,2,7,Casual Users
48902,2493,18,30,1,3,2,6,Casual Users
49029,989,11,84,2,2,4,8,Lost
49135,1701,9,16,1,2,2,5,Lost
49888,58,38,49,5,4,3,12,Loyal Users
49994,147,30,105,4,4,4,12,Champions
50381,2392,15,29,1,3,2,6,Casual Users
50458,175,14,29,3,3,2,8,Loyal Users
50661,1395,12,27,1,3,2,6,Casual Users
50868,88,14,46,4,3,3,10,Loyal Users
50991,225,5,21,3,1,2,6,Casual Users
51233,23,20,51,5,3,3,11,Loyal Users
51239,249,6,29,3,1,2,6,Casual Users
51273,1082,5,8,2,1,1,4,Lost
51340,122,23,55,4,4,3,11,Loyal Users
51474,116,60,258,4,5,5,14,Champions
51543,141,19,166,4,3,5,12,Loyal Users
51763,50,66,440,5,5,5,15,Champions
51803,1262,22,89,1,4,4,9,At Risk
52149,441,7,41,3,2,3,8,Casual Users
39241,1143,9,13,2,2,1,5,Lost
39997,133,5,15,4,1,1,6,Promising
40009,310,45,215,3,4,5,12,Loyal Users
40017,127,36,68,4,4,4,12,Champions
40095,137,33,227,4,4,5,13,Champions
40330,140,24,107,4,4,4,12,Champions
40409,964,10,19,2,2,2,6,Lost
40495,4,96,521,5,5,5,15,Champions
40706,2842,11,15,1,2,1,4,Lost
40872,290,40,54,3,4,3,10,Loyal Users
40883,440,14,25,3,3,2,8,Loyal Users
40904,839,8,10,2,2,1,5,Lost
41061,79,80,209,4,5,5,14,Champions
41145,140,30,139,4,4,4,12,Champions
41525,126,36,71,4,4,4,12,Champions
41616,54,16,84,5,3,4,12,Loyal Users
41716,65,85,206,5,5,5,15,Champions
41789,91,26,69,4,4,4,12,Champions
41889,1581,13,21,1,3,2,6,Casual Users
42076,99,7,25,4,2,2,8,Promising
42282,140,13,38,4,3,3,10,Loyal Users
42552,2681,6,29,1,1,2,4,Lost
42595,91,9,10,4,2,1,7,Promising
42693,94,14,26,4,3,2,9,Loyal Users
42782,1109,17,20,2,3,2,7,Casual Users
42946,568,17,31,2,3,2,7,Casual Users
43432,117,33,68,4,4,4,12,Champions
43644,115,88,212,4,5,5,14,Champions
43770,132,10,36,4,2,3,9,Promising
43948,0,16,25,5,3,2,10,Loyal Users
44049,1711,6,7,1,1,1,3,Lost
44075,105,29,79,4,4,4,12,Champions
44126,244,16,39,3,3,3,9,Loyal Users
44208,228,7,54,3,2,3,8,Casual Users
44232,416,11,16,3,2,2,7,Casual Users
44477,859,32,99,2,4,4,10,At Risk
44504,439,6,8,3,1,1,5,Casual Users
44660,24,79,188,5,5,5,15,Champions
45149,112,27,127,4,4,4,12,Champions
45440,1324,7,8,1,2,1,4,Lost
45475,893,5,13,2,1,1,4,Lost
45761,66,108,153,5,5,5,15,Champions
45839,119,57,178,4,5,5,14,Champions
46291,30,151,282,5,5,5,15,Champions
46464,5306,10,10,1,2,1,4,Lost
46702,349,126,240,3,5,5,13,Loyal Users
47016,41,26,47,5,4,3,12,Loyal Users
47075,115,17,38,4,3,3,10,Loyal Users
47076,304,42,96,3,4,4,11,Loyal Users
47262,33,12,18,5,3,2,10,Loyal Users
47406,658,5,6,2,1,1,4,Lost
47414,1258,9,36,1,2,3,6,Lost
47452,148,10,33,4,2,3,9,Promising
47575,1956,42,302,1,4,5,10,At Risk
47710,420,41,150,3,4,5,12,Loyal Users
47986,119,15,56,4,3,3,10,Loyal Users
48645,125,13,21,4,3,2,9,Loyal Users
48695,37,7,16,5,2,2,9,Promising
48746,69,6,7,5,1,1,7,Promising
49358,1520,5,7,1,1,1,3,Lost
49394,368,49,77,3,5,4,12,Loyal Users
49490,1096,24,78,2,4,4,10,At Risk
49540,994,7,9,2,2,1,5,Lost
49545,357,24,52,3,4,3,10,Loyal Users
49673,123,48,122,4,5,4,13,Champions
49736,626,7,8,2,2,1,5,Lost
49979,409,44,126,3,4,4,11,Loyal Users
50229,95,30,80,4,4,4,12,Champions
50419,55,33,42,5,4,3,12,Loyal Users
50634,964,9,25,2,2,2,6,Lost
50891,267,7,8,3,2,1,6,Casual Users
50911,675,17,39,2,3,3,8,Casual Users
50992,374,79,226,3,5,5,13,Loyal Users
51355,5210,19,56,1,3,3,7,Casual Users
51414,17,56,258,5,5,5,15,Champions
51428,1158,5,6,2,1,1,4,Lost
51445,137,9,31,4,2,2,8,Promising
51448,286,10,19,3,2,2,7,Casual Users
51567,107,58,294,4,5,5,14,Champions
51917,65,31,178,5,4,5,14,Champions
52249,3025,6,12,1,1,1,3,Lost
52291,158,40,109,4,4,4,12,Champions
39407,3,48,124,5,5,4,14,Champions
39574,41,170,366,5,5,5,15,Champions
39761,121,6,7,4,1,1,6,Promising
39925,80,34,50,4,4,3,11,Loyal Users
40155,739,34,47,2,4,3,9,At Risk
40696,1199,12,30,2,3,2,7,Casual Users
40820,675,18,33,2,3,3,8,Casual Users
41012,146,78,193,4,5,5,14,Champions
41306,693,17,27,2,3,2,7,Casual Users
41642,828,28,134,2,4,4,10,At Risk
41653,566,5,8,2,1,1,4,Lost
41902,266,19,46,3,3,3,9,Loyal Users
41963,4670,9,49,1,2,3,6,Lost
42007,3283,7,17,1,2,2,5,Lost
42018,267,130,596,3,5,5,13,Loyal Users
42094,3897,14,75,1,3,4,8,Casual Users
42204,1434,6,11,1,1,1,3,Lost
42222,455,32,164,3,4,5,12,Loyal Users
42360,1278,9,15,1,2,1,4,Lost
42582,16,30,77,5,4,4,13,Champions
42774,1417,10,115,1,2,4,7,Lost
42843,3256,6,6,1,1,1,3,Lost
43272,1479,5,8,1,1,1,3,Lost
43349,1903,14,17,1,3,2,6,Casual Users
43383,0,116,227,5,5,5,15,Champions
43733,698,6,27,2,1,2,5,Lost
43859,305,6,10,3,1,1,5,Casual Users
44279,432,15,49,3,3,3,9,Loyal Users
44511,841,15,42,2,3,3,8,Casual Users
44679,3551,12,18,1,3,2,6,Casual Users
44932,26,196,428,5,5,5,15,Champions
45287,972,8,35,2,2,3,7,Lost
45581,420,96,343,3,5,5,13,Loyal Users
45633,440,8,45,3,2,3,8,Casual Users
45717,129,90,129,4,5,4,13,Champions
45719,411,5,8,3,1,1,5,Casual Users
45865,269,61,183,3,5,5,13,Loyal Users
45934,424,27,114,3,4,4,11,Loyal Users
46179,385,42,182,3,4,5,12,Loyal Users
46278,175,26,43,3,4,3,10,Loyal Users
46590,46,90,277,5,5,5,15,Champions
46615,72,17,79,4,3,4,11,Loyal Users
46855,2507,7,23,1,2,2,5,Lost
47040,1852,20,26,1,3,2,6,Casual Users
47062,3057,9,10,1,2,1,4,Lost
48031,3120,8,11,1,2,1,4,Lost
48392,124,33,73,4,4,4,12,Champions
48597,26,79,199,5,5,5,15,Champions
48705,170,24,116,3,4,4,11,Loyal Users
48713,282,45,170,3,4,5,12,Loyal Users
49183,2844,10,18,1,2,2,5,Lost
49418,428,31,134,3,4,4,11,Loyal Users
49487,274,40,84,3,4,4,11,Loyal Users
49774,408,5,10,3,1,1,5,Casual Users
49903,1735,33,48,1,4,3,8,At Risk
49997,40,36,131,5,4,4,13,Champions
50011,1070,16,31,2,3,2,7,Casual Users
50057,41,37,76,5,4,4,13,Champions
50066,2965,7,12,1,2,1,4,Lost
50625,255,7,40,3,2,3,8,Casual Users
50631,264,19,32,3,3,3,9,Loyal Users
50666,272,7,41,3,2,3,8,Casual Users
50919,1726,5,5,1,1,1,3,Lost
51182,544,26,100,2,4,4,10,At Risk
51242,414,17,44,3,3,3,9,Loyal Users
51431,29,137,349,5,5,5,15,Champions
51589,19,134,234,5,5,5,15,Champions
51899,516,18,119,2,3,4,9,Casual Users
52258,968,11,32,2,2,3,7,Lost
52294,90,71,79,4,5,4,13,Champions
39291,1585,5,7,1,1,1,3,Lost
39533,33,136,284,5,5,5,15,Champions
39552,103,93,126,4,5,4,13,Champions
39635,1376,5,8,1,1,1,3,Lost
39821,27,21,35,5,3,3,11,Loyal Users
39835,280,6,33,3,1,3,7,Casual Users
39955,1285,21,30,1,3,2,6,Casual Users
39965,147,29,124,4,4,4,12,Champions
40405,1074,32,58,2,4,3,9,At Risk
40601,19,37,115,5,4,4,13,Champions
40713,74,159,657,4,5,5,14,Champions
40731,77,23,105,4,4,4,12,Champions
40863,4917,38,207,1,4,5,10,At Risk
40886,17,10,15,5,2,1,8,Promising
41153,1590,13,26,1,3,2,6,Casual Users
41172,2281,16,35,1,3,3,7,Casual Users
41196,96,111,227,4,5,5,14,Champions
41300,140,15,24,4,3,2,9,Loyal Users
41544,1030,7,12,2,2,1,5,Lost
41560,842,28,164,2,4,5,11,At Risk
41972,1455,5,7,1,1,1,3,Lost
42176,249,15,54,3,3,3,9,Loyal Users
42884,119,6,7,4,1,1,6,Promising
43119,2985,5,10,1,1,1,3,Lost
43327,819,31,55,2,4,3,9,At Risk
43937,117,40,127,4,4,4,12,Champions
44268,51,109,240,5,5,5,15,Champions
44912,1457,5,9,1,1,1,3,Lost
45635,210,11,13,3,2,1,6,Casual Users
45819,1738,6,26,1,1,2,4,Lost
45983,1827,8,13,1,2,1,4,Lost
46146,502,37,102,2,4,4,10,At Risk
46218,6022,5,5,1,1,1,3,Lost
46378,384,24,72,3,4,4,11,Loyal Users
46637,4819,23,39,1,4,3,8,At Risk
46661,74,10,16,4,2,2,8,Promising
46734,32,20,59,5,3,3,11,Loyal Users
46762,121,65,159,4,5,5,14,Champions
46775,114,16,127,4,3,4,11,Loyal Users
47120,11,53,146,5,5,4,14,Champions
47367,792,7,9,2,2,1,5,Lost
47480,1659,13,66,1,3,4,8,Casual Users
47615,632,32,64,2,4,4,10,At Risk
47641,242,22,41,3,4,3,10,Loyal Users
48148,566,8,15,2,2,1,5,Lost
48466,148,101,121,4,5,4,13,Champions
48587,768,35,203,2,4,5,11,At Risk
48907,131,124,396,4,5,5,14,Champions
49335,117,66,192,4,5,5,14,Champions
49447,131,11,38,4,2,3,9,Promising
49500,242,149,310,3,5,5,13,Loyal Users
49679,5,141,565,5,5,5,15,Champions
49693,828,5,7,2,1,1,4,Lost
49834,212,127,523,3,5,5,13,Loyal Users
50196,119,18,49,4,3,3,10,Loyal Users
50288,9,110,143,5,5,4,14,Champions
50554,129,11,149,4,2,5,11,Promising
50839,4143,10,18,1,2,2,5,Lost
50858,1158,6,34,2,1,3,6,Lost
50978,2033,5,7,1,1,1,3,Lost
51181,122,15,16,4,3,2,9,Loyal Users
51218,68,15,25,5,3,2,10,Loyal Users
51528,10,8,14,5,2,1,8,Promising
51590,5124,9,30,1,2,2,5,Lost
51600,2817,14,52,1,3,3,7,Casual Users
51611,2482,6,19,1,1,2,4,Lost
51727,793,14,38,2,3,3,8,Casual Users
51923,357,23,187,3,4,5,12,Loyal Users
51977,72,32,94,4,4,4,12,Champions
51997,1290,6,23,1,1,2,4,Lost
52186,143,5,5,4,1,1,6,Promising
52311,4,145,1100,5,5,5,15,Champions
52313,280,11,126,3,2,4,9,Casual Users
52332,226,68,197,3,5,5,13,Loyal Users
39646,171,29,184,3,4,5,12,Loyal Users
40123,429,11,26,3,2,2,7,Casual Users
40151,2456,10,11,1,2,1,4,Lost
40434,26,69,93,5,5,4,14,Champions
40762,16,34,131,5,4,4,13,Champions
40769,13,106,417,5,5,5,15,Champions
40851,82,21,91,4,3,4,11,Loyal Users
41765,157,27,95,4,4,4,12,Champions
41810,464,60,239,3,5,5,13,Loyal Users
42292,98,29,39,4,4,3,11,Loyal Users
42393,125,87,529,4,5,5,14,Champions
42440,3669,9,30,1,2,2,5,Lost
42760,145,49,229,4,5,5,14,Champions
42788,956,22,33,2,4,3,9,At Risk
42974,406,10,16,3,2,2,7,Casual Users
43033,433,6,7,3,1,1,5,Casual Users
43050,1711,17,29,1,3,2,6,Casual Users
43088,735,19,63,2,3,4,9,Casual Users
43156,74,9,12,4,2,1,7,Promising
43282,97,13,42,4,3,3,10,Loyal Users
43748,113,137,316,4,5,5,14,Champions
44089,19,115,197,5,5,5,15,Champions
44207,3156,5,14,1,1,1,3,Lost
44953,266,26,109,3,4,4,11,Loyal Users
45376,114,18,63,4,3,4,11,Loyal Users
45631,432,27,45,3,4,3,10,Loyal Users
45641,408,18,32,3,3,3,9,Loyal Users
45750,77,65,221,4,5,5,14,Champions
45784,287,7,34,3,2,3,8,Casual Users
45818,48,92,394,5,5,5,15,Champions
45876,537,5,13,2,1,1,4,Lost
45946,973,14,43,2,3,3,8,Casual Users
46562,1950,25,41,1,4,3,8,At Risk
46793,560,28,93,2,4,4,10,At Risk
46944,94,16,41,4,3,3,10,Loyal Users
47026,1803,5,5,1,1,1,3,Lost
47189,242,57,130,3,5,4,12,Loyal Users
47411,2105,5,11,1,1,1,3,Lost
47447,112,23,65,4,4,4,12,Champions
47763,464,9,18,3,2,2,7,Casual Users
47836,3,117,253,5,5,5,15,Champions
47967,13,39,43,5,4,3,12,Loyal Users
48175,3095,11,31,1,2,2,5,Lost
49196,505,28,123,2,4,4,10,At Risk
49626,27,39,343,5,4,5,14,Champions
49944,9,105,231,5,5,5,15,Champions
49966,290,11,52,3,2,3,8,Casual Users
50237,465,8,8,3,2,1,6,Casual Users
50382,422,10,20,3,2,2,7,Casual Users
50517,832,5,9,2,1,1,4,Lost
50570,16,9,9,5,2,1,8,Promising
50894,0,51,301,5,5,5,15,Champions
50896,826,10,13,2,2,1,5,Lost
50939,27,23,46,5,4,3,12,Loyal Users
50948,1104,15,42,2,3,3,8,Casual Users
50950,423,16,55,3,3,3,9,Loyal Users
50986,14,85,146,5,5,4,14,Champions
51055,5393,6,6,1,1,1,3,Lost
51154,30,92,217,5,5,5,15,Champions
51583,928,11,56,2,2,3,7,Lost
51677,433,60,238,3,5,5,13,Loyal Users
51901,715,17,49,2,3,3,8,Casual Users
52090,2674,8,38,1,2,3,6,Lost
39254,582,6,13,2,1,1,4,Lost
39392,540,6,90,2,1,4,7,Lost
39396,113,101,239,4,5,5,14,Champions
39594,288,31,45,3,4,3,10,Loyal Users
39690,5335,5,7,1,1,1,3,Lost
40077,1448,28,50,1,4,3,8,At Risk
40333,21,38,57,5,4,3,12,Loyal Users
40348,1439,6,8,1,1,1,3,Lost
40365,141,47,99,4,5,4,13,Champions
40491,701,7,11,2,2,1,5,Lost
40756,2263,7,18,1,2,2,5,Lost
40835,293,6,13,3,1,1,5,Casual Users
40931,113,26,98,4,4,4,12,Champions
40991,293,53,215,3,5,5,13,Loyal Users
41038,392,7,7,3,2,1,6,Casual Users
41230,100,13,29,4,3,2,9,Loyal Users
41641,400,13,19,3,3,2,8,Loyal Users
41689,123,51,206,4,5,5,14,Champions
41722,704,16,64,2,3,4,9,Casual Users
41723,517,5,9,2,1,1,4,Lost
42004,585,34,224,2,4,5,11,At Risk
42011,1639,5,7,1,1,1,3,Lost
42233,140,14,24,4,3,2,9,Loyal Users
42385,581,7,34,2,2,3,7,Lost
42454,280,72,171,3,5,5,13,Loyal Users
42642,389,6,23,3,1,2,6,Casual Users
42659,3,68,114,5,5,4,14,Champions
42916,264,21,67,3,3,4,10,Loyal Users
43003,49,51,135,5,5,4,14,Champions
43090,0,130,405,5,5,5,15,Champions
43222,29,9,27,5,2,2,9,Promising
43243,114,14,41,4,3,3,10,Loyal Users
43310,3331,32,50,1,4,3,8,At Risk
43548,2143,23,200,1,4,5,10,At Risk
43784,1600,6,8,1,1,1,3,Lost
43817,670,21,82,2,3,4,9,Casual Users
44032,23,79,296,5,5,5,15,Champions
44074,99,36,80,4,4,4,12,Champions
44611,131,11,22,4,2,2,8,Promising
45091,420,43,138,3,4,4,11,Loyal Users
45284,2283,8,35,1,2,3,6,Lost
45291,2728,15,96,1,3,4,8,Casual Users
45323,355,5,46,3,1,3,7,Casual Users
45513,972,68,292,2,5,5,12,At Risk
45741,1421,51,95,1,5,4,10,At Risk
45857,9,80,153,5,5,5,15,Champions
46159,1985,7,16,1,2,2,5,Lost
46501,1146,7,29,2,2,2,6,Lost
46517,305,34,300,3,4,5,12,Loyal Users
46997,47,159,354,5,5,5,15,Champions
47056,687,22,131,2,4,4,10,At Risk
47186,1828,25,89,1,4,4,9,At Risk
47352,1484,6,9,1,1,1,3,Lost
47421,477,9,18,2,2,2,6,Lost
47442,5,87,352,5,5,5,15,Champions
47493,5576,6,41,1,1,3,5,Lost
47555,34,39,64,5,4,4,13,Champions
47694,348,16,33,3,3,3,9,Loyal Users
47739,319,29,45,3,4,3,10,Loyal Users
47814,101,8,14,4,2,1,7,Promising
47872,3653,5,5,1,1,1,3,Lost
48498,3554,6,50,1,1,3,5,Lost
48721,12,24,93,5,4,4,13,Champions
49044,975,6,13,2,1,1,4,Lost
49663,952,7,9,2,2,1,5,Lost
49698,142,13,21,4,3,2,9,Loyal Users
49840,2819,6,21,1,1,2,4,Lost
50062,54,27,71,5,4,4,13,Champions
50065,101,8,9,4,2,1,7,Promising
50200,1538,6,6,1,1,1,3,Lost
50723,2478,5,10,1,1,1,3,Lost
50749,18,42,109,5,4,4,13,Champions
51011,144,31,55,4,4,3,11,Loyal Users
51124,715,25,104,2,4,4,10,At Risk
51333,1527,10,62,1,2,3,6,Lost
51376,271,7,21,3,2,2,7,Casual Users
51736,591,11,27,2,2,2,6,Lost
51765,409,12,28,3,3,2,8,Loyal Users
51792,139,85,389,4,5,5,14,Champions
51852,836,6,16,2,1,2,5,Lost
51867,840,7,15,2,2,1,5,Lost
51984,311,12,30,3,3,2,8,Loyal Users
52058,19,28,95,5,4,4,13,Champions
52074,5,31,49,5,4,3,12,Loyal Users
39273,654,12,41,2,3,3,8,Casual Users
39613,460,9,40,3,2,3,8,Casual Users
39820,36,69,664,5,5,5,15,Champions
40197,118,54,218,4,5,5,14,Champions
40416,87,65,148,4,5,5,14,Champions
40691,357,21,84,3,3,4,10,Loyal Users
40759,3,138,225,5,5,5,15,Champions
40859,257,45,52,3,4,3,10,Loyal Users
41083,141,34,87,4,4,4,12,Champions
41156,3256,5,8,1,1,1,3,Lost
41182,113,33,49,4,4,3,11,Loyal Users
41383,2420,16,24,1,3,2,6,Casual Users
41449,3362,12,22,1,3,2,6,Casual Users
41476,788,11,18,2,2,2,6,Lost
41910,113,22,47,4,4,3,11,Loyal Users
42265,5,8,13,5,2,1,8,Promising
42450,408,25,48,3,4,3,10,Loyal Users
42863,2361,14,22,1,3,2,6,Casual Users
43052,655,11,80,2,2,4,8,Lost
43155,4254,9,9,1,2,1,4,Lost
43308,1244,10,31,2,2,2,6,Lost
43337,52,84,216,5,5,5,15,Champions
43362,114,10,24,4,2,2,8,Promising
43427,1429,32,69,1,4,4,9,At Risk
43638,834,25,46,2,4,3,9,At Risk
44406,1455,19,52,1,3,3,7,Casual Users
44499,828,52,203,2,5,5,12,At Risk
44863,123,24,50,4,4,3,11,Loyal Users
44917,142,13,34,4,3,3,10,Loyal Users
45093,5022,9,24,1,2,2,5,Lost
45746,823,26,267,2,4,5,11,At Risk
45799,4224,9,11,1,2,1,4,Lost
46054,1428,53,115,1,5,4,10,At Risk
46863,4123,8,36,1,2,3,6,Lost
47018,112,66,338,4,5,5,14,Champions
47560,145,24,88,4,4,4,12,Champions
47643,683,7,10,2,2,1,5,Lost
48230,318,11,18,3,2,2,7,Casual Users
48262,282,29,68,3,4,4,11,Loyal Users
48442,720,14,25,2,3,2,7,Casual Users
48598,30,20,25,5,3,2,10,Loyal Users
48815,1328,14,69,1,3,4,8,Casual Users
48941,1384,13,37,1,3,3,7,Casual Users
48961,278,94,137,3,5,4,12,Loyal Users
49154,1595,16,26,1,3,2,6,Casual Users
49201,4061,6,16,1,1,2,4,Lost
49283,4856,7,12,1,2,1,4,Lost
49294,96,37,132,4,4,4,12,Champions
49316,149,112,642,4,5,5,14,Champions
49600,122,15,46,4,3,3,10,Loyal Users
49881,1727,5,5,1,1,1,3,Lost
50166,1,28,58,5,4,3,12,Loyal Users
50435,307,12,21,3,3,2,8,Loyal Users
51018,4,67,147,5,5,5,15,Champions
51266,4,7,39,5,2,3,10,Promising
51636,1591,6,10,1,1,1,3,Lost
51751,966,9,12,2,2,1,5,Lost
52041,2798,5,9,1,1,1,3,Lost
52304,669,14,86,2,3,4,9,Casual Users
39252,3771,8,8,1,2,1,4,Lost
39436,139,123,512,4,5,5,14,Champions
39477,524,5,31,2,1,2,5,Lost
39496,2271,9,17,1,2,2,5,Lost
39819,653,6,14,2,1,1,4,Lost
40030,88,12,53,4,3,3,10,Loyal Users
40100,524,14,23,2,3,2,7,Casual Users
40124,160,15,60,4,3,3,10,Loyal Users
40673,252,31,120,3,4,4,11,Loyal Users
41135,75,140,449,4,5,5,14,Champions
41869,1443,6,15,1,1,1,3,Lost
41957,965,6,6,2,1,1,4,Lost
42343,122,16,27,4,3,2,9,Loyal Users
42423,7,133,201,5,5,5,15,Champions
42972,126,24,39,4,4,3,11,Loyal Users
42978,1370,19,36,1,3,3,7,Casual Users
43175,513,9,9,2,2,1,5,Lost
43567,441,8,16,3,2,2,7,Casual Users
43763,419,7,10,3,2,1,6,Casual Users
43834,303,5,6,3,1,1,5,Casual Users
44000,6,7,35,5,2,3,10,Promising
44534,414,5,14,3,1,1,5,Casual Users
44699,779,10,10,2,2,1,5,Lost
44948,17,6,38,5,1,3,9,Promising
45087,838,7,21,2,2,2,6,Lost
45233,6,44,69,5,4,4,13,Champions
45350,1588,39,147,1,4,5,10,At Risk
45927,150,32,72,4,4,4,12,Champions
46318,1160,11,23,2,2,2,6,Lost
46582,225,100,216,3,5,5,13,Loyal Users
46925,5099,7,17,1,2,2,5,Lost
47219,3520,5,7,1,1,1,3,Lost
47360,132,17,21,4,3,2,9,Loyal Users
47602,1996,6,33,1,1,3,5,Lost
47953,1101,26,26,2,4,2,8,At Risk
48072,117,10,21,4,2,2,8,Promising
48136,268,12,26,3,3,2,8,Loyal Users
48214,125,126,729,4,5,5,14,Champions
48278,662,41,213,2,4,5,11,At Risk
48323,459,6,10,3,1,1,5,Casual Users
48542,625,7,19,2,2,2,6,Lost
48592,386,21,53,3,3,3,9,Loyal Users
48620,61,48,131,5,5,4,14,Champions
48831,67,38,173,5,4,5,14,Champions
48944,292,19,23,3,3,2,8,Loyal Users
49074,102,43,271,4,4,5,13,Champions
49452,121,14,22,4,3,2,9,Loyal Users
49459,567,7,8,2,2,1,5,Lost
49461,2314,16,56,1,3,3,7,Casual Users
49533,0,12,21,5,3,2,10,Loyal Users
50077,401,5,5,3,1,1,5,Casual Users
50101,1078,18,42,2,3,3,8,Casual Users
50568,1491,13,43,1,3,3,7,Casual Users
50857,237,6,28,3,1,2,6,Casual Users
51024,439,11,44,3,2,3,8,Casual Users
51070,861,13,53,2,3,3,8,Casual Users
51083,232,5,44,3,1,3,7,Casual Users
51163,1518,49,99,1,5,4,10,At Risk
51264,61,80,111,5,5,4,14,Champions
51301,110,44,180,4,4,5,13,Champions
51342,1271,19,23,1,3,2,6,Casual Users
51398,113,25,125,4,4,4,12,Champions
51459,168,37,63,3,4,4,11,Loyal Users
51497,1047,7,8,2,2,1,5,Lost
51855,344,7,10,3,2,1,6,Casual Users
52046,595,30,145,2,4,4,10,At Risk
52088,134,39,125,4,4,4,12,Champions
52179,1225,19,75,2,3,4,9,Casual Users
52224,400,15,20,3,3,2,8,Loyal Users
39306,1022,6,10,2,1,1,4,Lost
39356,1564,6,22,1,1,2,4,Lost
39435,25,51,84,5,5,4,14,Champions
39605,405,14,26,3,3,2,8,Loyal Users
39638,109,36,147,4,4,5,13,Champions
39685,136,29,76,4,4,4,12,Champions
40338,1843,13,60,1,3,3,7,Casual Users
40530,223,9,12,3,2,1,6,Casual Users
40564,288,7,10,3,2,1,6,Casual Users
41573,2299,5,5,1,1,1,3,Lost
41752,858,10,39,2,2,3,7,Lost
41960,15,19,88,5,3,4,12,Loyal Users
42005,144,107,230,4,5,5,14,Champions
42034,3892,5,34,1,1,3,5,Lost
42068,1717,20,30,1,3,2,6,Casual Users
42190,142,50,72,4,5,4,13,Champions
42701,259,11,16,3,2,2,7,Casual Users
42803,1379,34,102,1,4,4,9,At Risk
42818,138,17,43,4,3,3,10,Loyal Users
42928,457,7,21,3,2,2,7,Casual Users
42932,134,10,18,4,2,2,8,Promising
43276,311,6,16,3,1,2,6,Casual Users
43550,645,27,61,2,4,3,9,At Risk
43557,1097,10,30,2,2,2,6,Lost
43566,3204,6,30,1,1,2,4,Lost
43787,961,10,106,2,2,4,8,Lost
44029,270,21,25,3,3,2,8,Loyal Users
44195,365,15,43,3,3,3,9,Loyal Users
44267,15,57,280,5,5,5,15,Champions
44460,13,50,185,5,5,5,15,Champions
44467,134,36,64,4,4,4,12,Champions
44717,3,42,86,5,4,4,13,Champions
45112,572,39,51,2,4,3,9,At Risk
45468,4226,7,8,1,2,1,4,Lost
45487,1656,8,16,1,2,2,5,Lost
45573,115,7,12,4,2,1,7,Promising
45688,1337,8,33,1,2,3,6,Lost
46666,1557,8,16,1,2,2,5,Lost
46701,279,24,79,3,4,4,11,Loyal Users
46910,1419,5,21,1,1,2,4,Lost
47747,108,35,53,4,4,3,11,Loyal Users
47804,1694,5,6,1,1,1,3,Lost
47848,157,19,70,4,3,4,11,Loyal Users
47886,158,55,233,4,5,5,14,Champions
48082,411,12,29,3,3,2,8,Loyal Users
48327,6,85,163,5,5,5,15,Champions
48707,979,7,17,2,2,2,6,Lost
48811,1869,10,28,1,2,2,5,Lost
48853,752,19,29,2,3,2,7,Casual Users
48909,286,58,113,3,5,4,12,Loyal Users
48958,138,35,93,4,4,4,12,Champions
49339,700,17,37,2,3,3,8,Casual Users
49563,15,109,369,5,5,5,15,Champions
49993,123,15,24,4,3,2,9,Loyal Users
50183,64,8,22,5,2,2,9,Promising
50283,3422,15,39,1,3,3,7,Casual Users
50462,347,30,193,3,4,5,12,Loyal Users
50589,3114,7,20,1,2,2,5,Lost
50933,107,51,124,4,5,4,13,Champions
51029,374,37,175,3,4,5,12,Loyal Users
51468,172,24,91,3,4,4,11,Loyal Users
51564,1289,18,65,1,3,4,8,Casual Users
51707,153,16,80,4,3,4,11,Loyal Users
51777,105,20,33,4,3,3,10,Loyal Users
51944,124,30,57,4,4,3,11,Loyal Users
52015,534,7,50,2,2,3,7,Lost
52086,151,9,32,4,2,3,9,Promising
52320,370,19,35,3,3,3,9,Loyal Users
39360,67,32,52,5,4,3,12,Loyal Users
39414,134,8,42,4,2,3,9,Promising
39883,2734,5,5,1,1,1,3,Lost
39928,2117,9,22,1,2,2,5,Lost
40103,1448,6,7,1,1,1,3,Lost
40226,963,14,34,2,3,3,8,Casual Users
40337,169,17,35,3,3,3,9,Loyal Users
40389,164,55,110,4,5,4,13,Champions
40918,419,5,15,3,1,1,5,Casual Users
40952,42,38,172,5,4,5,14,Champions
41157,29,46,349,5,5,5,15,Champions
41197,81,51,90,4,5,4,13,Champions
41219,531,24,81,2,4,4,10,At Risk
41370,1612,5,25,1,1,2,4,Lost
41656,299,27,37,3,4,3,10,Loyal Users
41779,2826,14,30,1,3,2,6,Casual Users
41894,2,6,27,5,1,2,8,Promising
42130,286,93,114,3,5,4,12,Loyal Users
42318,24,44,96,5,4,4,13,Champions
42434,403,6,17,3,1,2,6,Casual Users
42975,27,24,97,5,4,4,13,Champions
43125,96,7,10,4,2,1,7,Promising
43456,16,9,17,5,2,2,9,Promising
43533,416,10,51,3,2,3,8,Casual Users
43659,703,10,28,2,2,2,6,Lost
43984,167,105,129,3,5,4,12,Loyal Users
44297,268,42,57,3,4,3,10,Loyal Users
44364,810,10,39,2,2,3,7,Lost
44887,559,16,19,2,3,2,7,Casual Users
45671,151,24,48,4,4,3,11,Loyal Users
46194,2,51,102,5,5,4,14,Champions
46360,1143,17,23,2,3,2,7,Casual Users
46402,50,44,238,5,4,5,14,Champions
46594,2659,6,7,1,1,1,3,Lost
46658,36,11,15,5,2,1,8,Promising
46681,18,38,97,5,4,4,13,Champions
46718,3556,15,18,1,3,2,6,Casual Users
46735,172,71,282,3,5,5,13,Loyal Users
46866,127,13,20,4,3,2,9,Loyal Users
47340,109,35,74,4,4,4,12,Champions
47530,1702,15,32,1,3,3,7,Casual Users
47579,45,80,456,5,5,5,15,Champions
47708,104,30,61,4,4,3,11,Loyal Users
47926,9,43,193,5,4,5,14,Champions
48210,489,59,183,2,5,5,12,At Risk
48266,661,8,8,2,2,1,5,Lost
48269,2409,8,125,1,2,4,7,Lost
48951,456,7,19,3,2,2,7,Casual Users
49268,92,10,33,4,2,3,9,Promising
49338,25,239,307,5,5,5,15,Champions
49541,1801,5,8,1,1,1,3,Lost
49599,121,35,136,4,4,4,12,Champions
49630,33,99,246,5,5,5,15,Champions
49653,11,25,67,5,4,4,13,Champions
49711,105,118,336,4,5,5,14,Champions
49777,398,13,78,3,3,4,10,Loyal Users
49843,960,13,18,2,3,2,7,Casual Users
49867,17,13,40,5,3,3,11,Loyal Users
50003,3482,7,11,1,2,1,4,Lost
50326,65,108,502,5,5,5,15,Champions
50908,140,52,303,4,5,5,14,Champions
51116,1061,12,44,2,3,3,8,Casual Users
51250,1153,6,13,2,1,1,4,Lost
51307,439,26,56,3,4,3,10,Loyal Users
51328,3808,9,28,1,2,2,5,Lost
51604,405,6,9,3,1,1,5,Casual Users
51641,1294,6,10,1,1,1,3,Lost
51839,948,5,5,2,1,1,4,Lost
51907,273,51,195,3,5,5,13,Loyal Users
51969,1378,7,13,1,2,1,4,Lost
52188,2,23,110,5,4,4,13,Champions
39452,91,28,30,4,4,2,10,Loyal Users
39457,143,27,136,4,4,4,12,Champions
39796,4422,7,40,1,2,3,6,Lost
39825,309,10,21,3,2,2,7,Casual Users
40054,594,14,24,2,3,2,7,Casual Users
40062,860,52,129,2,5,4,11,At Risk
40134,9,101,147,5,5,5,15,Champions
40699,870,14,24,2,3,2,7,Casual Users
41081,55,153,405,5,5,5,15,Champions
41298,1904,8,10,1,2,1,4,Lost
41625,1803,13,36,1,3,3,7,Casual Users
41858,218,76,204,3,5,5,13,Loyal Users
42534,1533,38,65,1,4,4,9,At Risk
42759,31,77,299,5,5,5,15,Champions
42896,481,15,19,2,3,2,7,Casual Users
43424,115,16,108,4,3,4,11,Loyal Users
43547,113,133,443,4,5,5,14,Champions
43893,1501,8,10,1,2,1,4,Lost
44169,654,7,32,2,2,3,7,Lost
44291,714,15,15,2,3,1,6,Casual Users
44794,1403,5,10,1,1,1,3,Lost
44935,2505,6,31,1,1,2,4,Lost
45057,5,59,125,5,5,4,14,Champions
45825,7,32,132,5,4,4,13,Champions
45872,450,16,21,3,3,2,8,Loyal Users
45915,59,72,276,5,5,5,15,Champions
46380,150,51,244,4,5,5,14,Champions
46677,585,39,114,2,4,4,10,At Risk
46913,87,7,16,4,2,2,8,Promising
47907,104,24,60,4,4,3,11,Loyal Users
47972,483,10,14,2,2,1,5,Lost
48045,1985,6,7,1,1,1,3,Lost
48745,3,97,292,5,5,5,15,Champions
48940,4136,8,13,1,2,1,4,Lost
49240,130,16,44,4,3,3,10,Loyal Users
49386,2465,7,12,1,2,1,4,Lost
49718,1828,7,32,1,2,3,6,Lost
49719,119,23,245,4,4,5,13,Champions
49887,1060,14,96,2,3,4,9,Casual Users
50158,1026,16,25,2,3,2,7,Casual Users
50186,498,8,14,2,2,1,5,Lost
50291,398,11,22,3,2,2,7,Casual Users
50463,152,179,518,4,5,5,14,Champions
50692,33,38,141,5,4,4,13,Champions
50779,278,5,19,3,1,2,6,Casual Users
50945,309,7,9,3,2,1,6,Casual Users
51547,333,60,389,3,5,5,13,Loyal Users
51555,656,11,43,2,2,3,7,Lost
51787,175,17,43,3,3,3,9,Loyal Users
51999,119,54,251,4,5,5,14,Champions
52057,544,6,10,2,1,1,4,Lost
52328,276,61,216,3,5,5,13,Loyal Users
52341,1146,34,42,2,4,3,9,At Risk
39848,4713,10,10,1,2,1,4,Lost
40087,25,73,271,5,5,5,15,Champions
40118,83,64,212,4,5,5,14,Champions
40139,33,18,51,5,3,3,11,Loyal Users
40417,2121,6,14,1,1,1,3,Lost
40648,113,50,472,4,5,5,14,Champions
40826,360,14,15,3,3,1,7,Loyal Users
41089,86,95,172,4,5,5,14,Champions
41474,459,9,21,3,2,2,7,Casual Users
41523,291,9,10,3,2,1,6,Casual Users
41533,928,21,69,2,3,4,9,Casual Users
41637,432,9,29,3,2,2,7,Casual Users
42302,276,18,40,3,3,3,9,Loyal Users
42362,117,7,12,4,2,1,7,Promising
43068,843,37,238,2,4,5,11,At Risk
43131,66,39,69,5,4,4,13,Champions
43247,222,11,27,3,2,2,7,Casual Users
43312,717,10,32,2,2,3,7,Lost
43323,2124,5,14,1,1,1,3,Lost
43389,1008,17,39,2,3,3,8,Casual Users
43670,219,14,44,3,3,3,9,Loyal Users
43707,1268,8,13,1,2,1,4,Lost
43959,1867,9,14,1,2,1,4,Lost
44010,78,32,99,4,4,4,12,Champions
44423,29,123,235,5,5,5,15,Champions
44427,12,27,69,5,4,4,13,Champions
44448,582,43,60,2,4,3,9,At Risk
45017,1713,8,20,1,2,2,5,Lost
45332,5,14,20,5,3,2,10,Loyal Users
45625,274,24,104,3,4,4,11,Loyal Users
46092,45,170,764,5,5,5,15,Champions
46356,419,13,59,3,3,3,9,Loyal Users
46430,1,23,56,5,4,3,12,Loyal Users
46474,1,59,249,5,5,5,15,Champions
47132,607,5,12,2,1,1,4,Lost
47277,827,17,34,2,3,3,8,Casual Users
48007,1519,16,111,1,3,4,8,Casual Users
48074,5,77,160,5,5,5,15,Champions
48638,4505,9,11,1,2,1,4,Lost
48714,6,108,586,5,5,5,15,Champions
48891,1710,6,7,1,1,1,3,Lost
49042,1540,5,8,1,1,1,3,Lost
49093,84,145,424,4,5,5,14,Champions
49247,4,64,142,5,5,4,14,Champions
49293,53,128,265,5,5,5,15,Champions
49484,12,205,597,5,5,5,15,Champions
49624,117,54,184,4,5,5,14,Champions
49830,421,28,44,3,4,3,10,Loyal Users
50128,32,72,110,5,5,4,14,Champions
50467,855,15,70,2,3,4,9,Casual Users
50712,76,154,582,4,5,5,14,Champions
50862,285,91,159,3,5,5,13,Loyal Users
51023,428,5,6,3,1,1,5,Casual Users
51159,653,23,29,2,4,2,8,At Risk
51248,839,6,22,2,1,2,5,Lost
51655,108,29,115,4,4,4,12,Champions
51946,2309,12,15,1,3,1,5,Casual Users
52063,8,43,226,5,4,5,14,Champions
52101,579,10,10,2,2,1,5,Lost
52191,3082,18,31,1,3,2,6,Casual Users
39373,47,100,325,5,5,5,15,Champions
39628,22,47,184,5,5,5,15,Champions
39907,424,17,33,3,3,3,9,Loyal Users
40185,2141,8,19,1,2,2,5,Lost
40411,97,9,18,4,2,2,8,Promising
40546,253,8,9,3,2,1,6,Casual Users
40800,19,75,330,5,5,5,15,Champions
41062,126,5,5,4,1,1,6,Promising
41282,529,50,253,2,5,5,12,At Risk
41349,128,26,80,4,4,4,12,Champions
41507,61,69,146,5,5,4,14,Champions
41682,4247,8,16,1,2,2,5,Lost
41966,443,42,77,3,4,4,11,Loyal Users
42259,754,10,21,2,2,2,6,Lost
42274,14,120,492,5,5,5,15,Champions
42541,1944,5,41,1,1,3,5,Lost
42576,337,6,18,3,1,2,6,Casual Users
42956,699,45,88,2,4,4,10,At Risk
43218,2421,5,22,1,1,2,4,Lost
43591,470,5,10,3,1,1,5,Casual Users
43680,129,34,62,4,4,3,11,Loyal Users
43965,471,22,48,2,4,3,9,At Risk
43997,280,129,213,3,5,5,13,Loyal Users
44290,251,42,353,3,4,5,12,Loyal Users
44431,182,28,56,3,4,3,10,Loyal Users
44832,11,8,21,5,2,2,9,Promising
45103,656,12,25,2,3,2,7,Casual Users
45745,111,39,107,4,4,4,12,Champions
45800,736,9,10,2,2,1,5,Lost
45849,2486,12,15,1,3,1,5,Casual Users
46355,588,16,26,2,3,2,7,Casual Users
46621,1009,15,27,2,3,2,7,Casual Users
46720,14,8,30,5,2,2,9,Promising
46907,18,7,76,5,2,4,11,Promising
46969,406,13,78,3,3,4,10,Loyal Users
47228,983,23,70,2,4,4,10,At Risk
47822,72,5,5,4,1,1,6,Promising
48069,208,9,20,3,2,2,7,Casual Users
48182,367,14,25,3,3,2,8,Loyal Users
48895,46,61,298,5,5,5,15,Champions
49127,283,44,184,3,4,5,12,Loyal Users
49443,15,6,13,5,1,1,7,Promising
49754,130,64,171,4,5,5,14,Champions
49812,260,21,52,3,3,3,9,Loyal Users
50051,2553,5,12,1,1,1,3,Lost
50339,522,11,12,2,2,1,5,Lost
50498,17,136,214,5,5,5,15,Champions
50909,1617,5,10,1,1,1,3,Lost
51240,4425,6,8,1,1,1,3,Lost
51892,224,14,50,3,3,3,9,Loyal Users
52012,568,17,25,2,3,2,7,Casual Users
39579,841,181,545,2,5,5,12,At Risk
39668,88,35,162,4,4,5,13,Champions
39817,117,79,237,4,5,5,14,Champions
39957,78,6,9,4,1,1,6,Promising
40115,61,45,52,5,4,3,12,Loyal Users
40263,422,16,22,3,3,2,8,Loyal Users
40283,190,10,35,3,2,3,8,Casual Users
40753,169,14,17,3,3,2,8,Loyal Users
41003,544,8,15,2,2,1,5,Lost
41105,121,11,22,4,2,2,8,Promising
41729,393,14,17,3,3,2,8,Loyal Users
41771,119,9,23,4,2,2,8,Promising
41965,816,29,228,2,4,5,11,At Risk
42480,817,21,40,2,3,3,8,Casual Users
42720,3294,18,35,1,3,3,7,Casual Users
42878,28,14,40,5,3,3,11,Loyal Users
42899,1,115,717,5,5,5,15,Champions
43008,91,21,40,4,3,3,10,Loyal Users
43071,115,52,70,4,5,4,13,Champions
43364,197,13,30,3,3,2,8,Loyal Users
43508,485,9,22,2,2,2,6,Lost
43829,5,64,242,5,5,5,15,Champions
43832,713,17,24,2,3,2,7,Casual Users
43979,1151,5,5,2,1,1,4,Lost
44186,431,16,28,3,3,2,8,Loyal Users
44589,566,11,41,2,2,3,7,Lost
44915,975,9,33,2,2,3,7,Lost
45213,1409,8,16,1,2,2,5,Lost
45499,1,11,22,5,2,2,9,Promising
45694,27,45,181,5,4,5,14,Champions
45894,6,90,307,5,5,5,15,Champions
46439,1670,8,11,1,2,1,4,Lost
46473,2490,5,5,1,1,1,3,Lost
46567,440,28,37,3,4,3,10,Loyal Users
46988,67,75,372,5,5,5,15,Champions
47847,523,20,35,2,3,3,8,Casual Users
48440,1,140,630,5,5,5,15,Champions
48555,386,87,454,3,5,5,13,Loyal Users
49381,4299,5,10,1,1,1,3,Lost
49396,5,43,249,5,4,5,14,Champions
49952,163,11,86,4,2,4,10,Promising
51486,137,63,184,4,5,5,14,Champions
51585,102,5,8,4,1,1,6,Promising
51642,102,25,81,4,4,4,12,Champions
51773,585,12,12,2,3,1,6,Casual Users
52016,4753,5,5,1,1,1,3,Lost
52038,1126,16,21,2,3,2,7,Casual Users
39341,239,10,10,3,2,1,6,Casual Users
39404,76,64,257,4,5,5,14,Champions
39521,1227,8,65,2,2,4,8,Lost
39546,247,16,58,3,3,3,9,Loyal Users
39774,26,132,230,5,5,5,15,Champions
40476,273,37,164,3,4,5,12,Loyal Users
40602,254,117,493,3,5,5,13,Loyal Users
40794,18,50,132,5,5,4,14,Champions
40898,186,8,13,3,2,1,6,Casual Users
41119,2135,12,43,1,3,3,7,Casual Users
41293,14,122,445,5,5,5,15,Champions
41693,487,31,62,2,4,3,9,At Risk
41713,420,5,9,3,1,1,5,Casual Users
41778,565,6,9,2,1,1,4,Lost
42080,143,14,63,4,3,4,11,Loyal Users
42166,125,44,96,4,4,4,12,Champions
42374,480,42,273,2,4,5,11,At Risk
43079,216,46,104,3,5,4,12,Loyal Users
43211,1087,10,25,2,2,2,6,Lost
43544,121,36,387,4,4,5,13,Champions
43844,83,143,440,4,5,5,14,Champions
43955,112,6,8,4,1,1,6,Promising
44083,4,40,122,5,4,4,13,Champions
44250,4,124,501,5,5,5,15,Champions
44299,743,22,33,2,4,3,9,At Risk
44329,108,13,33,4,3,3,10,Loyal Users
44723,36,87,318,5,5,5,15,Champions
44839,68,46,184,5,5,5,15,Champions
45416,123,21,64,4,3,4,11,Loyal Users
45419,671,5,12,2,1,1,4,Lost
45562,3880,6,6,1,1,1,3,Lost
45767,533,37,123,2,4,4,10,At Risk
45929,70,21,36,4,3,3,10,Loyal Users
46160,41,18,31,5,3,2,10,Loyal Users
46216,12,30,109,5,4,4,13,Champions
46542,1523,11,34,1,2,3,6,Lost
46573,729,64,101,2,5,4,11,At Risk
46696,532,5,9,2,1,1,4,Lost
46800,681,5,7,2,1,1,4,Lost
47101,187,19,77,3,3,4,10,Loyal Users
47438,1024,21,37,2,3,3,8,Casual Users
47492,82,14,27,4,3,2,9,Loyal Users
47728,2380,6,9,1,1,1,3,Lost
47887,214,108,395,3,5,5,13,Loyal Users
48231,1986,11,31,1,2,2,5,Lost
48361,4,15,47,5,3,3,11,Loyal Users
48373,8,12,33,5,3,3,11,Loyal Users
48463,1971,8,19,1,2,2,5,Lost
48471,8,118,445,5,5,5,15,Champions
48900,156,62,124,4,5,4,13,Champions
49207,577,5,8,2,1,1,4,Lost
49217,403,88,290,3,5,5,13,Loyal Users
49570,16,77,142,5,5,4,14,Champions
49723,3252,44,93,1,4,4,9,At Risk
49743,1005,8,12,2,2,1,5,Lost
50109,1940,10,39,1,2,3,6,Lost
50279,2287,10,29,1,2,2,5,Lost
50372,2,54,149,5,5,5,15,Champions
50485,2098,15,19,1,3,2,6,Casual Users
50510,1110,5,5,2,1,1,4,Lost
51062,108,56,354,4,5,5,14,Champions
51251,124,68,205,4,5,5,14,Champions
51390,308,28,31,3,4,2,9,Loyal Users
51746,87,97,185,4,5,5,14,Champions
52285,857,42,171,2,4,5,11,At Risk
39608,695,6,34,2,1,3,6,Lost
39654,23,24,41,5,4,3,12,Loyal Users
39766,1139,40,87,2,4,4,10,At Risk
39877,406,42,139,3,4,4,11,Loyal Users
39915,1459,6,55,1,1,3,5,Lost
40368,2769,14,73,1,3,4,8,Casual Users
40418,424,21,28,3,3,2,8,Loyal Users
40558,1281,5,5,1,1,1,3,Lost
40943,12,90,150,5,5,5,15,Champions
40998,8,157,177,5,5,5,15,Champions
41162,260,18,140,3,3,4,10,Loyal Users
41213,568,6,26,2,1,2,5,Lost
41698,84,126,337,4,5,5,14,Champions
41931,1327,43,76,1,4,4,9,At Risk
42028,3,9,21,5,2,2,9,Promising
42135,2871,13,39,1,3,3,7,Casual Users
42530,1435,42,69,1,4,4,9,At Risk
42689,130,9,29,4,2,2,8,Promising
42802,170,27,61,3,4,3,10,Loyal Users
43164,379,11,20,3,2,2,7,Casual Users
43755,137,43,64,4,4,4,12,Champions
43831,13,5,9,5,1,1,7,Promising
43905,129,13,70,4,3,4,11,Loyal Users
44091,8,35,211,5,4,5,14,Champions
44138,1535,10,38,1,2,3,6,Lost
44305,683,13,23,2,3,2,7,Casual Users
44541,297,7,7,3,2,1,6,Casual Users
44789,694,11,33,2,2,3,7,Lost
44888,736,5,7,2,1,1,4,Lost
45084,542,11,18,2,2,2,6,Lost
45202,6018,6,7,1,1,1,3,Lost
45496,537,9,33,2,2,3,7,Lost
45708,0,35,61,5,4,3,12,Loyal Users
45820,815,5,8,2,1,1,4,Lost
45992,3,43,128,5,4,4,13,Champions
46729,1772,10,30,1,2,2,5,Lost
47017,63,7,10,5,2,1,8,Promising
47029,13,68,194,5,5,5,15,Champions
47825,573,8,10,2,2,1,5,Lost
47854,415,25,51,3,4,3,10,Loyal Users
48049,2736,11,20,1,2,2,5,Lost
48157,695,5,12,2,1,1,4,Lost
48167,109,7,23,4,2,2,8,Promising
48350,10,42,151,5,4,5,14,Champions
48447,1183,5,7,2,1,1,4,Lost
48450,139,21,57,4,3,3,10,Loyal Users
48692,13,92,193,5,5,5,15,Champions
48797,101,11,22,4,2,2,8,Promising
48848,72,53,373,4,5,5,14,Champions
49019,544,73,86,2,5,4,11,At Risk
49213,670,6,18,2,1,2,5,Lost
49409,2,7,42,5,2,3,10,Promising
49530,92,15,57,4,3,3,10,Loyal Users
49714,542,7,15,2,2,1,5,Lost
49762,1186,33,55,2,4,3,9,At Risk
49845,27,17,33,5,3,3,11,Loyal Users
50114,293,17,29,3,3,2,8,Loyal Users
50153,976,9,17,2,2,2,6,Lost
50243,877,8,11,2,2,1,5,Lost
50367,6035,5,17,1,1,2,4,Lost
50514,132,7,10,4,2,1,7,Promising
50798,129,75,209,4,5,5,14,Champions
50825,1871,23,51,1,4,3,8,At Risk
50932,135,32,53,4,4,3,11,Loyal Users
50937,290,28,69,3,4,4,11,Loyal Users
50969,23,20,44,5,3,3,11,Loyal Users
51219,5,36,39,5,4,3,12,Loyal Users
51278,216,31,46,3,4,3,10,Loyal Users
51336,1743,11,34,1,2,3,6,Lost
51369,292,33,98,3,4,4,11,Loyal Users
51467,183,25,85,3,4,4,11,Loyal Users
51483,388,14,29,3,3,2,8,Loyal Users
52209,135,21,40,4,3,3,10,Loyal Users
52232,706,5,17,2,1,2,5,Lost
52257,1536,5,24,1,1,2,4,Lost
52322,232,28,143,3,4,4,11,Loyal Users
39348,375,45,49,3,4,3,10,Loyal Users
39355,505,10,27,2,2,2,6,Lost
39918,275,8,12,3,2,1,6,Casual Users
39938,1969,6,8,1,1,1,3,Lost
40359,1449,27,93,1,4,4,9,At Risk
40626,2,15,97,5,3,4,12,Loyal Users
40638,409,22,32,3,4,3,10,Loyal Users
40803,30,11,56,5,2,3,10,Promising
41246,161,35,130,4,4,4,12,Champions
41852,2,112,441,5,5,5,15,Champions
41938,471,66,142,2,5,4,11,At Risk
42516,271,18,229,3,3,5,11,Loyal Users
42993,69,26,223,5,4,5,14,Champions
43555,1713,15,32,1,3,3,7,Casual Users
43856,118,46,240,4,5,5,14,Champions
44026,183,20,84,3,3,4,10,Loyal Users
44114,2317,51,83,1,5,4,10,At Risk
44952,47,34,59,5,4,3,12,Loyal Users
45036,857,8,13,2,2,1,5,Lost
45265,1096,5,8,2,1,1,4,Lost
45300,74,6,13,4,1,1,6,Promising
45339,697,8,20,2,2,2,6,Lost
45509,125,7,55,4,2,3,9,Promising
45553,4263,5,15,1,1,1,3,Lost
45680,2300,17,35,1,3,3,7,Casual Users
45961,1752,7,9,1,2,1,4,Lost
46041,524,72,173,2,5,5,12,At Risk
46106,173,46,161,3,5,5,13,Loyal Users
46154,939,18,95,2,3,4,9,Casual Users
46335,411,23,89,3,4,4,11,Loyal Users
46367,11,16,19,5,3,2,10,Loyal Users
46427,73,37,60,4,4,3,11,Loyal Users
46695,305,17,51,3,3,3,9,Loyal Users
47052,132,5,42,4,1,3,8,Promising
47249,46,129,362,5,5,5,15,Champions
47264,122,17,26,4,3,2,9,Loyal Users
47494,9,113,290,5,5,5,15,Champions
47773,153,16,90,4,3,4,11,Loyal Users
48399,415,18,28,3,3,2,8,Loyal Users
48476,2065,13,16,1,3,2,6,Casual Users
48602,313,24,83,3,4,4,11,Loyal Users
48698,24,18,39,5,3,3,11,Loyal Users
48812,105,30,93,4,4,4,12,Champions
49027,420,7,16,3,2,2,7,Casual Users
49737,397,70,448,3,5,5,13,Loyal Users
49753,207,9,19,3,2,2,7,Casual Users
49992,142,7,34,4,2,3,9,Promising
50351,76,16,64,4,3,4,11,Loyal Users
50613,2579,7,13,1,2,1,4,Lost
50694,586,27,42,2,4,3,9,At Risk
50713,143,66,194,4,5,5,14,Champions
50886,406,11,14,3,2,1,6,Casual Users
51048,60,7,16,5,2,2,9,Promising
51054,112,119,428,4,5,5,14,Champions
51100,862,36,101,2,4,4,10,At Risk
51140,58,9,14,5,2,1,8,Promising
51436,598,9,40,2,2,3,7,Lost
51701,3,31,235,5,4,5,14,Champions
51898,104,22,86,4,4,4,12,Champions
51918,583,8,21,2,2,2,6,Lost
52091,1843,6,23,1,1,2,4,Lost
39334,816,6,8,2,1,1,4,Lost
39495,493,13,20,2,3,2,7,Casual Users
39538,77,9,33,4,2,3,9,Promising
39571,97,9,18,4,2,2,8,Promising
39870,148,8,19,4,2,2,8,Promising
39987,13,8,26,5,2,2,9,Promising
40891,250,5,6,3,1,1,5,Casual Users
41025,3572,5,10,1,1,1,3,Lost
41096,209,23,107,3,4,4,11,Loyal Users
41245,14,128,584,5,5,5,15,Champions
41461,4647,16,34,1,3,3,7,Casual Users
41508,115,11,23,4,2,2,8,Promising
41518,13,106,215,5,5,5,15,Champions
41650,3286,5,9,1,1,1,3,Lost
42256,65,185,540,5,5,5,15,Champions
42330,389,18,37,3,3,3,9,Loyal Users
42388,2822,6,10,1,1,1,3,Lost
42428,4564,14,14,1,3,1,5,Casual Users
42469,0,70,150,5,5,5,15,Champions
42556,142,102,378,4,5,5,14,Champions
42799,65,11,31,5,2,2,9,Promising
43449,40,55,142,5,5,4,14,Champions
43454,47,50,159,5,5,5,15,Champions
43902,6,13,20,5,3,2,10,Loyal Users
44134,228,15,85,3,3,4,10,Loyal Users
44176,34,71,279,5,5,5,15,Champions
45200,256,16,49,3,3,3,9,Loyal Users
45397,3928,10,49,1,2,3,6,Lost
45458,538,7,11,2,2,1,5,Lost
45768,1727,5,9,1,1,1,3,Lost
45902,569,7,17,2,2,2,6,Lost
45958,2111,5,65,1,1,4,6,Lost
46035,418,5,6,3,1,1,5,Casual Users
46259,874,8,75,2,2,4,8,Lost
46345,303,24,43,3,4,3,10,Loyal Users
46365,127,17,66,4,3,4,11,Loyal Users
46605,122,19,55,4,3,3,10,Loyal Users
46883,1103,35,79,2,4,4,10,At Risk
46919,125,13,23,4,3,2,9,Loyal Users
46946,681,10,26,2,2,2,6,Lost
47067,191,21,31,3,3,2,8,Loyal Users
47239,393,29,92,3,4,4,11,Loyal Users
47432,530,17,34,2,3,3,8,Casual Users
47479,17,83,329,5,5,5,15,Champions
48111,493,5,14,2,1,1,4,Lost
48378,1675,6,7,1,1,1,3,Lost
48728,1003,21,41,2,3,3,8,Casual Users
48751,437,32,84,3,4,4,11,Loyal Users
48921,68,79,166,5,5,5,15,Champions
49206,740,24,52,2,4,3,9,At Risk
49302,202,58,373,3,5,5,13,Loyal Users
49333,126,16,44,4,3,3,10,Loyal Users
50044,24,92,255,5,5,5,15,Champions
50093,5,43,58,5,4,3,12,Loyal Users
50477,4,40,90,5,4,4,13,Champions
50790,399,10,15,3,2,1,6,Casual Users
50808,479,8,13,2,2,1,5,Lost
50893,1594,6,40,1,1,3,5,Lost
51542,124,65,186,4,5,5,14,Champions
51922,2476,5,50,1,1,3,5,Lost
39868,838,6,10,2,1,1,4,Lost
40096,63,140,435,5,5,5,15,Champions
40161,353,62,120,3,5,4,12,Loyal Users
40213,18,199,311,5,5,5,15,Champions
40442,2025,13,27,1,3,2,6,Casual Users
40500,422,12,34,3,3,3,9,Loyal Users
40573,240,42,98,3,4,4,11,Loyal Users
40649,3,52,95,5,5,4,14,Champions
40730,229,50,201,3,5,5,13,Loyal Users
40773,2129,9,10,1,2,1,4,Lost
40846,112,44,64,4,4,4,12,Champions
41251,50,10,40,5,2,3,10,Promising
41294,5,35,192,5,4,5,14,Champions
41408,5188,5,55,1,1,3,5,Lost
41470,4888,6,11,1,1,1,3,Lost
41746,393,8,15,3,2,1,6,Casual Users
42753,408,12,26,3,3,2,8,Loyal Users
42879,44,102,396,5,5,5,15,Champions
43280,126,28,57,4,4,3,11,Loyal Users
43398,399,11,21,3,2,2,7,Casual Users
43518,272,14,64,3,3,4,10,Loyal Users
43563,14,100,181,5,5,5,15,Champions
43678,127,8,45,4,2,3,9,Promising
43719,3013,5,9,1,1,1,3,Lost
43725,1697,5,11,1,1,1,3,Lost
43812,3709,15,39,1,3,3,7,Casual Users
44117,438,64,186,3,5,5,13,Loyal Users
44851,116,14,65,4,3,4,11,Loyal Users
44897,278,95,212,3,5,5,13,Loyal Users
44971,806,20,59,2,3,3,8,Casual Users
45232,13,70,200,5,5,5,15,Champions
45316,333,12,25,3,3,2,8,Loyal Users
45740,416,11,23,3,2,2,7,Casual Users
46042,2029,12,21,1,3,2,6,Casual Users
46186,662,8,25,2,2,2,6,Lost
46316,822,28,119,2,4,4,10,At Risk
46425,117,25,41,4,4,3,11,Loyal Users
46440,413,10,33,3,2,3,8,Casual Users
46481,427,48,339,3,5,5,13,Loyal Users
46576,148,17,43,4,3,3,10,Loyal Users
46611,2,27,70,5,4,4,13,Champions
46622,22,26,157,5,4,5,14,Champions
46777,51,9,19,5,2,2,9,Promising
46936,24,28,71,5,4,4,13,Champions
47140,6,110,290,5,5,5,15,Champions
47706,33,60,221,5,5,5,15,Champions
47759,9,6,34,5,1,3,9,Promising
47944,27,32,52,5,4,3,12,Loyal Users
48023,20,41,80,5,4,4,13,Champions
48209,406,10,32,3,2,3,8,Casual Users
48311,29,59,121,5,5,4,14,Champions
48475,2039,7,11,1,2,1,4,Lost
48644,997,8,15,2,2,1,5,Lost
48854,284,38,109,3,4,4,11,Loyal Users
49177,849,10,16,2,2,2,6,Lost
49323,894,15,27,2,3,2,7,Casual Users
49472,1425,7,42,1,2,3,6,Lost
50232,253,20,26,3,3,2,8,Loyal Users
50431,701,5,16,2,1,2,5,Lost
50555,97,24,56,4,4,3,11,Loyal Users
50603,700,17,51,2,3,3,8,Casual Users
50675,668,10,15,2,2,1,5,Lost
50782,805,27,55,2,4,3,9,At Risk
51013,13,5,6,5,1,1,7,Promising
51582,1135,5,30,2,1,2,5,Lost
51651,1892,51,226,1,5,5,11,At Risk
51758,393,20,57,3,3,3,9,Loyal Users
39810,2967,5,16,1,1,2,4,Lost
39895,3001,22,129,1,4,4,9,At Risk
40266,0,28,82,5,4,4,13,Champions
40321,5614,20,20,1,3,2,6,Casual Users
41070,26,8,14,5,2,1,8,Promising
41176,52,12,19,5,3,2,10,Loyal Users
41362,644,21,80,2,3,4,9,Casual Users
42082,1695,10,21,1,2,2,5,Lost
42438,5240,5,6,1,1,1,3,Lost
42813,127,6,120,4,1,4,9,Promising
42868,67,62,203,5,5,5,15,Champions
42909,492,36,322,2,4,5,11,At Risk
42931,156,107,179,4,5,5,14,Champions
43492,276,6,9,3,1,1,5,Casual Users
43516,565,22,73,2,4,4,10,At Risk
44090,154,46,74,4,5,4,13,Champions
44218,551,9,15,2,2,1,5,Lost
44238,275,5,7,3,1,1,5,Casual Users
44315,415,22,57,3,4,3,10,Loyal Users
44565,1307,7,15,1,2,1,4,Lost
44635,1050,7,11,2,2,1,5,Lost
45125,984,59,115,2,5,4,11,At Risk
45271,473,9,88,2,2,4,8,Lost
45538,1530,34,243,1,4,5,10,At Risk
45546,781,11,46,2,2,3,7,Lost
45551,1126,12,30,2,3,2,7,Casual Users
45639,848,12,74,2,3,4,9,Casual Users
46109,303,30,102,3,4,4,11,Loyal Users
46152,1697,7,12,1,2,1,4,Lost
46596,5534,8,16,1,2,2,5,Lost
46597,2219,7,10,1,2,1,4,Lost
46667,382,6,12,3,1,1,5,Casual Users
46789,1630,6,9,1,1,1,3,Lost
46821,3630,12,12,1,3,1,5,Casual Users
47316,1304,29,48,1,4,3,8,At Risk
47448,2123,11,20,1,2,2,5,Lost
47508,80,6,16,4,1,2,7,Promising
47716,632,10,48,2,2,3,7,Lost
47841,460,6,31,3,1,2,6,Casual Users
47846,548,11,61,2,2,3,7,Lost
47992,14,155,238,5,5,5,15,Champions
48164,24,57,117,5,5,4,14,Champions
48281,303,13,103,3,3,4,10,Loyal Users
48334,115,24,47,4,4,3,11,Loyal Users
49032,203,32,95,3,4,4,11,Loyal Users
49086,56,26,27,5,4,2,11,Loyal Users
49276,1756,12,40,1,3,3,7,Casual Users
49465,758,9,18,2,2,2,6,Lost
49493,1673,7,7,1,2,1,4,Lost
49535,2370,5,28,1,1,2,4,Lost
49689,140,5,6,4,1,1,6,Promising
49968,862,22,34,2,4,3,9,At Risk
50394,82,82,345,4,5,5,14,Champions
50587,119,94,299,4,5,5,14,Champions
50609,2950,12,109,1,3,4,8,Casual Users
50636,1275,7,27,1,2,2,5,Lost
50865,106,104,390,4,5,5,14,Champions
50947,103,97,745,4,5,5,14,Champions
50974,87,31,108,4,4,4,12,Champions
51290,1573,10,13,1,2,1,4,Lost
51327,2806,10,12,1,2,1,4,Lost
51380,393,10,16,3,2,2,7,Casual Users
51559,434,17,37,3,3,3,9,Loyal Users
51630,826,8,8,2,2,1,5,Lost
51980,103,47,341,4,5,5,14,Champions
52037,869,18,168,2,3,5,10,Casual Users
52233,4306,16,29,1,3,2,6,Casual Users
39337,26,125,310,5,5,5,15,Champions
39441,0,75,142,5,5,4,14,Champions
39478,997,7,15,2,2,1,5,Lost
39802,101,58,171,4,5,5,14,Champions
40559,147,24,76,4,4,4,12,Champions
40614,78,30,80,4,4,4,12,Champions
40740,2,72,149,5,5,5,15,Champions
41131,106,34,84,4,4,4,12,Champions
41237,4475,8,11,1,2,1,4,Lost
41498,60,24,85,5,4,4,13,Champions
41548,172,65,369,3,5,5,13,Loyal Users
41994,1098,5,12,2,1,1,4,Lost
42306,0,43,52,5,4,3,12,Loyal Users
42489,577,20,39,2,3,3,8,Casual Users
43095,267,13,22,3,3,2,8,Loyal Users
43259,130,9,9,4,2,1,7,Promising
43600,239,34,95,3,4,4,11,Loyal Users
44748,1392,6,14,1,1,1,3,Lost
44976,2963,8,68,1,2,4,7,Lost
45070,190,8,38,3,2,3,8,Casual Users
45896,2114,7,11,1,2,1,4,Lost
45973,228,59,413,3,5,5,13,Loyal Users
46119,109,27,76,4,4,4,12,Champions
46122,688,20,100,2,3,4,9,Casual Users
46664,76,33,65,4,4,4,12,Champions
47282,154,59,461,4,5,5,14,Champions
47301,163,37,72,4,4,4,12,Champions
47656,704,7,15,2,2,1,5,Lost
47662,832,16,74,2,3,4,9,Casual Users
48336,3414,7,17,1,2,2,5,Lost
48967,1255,9,9,2,2,1,5,Lost
49055,1838,10,64,1,2,4,7,Lost
49100,28,12,41,5,3,3,11,Loyal Users
49364,8,23,68,5,4,4,13,Champions
49437,1,16,77,5,3,4,12,Loyal Users
49543,106,48,114,4,5,4,13,Champions
49553,2991,5,20,1,1,2,4,Lost
49585,975,28,78,2,4,4,10,At Risk
50358,421,13,57,3,3,3,9,Loyal Users
50362,571,7,12,2,2,1,5,Lost
50676,19,24,37,5,4,3,12,Loyal Users
50680,3,32,114,5,4,4,13,Champions
50836,1810,5,7,1,1,1,3,Lost
51457,273,15,42,3,3,3,9,Loyal Users
51569,3659,5,75,1,1,4,6,Lost
51578,3,39,109,5,4,4,13,Champions
51639,175,9,21,3,2,2,7,Casual Users
51778,3,8,20,5,2,2,9,Promising
39318,43,64,254,5,5,5,15,Champions
39531,1836,5,5,1,1,1,3,Lost
39539,2249,6,7,1,1,1,3,Lost
39611,1,31,125,5,4,4,13,Champions
39935,149,79,177,4,5,5,14,Champions
40138,2150,11,43,1,2,3,6,Lost
40218,124,12,28,4,3,2,9,Loyal Users
40279,1228,6,6,2,1,1,4,Lost
40304,132,20,47,4,3,3,10,Loyal Users
40399,1709,10,20,1,2,2,5,Lost
40591,2490,39,69,1,4,4,9,At Risk
40689,518,12,58,2,3,3,8,Casual Users
40708,411,7,28,3,2,2,7,Casual Users
41051,417,5,8,3,1,1,5,Casual Users
41305,1012,6,10,2,1,1,4,Lost
41554,58,23,59,5,4,3,12,Loyal Users
41596,0,11,38,5,2,3,10,Promising
41973,1183,5,50,2,1,3,6,Lost
42557,215,47,187,3,5,5,13,Loyal Users
42757,326,7,12,3,2,1,6,Casual Users
42894,311,64,87,3,5,4,12,Loyal Users
43281,108,13,17,4,3,2,9,Loyal Users
43309,1862,20,39,1,3,3,7,Casual Users
43551,411,8,23,3,2,2,7,Casual Users
43703,63,54,438,5,5,5,15,Champions
43928,0,52,164,5,5,5,15,Champions
44390,106,28,52,4,4,3,11,Loyal Users
45029,4010,6,8,1,1,1,3,Lost
45593,810,7,7,2,2,1,5,Lost
45657,4855,6,20,1,1,2,4,Lost
45681,42,6,29,5,1,2,8,Promising
46239,21,18,31,5,3,2,10,Loyal Users
46346,141,36,151,4,4,5,13,Champions
46850,54,104,493,5,5,5,15,Champions
46959,4667,12,12,1,3,1,5,Casual Users
47177,6,14,27,5,3,2,10,Loyal Users
47306,2489,5,8,1,1,1,3,Lost
47528,407,9,12,3,2,1,6,Casual Users
47680,696,12,33,2,3,3,8,Casual Users
48251,4341,7,7,1,2,1,4,Lost
48302,2570,5,6,1,1,1,3,Lost
49145,159,5,6,4,1,1,6,Promising
49455,5,41,396,5,4,5,14,Champions
49488,411,20,72,3,3,4,10,Loyal Users
49532,292,30,60,3,4,3,10,Loyal Users
49951,598,22,36,2,4,3,9,At Risk
50032,435,9,22,3,2,2,7,Casual Users
50125,1398,6,10,1,1,1,3,Lost
50453,530,26,54,2,4,3,9,At Risk
50879,73,57,190,4,5,5,14,Champions
50952,1795,14,64,1,3,4,8,Casual Users
51276,126,141,523,4,5,5,14,Champions
51392,694,20,83,2,3,4,9,Casual Users
51522,215,61,326,3,5,5,13,Loyal Users
51757,137,10,63,4,2,4,10,Promising
51780,114,90,378,4,5,5,14,Champions
52083,54,5,25,5,1,2,8,Promising
52189,0,24,45,5,4,3,12,Loyal Users
39541,257,5,5,3,1,1,5,Casual Users
39548,2258,5,7,1,1,1,3,Lost
39663,98,5,15,4,1,1,6,Promising
39702,75,92,111,4,5,4,13,Champions
39931,851,15,20,2,3,2,7,Casual Users
40086,2205,9,17,1,2,2,5,Lost
40385,108,70,101,4,5,4,13,Champions
40541,3,14,28,5,3,2,10,Loyal Users
41526,10,24,39,5,4,3,12,Loyal Users
41559,984,10,14,2,2,1,5,Lost
41594,973,6,7,2,1,1,4,Lost
41930,606,14,86,2,3,4,9,Casual Users
41969,1284,25,69,1,4,4,9,At Risk
42268,6,10,32,5,2,3,10,Promising
42312,108,49,267,4,5,5,14,Champions
42444,12,185,382,5,5,5,15,Champions
42495,376,6,10,3,1,1,5,Casual Users
42504,1674,5,10,1,1,1,3,Lost
42564,106,35,285,4,4,5,13,Champions
42634,100,9,11,4,2,1,7,Promising
42873,71,15,55,4,3,3,10,Loyal Users
43898,178,29,66,3,4,4,11,Loyal Users
43985,3,38,78,5,4,4,13,Champions
44064,2303,12,17,1,3,2,6,Casual Users
44116,134,29,73,4,4,4,12,Champions
44173,282,6,7,3,1,1,5,Casual Users
44185,787,15,24,2,3,2,7,Casual Users
45028,5,37,85,5,4,4,13,Champions
45108,44,83,478,5,5,5,15,Champions
45587,225,8,49,3,2,3,8,Casual Users
45928,5310,8,22,1,2,2,5,Lost
46132,3141,6,10,1,1,1,3,Lost
46157,82,29,64,4,4,4,12,Champions
46281,688,16,33,2,3,3,8,Casual Users
47431,66,29,74,5,4,4,13,Champions
47609,82,25,51,4,4,3,11,Loyal Users
47652,115,54,194,4,5,5,14,Champions
47667,2100,6,10,1,1,1,3,Lost
47673,269,12,37,3,3,3,9,Loyal Users
48141,7,23,33,5,4,3,12,Loyal Users
48144,9,141,353,5,5,5,15,Champions
48300,10,42,95,5,4,4,13,Champions
48332,275,9,55,3,2,3,8,Casual Users
48449,487,32,70,2,4,4,10,At Risk
48653,2986,8,12,1,2,1,4,Lost
48771,1253,48,119,2,5,4,11,At Risk
48878,44,116,719,5,5,5,15,Champions
48964,221,24,124,3,4,4,11,Loyal Users
49148,4494,8,9,1,2,1,4,Lost
49404,513,11,23,2,2,2,6,Lost
49527,191,27,42,3,4,3,10,Loyal Users
49701,20,30,38,5,4,3,12,Loyal Users
49740,118,6,21,4,1,2,7,Promising
50228,0,89,272,5,5,5,15,Champions
50389,41,80,257,5,5,5,15,Champions
50492,787,8,37,2,2,3,7,Lost
50507,303,15,32,3,3,3,9,Loyal Users
50734,1,27,111,5,4,4,13,Champions
50831,1267,8,28,1,2,2,5,Lost
50960,1973,16,46,1,3,3,7,Casual Users
51019,7,80,155,5,5,5,15,Champions
51558,109,8,30,4,2,2,8,Promising
51647,17,27,90,5,4,4,13,Champions
52112,540,19,90,2,3,4,9,Casual Users
52116,23,28,165,5,4,5,14,Champions
52316,114,18,40,4,3,3,10,Loyal Users
39966,181,20,55,3,3,3,9,Loyal Users
40245,229,12,26,3,3,2,8,Loyal Users
40607,430,28,36,3,4,3,10,Loyal Users
41110,209,11,39,3,2,3,8,Casual Users
41286,145,23,33,4,4,3,11,Loyal Users
41303,565,7,18,2,2,2,6,Lost
41471,381,6,15,3,1,1,5,Casual Users
41549,35,52,250,5,5,5,15,Champions
41626,26,46,127,5,5,4,14,Champions
42000,236,22,31,3,4,2,9,Loyal Users
42197,110,11,22,4,2,2,8,Promising
42369,83,45,103,4,4,4,12,Champions
42627,109,23,58,4,4,3,11,Loyal Users
42646,1135,9,9,2,2,1,5,Lost
42655,130,17,68,4,3,4,11,Loyal Users
42781,265,6,34,3,1,3,7,Casual Users
42871,40,79,413,5,5,5,15,Champions
43009,144,6,10,4,1,1,6,Promising
43537,69,10,21,5,2,2,9,Promising
43768,282,17,35,3,3,3,9,Loyal Users
44179,411,28,134,3,4,4,11,Loyal Users
44229,134,43,72,4,4,4,12,Champions
44451,424,15,40,3,3,3,9,Loyal Users
44802,1150,12,30,2,3,2,7,Casual Users
44883,1979,11,34,1,2,3,6,Lost
44969,343,13,23,3,3,2,8,Loyal Users
45247,151,35,151,4,4,5,13,Champions
45758,13,137,352,5,5,5,15,Champions
45985,5,33,110,5,4,4,13,Champions
46713,1269,15,28,1,3,2,6,Casual Users
46968,1406,13,129,1,3,4,8,Casual Users
47049,2264,5,8,1,1,1,3,Lost
47100,298,23,107,3,4,4,11,Loyal Users
47580,107,38,187,4,4,5,13,Champions
47674,306,11,17,3,2,2,7,Casual Users
47830,32,33,46,5,4,3,12,Loyal Users
47974,32,104,280,5,5,5,15,Champions
48571,407,9,19,3,2,2,7,Casual Users
48774,644,7,13,2,2,1,5,Lost
49292,131,20,45,4,3,3,10,Loyal Users
49365,1169,17,37,2,3,3,8,Casual Users
49403,652,9,10,2,2,1,5,Lost
49531,5,34,88,5,4,4,13,Champions
50761,3916,6,19,1,1,2,4,Lost
50993,2,98,182,5,5,5,15,Champions
51109,19,32,88,5,4,4,13,Champions
51197,836,5,33,2,1,3,6,Lost
51326,1897,11,11,1,2,1,4,Lost
51331,174,35,111,3,4,4,11,Loyal Users
51346,4,35,312,5,4,5,14,Champions
51723,475,6,14,2,1,1,4,Lost
51910,62,107,320,5,5,5,15,Champions
52017,83,46,504,4,5,5,14,Champions
52184,141,15,49,4,3,3,10,Loyal Users
52222,37,22,164,5,4,5,14,Champions
39312,280,5,10,3,1,1,5,Casual Users
39659,20,8,11,5,2,1,8,Promising
39757,352,20,130,3,3,4,10,Loyal Users
39884,947,5,5,2,1,1,4,Lost
40177,172,37,163,3,4,5,12,Loyal Users
40566,430,5,8,3,1,1,5,Casual Users
41106,70,73,671,4,5,5,14,Champions
41541,1,230,300,5,5,5,15,Champions
41800,147,20,29,4,3,2,9,Loyal Users
41846,453,10,19,3,2,2,7,Casual Users
41995,4,58,153,5,5,5,15,Champions
42320,106,34,188,4,4,5,13,Champions
42329,5250,5,7,1,1,1,3,Lost
42435,1376,12,13,1,3,1,5,Casual Users
42858,15,104,155,5,5,5,15,Champions
43298,73,10,130,4,2,4,10,Promising
43361,16,24,74,5,4,4,13,Champions
43835,18,24,61,5,4,3,12,Loyal Users
43931,1697,5,8,1,1,1,3,Lost
44314,1035,6,95,2,1,4,7,Lost
44566,0,57,66,5,5,4,14,Champions
44668,264,8,15,3,2,1,6,Casual Users
44943,426,11,20,3,2,2,7,Casual Users
45067,403,6,8,3,1,1,5,Casual Users
45577,371,11,18,3,2,2,7,Casual Users
45695,978,6,12,2,1,1,4,Lost
45737,107,95,134,4,5,4,13,Champions
45889,109,12,68,4,3,4,11,Loyal Users
45941,4160,28,39,1,4,3,8,At Risk
46324,20,109,199,5,5,5,15,Champions
46642,92,11,16,4,2,2,8,Promising
46761,109,14,29,4,3,2,9,Loyal Users
46806,137,9,10,4,2,1,7,Promising
46820,356,14,42,3,3,3,9,Loyal Users
47355,113,8,10,4,2,1,7,Promising
47405,36,67,189,5,5,5,15,Champions
47613,7,31,130,5,4,4,13,Champions
47909,70,7,25,4,2,2,8,Promising
47950,5,54,226,5,5,5,15,Champions
48481,796,10,22,2,2,2,6,Lost
48485,3131,5,16,1,1,2,4,Lost
48850,81,21,34,4,3,3,10,Loyal Users
48903,136,38,90,4,4,4,12,Champions
48994,847,84,158,2,5,5,12,At Risk
49046,549,9,13,2,2,1,5,Lost
49105,3545,7,25,1,2,2,5,Lost
49939,715,6,10,2,1,1,4,Lost
50198,1068,99,525,2,5,5,12,At Risk
50521,725,6,10,2,1,1,4,Lost
50788,835,10,17,2,2,2,6,Lost
50882,18,106,219,5,5,5,15,Champions
50955,604,11,20,2,2,2,6,Lost
51044,1094,6,11,2,1,1,4,Lost
51322,120,121,221,4,5,5,14,Champions
51895,1252,30,87,2,4,4,10,At Risk
52140,96,77,425,4,5,5,14,Champions
52321,76,52,367,4,5,5,14,Champions
39486,820,8,32,2,2,3,7,Lost
39636,72,92,490,4,5,5,14,Champions
39963,4453,5,7,1,1,1,3,Lost
40055,531,16,54,2,3,3,8,Casual Users
40488,1262,14,23,1,3,2,6,Casual Users
40494,7,24,78,5,4,4,13,Champions
40501,250,6,29,3,1,2,6,Casual Users
40577,707,14,44,2,3,3,8,Casual Users
41076,106,31,47,4,4,3,11,Loyal Users
41109,92,34,162,4,4,5,13,Champions
41122,665,9,25,2,2,2,6,Lost
41217,100,130,188,4,5,5,14,Champions
41354,30,32,96,5,4,4,13,Champions
41489,166,65,118,3,5,4,12,Loyal Users
41545,1442,23,52,1,4,3,8,At Risk
41582,1067,9,32,2,2,3,7,Lost
41706,415,25,146,3,4,4,11,Loyal Users
41834,141,10,22,4,2,2,8,Promising
41906,3,120,233,5,5,5,15,Champions
42492,954,6,9,2,1,1,4,Lost
43237,939,6,8,2,1,1,4,Lost
43347,848,6,10,2,1,1,4,Lost
43365,1500,16,92,1,3,4,8,Casual Users
43374,121,18,28,4,3,2,9,Loyal Users
44069,375,5,7,3,1,1,5,Casual Users
44113,432,7,31,3,2,2,7,Casual Users
44836,100,26,101,4,4,4,12,Champions
45220,417,7,33,3,2,3,8,Casual Users
45357,409,34,138,3,4,4,11,Loyal Users
45626,111,12,28,4,3,2,9,Loyal Users
45667,1963,54,215,1,5,5,11,At Risk
46032,39,49,136,5,5,4,14,Champions
47005,2623,7,16,1,2,2,5,Lost
47898,850,6,9,2,1,1,4,Lost
48467,119,118,293,4,5,5,14,Champions
48925,1892,8,47,1,2,3,6,Lost
49297,853,8,27,2,2,2,6,Lost
49332,264,33,64,3,4,4,11,Loyal Users
49387,293,18,51,3,3,3,9,Loyal Users
49466,85,77,293,4,5,5,14,Champions
49839,2555,6,8,1,1,1,3,Lost
50647,1197,14,25,2,3,2,7,Casual Users
50753,39,149,399,5,5,5,15,Champions
50777,109,24,41,4,4,3,11,Loyal Users
51145,1043,22,43,2,4,3,9,At Risk
51216,820,11,13,2,2,1,5,Lost
51270,4677,7,16,1,2,2,5,Lost
51277,539,34,59,2,4,3,9,At Risk
51652,77,24,32,4,4,3,11,Loyal Users
52049,2847,5,7,1,1,1,3,Lost
52157,79,29,79,4,4,4,12,Champions
52221,2642,19,55,1,3,3,7,Casual Users
39534,27,32,119,5,4,4,13,Champions
40433,5463,18,18,1,3,2,6,Casual Users
40596,1237,9,11,2,2,1,5,Lost
40663,407,15,74,3,3,4,10,Loyal Users
41015,693,7,12,2,2,1,5,Lost
41148,1819,5,6,1,1,1,3,Lost
41171,64,100,185,5,5,5,15,Champions
41332,1654,23,31,1,4,2,7,At Risk
41733,422,14,34,3,3,3,9,Loyal Users
41741,107,59,232,4,5,5,14,Champions
41745,162,49,78,4,5,4,13,Champions
41850,103,56,241,4,5,5,14,Champions
41903,641,21,45,2,3,3,8,Casual Users
41942,117,46,86,4,5,4,13,Champions
42039,881,37,82,2,4,4,10,At Risk
42092,20,12,40,5,3,3,11,Loyal Users
42263,2357,9,15,1,2,1,4,Lost
42462,48,107,205,5,5,5,15,Champions
42498,1737,6,11,1,1,1,3,Lost
42583,436,6,14,3,1,1,5,Casual Users
42643,2712,12,19,1,3,2,6,Casual Users
42769,124,56,172,4,5,5,14,Champions
42854,575,44,71,2,4,4,10,At Risk
43060,144,9,49,4,2,3,9,Promising
43412,1310,18,42,1,3,3,7,Casual Users
43564,375,42,120,3,4,4,11,Loyal Users
43646,448,10,85,3,2,4,9,Casual Users
43878,25,6,20,5,1,2,8,Promising
44347,183,9,16,3,2,2,7,Casual Users
44353,91,64,200,4,5,5,14,Champions
44696,586,8,28,2,2,2,6,Lost
45226,115,10,22,4,2,2,8,Promising
45309,365,12,32,3,3,3,9,Loyal Users
45386,436,7,19,3,2,2,7,Casual Users
45430,1492,5,7,1,1,1,3,Lost
45486,31,35,117,5,4,4,13,Champions
45806,103,78,197,4,5,5,14,Champions
46277,875,9,27,2,2,2,6,Lost
46361,72,7,30,4,2,2,8,Promising
46416,2271,7,25,1,2,2,5,Lost
46451,244,24,39,3,4,3,10,Loyal Users
46817,3088,12,21,1,3,2,6,Casual Users
46966,168,17,54,3,3,3,9,Loyal Users
47812,523,30,63,2,4,4,10,At Risk
47864,1772,17,19,1,3,2,6,Casual Users
48058,545,6,9,2,1,1,4,Lost
48257,86,112,180,4,5,5,14,Champions
48394,3304,24,33,1,4,3,8,At Risk
48669,3691,6,12,1,1,1,3,Lost
48841,5339,12,17,1,3,2,6,Casual Users
49001,70,28,52,4,4,3,11,Loyal Users
49128,158,22,31,4,4,2,10,Loyal Users
49456,1715,25,25,1,4,2,7,At Risk
49818,124,16,41,4,3,3,10,Loyal Users
50016,430,51,85,3,5,4,12,Loyal Users
50205,157,28,78,4,4,4,12,Champions
50474,103,21,45,4,3,3,10,Loyal Users
50550,189,22,31,3,4,2,9,Loyal Users
50602,2535,8,10,1,2,1,4,Lost
50816,186,21,41,3,3,3,9,Loyal Users
50929,34,33,54,5,4,3,12,Loyal Users
51255,425,23,48,3,4,3,10,Loyal Users
51283,1231,12,33,2,3,3,8,Casual Users
51691,59,82,383,5,5,5,15,Champions
51812,1407,6,9,1,1,1,3,Lost
51903,1597,11,39,1,2,3,6,Lost
51988,70,12,43,4,3,3,10,Loyal Users
39317,2802,13,29,1,3,2,6,Casual Users
39527,68,64,148,5,5,5,15,Champions
39724,567,7,9,2,2,1,5,Lost
39806,57,6,11,5,1,1,7,Promising
40215,868,15,59,2,3,3,8,Casual Users
40232,72,46,65,4,5,4,13,Champions
40393,89,105,576,4,5,5,14,Champions
41137,2000,5,25,1,1,2,4,Lost
41445,347,39,113,3,4,4,11,Loyal Users
41524,89,24,59,4,4,3,11,Loyal Users
41680,279,40,138,3,4,4,11,Loyal Users
41701,91,45,94,4,4,4,12,Champions
42012,525,13,50,2,3,3,8,Casual Users
42029,837,13,22,2,3,2,7,Casual Users
42051,201,33,39,3,4,3,10,Loyal Users
42288,928,17,87,2,3,4,9,Casual Users
42289,23,48,222,5,5,5,15,Champions
42324,128,51,115,4,5,4,13,Champions
42532,415,6,19,3,1,2,6,Casual Users
42772,118,12,15,4,3,1,8,Loyal Users
43285,1837,8,35,1,2,3,6,Lost
43313,105,34,116,4,4,4,12,Champions
43668,64,24,118,5,4,4,13,Champions
43716,2249,6,38,1,1,3,5,Lost
43735,82,13,32,4,3,3,10,Loyal Users
43915,23,13,28,5,3,2,10,Loyal Users
43998,735,5,76,2,1,4,7,Lost
44023,2738,6,8,1,1,1,3,Lost
44325,663,21,41,2,3,3,8,Casual Users
44405,841,10,11,2,2,1,5,Lost
44605,63,10,80,5,2,4,11,Promising
44908,710,15,80,2,3,4,9,Casual Users
44930,256,44,126,3,4,4,11,Loyal Users
45536,316,13,16,3,3,2,8,Loyal Users
45712,2225,30,79,1,4,4,9,At Risk
46471,509,7,12,2,2,1,5,Lost
47115,40,9,15,5,2,1,8,Promising
47339,531,49,155,2,5,5,12,At Risk
47433,24,152,509,5,5,5,15,Champions
47505,2935,17,49,1,3,3,7,Casual Users
47684,123,165,239,4,5,5,14,Champions
47821,1772,5,8,1,1,1,3,Lost
47832,410,25,62,3,4,3,10,Loyal Users
47842,63,13,18,5,3,2,10,Loyal Users
47896,5,10,30,5,2,2,9,Promising
48009,53,70,116,5,5,4,14,Champions
48017,597,5,18,2,1,2,5,Lost
48051,1,98,162,5,5,5,15,Champions
48518,68,74,302,5,5,5,15,Champions
48652,285,8,19,3,2,2,7,Casual Users
48735,1281,8,15,1,2,1,4,Lost
48847,272,13,51,3,3,3,9,Loyal Users
48886,2624,26,29,1,4,2,7,At Risk
49391,0,20,80,5,3,4,12,Loyal Users
49752,109,121,423,4,5,5,14,Champions
49922,2237,31,189,1,4,5,10,At Risk
50113,7,88,129,5,5,4,14,Champions
50464,20,32,118,5,4,4,13,Champions
50577,125,10,22,4,2,2,8,Promising
50640,704,15,55,2,3,3,8,Casual Users
50690,835,6,10,2,1,1,4,Lost
50887,0,8,8,5,2,1,8,Promising
50923,1460,27,136,1,4,4,9,At Risk
51128,31,101,463,5,5,5,15,Champions
51228,24,9,26,5,2,2,9,Promising
51316,5,16,79,5,3,4,12,Loyal Users
51423,36,55,115,5,5,4,14,Champions
51557,998,19,49,2,3,3,8,Casual Users
51657,236,20,33,3,3,3,9,Loyal Users
51726,147,18,53,4,3,3,10,Loyal Users
51816,711,39,50,2,4,3,9,At Risk
51829,689,14,43,2,3,3,8,Casual Users
52326,2832,7,8,1,2,1,4,Lost
39703,122,64,282,4,5,5,14,Champions
39726,1279,8,39,1,2,3,6,Lost
39969,3117,17,60,1,3,3,7,Casual Users
40378,44,37,111,5,4,4,13,Champions
40609,713,5,12,2,1,1,4,Lost
40671,114,12,32,4,3,3,10,Loyal Users
40672,663,11,21,2,2,2,6,Lost
40785,5391,8,9,1,2,1,4,Lost
40908,131,21,25,4,3,2,9,Loyal Users
41092,4572,9,13,1,2,1,4,Lost
41322,1730,10,80,1,2,4,7,Lost
41651,417,20,218,3,3,5,11,Loyal Users
41703,549,8,44,2,2,3,7,Lost
41844,94,26,229,4,4,5,13,Champions
41859,590,20,31,2,3,2,7,Casual Users
41862,973,40,47,2,4,3,9,At Risk
42083,132,92,591,4,5,5,14,Champions
42145,2,48,76,5,5,4,14,Champions
42346,2349,7,22,1,2,2,5,Lost
42357,153,9,17,4,2,2,8,Promising
42406,452,29,77,3,4,4,11,Loyal Users
42543,728,11,22,2,2,2,6,Lost
42820,7,12,19,5,3,2,10,Loyal Users
42841,753,22,132,2,4,4,10,At Risk
42876,3454,5,5,1,1,1,3,Lost
42943,1,6,12,5,1,1,7,Promising
42950,8,13,48,5,3,3,11,Loyal Users
43100,3,8,20,5,2,2,9,Promising
43311,72,100,191,4,5,5,14,Champions
44336,3789,5,23,1,1,2,4,Lost
44369,3105,10,11,1,2,1,4,Lost
44496,1712,7,7,1,2,1,4,Lost
44739,35,81,396,5,5,5,15,Champions
44811,409,7,22,3,2,2,7,Casual Users
44972,1081,49,111,2,5,4,11,At Risk
45032,3,22,59,5,4,3,12,Loyal Users
45109,107,6,15,4,1,1,6,Promising
45143,79,10,20,4,2,2,8,Promising
45156,654,5,30,2,1,2,5,Lost
45244,235,50,66,3,5,4,12,Loyal Users
45555,95,107,309,4,5,5,14,Champions
45920,526,8,42,2,2,3,7,Lost
46083,6,28,38,5,4,3,12,Loyal Users
46534,350,9,26,3,2,2,7,Casual Users
46607,824,14,14,2,3,1,6,Casual Users
46960,2475,14,20,1,3,2,6,Casual Users
47593,72,14,66,4,3,4,11,Loyal Users
47772,30,48,99,5,5,4,14,Champions
47833,110,27,50,4,4,3,11,Loyal Users
47957,968,13,27,2,3,2,7,Casual Users
48181,257,13,39,3,3,3,9,Loyal Users
48430,1165,8,33,2,2,3,7,Lost
48785,2984,5,37,1,1,3,5,Lost
49022,668,6,44,2,1,3,6,Lost
49025,1509,7,25,1,2,2,5,Lost
49681,284,9,21,3,2,2,7,Casual Users
50333,12,44,174,5,4,5,14,Champions
50386,11,12,41,5,3,3,11,Loyal Users
50434,806,6,12,2,1,1,4,Lost
50505,36,100,137,5,5,4,14,Champions
50547,5151,10,16,1,2,2,5,Lost
50724,107,33,46,4,4,3,11,Loyal Users
50833,96,33,81,4,4,4,12,Champions
50902,876,6,28,2,1,2,5,Lost
50956,187,30,54,3,4,3,10,Loyal Users
51122,247,8,16,3,2,2,7,Casual Users
51367,597,11,23,2,2,2,6,Lost
51926,33,96,191,5,5,5,15,Champions
51958,2796,6,6,1,1,1,3,Lost
52359,257,27,103,3,4,4,11,Loyal Users
39330,421,5,59,3,1,3,7,Casual Users
39352,643,30,50,2,4,3,9,At Risk
39537,113,22,205,4,4,5,13,Champions
39590,2562,10,37,1,2,3,6,Lost
39612,140,12,69,4,3,4,11,Loyal Users
39891,2894,8,8,1,2,1,4,Lost
39917,2444,27,90,1,4,4,9,At Risk
40475,414,14,69,3,3,4,10,Loyal Users
40669,2,17,52,5,3,3,11,Loyal Users
40967,190,6,26,3,1,2,6,Casual Users
41018,170,15,32,3,3,3,9,Loyal Users
41136,2527,5,8,1,1,1,3,Lost
41568,529,21,121,2,3,4,9,Casual Users
41609,474,14,62,2,3,3,8,Casual Users
41610,289,25,33,3,4,3,10,Loyal Users
41726,598,9,14,2,2,1,5,Lost
41997,58,29,52,5,4,3,12,Loyal Users
42118,305,5,9,3,1,1,5,Casual Users
42217,2,58,179,5,5,5,15,Champions
42286,738,33,128,2,4,4,10,At Risk
42298,951,7,14,2,2,1,5,Lost
42359,107,17,44,4,3,3,10,Loyal Users
42364,699,15,42,2,3,3,8,Casual Users
43153,304,12,19,3,3,2,8,Loyal Users
43330,150,10,17,4,2,2,8,Promising
43339,105,42,93,4,4,4,12,Champions
44695,309,6,6,3,1,1,5,Casual Users
45090,14,116,432,5,5,5,15,Champions
45381,1174,11,40,2,2,3,7,Lost
45661,250,14,45,3,3,3,9,Loyal Users
45862,183,31,56,3,4,3,10,Loyal Users
45879,743,5,10,2,1,1,4,Lost
45969,3119,12,50,1,3,3,7,Casual Users
45982,289,26,42,3,4,3,10,Loyal Users
46093,1662,8,34,1,2,3,6,Lost
47229,132,55,110,4,5,4,13,Champions
47458,102,128,755,4,5,5,14,Champions
47527,19,5,5,5,1,1,7,Promising
47828,131,11,46,4,2,3,9,Promising
48223,118,15,65,4,3,4,11,Loyal Users
48249,3689,10,34,1,2,3,6,Lost
48801,736,13,26,2,3,2,7,Casual Users
48986,507,21,31,2,3,2,7,Casual Users
49014,24,42,76,5,4,4,13,Champions
49016,16,141,302,5,5,5,15,Champions
49223,1666,11,25,1,2,2,5,Lost
49357,87,147,413,4,5,5,14,Champions
49478,286,8,9,3,2,1,6,Casual Users
49486,143,118,207,4,5,5,14,Champions
49529,5410,5,7,1,1,1,3,Lost
49536,735,35,44,2,4,3,9,At Risk
49688,2582,54,65,1,5,4,10,At Risk
49917,65,90,417,5,5,5,15,Champions
49941,0,23,111,5,4,4,13,Champions
50076,2144,6,6,1,1,1,3,Lost
50151,594,13,26,2,3,2,7,Casual Users
50154,1655,5,21,1,1,2,4,Lost
50459,38,75,171,5,5,5,15,Champions
50623,975,9,14,2,2,1,5,Lost
50674,240,71,116,3,5,4,12,Loyal Users
50775,732,14,16,2,3,2,7,Casual Users
51198,412,42,139,3,4,4,11,Loyal Users
51285,4387,5,8,1,1,1,3,Lost
51529,414,13,18,3,3,2,8,Loyal Users
51834,210,44,186,3,4,5,12,Loyal Users
52075,84,5,6,4,1,1,6,Promising
52344,117,32,187,4,4,5,13,Champions
52349,118,36,106,4,4,4,12,Champions
39248,113,6,21,4,1,2,7,Promising
39515,1108,12,33,2,3,3,8,Casual Users
39704,90,10,34,4,2,3,9,Promising
40125,426,7,10,3,2,1,6,Casual Users
40420,25,42,184,5,4,5,14,Champions
40492,309,10,46,3,2,3,8,Casual Users
40837,245,50,116,3,5,4,12,Loyal Users
40965,754,8,12,2,2,1,5,Lost
41090,16,25,52,5,4,3,12,Loyal Users
41189,287,45,142,3,4,4,11,Loyal Users
41393,301,150,377,3,5,5,13,Loyal Users
41755,36,9,33,5,2,3,10,Promising
41842,711,8,15,2,2,1,5,Lost
41918,171,15,70,3,3,4,10,Loyal Users
42044,92,23,67,4,4,4,12,Champions
42314,422,12,24,3,3,2,8,Loyal Users
42322,190,130,277,3,5,5,13,Loyal Users
42442,92,44,91,4,4,4,12,Champions
42674,266,5,13,3,1,1,5,Casual Users
42723,134,21,47,4,3,3,10,Loyal Users
42746,125,70,207,4,5,5,14,Champions
42969,3,19,32,5,3,3,11,Loyal Users
43028,366,26,39,3,4,3,10,Loyal Users
43115,175,16,36,3,3,3,9,Loyal Users
43769,2422,5,11,1,1,1,3,Lost
44006,130,46,58,4,5,3,12,Loyal Users
44044,579,17,34,2,3,3,8,Casual Users
44253,800,5,9,2,1,1,4,Lost
44547,603,46,94,2,5,4,11,At Risk
44707,566,9,37,2,2,3,7,Lost
44834,69,58,163,5,5,5,15,Champions
44924,3155,10,10,1,2,1,4,Lost
44946,305,27,43,3,4,3,10,Loyal Users
45060,107,74,217,4,5,5,14,Champions
45175,3442,18,33,1,3,3,7,Casual Users
45204,3556,7,8,1,2,1,4,Lost
45456,101,17,71,4,3,4,11,Loyal Users
45771,254,16,70,3,3,4,10,Loyal Users
46044,267,13,29,3,3,2,8,Loyal Users
46203,97,26,52,4,4,3,11,Loyal Users
46206,654,18,33,2,3,3,8,Casual Users
47732,88,15,33,4,3,3,10,Loyal Users
47977,88,11,14,4,2,1,7,Promising
48405,831,9,19,2,2,2,6,Lost
48625,330,13,124,3,3,4,10,Loyal Users
48657,455,10,18,3,2,2,7,Casual Users
48706,1683,8,15,1,2,1,4,Lost
48717,126,40,51,4,4,3,11,Loyal Users
48949,7,25,34,5,4,3,12,Loyal Users
49002,6,50,184,5,5,5,15,Champions
49143,85,44,72,4,4,4,12,Champions
49150,3898,5,6,1,1,1,3,Lost
49598,568,9,17,2,2,2,6,Lost
49973,345,48,74,3,5,4,12,Loyal Users
50094,6025,6,32,1,1,3,5,Lost
50296,248,43,217,3,4,5,12,Loyal Users
50719,246,12,123,3,3,4,10,Loyal Users
50951,84,6,8,4,1,1,6,Promising
50980,1125,7,12,2,2,1,5,Lost
51319,1681,5,7,1,1,1,3,Lost
51453,46,12,28,5,3,2,10,Loyal Users
51480,95,143,314,4,5,5,14,Champions
51503,2519,10,26,1,2,2,5,Lost
51566,13,126,514,5,5,5,15,Champions
51685,483,10,25,2,2,2,6,Lost
51702,304,12,38,3,3,3,9,Loyal Users
51714,722,9,30,2,2,2,6,Lost
51888,1963,10,18,1,2,2,5,Lost
52018,638,13,20,2,3,2,7,Casual Users
52033,17,110,522,5,5,5,15,Champions
52270,245,46,147,3,5,5,13,Loyal Users
39268,87,74,520,4,5,5,14,Champions
39609,138,35,74,4,4,4,12,Champions
40275,78,37,186,4,4,5,13,Champions
40650,996,13,155,2,3,5,10,Casual Users
40692,0,11,19,5,2,2,9,Promising
40907,2181,14,70,1,3,4,8,Casual Users
40956,53,19,75,5,3,4,12,Loyal Users
41279,13,44,191,5,4,5,14,Champions
41296,250,34,40,3,4,3,10,Loyal Users
41328,23,23,109,5,4,4,13,Champions
41495,4,122,370,5,5,5,15,Champions
42151,159,30,98,4,4,4,12,Champions
42229,261,41,81,3,4,4,11,Loyal Users
42553,136,18,57,4,3,3,10,Loyal Users
42721,658,36,231,2,4,5,11,At Risk
42736,209,45,245,3,4,5,12,Loyal Users
42779,24,33,157,5,4,5,14,Champions
42791,148,5,8,4,1,1,6,Promising
42917,585,6,41,2,1,3,6,Lost
43261,999,7,32,2,2,3,7,Lost
43358,1373,13,28,1,3,2,6,Casual Users
43682,135,9,42,4,2,3,9,Promising
44153,667,9,15,2,2,1,5,Lost
44705,109,28,100,4,4,4,12,Champions
44875,2178,11,25,1,2,2,5,Lost
45147,145,93,223,4,5,5,14,Champions
45191,160,66,429,4,5,5,14,Champions
45540,268,58,216,3,5,5,13,Loyal Users
46207,4841,8,17,1,2,2,5,Lost
46243,280,30,112,3,4,4,11,Loyal Users
46264,138,35,44,4,4,3,11,Loyal Users
46447,225,28,37,3,4,3,10,Loyal Users
46628,2340,16,40,1,3,3,7,Casual Users
46738,4,85,338,5,5,5,15,Champions
46758,1688,12,13,1,3,1,5,Casual Users
47070,264,14,24,3,3,2,8,Loyal Users
47113,314,32,66,3,4,4,11,Loyal Users
47218,387,5,5,3,1,1,5,Casual Users
47524,242,42,78,3,4,4,11,Loyal Users
47599,125,87,444,4,5,5,14,Champions
47895,192,28,32,3,4,3,10,Loyal Users
47945,110,146,332,4,5,5,14,Champions
48097,51,48,340,5,5,5,15,Champions
48310,125,22,75,4,4,4,12,Champions
48501,117,31,149,4,4,5,13,Champions
48532,3917,5,17,1,1,2,4,Lost
48543,1162,13,35,2,3,3,8,Casual Users
48666,35,54,186,5,5,5,15,Champions
48953,548,16,71,2,3,4,9,Casual Users
49432,134,61,154,4,5,5,14,Champions
49537,0,128,549,5,5,5,15,Champions
49761,27,71,106,5,5,4,14,Champions
49805,3129,5,39,1,1,3,5,Lost
49864,405,12,78,3,3,4,10,Loyal Users
49955,534,13,31,2,3,2,7,Casual Users
49961,5,46,87,5,5,4,14,Champions
50272,997,7,8,2,2,1,5,Lost
50615,170,20,55,3,3,3,9,Loyal Users
50726,1843,5,21,1,1,2,4,Lost
51627,539,6,11,2,1,1,4,Lost
51635,1212,6,22,2,1,2,5,Lost
51774,402,10,19,3,2,2,7,Casual Users
52000,718,8,36,2,2,3,7,Lost
52040,97,5,11,4,1,1,6,Promising
52148,755,7,8,2,2,1,5,Lost
52259,2281,6,6,1,1,1,3,Lost
52352,0,34,143,5,4,4,13,Champions
39345,48,142,784,5,5,5,15,Champions
39399,119,8,82,4,2,4,10,Promising
39449,233,11,15,3,2,1,6,Casual Users
40435,110,19,27,4,3,2,9,Loyal Users
40471,1294,29,66,1,4,4,9,At Risk
40489,27,32,91,5,4,4,13,Champions
41198,25,43,85,5,4,4,13,Champions
41277,864,17,28,2,3,2,7,Casual Users
41398,675,23,42,2,4,3,9,At Risk
41454,109,64,163,4,5,5,14,Champions
41535,251,13,20,3,3,2,8,Loyal Users
41753,22,56,175,5,5,5,15,Champions
41872,3,18,131,5,3,4,12,Loyal Users
41897,545,14,23,2,3,2,7,Casual Users
41970,115,10,15,4,2,1,7,Promising
41979,319,13,40,3,3,3,9,Loyal Users
42001,7,15,72,5,3,4,12,Loyal Users
42046,593,23,30,2,4,2,8,At Risk
42079,740,9,57,2,2,3,7,Lost
42170,804,9,9,2,2,1,5,Lost
42400,40,60,95,5,5,4,14,Champions
42517,402,47,275,3,5,5,13,Loyal Users
42849,425,12,25,3,3,2,8,Loyal Users
43124,510,37,123,2,4,4,10,At Risk
43213,344,7,11,3,2,1,6,Casual Users
43580,399,31,42,3,4,3,10,Loyal Users
43655,1254,5,37,2,1,3,6,Lost
43869,957,28,122,2,4,4,10,At Risk
44240,813,13,44,2,3,3,8,Casual Users
44585,4315,6,9,1,1,1,3,Lost
44798,162,164,695,4,5,5,14,Champions
45121,217,59,155,3,5,5,13,Loyal Users
45405,820,9,11,2,2,1,5,Lost
45520,1597,29,39,1,4,3,8,At Risk
45765,1025,5,10,2,1,1,4,Lost
45887,407,39,105,3,4,4,11,Loyal Users
46408,689,7,101,2,2,4,8,Lost
46773,389,15,16,3,3,2,8,Loyal Users
46899,4233,7,12,1,2,1,4,Lost
47059,13,48,66,5,5,4,14,Champions
47185,112,39,399,4,4,5,13,Champions
47208,27,73,614,5,5,5,15,Champions
47364,710,7,18,2,2,2,6,Lost
47639,833,44,252,2,4,5,11,At Risk
47657,37,64,249,5,5,5,15,Champions
47707,27,21,24,5,3,2,10,Loyal Users
47829,1697,6,9,1,1,1,3,Lost
47906,252,7,17,3,2,2,7,Casual Users
47956,308,8,30,3,2,2,7,Casual Users
48575,31,62,193,5,5,5,15,Champions
48969,130,30,58,4,4,3,11,Loyal Users
49087,1,56,73,5,5,4,14,Champions
49420,2950,5,11,1,1,1,3,Lost
49506,155,46,86,4,5,4,13,Champions
49646,131,73,238,4,5,5,14,Champions
50188,454,11,13,3,2,1,6,Casual Users
50469,1045,5,6,2,1,1,4,Lost
50850,154,36,141,4,4,4,12,Champions
51103,5931,6,6,1,1,1,3,Lost
51167,0,107,343,5,5,5,15,Champions
51381,2172,9,11,1,2,1,4,Lost
51389,768,6,8,2,1,1,4,Lost
51440,778,8,42,2,2,3,7,Lost
51846,13,78,273,5,5,5,15,Champions
39500,5284,26,66,1,4,4,9,At Risk
39743,129,20,27,4,3,2,9,Loyal Users
39989,61,38,141,5,4,4,13,Champions
40068,120,9,40,4,2,3,9,Promising
40113,120,23,44,4,4,3,11,Loyal Users
40587,3879,12,49,1,3,3,7,Casual Users
40704,4,179,764,5,5,5,15,Champions
40797,1396,6,6,1,1,1,3,Lost
41241,4232,7,15,1,2,1,4,Lost
41429,244,25,59,3,4,3,10,Loyal Users
41433,4,81,273,5,5,5,15,Champions
41670,25,93,555,5,5,5,15,Champions
42065,218,34,80,3,4,4,11,Loyal Users
42093,961,5,14,2,1,1,4,Lost
42681,101,16,39,4,3,3,10,Loyal Users
42929,2573,6,21,1,1,2,4,Lost
43304,3512,15,18,1,3,2,6,Casual Users
43482,1361,10,24,1,2,2,5,Lost
43574,108,46,148,4,5,5,14,Champions
43622,1231,16,190,2,3,5,10,Casual Users
43671,278,21,63,3,3,4,10,Loyal Users
43854,707,17,30,2,3,2,7,Casual Users
44155,1200,5,62,2,1,3,6,Lost
44571,47,86,284,5,5,5,15,Champions
44610,104,7,17,4,2,2,8,Promising
45009,280,41,227,3,4,5,12,Loyal Users
45905,416,42,188,3,4,5,12,Loyal Users
45966,2158,21,30,1,3,2,6,Casual Users
45974,172,12,35,3,3,3,9,Loyal Users
46078,48,102,193,5,5,5,15,Champions
46307,2255,8,30,1,2,2,5,Lost
46459,425,13,37,3,3,3,9,Loyal Users
46645,1159,14,18,2,3,2,7,Casual Users
46732,166,16,59,3,3,3,9,Loyal Users
47278,26,34,43,5,4,3,12,Loyal Users
47401,466,12,18,3,3,2,8,Loyal Users
47699,155,21,75,4,3,4,11,Loyal Users
47780,5029,5,7,1,1,1,3,Lost
47947,171,5,6,3,1,1,5,Casual Users
48421,109,44,65,4,4,4,12,Champions
48523,877,23,34,2,4,3,9,At Risk
48840,4,154,504,5,5,5,15,Champions
48987,34,16,70,5,3,4,12,Loyal Users
49159,2,117,382,5,5,5,15,Champions
49637,66,38,175,5,4,5,14,Champions
49755,2715,6,33,1,1,3,5,Lost
50335,485,10,12,2,2,1,5,Lost
50466,30,109,759,5,5,5,15,Champions
50751,189,5,7,3,1,1,5,Casual Users
50906,820,15,43,2,3,3,8,Casual Users
51171,847,20,35,2,3,3,8,Casual Users
51668,681,21,22,2,3,2,7,Casual Users
51845,264,21,99,3,3,4,10,Loyal Users
51995,2414,19,49,1,3,3,7,Casual Users
52127,579,9,42,2,2,3,7,Lost
52314,76,62,112,4,5,4,13,Champions
52331,1845,16,46,1,3,3,7,Casual Users
39283,691,6,41,2,1,3,6,Lost
39439,1739,11,11,1,2,1,4,Lost
39933,85,71,140,4,5,4,13,Champions
40065,111,27,90,4,4,4,12,Champions
40575,42,51,110,5,5,4,14,Champions
40682,114,58,117,4,5,4,13,Champions
40716,2152,5,24,1,1,2,4,Lost
40850,64,92,417,5,5,5,15,Champions
41088,2401,9,48,1,2,3,6,Lost
41104,24,9,23,5,2,2,9,Promising
41179,437,44,80,3,4,4,11,Loyal Users
41661,188,25,107,3,4,4,11,Loyal Users
41673,3379,10,12,1,2,1,4,Lost
41853,44,59,107,5,5,4,14,Champions
41864,19,61,204,5,5,5,15,Champions
41876,24,17,24,5,3,2,10,Loyal Users
41999,356,14,66,3,3,4,10,Loyal Users
42162,121,71,118,4,5,4,13,Champions
42215,154,29,70,4,4,4,12,Champions
42285,534,8,10,2,2,1,5,Lost
42436,1568,9,14,1,2,1,4,Lost
42682,103,130,350,4,5,5,14,Champions
43511,19,14,35,5,3,3,11,Loyal Users
43611,1180,22,42,2,4,3,9,At Risk
43683,374,14,25,3,3,2,8,Loyal Users
44146,162,64,158,4,5,5,14,Champions
44559,405,25,69,3,4,4,11,Loyal Users
44614,282,8,13,3,2,1,6,Casual Users
44687,112,92,486,4,5,5,14,Champions
44716,389,8,17,3,2,2,7,Casual Users
44722,2429,6,15,1,1,1,3,Lost
44770,143,12,51,4,3,3,10,Loyal Users
45234,2285,9,35,1,2,3,6,Lost
45375,147,7,14,4,2,1,7,Promising
45570,106,34,40,4,4,3,11,Loyal Users
45654,686,7,30,2,2,2,6,Lost
45859,3439,16,43,1,3,3,7,Casual Users
46105,917,6,14,2,1,1,4,Lost
46145,468,19,36,3,3,3,9,Loyal Users
46252,35,73,260,5,5,5,15,Champions
46399,2173,12,13,1,3,1,5,Casual Users
46550,220,11,44,3,2,3,8,Casual Users
47419,696,6,12,2,1,1,4,Lost
48298,1978,7,8,1,2,1,4,Lost
48328,60,71,257,5,5,5,15,Champions
48374,308,10,13,3,2,1,6,Casual Users
48499,434,16,44,3,3,3,9,Loyal Users
48560,444,5,13,3,1,1,5,Casual Users
48613,1149,22,117,2,4,4,10,At Risk
49023,301,8,10,3,2,1,6,Casual Users
49056,82,31,80,4,4,4,12,Champions
49140,105,184,765,4,5,5,14,Champions
49362,660,11,29,2,2,2,6,Lost
49401,429,39,159,3,4,5,12,Loyal Users
49733,1147,13,74,2,3,4,9,Casual Users
50301,1840,6,7,1,1,1,3,Lost
50497,1468,5,7,1,1,1,3,Lost
50569,965,37,75,2,4,4,10,At Risk
50965,401,16,70,3,3,4,10,Loyal Users
50979,514,5,7,2,1,1,4,Lost
51191,76,32,63,4,4,4,12,Champions
51363,96,6,23,4,1,2,7,Promising
51771,3,158,476,5,5,5,15,Champions
39316,1688,8,11,1,2,1,4,Lost
39394,150,15,45,4,3,3,10,Loyal Users
39482,683,11,12,2,2,1,5,Lost
39545,4,20,29,5,3,2,10,Loyal Users
39642,3,13,49,5,3,3,11,Loyal Users
39711,281,40,66,3,4,4,11,Loyal Users
39894,526,18,41,2,3,3,8,Casual Users
39961,105,29,104,4,4,4,12,Champions
40250,245,38,129,3,4,4,11,Loyal Users
40437,337,35,52,3,4,3,10,Loyal Users
40537,150,8,13,4,2,1,7,Promising
40599,2714,19,29,1,3,2,6,Casual Users
41020,55,160,322,5,5,5,15,Champions
41351,147,19,79,4,3,4,11,Loyal Users
41394,82,5,7,4,1,1,6,Promising
41416,218,19,89,3,3,4,10,Loyal Users
42038,23,42,118,5,4,4,13,Champions
42041,1577,21,217,1,3,5,9,Casual Users
42045,28,39,62,5,4,3,12,Loyal Users
42095,61,205,439,5,5,5,15,Champions
42100,572,20,32,2,3,3,8,Casual Users
42105,629,16,56,2,3,3,8,Casual Users
42379,4234,6,16,1,1,2,4,Lost
42991,282,17,18,3,3,2,8,Loyal Users
43069,759,40,73,2,4,4,10,At Risk
43178,1261,9,12,1,2,1,4,Lost
43193,2154,7,10,1,2,1,4,Lost
43325,426,56,90,3,5,4,12,Loyal Users
43565,797,30,56,2,4,3,9,At Risk
43658,428,24,64,3,4,4,11,Loyal Users
44087,1539,12,13,1,3,1,5,Casual Users
44106,305,72,314,3,5,5,13,Loyal Users
44178,117,33,102,4,4,4,12,Champions
44260,117,17,93,4,3,4,11,Loyal Users
44621,60,50,92,5,5,4,14,Champions
44656,2237,5,10,1,1,1,3,Lost
44760,88,113,452,4,5,5,14,Champions
44891,308,30,527,3,4,5,12,Loyal Users
45529,2566,10,22,1,2,2,5,Lost
45736,713,9,17,2,2,2,6,Lost
45843,1701,16,43,1,3,3,7,Casual Users
46012,80,81,114,4,5,4,13,Champions
46393,566,9,42,2,2,3,7,Lost
46707,1547,41,102,1,4,4,9,At Risk
46714,203,43,68,3,4,4,11,Loyal Users
46756,61,16,72,5,3,4,12,Loyal Users
47153,135,52,188,4,5,5,14,Champions
47685,77,7,38,4,2,3,9,Promising
48362,24,30,88,5,4,4,13,Champions
48465,267,26,51,3,4,3,10,Loyal Users
48511,19,42,258,5,4,5,14,Champions
48976,24,82,175,5,5,5,15,Champions
49421,116,8,21,4,2,2,8,Promising
49899,396,9,22,3,2,2,7,Casual Users
49934,106,125,332,4,5,5,14,Champions
50117,3047,5,5,1,1,1,3,Lost
50300,264,25,74,3,4,4,11,Loyal Users
50313,418,56,289,3,5,5,13,Loyal Users
50611,68,13,48,5,3,3,11,Loyal Users
50717,27,30,199,5,4,5,14,Champions
50763,439,26,43,3,4,3,10,Loyal Users
50927,69,62,213,5,5,5,15,Champions
50967,23,41,102,5,4,4,13,Champions
51190,156,6,18,4,1,2,7,Promising
51856,403,5,5,3,1,1,5,Casual Users
52351,119,43,507,4,4,5,13,Champions
39325,404,6,10,3,1,1,5,Casual Users
39803,3383,7,10,1,2,1,4,Lost
39981,676,6,15,2,1,1,4,Lost
40711,872,12,26,2,3,2,7,Casual Users
40941,823,6,25,2,1,2,5,Lost
40976,1430,33,111,1,4,4,9,At Risk
41120,173,72,286,3,5,5,13,Loyal Users
41321,18,111,189,5,5,5,15,Champions
41547,444,44,93,3,4,4,11,Loyal Users
42592,175,29,55,3,4,3,10,Loyal Users
43040,1309,30,62,1,4,3,8,At Risk
43133,138,44,96,4,4,4,12,Champions
43232,258,20,91,3,3,4,10,Loyal Users
43428,279,50,122,3,5,4,12,Loyal Users
43436,12,88,138,5,5,4,14,Champions
43483,424,108,633,3,5,5,13,Loyal Users
43795,2950,5,10,1,1,1,3,Lost
43820,1369,13,23,1,3,2,6,Casual Users
44003,246,42,91,3,4,4,11,Loyal Users
44783,12,74,102,5,5,4,14,Champions
44950,3677,6,18,1,1,2,4,Lost
45098,514,8,29,2,2,2,6,Lost
45110,271,14,33,3,3,3,9,Loyal Users
45382,101,5,13,4,1,1,6,Promising
45413,1027,6,11,2,1,1,4,Lost
45588,2,21,97,5,3,4,12,Loyal Users
46066,312,6,71,3,1,4,8,Casual Users
46286,59,31,129,5,4,4,13,Champions
46358,291,55,387,3,5,5,13,Loyal Users
46368,335,58,276,3,5,5,13,Loyal Users
46527,63,54,440,5,5,5,15,Champions
46748,158,6,9,4,1,1,6,Promising
46796,768,12,127,2,3,4,9,Casual Users
47130,6,220,721,5,5,5,15,Champions
47253,82,92,314,4,5,5,14,Champions
48042,434,10,18,3,2,2,7,Casual Users
48119,280,15,49,3,3,3,9,Loyal Users
48584,1618,5,7,1,1,1,3,Lost
49175,1713,8,11,1,2,1,4,Lost
49257,144,32,62,4,4,3,11,Loyal Users
49383,3238,12,21,1,3,2,6,Casual Users
49410,522,5,6,2,1,1,4,Lost
50303,82,108,390,4,5,5,14,Champions
50737,407,7,11,3,2,1,6,Casual Users
51413,136,48,391,4,5,5,14,Champions
51663,283,37,217,3,4,5,12,Loyal Users
51970,81,19,22,4,3,2,9,Loyal Users
52113,130,50,79,4,5,4,13,Champions
52335,277,22,161,3,4,5,12,Loyal Users
52350,90,49,103,4,5,4,13,Champions
39475,130,10,17,4,2,2,8,Promising
39497,4908,7,13,1,2,1,4,Lost
39543,278,7,13,3,2,1,6,Casual Users
40130,198,7,39,3,2,3,8,Casual Users
40264,245,38,148,3,4,5,12,Loyal Users
40327,2079,8,18,1,2,2,5,Lost
40351,668,5,12,2,1,1,4,Lost
40412,477,10,11,2,2,1,5,Lost
40816,920,5,17,2,1,2,5,Lost
40838,113,93,598,4,5,5,14,Champions
40884,128,21,69,4,3,4,11,Loyal Users
40994,132,114,151,4,5,5,14,Champions
41500,20,83,222,5,5,5,15,Champions
41579,156,71,192,4,5,5,14,Champions
41601,133,60,101,4,5,4,13,Champions
41783,104,25,163,4,4,5,13,Champions
42061,173,71,165,3,5,5,13,Loyal Users
42086,1895,6,6,1,1,1,3,Lost
43022,15,16,45,5,3,3,11,Loyal Users
43226,1526,6,15,1,1,1,3,Lost
43843,102,53,158,4,5,5,14,Champions
43858,75,47,66,4,5,4,13,Champions
43990,694,13,21,2,3,2,7,Casual Users
44040,2595,10,35,1,2,3,6,Lost
44082,113,22,39,4,4,3,11,Loyal Users
44385,182,12,37,3,3,3,9,Loyal Users
44662,4124,6,33,1,1,3,5,Lost
44786,126,17,29,4,3,2,9,Loyal Users
44965,121,32,136,4,4,4,12,Champions
44992,2,33,180,5,4,5,14,Champions
45482,72,51,104,4,5,4,13,Champions
45949,3,60,130,5,5,4,14,Champions
45977,10,147,457,5,5,5,15,Champions
46228,128,43,119,4,4,4,12,Champions
46353,450,51,64,3,5,4,12,Loyal Users
46545,126,27,47,4,4,3,11,Loyal Users
46549,1915,5,6,1,1,1,3,Lost
46593,118,15,21,4,3,2,9,Loyal Users
46911,413,12,18,3,3,2,8,Loyal Users
46957,739,11,28,2,2,2,6,Lost
47117,2253,6,24,1,1,2,4,Lost
47251,103,81,230,4,5,5,14,Champions
47295,133,20,27,4,3,2,9,Loyal Users
47990,460,27,113,3,4,4,11,Loyal Users
48096,246,20,33,3,3,3,9,Loyal Users
48155,660,23,37,2,4,3,9,At Risk
48495,210,26,47,3,4,3,10,Loyal Users
48611,308,5,10,3,1,1,5,Casual Users
48618,279,8,23,3,2,2,7,Casual Users
48809,243,42,160,3,4,5,12,Loyal Users
48832,123,12,68,4,3,4,11,Loyal Users
48913,22,139,274,5,5,5,15,Champions
48938,1994,5,8,1,1,1,3,Lost
49272,94,49,108,4,5,4,13,Champions
49558,129,20,21,4,3,2,9,Loyal Users
49708,3149,12,17,1,3,2,6,Casual Users
49815,607,6,25,2,1,2,5,Lost
50008,29,61,127,5,5,4,14,Champions
50030,26,8,19,5,2,2,9,Promising
50604,2099,11,19,1,2,2,5,Lost
50736,857,15,85,2,3,4,9,Casual Users
50915,7,10,96,5,2,4,11,Promising
50982,5445,16,26,1,3,2,6,Casual Users
51015,162,26,68,4,4,4,12,Champions
51096,83,76,211,4,5,5,14,Champions
51409,159,53,123,4,5,4,13,Champions
51518,116,112,449,4,5,5,14,Champions
51531,19,63,330,5,5,5,15,Champions
52085,19,12,18,5,3,2,10,Loyal Users
39444,69,35,48,5,4,3,12,Loyal Users
39446,68,96,206,5,5,5,15,Champions
39519,318,11,132,3,2,4,9,Casual Users
39631,1141,9,12,2,2,1,5,Lost
39765,74,45,125,4,4,4,12,Champions
39782,196,12,22,3,3,2,8,Loyal Users
39814,1565,18,25,1,3,2,6,Casual Users
40031,5,70,182,5,5,5,15,Champions
40039,129,58,88,4,5,4,13,Champions
40388,1575,6,12,1,1,1,3,Lost
40621,3703,8,9,1,2,1,4,Lost
40681,259,5,7,3,1,1,5,Casual Users
40749,1027,15,27,2,3,2,7,Casual Users
40750,14,73,109,5,5,4,14,Champions
40934,2819,6,7,1,1,1,3,Lost
41168,322,25,163,3,4,5,12,Loyal Users
41531,4400,5,28,1,1,2,4,Lost
41700,1219,26,123,2,4,4,10,At Risk
41740,242,23,44,3,4,3,10,Loyal Users
41786,329,7,64,3,2,4,9,Casual Users
42345,405,24,30,3,4,2,9,Loyal Users
43120,298,23,31,3,4,2,9,Loyal Users
43129,161,24,47,4,4,3,11,Loyal Users
43277,57,7,13,5,2,1,8,Promising
43317,85,51,119,4,5,4,13,Champions
43346,305,9,19,3,2,2,7,Casual Users
43598,5322,20,35,1,3,3,7,Casual Users
43679,723,6,10,2,1,1,4,Lost
43772,101,9,31,4,2,2,8,Promising
43777,101,42,69,4,4,4,12,Champions
43970,574,7,20,2,2,2,6,Lost
44002,2693,7,7,1,2,1,4,Lost
44086,890,6,27,2,1,2,5,Lost
44225,4,131,367,5,5,5,15,Champions
44488,939,7,33,2,2,3,7,Lost
44674,231,71,126,3,5,4,12,Loyal Users
44682,799,15,29,2,3,2,7,Casual Users
45142,710,11,24,2,2,2,6,Lost
45379,796,7,7,2,2,1,5,Lost
45925,272,123,331,3,5,5,13,Loyal Users
46128,1427,6,21,1,1,2,4,Lost
46404,418,6,17,3,1,2,6,Casual Users
46575,2847,19,33,1,3,3,7,Casual Users
46633,1311,13,56,1,3,3,7,Casual Users
46853,289,6,14,3,1,1,5,Casual Users
46859,6,95,220,5,5,5,15,Champions
47054,2,10,13,5,2,1,8,Promising
47345,424,10,20,3,2,2,7,Casual Users
47625,22,215,444,5,5,5,15,Champions
47993,316,56,128,3,5,4,12,Loyal Users
48868,305,16,133,3,3,4,10,Loyal Users
49052,633,30,43,2,4,3,9,At Risk
49349,1789,33,243,1,4,5,10,At Risk
49448,418,31,62,3,4,3,10,Loyal Users
49473,14,9,29,5,2,2,9,Promising
49669,235,44,164,3,4,5,12,Loyal Users
50156,70,94,417,4,5,5,14,Champions
50445,82,9,86,4,2,4,10,Promising
50598,407,11,22,3,2,2,7,Casual Users
51131,265,161,268,3,5,5,13,Loyal Users
51334,121,21,140,4,3,4,11,Loyal Users
51673,118,45,203,4,4,5,13,Champions
52042,3,115,428,5,5,5,15,Champions
52172,2981,7,23,1,2,2,5,Lost
40443,953,14,29,2,3,2,7,Casual Users
40454,825,11,21,2,2,2,6,Lost
40529,117,20,55,4,3,3,10,Loyal Users
40639,4838,5,10,1,1,1,3,Lost
40992,1220,8,11,2,2,1,5,Lost
41297,2,65,476,5,5,5,15,Champions
41688,2766,6,6,1,1,1,3,Lost
42220,195,12,40,3,3,3,9,Loyal Users
42305,379,42,59,3,4,3,10,Loyal Users
42432,206,9,65,3,2,4,9,Casual Users
42702,82,95,308,4,5,5,14,Champions
42804,86,79,137,4,5,4,13,Champions
42846,1173,22,37,2,4,3,9,At Risk
43020,311,53,266,3,5,5,13,Loyal Users
43147,0,81,300,5,5,5,15,Champions
43461,12,94,325,5,5,5,15,Champions
43505,122,30,144,4,4,4,12,Champions
44189,20,87,240,5,5,5,15,Champions
44216,1259,16,46,1,3,3,7,Casual Users
44409,468,13,24,3,3,2,8,Loyal Users
44594,171,20,90,3,3,4,10,Loyal Users
44854,2376,7,67,1,2,4,7,Lost
45153,324,31,138,3,4,4,11,Loyal Users
45360,43,32,66,5,4,4,13,Champions
45461,2,20,28,5,3,2,10,Loyal Users
45477,940,73,240,2,5,5,12,At Risk
46181,97,29,48,4,4,3,11,Loyal Users
46561,135,24,93,4,4,4,12,Champions
47884,4178,7,9,1,2,1,4,Lost
47936,261,31,147,3,4,5,12,Loyal Users
48046,122,24,82,4,4,4,12,Champions
48048,7,22,75,5,4,4,13,Champions
48184,132,80,154,4,5,5,14,Champions
48614,877,18,48,2,3,3,8,Casual Users
48699,1002,12,18,2,3,2,7,Casual Users
49765,4388,10,10,1,2,1,4,Lost
50376,26,15,19,5,3,2,10,Loyal Users
50679,687,26,48,2,4,3,9,At Risk
51045,4102,7,7,1,2,1,4,Lost
51129,99,113,232,4,5,5,14,Champions
51320,32,125,466,5,5,5,15,Champions
51325,132,25,44,4,4,3,11,Loyal Users
51724,130,12,37,4,3,3,10,Loyal Users
52003,292,47,106,3,5,4,12,Loyal Users
52008,263,24,30,3,4,2,9,Loyal Users
52202,96,7,74,4,2,4,10,Promising
52237,986,6,14,2,1,1,4,Lost
52282,37,15,43,5,3,3,11,Loyal Users
39255,124,26,172,4,4,5,13,Champions
39504,402,8,10,3,2,1,6,Casual Users
39549,79,114,199,4,5,5,14,Champions
39557,242,31,85,3,4,4,11,Loyal Users
39700,272,15,34,3,3,3,9,Loyal Users
39855,200,36,86,3,4,4,11,Loyal Users
39866,0,51,86,5,5,4,14,Champions
40331,976,27,62,2,4,3,9,At Risk
40483,230,60,131,3,5,4,12,Loyal Users
40521,614,8,12,2,2,1,5,Lost
41116,501,10,33,2,2,3,7,Lost
41269,373,40,119,3,4,4,11,Loyal Users
41396,13,91,303,5,5,5,15,Champions
41667,252,6,47,3,1,3,7,Casual Users
41718,142,87,458,4,5,5,14,Champions
41895,374,10,14,3,2,1,6,Casual Users
42057,1853,13,34,1,3,3,7,Casual Users
42699,1997,19,66,1,3,4,8,Casual Users
42749,2989,11,14,1,2,1,4,Lost
43197,2132,8,52,1,2,3,6,Lost
43275,141,16,76,4,3,4,11,Loyal Users
43396,84,39,97,4,4,4,12,Champions
43510,407,8,13,3,2,1,6,Casual Users
43628,301,39,120,3,4,4,11,Loyal Users
43705,569,7,11,2,2,1,5,Lost
43815,2395,13,17,1,3,2,6,Casual Users
44033,766,7,12,2,2,1,5,Lost
44071,888,6,7,2,1,1,4,Lost
44445,91,29,71,4,4,4,12,Champions
44497,185,34,88,3,4,4,11,Loyal Users
44519,1274,6,6,1,1,1,3,Lost
44926,586,8,21,2,2,2,6,Lost
44931,120,105,638,4,5,5,14,Champions
45363,264,21,106,3,3,4,10,Loyal Users
45409,0,103,416,5,5,5,15,Champions
45624,1417,9,17,1,2,2,5,Lost
45772,1619,12,15,1,3,1,5,Casual Users
45854,666,15,219,2,3,5,10,Casual Users
45899,273,15,19,3,3,2,8,Loyal Users
45960,999,7,24,2,2,2,6,Lost
45996,1979,6,6,1,1,1,3,Lost
46175,23,25,53,5,4,3,12,Loyal Users
46193,995,11,32,2,2,3,7,Lost
46236,157,78,147,4,5,5,14,Champions
46396,261,15,42,3,3,3,9,Loyal Users
46632,1818,8,21,1,2,2,5,Lost
47145,2261,16,74,1,3,4,8,Casual Users
47436,195,6,7,3,1,1,5,Casual Users
47899,421,6,17,3,1,2,6,Casual Users
48113,8,22,48,5,4,3,12,Loyal Users
48150,17,44,349,5,4,5,14,Champions
48241,105,7,18,4,2,2,8,Promising
48408,4279,11,22,1,2,2,5,Lost
48429,643,21,55,2,3,3,8,Casual Users
48487,429,7,20,3,2,2,7,Casual Users
48500,2985,5,48,1,1,3,5,Lost
48509,45,29,52,5,4,3,12,Loyal Users
48529,122,115,155,4,5,5,14,Champions
48701,1710,22,73,1,4,4,9,At Risk
48852,3829,6,24,1,1,2,4,Lost
48904,257,6,19,3,1,2,6,Casual Users
49113,533,15,47,2,3,3,8,Casual Users
49117,1038,6,28,2,1,2,5,Lost
49460,400,13,45,3,3,3,9,Loyal Users
49627,3738,28,103,1,4,4,9,At Risk
49644,124,19,42,4,3,3,10,Loyal Users
49659,2664,6,31,1,1,2,4,Lost
49894,14,58,123,5,5,4,14,Champions
50071,90,44,107,4,4,4,12,Champions
50091,31,21,105,5,3,4,12,Loyal Users
50481,406,25,145,3,4,4,11,Loyal Users
50890,1388,7,29,1,2,2,5,Lost
51178,3121,9,14,1,2,1,4,Lost
51925,1841,9,22,1,2,2,5,Lost
51952,250,59,85,3,5,4,12,Loyal Users
52099,29,125,542,5,5,5,15,Champions
52185,167,19,68,3,3,4,10,Loyal Users
52226,121,38,79,4,4,4,12,Champions
52235,696,35,110,2,4,4,10,At Risk
39553,96,15,41,4,3,3,10,Loyal Users
39596,695,17,37,2,3,3,8,Casual Users
39658,1873,6,9,1,1,1,3,Lost
39862,1089,7,10,2,2,1,5,Lost
40408,3556,5,7,1,1,1,3,Lost
40589,11,46,102,5,5,4,14,Champions
40871,132,15,25,4,3,2,9,Loyal Users
40901,802,24,56,2,4,3,9,At Risk
40995,20,40,78,5,4,4,13,Champions
41016,248,57,76,3,5,4,12,Loyal Users
41221,5,106,267,5,5,5,15,Champions
41491,103,89,650,4,5,5,14,Champions
41770,2275,7,13,1,2,1,4,Lost
41785,94,40,84,4,4,4,12,Champions
42499,1599,6,14,1,1,1,3,Lost
42561,135,14,28,4,3,2,9,Loyal Users
42844,281,8,10,3,2,1,6,Casual Users
43331,2361,8,9,1,2,1,4,Lost
43495,154,18,51,4,3,3,10,Loyal Users
43697,210,6,8,3,1,1,5,Casual Users
43798,136,16,70,4,3,4,11,Loyal Users
43836,225,13,41,3,3,3,9,Loyal Users
43887,900,19,42,2,3,3,8,Casual Users
44330,130,13,42,4,3,3,10,Loyal Users
44391,702,5,9,2,1,1,4,Lost
44494,3060,24,28,1,4,2,7,At Risk
44861,132,13,33,4,3,3,10,Loyal Users
45245,470,14,52,3,3,3,9,Loyal Users
45609,24,41,99,5,4,4,13,Champions
46553,8,106,451,5,5,5,15,Champions
46848,23,45,72,5,4,4,13,Champions
46923,1819,30,74,1,4,4,9,At Risk
46976,17,35,58,5,4,3,12,Loyal Users
47163,305,8,8,3,2,1,6,Casual Users
47201,55,22,38,5,4,3,12,Loyal Users
47328,90,108,361,4,5,5,14,Champions
47413,444,21,52,3,3,3,9,Loyal Users
47481,998,14,28,2,3,2,7,Casual Users
47870,151,13,35,4,3,3,10,Loyal Users
47943,91,27,77,4,4,4,12,Champions
47995,569,11,14,2,2,1,5,Lost
48055,1861,14,31,1,3,2,6,Casual Users
48432,34,9,10,5,2,1,8,Promising
49090,1436,5,5,1,1,1,3,Lost
49137,20,69,158,5,5,5,15,Champions
49303,425,18,55,3,3,3,9,Loyal Users
50350,136,5,27,4,1,2,7,Promising
50413,285,12,23,3,3,2,8,Loyal Users
50488,695,8,19,2,2,2,6,Lost
50541,277,5,6,3,1,1,5,Casual Users
50573,95,107,301,4,5,5,14,Champions
50738,142,49,404,4,5,5,14,Champions
51002,589,7,11,2,2,1,5,Lost
51118,282,7,11,3,2,1,6,Casual Users
51452,136,6,27,4,1,2,7,Promising
51570,232,18,63,3,3,4,10,Loyal Users
51690,52,5,30,5,1,2,8,Promising
51703,18,81,448,5,5,5,15,Champions
51858,110,64,163,4,5,5,14,Champions
52076,46,26,119,5,4,4,13,Champions
52308,20,17,26,5,3,2,10,Loyal Users
40051,417,12,20,3,3,2,8,Loyal Users
40240,150,15,35,4,3,3,10,Loyal Users
40724,170,5,21,3,1,2,6,Casual Users
41123,422,5,8,3,1,1,5,Casual Users
41190,2143,7,10,1,2,1,4,Lost
41199,4271,9,9,1,2,1,4,Lost
41242,1018,6,21,2,1,2,5,Lost
41587,2927,8,24,1,2,2,5,Lost
41749,2730,9,28,1,2,2,5,Lost
41937,24,26,55,5,4,3,12,Loyal Users
42099,1952,7,7,1,2,1,4,Lost
42169,5762,7,29,1,2,2,5,Lost
42258,159,18,122,4,3,4,11,Loyal Users
42368,15,37,81,5,4,4,13,Champions
42507,459,22,31,3,4,2,9,Loyal Users
42678,1415,10,67,1,2,4,7,Lost
42758,271,23,61,3,4,3,10,Loyal Users
42900,268,27,53,3,4,3,10,Loyal Users
42936,477,37,68,2,4,4,10,At Risk
42995,40,70,223,5,5,5,15,Champions
43019,122,46,83,4,5,4,13,Champions
43606,101,7,12,4,2,1,7,Promising
44055,3616,11,32,1,2,3,6,Lost
44263,670,7,9,2,2,1,5,Lost
44420,1305,10,14,1,2,1,4,Lost
44676,3,12,96,5,3,4,12,Loyal Users
44733,2,24,121,5,4,4,13,Champions
44781,216,120,524,3,5,5,13,Loyal Users
44991,979,7,31,2,2,2,6,Lost
45014,162,11,42,4,2,3,9,Promising
45205,2,18,31,5,3,2,10,Loyal Users
45645,3499,5,10,1,1,1,3,Lost
45655,351,14,102,3,3,4,10,Loyal Users
45881,480,9,40,2,2,3,7,Lost
45890,192,49,154,3,5,5,13,Loyal Users
46317,285,5,11,3,1,1,5,Casual Users
46780,119,23,63,4,4,4,12,Champions
46849,2133,6,36,1,1,3,5,Lost
47086,87,135,289,4,5,5,14,Champions
47466,601,32,71,2,4,4,10,At Risk
47486,1109,5,10,2,1,1,4,Lost
47576,1718,5,33,1,1,3,5,Lost
47794,51,52,59,5,5,3,13,Loyal Users
47805,562,30,103,2,4,4,10,At Risk
47843,128,16,56,4,3,3,10,Loyal Users
47979,441,8,18,3,2,2,7,Casual Users
48446,2548,5,6,1,1,1,3,Lost
48586,264,59,194,3,5,5,13,Loyal Users
48710,152,36,159,4,4,5,13,Champions
48834,1328,10,21,1,2,2,5,Lost
49069,37,86,249,5,5,5,15,Champions
49511,2477,6,10,1,1,1,3,Lost
49611,146,36,98,4,4,4,12,Champions
49649,2131,10,16,1,2,2,5,Lost
49674,1323,7,7,1,2,1,4,Lost
50222,93,6,15,4,1,1,6,Promising
50281,300,35,83,3,4,4,11,Loyal Users
50346,437,48,144,3,5,4,12,Loyal Users
50408,271,26,115,3,4,4,11,Loyal Users
50709,409,8,50,3,2,3,8,Casual Users
50796,568,5,6,2,1,1,4,Lost
51089,2609,13,20,1,3,2,6,Casual Users
51823,2690,9,29,1,2,2,5,Lost
51847,1052,9,11,2,2,1,5,Lost
52118,112,48,118,4,5,4,13,Champions
52136,4,183,240,5,5,5,15,Champions
39309,121,36,101,4,4,4,12,Champions
39575,564,9,14,2,2,1,5,Lost
39697,728,12,22,2,3,2,7,Casual Users
39798,121,21,45,4,3,3,10,Loyal Users
39865,0,24,56,5,4,3,12,Loyal Users
40078,835,7,20,2,2,2,6,Lost
40243,623,6,6,2,1,1,4,Lost
40484,8,82,139,5,5,4,14,Champions
40498,11,9,16,5,2,2,9,Promising
40504,550,11,29,2,2,2,6,Lost
40507,2250,8,9,1,2,1,4,Lost
40921,17,18,28,5,3,2,10,Loyal Users
41067,194,17,26,3,3,2,8,Loyal Users
41091,5,241,970,5,5,5,15,Champions
41248,5211,8,13,1,2,1,4,Lost
41289,2074,23,39,1,4,3,8,At Risk
41336,1551,27,50,1,4,3,8,At Risk
41634,399,6,19,3,1,2,6,Casual Users
41756,1141,17,84,2,3,4,9,Casual Users
41974,469,15,42,3,3,3,9,Loyal Users
42460,2412,9,21,1,2,2,5,Lost
42598,847,18,25,2,3,2,7,Casual Users
43465,183,10,26,3,2,2,7,Casual Users
43874,422,6,19,3,1,2,6,Casual Users
44080,706,20,26,2,3,2,7,Casual Users
44181,2351,6,26,1,1,2,4,Lost
44259,88,23,144,4,4,4,12,Champions
44328,2335,14,40,1,3,3,7,Casual Users
44642,266,25,33,3,4,3,10,Loyal Users
44899,2062,5,31,1,1,2,4,Lost
45321,481,38,128,2,4,4,10,At Risk
45755,427,7,13,3,2,1,6,Casual Users
45994,9,96,196,5,5,5,15,Champions
46086,71,6,7,4,1,1,6,Promising
46123,930,9,25,2,2,2,6,Lost
46548,792,15,48,2,3,3,8,Casual Users
47224,127,16,126,4,3,4,11,Loyal Users
47348,6,49,120,5,5,4,14,Champions
47440,254,44,87,3,4,4,11,Loyal Users
47679,467,24,57,3,4,3,10,Loyal Users
47838,137,34,114,4,4,4,12,Champions
47923,160,7,65,4,2,4,10,Promising
48594,192,77,354,3,5,5,13,Loyal Users
48626,744,6,15,2,1,1,4,Lost
48664,1121,6,7,2,1,1,4,Lost
48756,404,8,27,3,2,2,7,Casual Users
48873,613,32,62,2,4,3,9,At Risk
48948,548,26,45,2,4,3,9,At Risk
49066,677,12,35,2,3,3,8,Casual Users
49187,300,10,24,3,2,2,7,Casual Users
49360,109,21,91,4,3,4,11,Loyal Users
49628,41,20,46,5,3,3,11,Loyal Users
49827,4900,19,19,1,3,2,6,Casual Users
50628,157,8,10,4,2,1,7,Promising
50835,1155,24,48,2,4,3,9,At Risk
51098,359,6,7,3,1,1,5,Casual Users
51370,143,47,158,4,5,5,14,Champions
52025,694,53,83,2,5,4,11,At Risk
52277,50,116,402,5,5,5,15,Champions
39290,1472,7,9,1,2,1,4,Lost
39625,25,43,180,5,4,5,14,Champions
39842,100,80,250,4,5,5,14,Champions
39974,118,48,73,4,5,4,13,Champions
40001,4579,16,58,1,3,3,7,Casual Users
40361,82,7,20,4,2,2,8,Promising
40457,51,37,169,5,4,5,14,Champions
40848,4890,7,21,1,2,2,5,Lost
40950,625,11,22,2,2,2,6,Lost
41048,3649,8,8,1,2,1,4,Lost
41165,1839,16,69,1,3,4,8,Casual Users
41227,1800,5,11,1,1,1,3,Lost
41327,5,126,261,5,5,5,15,Champions
41366,18,101,301,5,5,5,15,Champions
41426,92,76,171,4,5,5,14,Champions
41604,2378,11,16,1,2,2,5,Lost
41715,135,67,215,4,5,5,14,Champions
41774,858,31,117,2,4,4,10,At Risk
41796,989,5,15,2,1,1,4,Lost
42205,17,36,45,5,4,3,12,Loyal Users
42272,221,20,38,3,3,3,9,Loyal Users
42539,82,13,55,4,3,3,10,Loyal Users
42567,3421,6,10,1,1,1,3,Lost
42762,464,7,18,3,2,2,7,Casual Users
42823,117,21,48,4,3,3,10,Loyal Users
43046,1214,9,10,2,2,1,5,Lost
43116,54,76,328,5,5,5,15,Champions
43238,2415,7,7,1,2,1,4,Lost
43287,536,143,319,2,5,5,12,At Risk
44021,305,16,38,3,3,3,9,Loyal Users
44399,147,14,43,4,3,3,10,Loyal Users
44758,409,15,75,3,3,4,10,Loyal Users
44877,1540,16,27,1,3,2,6,Casual Users
45013,12,71,263,5,5,5,15,Champions
45095,12,41,134,5,4,4,13,Champions
45128,412,16,26,3,3,2,8,Loyal Users
45242,45,51,106,5,5,4,14,Champions
45346,115,12,17,4,3,2,9,Loyal Users
45348,123,26,34,4,4,3,11,Loyal Users
46204,126,49,88,4,5,4,13,Champions
46298,2732,5,17,1,1,2,4,Lost
46580,1160,21,132,2,3,4,9,Casual Users
46670,12,55,99,5,5,4,14,Champions
46730,235,12,17,3,3,2,8,Loyal Users
47161,1571,6,27,1,1,2,4,Lost
47202,75,81,199,4,5,5,14,Champions
47254,545,21,54,2,3,3,8,Casual Users
47512,437,42,75,3,4,4,11,Loyal Users
47713,263,85,394,3,5,5,13,Loyal Users
47782,997,16,23,2,3,2,7,Casual Users
48585,40,45,49,5,4,3,12,Loyal Users
48755,533,17,58,2,3,3,8,Casual Users
48775,1570,5,7,1,1,1,3,Lost
49091,347,11,14,3,2,1,6,Casual Users
49399,26,93,137,5,5,4,14,Champions
49909,394,8,10,3,2,1,6,Casual Users
49984,59,33,51,5,4,3,12,Loyal Users
50029,1525,11,18,1,2,2,5,Lost
50061,13,88,391,5,5,5,15,Champions
50275,1688,15,108,1,3,4,8,Casual Users
50357,308,30,53,3,4,3,10,Loyal Users
50710,266,65,295,3,5,5,13,Loyal Users
51289,0,34,57,5,4,3,12,Loyal Users
51573,1288,10,23,1,2,2,5,Lost
51768,58,11,16,5,2,2,9,Promising
51788,116,88,325,4,5,5,14,Champions
52134,4561,9,20,1,2,2,5,Lost
52243,289,7,28,3,2,2,7,Casual Users
39653,1831,17,56,1,3,3,7,Casual Users
39693,1515,12,34,1,3,3,7,Casual Users
39772,2266,5,9,1,1,1,3,Lost
39905,1145,7,22,2,2,2,6,Lost
39910,38,39,53,5,4,3,12,Loyal Users
39952,820,10,24,2,2,2,6,Lost
39956,284,12,25,3,3,2,8,Loyal Users
40026,261,122,243,3,5,5,13,Loyal Users
40166,16,70,189,5,5,5,15,Champions
40550,138,38,88,4,4,4,12,Champions
40722,162,99,163,4,5,5,14,Champions
40938,4,15,18,5,3,2,10,Loyal Users
41074,1262,8,45,1,2,3,6,Lost
41214,53,17,30,5,3,2,10,Loyal Users
41434,1369,5,11,1,1,1,3,Lost
41567,368,15,22,3,3,2,8,Loyal Users
41898,4747,8,35,1,2,3,6,Lost
41940,7,98,264,5,5,5,15,Champions
42062,54,84,372,5,5,5,15,Champions
42096,54,50,114,5,5,4,14,Champions
42125,154,5,7,4,1,1,6,Promising
42408,1,121,218,5,5,5,15,Champions
42722,2122,12,72,1,3,4,8,Casual Users
43195,2964,11,105,1,2,4,7,Lost
43435,3162,6,28,1,1,2,4,Lost
43715,1204,6,26,2,1,2,5,Lost
44728,3002,5,20,1,1,2,4,Lost
44857,11,12,26,5,3,2,10,Loyal Users
44934,270,10,13,3,2,1,6,Casual Users
45308,144,28,85,4,4,4,12,Champions
45436,289,6,7,3,1,1,5,Casual Users
45653,688,43,158,2,4,5,11,At Risk
46057,382,32,61,3,4,3,10,Loyal Users
46102,720,13,46,2,3,3,8,Casual Users
46208,3002,8,9,1,2,1,4,Lost
46787,303,28,58,3,4,3,10,Loyal Users
46795,1035,80,419,2,5,5,12,At Risk
46963,65,118,1118,5,5,5,15,Champions
47138,39,15,48,5,3,3,11,Loyal Users
47213,1409,12,17,1,3,2,6,Casual Users
47404,517,5,10,2,1,1,4,Lost
47988,1410,12,54,1,3,3,7,Casual Users
49433,70,30,94,4,4,4,12,Champions
49436,496,35,253,2,4,5,11,At Risk
49566,14,10,45,5,2,3,10,Promising
49571,531,16,95,2,3,4,9,Casual Users
49810,135,41,78,4,4,4,12,Champions
49883,232,82,533,3,5,5,13,Loyal Users
50841,108,6,18,4,1,2,7,Promising
50885,577,12,19,2,3,2,7,Casual Users
51074,576,62,99,2,5,4,11,At Risk
51157,757,5,7,2,1,1,4,Lost
51168,303,17,136,3,3,4,10,Loyal Users
51196,444,41,50,3,4,3,10,Loyal Users
51288,414,5,16,3,1,2,6,Casual Users
51485,7,63,114,5,5,4,14,Champions
52178,1581,5,32,1,1,3,5,Lost
39402,413,12,33,3,3,3,9,Loyal Users
39623,1598,8,43,1,2,3,6,Lost
39705,6,72,139,5,5,4,14,Champions
39800,1645,7,7,1,2,1,4,Lost
40191,279,17,23,3,3,2,8,Loyal Users
41103,2407,6,18,1,1,2,4,Lost
41412,33,47,189,5,5,5,15,Champions
41551,185,15,40,3,3,3,9,Loyal Users
41811,796,34,100,2,4,4,10,At Risk
41820,65,26,175,5,4,5,14,Champions
41976,317,6,15,3,1,1,5,Casual Users
42108,1739,8,18,1,2,2,5,Lost
42238,1994,12,45,1,3,3,7,Casual Users
42404,52,17,33,5,3,3,11,Loyal Users
42493,426,22,32,3,4,3,10,Loyal Users
42602,0,32,141,5,4,4,13,Champions
42604,215,23,113,3,4,4,11,Loyal Users
42688,627,16,130,2,3,4,9,Casual Users
42710,151,8,14,4,2,1,7,Promising
42805,299,173,313,3,5,5,13,Loyal Users
42877,96,17,28,4,3,2,9,Loyal Users
43004,169,92,324,3,5,5,13,Loyal Users
43070,1269,5,31,1,1,2,4,Lost
43107,433,19,41,3,3,3,9,Loyal Users
43123,45,62,99,5,5,4,14,Champions
43250,77,19,46,4,3,3,10,Loyal Users
43496,813,32,86,2,4,4,10,At Risk
43923,147,8,14,4,2,1,7,Promising
43975,850,7,17,2,2,2,6,Lost
44052,1615,8,8,1,2,1,4,Lost
44162,102,11,16,4,2,2,8,Promising
44721,1429,16,75,1,3,4,8,Casual Users
45844,1211,18,41,2,3,3,8,Casual Users
45948,195,162,274,3,5,5,13,Loyal Users
46249,117,14,42,4,3,3,10,Loyal Users
46279,126,7,38,4,2,3,9,Promising
46302,398,22,68,3,4,4,11,Loyal Users
46372,445,10,30,3,2,2,7,Casual Users
46595,520,86,169,2,5,5,12,At Risk
46874,412,5,19,3,1,2,6,Casual Users
46962,51,44,70,5,4,4,13,Champions
47303,1433,6,10,1,1,1,3,Lost
47327,3,157,451,5,5,5,15,Champions
47424,25,129,447,5,5,5,15,Champions
47665,626,6,8,2,1,1,4,Lost
47729,386,44,144,3,4,4,11,Loyal Users
47736,655,15,34,2,3,3,8,Casual Users
47955,279,14,22,3,3,2,8,Loyal Users
48741,1,42,105,5,4,4,13,Champions
49647,6,105,674,5,5,5,15,Champions
49868,116,55,139,4,5,4,13,Champions
49896,660,8,15,2,2,1,5,Lost
50088,10,66,170,5,5,5,15,Champions
50337,1415,10,61,1,2,3,6,Lost
50695,79,63,198,4,5,5,14,Champions
50715,149,10,41,4,2,3,9,Promising
50742,150,49,100,4,5,4,13,Champions
50750,69,105,673,5,5,5,15,Champions
51069,9,45,282,5,4,5,14,Champions
51299,694,17,36,2,3,3,8,Casual Users
51464,5728,5,5,1,1,1,3,Lost
51568,822,5,8,2,1,1,4,Lost
51864,115,41,135,4,4,4,12,Champions
52181,26,32,173,5,4,5,14,Champions
52208,1269,20,85,1,3,4,8,Casual Users
39315,431,6,8,3,1,1,5,Casual Users
39542,91,34,172,4,4,5,13,Champions
39735,6,218,713,5,5,5,15,Champions
39780,76,26,111,4,4,4,12,Champions
40101,66,67,170,5,5,5,15,Champions
40772,5285,5,13,1,1,1,3,Lost
40831,72,37,72,4,4,4,12,Champions
40857,1565,6,6,1,1,1,3,Lost
41150,1734,5,12,1,1,1,3,Lost
41339,441,10,46,3,2,3,8,Casual Users
41440,2251,15,30,1,3,2,6,Casual Users
41592,2078,15,27,1,3,2,6,Casual Users
41652,17,94,320,5,5,5,15,Champions
41735,2793,10,17,1,2,2,5,Lost
41884,431,13,20,3,3,2,8,Loyal Users
41939,33,49,88,5,5,4,14,Champions
41996,275,11,36,3,2,3,8,Casual Users
42063,132,16,41,4,3,3,10,Loyal Users
42472,0,45,84,5,4,4,13,Champions
42490,4299,5,8,1,1,1,3,Lost
42497,547,12,19,2,3,2,7,Casual Users
42893,11,31,122,5,4,4,13,Champions
43005,160,7,18,4,2,2,8,Promising
43475,277,21,37,3,3,3,9,Loyal Users
43954,1122,8,10,2,2,1,5,Lost
44098,95,104,398,4,5,5,14,Champions
44149,8,112,238,5,5,5,15,Champions
44359,2019,9,18,1,2,2,5,Lost
44714,428,28,49,3,4,3,10,Loyal Users
45088,3,142,474,5,5,5,15,Champions
45238,380,5,11,3,1,1,5,Casual Users
45336,4254,22,23,1,4,2,7,At Risk
45803,128,77,123,4,5,4,13,Champions
45880,3,13,15,5,3,1,9,Loyal Users
45921,13,71,358,5,5,5,15,Champions
46141,144,9,33,4,2,3,9,Promising
46163,1283,12,28,1,3,2,6,Casual Users
46260,675,13,20,2,3,2,7,Casual Users
46392,170,8,13,3,2,1,6,Casual Users
46570,1210,5,12,2,1,1,4,Lost
46578,454,31,155,3,4,5,12,Loyal Users
46774,1757,40,223,1,4,5,10,At Risk
47010,2195,10,11,1,2,1,4,Lost
47198,832,14,63,2,3,4,9,Casual Users
47548,23,116,567,5,5,5,15,Champions
47924,17,57,146,5,5,4,14,Champions
47941,441,24,88,3,4,4,11,Loyal Users
48217,224,18,139,3,3,4,10,Loyal Users
48331,105,69,263,4,5,5,14,Champions
48905,71,115,214,4,5,5,14,Champions
49166,3065,6,12,1,1,1,3,Lost
49359,231,30,183,3,4,5,12,Loyal Users
49577,79,12,29,4,3,2,9,Loyal Users
49969,56,116,495,5,5,5,15,Champions
50191,751,6,35,2,1,3,6,Lost
50759,1734,11,65,1,2,4,7,Lost
50998,983,5,19,2,1,2,5,Lost
51006,72,15,94,4,3,4,11,Loyal Users
52240,235,40,248,3,4,5,12,Loyal Users
39243,930,14,127,2,3,4,9,Casual Users
39472,163,7,14,4,2,1,7,Promising
39754,66,60,270,5,5,5,15,Champions
39912,2719,7,10,1,2,1,4,Lost
40323,453,29,82,3,4,4,11,Loyal Users
40679,238,9,12,3,2,1,6,Casual Users
41033,698,5,13,2,1,1,4,Lost
41278,671,17,30,2,3,2,7,Casual Users
41311,1673,10,11,1,2,1,4,Lost
41692,13,46,220,5,5,5,15,Champions
41748,221,12,32,3,3,3,9,Loyal Users
41917,5,24,36,5,4,3,12,Loyal Users
42128,79,43,78,4,4,4,12,Champions
42146,20,59,304,5,5,5,15,Champions
42287,27,77,453,5,5,5,15,Champions
42319,1455,15,42,1,3,3,7,Casual Users
42471,811,23,73,2,4,4,10,At Risk
42478,3171,5,20,1,1,2,4,Lost
42548,263,43,106,3,4,4,11,Loyal Users
42712,5680,5,7,1,1,1,3,Lost
43059,94,37,73,4,4,4,12,Champions
43142,209,27,36,3,4,3,10,Loyal Users
43159,47,8,14,5,2,1,8,Promising
43394,4376,8,22,1,2,2,5,Lost
43433,839,21,70,2,3,4,9,Casual Users
43451,867,15,33,2,3,3,8,Casual Users
43523,980,8,20,2,2,2,6,Lost
43639,4,24,45,5,4,3,12,Loyal Users
43876,1056,12,23,2,3,2,7,Casual Users
43939,2247,7,63,1,2,4,7,Lost
44270,24,16,98,5,3,4,12,Loyal Users
44271,1896,8,10,1,2,1,4,Lost
44425,82,42,129,4,4,4,12,Champions
44896,150,5,11,4,1,1,6,Promising
45501,5,24,74,5,4,4,13,Champions
46173,271,97,367,3,5,5,13,Loyal Users
46385,413,38,148,3,4,5,12,Loyal Users
46435,994,7,19,2,2,2,6,Lost
46487,10,160,251,5,5,5,15,Champions
46651,169,24,122,3,4,4,11,Loyal Users
47459,143,17,53,4,3,3,10,Loyal Users
47660,24,95,324,5,5,5,15,Champions
48011,3563,6,27,1,1,2,4,Lost
48168,758,6,14,2,1,1,4,Lost
48519,955,33,52,2,4,3,9,At Risk
48544,81,52,179,4,5,5,14,Champions
48697,350,19,44,3,3,3,9,Loyal Users
48861,472,25,77,2,4,4,10,At Risk
48888,516,9,39,2,2,3,7,Lost
49269,394,17,95,3,3,4,10,Loyal Users
49343,3284,8,15,1,2,1,4,Lost
49388,11,9,18,5,2,2,9,Promising
49509,116,36,128,4,4,4,12,Champions
49725,1474,13,40,1,3,3,7,Casual Users
49787,1715,13,19,1,3,2,6,Casual Users
50423,392,8,19,3,2,2,7,Casual Users
50536,2626,15,18,1,3,2,6,Casual Users
50787,693,8,52,2,2,3,7,Lost
50922,422,7,15,3,2,1,6,Casual Users
51192,144,5,26,4,1,2,7,Promising
51271,1708,7,17,1,2,2,5,Lost
51535,287,6,16,3,1,2,6,Casual Users
51660,543,39,135,2,4,4,10,At Risk
51704,238,22,41,3,4,3,10,Loyal Users
52095,3039,5,13,1,1,1,3,Lost
39275,246,17,61,3,3,3,9,Loyal Users
39595,93,58,108,4,5,4,13,Champions
39773,3880,10,18,1,2,2,5,Lost
39999,178,50,198,3,5,5,13,Loyal Users
40042,105,31,48,4,4,3,11,Loyal Users
40277,219,12,17,3,3,2,8,Loyal Users
40355,3957,9,23,1,2,2,5,Lost
40755,4288,5,5,1,1,1,3,Lost
41039,93,72,121,4,5,4,13,Champions
41428,1169,5,13,2,1,1,4,Lost
41659,19,41,49,5,4,3,12,Loyal Users
41981,236,107,359,3,5,5,13,Loyal Users
42464,226,16,83,3,3,4,10,Loyal Users
42588,2222,26,157,1,4,5,10,At Risk
42615,1410,5,27,1,1,2,4,Lost
42751,271,120,306,3,5,5,13,Loyal Users
42764,952,33,35,2,4,3,9,At Risk
42912,419,59,76,3,5,4,12,Loyal Users
42970,3163,5,6,1,1,1,3,Lost
43152,937,58,134,2,5,4,11,At Risk
43245,45,39,204,5,4,5,14,Champions
43907,221,37,100,3,4,4,11,Loyal Users
44097,81,10,16,4,2,2,8,Promising
44791,277,14,28,3,3,2,8,Loyal Users
45025,115,144,379,4,5,5,14,Champions
45063,46,23,31,5,4,2,11,Loyal Users
45219,1817,8,32,1,2,3,6,Lost
45275,126,25,90,4,4,4,12,Champions
45285,1661,6,7,1,1,1,3,Lost
45329,429,17,35,3,3,3,9,Loyal Users
45438,112,51,101,4,5,4,13,Champions
45591,438,14,42,3,3,3,9,Loyal Users
46094,238,101,263,3,5,5,13,Loyal Users
46133,547,6,17,2,1,2,5,Lost
46233,609,9,23,2,2,2,6,Lost
46326,18,210,716,5,5,5,15,Champions
46558,36,42,87,5,4,4,13,Champions
46606,113,32,55,4,4,3,11,Loyal Users
46652,2309,7,11,1,2,1,4,Lost
46704,3,56,453,5,5,5,15,Champions
46816,788,15,23,2,3,2,7,Casual Users
46830,7,77,188,5,5,5,15,Champions
46838,0,10,29,5,2,2,9,Promising
47336,26,109,311,5,5,5,15,Champions
47800,2520,5,11,1,1,1,3,Lost
47816,913,7,18,2,2,2,6,Lost
48086,687,9,30,2,2,2,6,Lost
48423,3571,5,12,1,1,1,3,Lost
48932,676,7,14,2,2,1,5,Lost
48975,78,36,90,4,4,4,12,Champions
49258,862,16,57,2,3,3,8,Casual Users
49380,414,11,22,3,2,2,7,Casual Users
49583,1816,7,10,1,2,1,4,Lost
49654,281,13,32,3,3,3,9,Loyal Users
49710,37,55,265,5,5,5,15,Champions
49841,28,79,235,5,5,5,15,Champions
50082,194,14,75,3,3,4,10,Loyal Users
50099,709,10,27,2,2,2,6,Lost
50248,343,16,22,3,3,2,8,Loyal Users
50274,124,6,41,4,1,3,8,Promising
50446,1500,77,484,1,5,5,11,At Risk
50591,3162,5,5,1,1,1,3,Lost
50824,2221,27,50,1,4,3,8,At Risk
50962,240,29,44,3,4,3,10,Loyal Users
51088,596,6,13,2,1,1,4,Lost
51324,23,35,57,5,4,3,12,Loyal Users
51458,139,16,31,4,3,2,9,Loyal Users
52020,281,6,12,3,1,1,5,Casual Users
52144,8,81,421,5,5,5,15,Champions
52355,490,25,60,2,4,3,9,At Risk
39339,16,65,272,5,5,5,15,Champions
39421,17,14,24,5,3,2,10,Loyal Users
39426,125,31,98,4,4,4,12,Champions
39715,459,36,80,3,4,4,11,Loyal Users
40210,272,45,260,3,4,5,12,Loyal Users
40316,80,92,436,4,5,5,14,Champions
40387,2426,6,15,1,1,1,3,Lost
40451,1458,23,33,1,4,3,8,At Risk
40508,557,10,75,2,2,4,8,Lost
40916,790,10,67,2,2,4,8,Lost
41340,82,20,26,4,3,2,9,Loyal Users
41373,143,19,126,4,3,4,11,Loyal Users
41382,102,22,48,4,4,3,11,Loyal Users
41687,274,46,65,3,5,4,12,Loyal Users
41721,697,18,80,2,3,4,9,Casual Users
41947,96,33,157,4,4,5,13,Champions
42221,797,5,11,2,1,1,4,Lost
42331,134,29,86,4,4,4,12,Champions
42563,889,24,33,2,4,3,9,At Risk
42570,0,23,111,5,4,4,13,Champions
42700,13,27,153,5,4,5,14,Champions
42793,172,66,152,3,5,5,13,Loyal Users
42955,1545,7,17,1,2,2,5,Lost
42965,23,39,132,5,4,4,13,Champions
43139,965,8,9,2,2,1,5,Lost
43922,27,24,38,5,4,3,12,Loyal Users
44165,127,9,9,4,2,1,7,Promising
44905,59,52,112,5,5,4,14,Champions
44944,5881,9,36,1,2,3,6,Lost
45283,426,29,86,3,4,4,11,Loyal Users
45564,108,64,78,4,5,4,13,Champions
45586,208,32,136,3,4,4,11,Loyal Users
45651,281,23,35,3,4,3,10,Loyal Users
46191,3388,6,37,1,1,3,5,Lost
46334,445,18,50,3,3,3,9,Loyal Users
46532,139,20,157,4,3,5,12,Loyal Users
46987,3583,6,28,1,1,2,4,Lost
47095,1519,17,28,1,3,2,6,Casual Users
47349,19,7,15,5,2,1,8,Promising
47368,112,10,89,4,2,4,10,Promising
47632,12,166,430,5,5,5,15,Champions
47737,2411,9,37,1,2,3,6,Lost
47762,36,111,472,5,5,5,15,Champions
48609,422,31,88,3,4,4,11,Loyal Users
48622,50,155,210,5,5,5,15,Champions
48845,137,27,165,4,4,5,13,Champions
49124,488,5,9,2,1,1,4,Lost
49372,3,58,202,5,5,5,15,Champions
49634,38,66,95,5,5,4,14,Champions
50014,200,5,5,3,1,1,5,Casual Users
50746,5,18,64,5,3,4,12,Loyal Users
50999,101,11,58,4,2,3,9,Promising
51021,12,5,14,5,1,1,7,Promising
51262,432,23,40,3,4,3,10,Loyal Users
51584,122,25,86,4,4,4,12,Champions
52207,406,35,45,3,4,3,10,Loyal Users
39313,5,28,143,5,4,4,13,Champions
39335,452,11,16,3,2,2,7,Casual Users
39336,273,14,28,3,3,2,8,Loyal Users
39368,277,15,22,3,3,2,8,Loyal Users
39386,3485,20,82,1,3,4,8,Casual Users
39578,116,88,114,4,5,4,13,Champions
39749,532,6,9,2,1,1,4,Lost
40079,287,8,19,3,2,2,7,Casual Users
40193,915,10,44,2,2,3,7,Lost
40606,407,12,58,3,3,3,9,Loyal Users
40720,27,33,54,5,4,3,12,Loyal Users
40844,40,21,33,5,3,3,11,Loyal Users
41284,2310,23,29,1,4,2,7,At Risk
41581,1426,8,12,1,2,1,4,Lost
41606,2310,10,45,1,2,3,6,Lost
41841,258,52,93,3,5,4,12,Loyal Users
41956,44,37,96,5,4,4,13,Champions
42152,825,5,26,2,1,2,5,Lost
42734,3992,7,17,1,2,2,5,Lost
42981,66,69,167,5,5,5,15,Champions
43029,114,26,84,4,4,4,12,Champions
43215,82,13,22,4,3,2,9,Loyal Users
43442,18,85,194,5,5,5,15,Champions
43667,95,81,249,4,5,5,14,Champions
43855,1720,14,15,1,3,1,5,Casual Users
44013,569,7,13,2,2,1,5,Lost
44170,2146,8,24,1,2,2,5,Lost
44244,12,65,277,5,5,5,15,Champions
44355,109,6,9,4,1,1,6,Promising
44357,2593,73,100,1,5,4,10,At Risk
44624,1507,13,22,1,3,2,6,Casual Users
44842,146,44,59,4,4,3,11,Loyal Users
45167,4282,5,9,1,1,1,3,Lost
45281,12,17,29,5,3,2,10,Loyal Users
45293,108,9,44,4,2,3,9,Promising
45508,273,63,155,3,5,5,13,Loyal Users
45734,127,20,44,4,3,3,10,Loyal Users
46043,30,6,49,5,1,3,9,Promising
46171,574,16,26,2,3,2,7,Casual Users
46187,1667,7,34,1,2,3,6,Lost
46246,214,6,40,3,1,3,7,Casual Users
46395,2782,6,6,1,1,1,3,Lost
46616,267,22,39,3,4,3,10,Loyal Users
46668,32,126,217,5,5,5,15,Champions
47435,1569,9,40,1,2,3,6,Lost
47616,166,45,101,3,4,4,11,Loyal Users
47634,13,13,22,5,3,2,10,Loyal Users
47764,1002,11,27,2,2,2,6,Lost
48140,137,13,44,4,3,3,10,Loyal Users
48264,405,17,52,3,3,3,9,Loyal Users
48685,939,12,38,2,3,3,8,Casual Users
48761,136,105,173,4,5,5,14,Champions
48916,1414,6,34,1,1,3,5,Lost
49008,14,38,193,5,4,5,14,Champions
49102,10,30,131,5,4,4,13,Champions
49847,3548,6,19,1,1,2,4,Lost
49926,5524,7,12,1,2,1,4,Lost
50013,3466,9,16,1,2,2,5,Lost
50197,14,96,366,5,5,5,15,Champions
50545,3595,5,6,1,1,1,3,Lost
50607,1133,7,25,2,2,2,6,Lost
50819,4,162,314,5,5,5,15,Champions
51033,119,7,43,4,2,3,9,Promising
51416,131,7,16,4,2,2,8,Promising
51443,203,31,106,3,4,4,11,Loyal Users
51472,1292,14,31,1,3,2,6,Casual Users
51482,218,87,504,3,5,5,13,Loyal Users
51550,2602,11,15,1,2,1,4,Lost
52082,1,187,306,5,5,5,15,Champions
39249,1262,13,29,1,3,2,6,Casual Users
39353,654,5,12,2,1,1,4,Lost
39536,2243,19,30,1,3,2,6,Casual Users
39564,7,8,44,5,2,3,10,Promising
39698,98,12,44,4,3,3,10,Loyal Users
39775,27,8,13,5,2,1,8,Promising
39811,841,62,73,2,5,4,11,At Risk
40006,5,61,193,5,5,5,15,Champions
40088,106,26,97,4,4,4,12,Champions
40357,3730,5,12,1,1,1,3,Lost
41053,77,38,120,4,4,4,12,Champions
41233,412,7,32,3,2,3,8,Casual Users
41561,8,14,38,5,3,3,11,Loyal Users
42072,1608,9,32,1,2,3,6,Lost
42453,694,7,13,2,2,1,5,Lost
42538,118,69,247,4,5,5,14,Champions
42971,271,7,39,3,2,3,8,Casual Users
43150,34,18,29,5,3,2,10,Loyal Users
43333,836,19,73,2,3,4,9,Casual Users
44220,876,11,16,2,2,2,6,Lost
44285,971,13,40,2,3,3,8,Casual Users
44323,33,60,169,5,5,5,15,Champions
44383,177,49,361,3,5,5,13,Loyal Users
44418,407,15,53,3,3,3,9,Loyal Users
44828,160,7,23,4,2,2,8,Promising
44830,88,85,255,4,5,5,14,Champions
44858,8,48,81,5,5,4,14,Champions
45139,720,7,23,2,2,2,6,Lost
45279,45,53,127,5,5,4,14,Champions
45304,13,133,700,5,5,5,15,Champions
45827,743,27,101,2,4,4,10,At Risk
45863,73,15,40,4,3,3,10,Loyal Users
45877,422,14,19,3,3,2,8,Loyal Users
46062,3107,8,14,1,2,1,4,Lost
46349,171,9,33,3,2,3,8,Casual Users
46687,53,77,240,5,5,5,15,Champions
47139,26,33,121,5,4,4,13,Champions
47261,4176,6,28,1,1,2,4,Lost
48703,33,21,26,5,3,2,10,Loyal Users
48753,713,11,20,2,2,2,6,Lost
49057,129,90,172,4,5,5,14,Champions
49130,122,28,115,4,4,4,12,Champions
49174,878,17,24,2,3,2,7,Casual Users
49700,19,54,89,5,5,4,14,Champions
49756,1546,7,9,1,2,1,4,Lost
50169,403,20,36,3,3,3,9,Loyal Users
50206,11,64,142,5,5,4,14,Champions
50565,768,5,15,2,1,1,4,Lost
51078,83,31,147,4,4,5,13,Champions
51441,12,6,17,5,1,2,8,Promising
52260,297,34,71,3,4,4,11,Loyal Users
52267,30,56,268,5,5,5,15,Champions
39262,585,22,38,2,4,3,9,At Risk
39463,371,48,93,3,5,4,12,Loyal Users
39489,546,24,48,2,4,3,9,At Risk
39752,93,66,170,4,5,5,14,Champions
39908,698,11,12,2,2,1,5,Lost
40005,1647,5,45,1,1,3,5,Lost
40050,4,18,26,5,3,2,10,Loyal Users
40067,187,28,78,3,4,4,11,Loyal Users
40224,27,24,34,5,4,3,12,Loyal Users
40490,2390,6,8,1,1,1,3,Lost
40619,467,12,98,3,3,4,10,Loyal Users
40643,84,12,21,4,3,2,9,Loyal Users
41403,844,8,20,2,2,2,6,Lost
41410,101,136,283,4,5,5,14,Champions
41515,674,19,58,2,3,3,8,Casual Users
41662,213,117,406,3,5,5,13,Loyal Users
41664,315,10,20,3,2,2,7,Casual Users
41989,504,6,13,2,1,1,4,Lost
42117,725,5,41,2,1,3,6,Lost
42210,173,32,99,3,4,4,11,Loyal Users
42213,308,10,51,3,2,3,8,Casual Users
42335,966,5,7,2,1,1,4,Lost
42580,181,18,46,3,3,3,9,Loyal Users
42776,236,7,13,3,2,1,6,Casual Users
42827,1264,37,129,1,4,4,9,At Risk
43013,810,20,113,2,3,4,9,Casual Users
43127,128,12,38,4,3,3,10,Loyal Users
43278,3981,6,13,1,1,1,3,Lost
43416,849,8,10,2,2,1,5,Lost
43653,2952,5,7,1,1,1,3,Lost
43727,130,30,352,4,4,5,13,Champions
43875,381,11,99,3,2,4,9,Casual Users
44007,1548,11,12,1,2,1,4,Lost
44015,386,12,22,3,3,2,8,Loyal Users
44070,241,9,28,3,2,2,7,Casual Users
44380,2101,5,11,1,1,1,3,Lost
44392,915,19,108,2,3,4,9,Casual Users
44463,55,5,18,5,1,2,8,Promising
44928,23,67,579,5,5,5,15,Champions
45078,2,106,359,5,5,5,15,Champions
45296,413,22,87,3,4,4,11,Loyal Users
45343,47,19,133,5,3,4,12,Loyal Users
45402,498,16,28,2,3,2,7,Casual Users
45443,5,117,621,5,5,5,15,Champions
45797,939,9,13,2,2,1,5,Lost
46257,808,10,12,2,2,1,5,Lost
46536,1105,200,644,2,5,5,12,At Risk
46543,1367,15,25,1,3,2,6,Casual Users
46749,3403,9,10,1,2,1,4,Lost
47498,5,19,48,5,3,3,11,Loyal Users
47690,1395,14,106,1,3,4,8,Casual Users
47792,29,241,425,5,5,5,15,Champions
48100,107,83,342,4,5,5,14,Champions
48473,177,36,67,3,4,4,11,Loyal Users
48704,38,43,179,5,4,5,14,Champions
48929,216,8,26,3,2,2,7,Casual Users
49569,1460,18,39,1,3,3,7,Casual Users
50247,252,90,346,3,5,5,13,Loyal Users
50345,665,8,32,2,2,3,7,Lost
51137,1969,7,20,1,2,2,5,Lost
51138,56,116,160,5,5,5,15,Champions
51237,712,9,19,2,2,2,6,Lost
51281,27,32,147,5,4,5,14,Champions
51487,1429,9,12,1,2,1,4,Lost
51811,122,169,360,4,5,5,14,Champions
52032,2135,12,21,1,3,2,6,Casual Users
52048,688,6,10,2,1,1,4,Lost
52124,332,12,102,3,3,4,10,Loyal Users
39672,87,117,280,4,5,5,14,Champions
39881,383,11,11,3,2,1,6,Casual Users
39949,160,25,43,4,4,3,11,Loyal Users
40532,5569,5,5,1,1,1,3,Lost
40583,235,25,55,3,4,3,10,Loyal Users
40829,234,67,245,3,5,5,13,Loyal Users
41247,505,16,84,2,3,4,9,Casual Users
41591,1,42,192,5,4,5,14,Champions
41613,2089,5,22,1,1,2,4,Lost
41805,32,62,96,5,5,4,14,Champions
41822,2414,5,18,1,1,2,4,Lost
41951,827,13,25,2,3,2,7,Casual Users
41959,549,14,27,2,3,2,7,Casual Users
42101,41,22,35,5,4,3,12,Loyal Users
42584,101,21,146,4,3,4,11,Loyal Users
42829,735,10,17,2,2,2,6,Lost
42835,33,44,82,5,4,4,13,Champions
42959,1179,10,14,2,2,1,5,Lost
42966,142,8,15,4,2,1,7,Promising
43344,700,8,16,2,2,2,6,Lost
43570,1425,8,20,1,2,2,5,Lost
43686,398,22,76,3,4,4,11,Loyal Users
43720,790,11,28,2,2,2,6,Lost
43949,44,161,325,5,5,5,15,Champions
44043,53,46,76,5,5,4,14,Champions
44076,1535,15,78,1,3,4,8,Casual Users
44246,726,21,57,2,3,3,8,Casual Users
44709,3,135,425,5,5,5,15,Champions
44933,685,7,36,2,2,3,7,Lost
45260,127,21,49,4,3,3,10,Loyal Users
45373,146,79,545,4,5,5,14,Champions
45647,569,7,11,2,2,1,5,Lost
45901,790,8,43,2,2,3,7,Lost
46077,10,23,38,5,4,3,12,Loyal Users
46308,535,10,11,2,2,1,5,Lost
46387,56,78,112,5,5,4,14,Champions
46458,2,19,84,5,3,4,12,Loyal Users
46515,2151,7,16,1,2,2,5,Lost
46636,1565,16,19,1,3,2,6,Casual Users
46703,156,10,11,4,2,1,7,Promising
46744,283,11,40,3,2,3,8,Casual Users
47041,436,20,28,3,3,2,8,Loyal Users
47293,212,21,33,3,3,3,9,Loyal Users
47298,545,19,57,2,3,3,8,Casual Users
47350,237,10,11,3,2,1,6,Casual Users
47547,4,79,338,5,5,5,15,Champions
47626,148,25,70,4,4,4,12,Champions
47688,11,35,42,5,4,3,12,Loyal Users
47927,1434,5,16,1,1,2,4,Lost
48108,27,69,581,5,5,5,15,Champions
48493,980,82,188,2,5,5,12,At Risk
48538,12,19,48,5,3,3,11,Loyal Users
48768,91,41,119,4,4,4,12,Champions
49167,281,16,39,3,3,3,9,Loyal Users
49265,151,45,143,4,4,4,12,Champions
49340,408,5,11,3,1,1,5,Casual Users
49683,96,12,43,4,3,3,10,Loyal Users
49923,542,9,22,2,2,2,6,Lost
49929,461,6,16,3,1,2,6,Casual Users
50049,1439,36,134,1,4,4,9,At Risk
50141,154,64,502,4,5,5,14,Champions
50315,1,49,155,5,5,5,15,Champions
50608,152,24,146,4,4,4,12,Champions
50665,322,10,28,3,2,2,7,Casual Users
50698,2851,5,23,1,1,2,4,Lost
50852,11,68,293,5,5,5,15,Champions
51471,456,33,38,3,4,3,10,Loyal Users
51764,1331,6,7,1,1,1,3,Lost
51830,1430,7,12,1,2,1,4,Lost
51906,37,76,177,5,5,5,15,Champions
51938,86,7,15,4,2,1,7,Promising
51942,244,26,33,3,4,3,10,Loyal Users
52272,3686,6,27,1,1,2,4,Lost
39265,402,25,27,3,4,2,9,Loyal Users
39350,155,105,225,4,5,5,14,Champions
39398,4080,8,14,1,2,1,4,Lost
39680,90,17,31,4,3,2,9,Loyal Users
39822,85,86,522,4,5,5,14,Champions
39978,2716,5,8,1,1,1,3,Lost
40217,528,8,19,2,2,2,6,Lost
40222,436,30,62,3,4,3,10,Loyal Users
40290,301,15,17,3,3,2,8,Loyal Users
40463,1701,7,20,1,2,2,5,Lost
41482,15,11,18,5,2,2,9,Promising
42309,258,15,22,3,3,2,8,Loyal Users
42503,267,46,88,3,5,4,12,Loyal Users
42526,16,28,78,5,4,4,13,Champions
42874,247,24,41,3,4,3,10,Loyal Users
43076,749,18,111,2,3,4,9,Casual Users
43210,920,10,43,2,2,3,7,Lost
43252,76,25,49,4,4,3,11,Loyal Users
43584,3299,7,13,1,2,1,4,Lost
43908,661,9,51,2,2,3,7,Lost
43936,706,26,70,2,4,4,10,At Risk
44190,425,8,15,3,2,1,6,Casual Users
44320,2374,5,5,1,1,1,3,Lost
44825,7,132,347,5,5,5,15,Champions
45114,307,15,66,3,3,4,10,Loyal Users
45195,1858,9,13,1,2,1,4,Lost
45658,2681,6,9,1,1,1,3,Lost
45917,1499,19,64,1,3,4,8,Casual Users
46223,7,10,38,5,2,3,10,Promising
46235,114,33,126,4,4,4,12,Champions
46343,53,68,635,5,5,5,15,Champions
46482,42,103,389,5,5,5,15,Champions
46906,10,11,21,5,2,2,9,Promising
47192,2898,5,20,1,1,2,4,Lost
47234,41,82,380,5,5,5,15,Champions
47271,161,19,65,4,3,4,11,Loyal Users
47378,271,14,58,3,3,3,9,Loyal Users
47539,418,6,12,3,1,1,5,Casual Users
47930,737,57,131,2,5,4,11,At Risk
48561,7,26,108,5,4,4,13,Champions
48671,969,64,184,2,5,5,12,At Risk
48673,425,17,49,3,3,3,9,Loyal Users
48991,2660,12,68,1,3,4,8,Casual Users
49034,394,46,101,3,5,4,12,Loyal Users
49298,251,5,27,3,1,2,6,Casual Users
49893,37,80,330,5,5,5,15,Champions
50002,826,13,26,2,3,2,7,Casual Users
50322,357,9,28,3,2,2,7,Casual Users
50664,1666,6,15,1,1,1,3,Lost
50748,150,8,51,4,2,3,9,Promising
51339,432,7,37,3,2,3,8,Casual Users
51403,1216,6,9,2,1,1,4,Lost
51451,70,124,352,4,5,5,14,Champions
51504,30,5,14,5,1,1,7,Promising
51708,124,16,25,4,3,2,9,Loyal Users
51869,67,206,623,5,5,5,15,Champions
51992,831,15,43,2,3,3,8,Casual Users
52187,443,21,36,3,3,3,9,Loyal Users
52286,7,68,119,5,5,4,14,Champions
52354,62,30,337,5,4,5,14,Champions
39346,1660,8,12,1,2,1,4,Lost
39645,421,5,20,3,1,2,6,Casual Users
39657,207,52,197,3,5,5,13,Loyal Users
39793,268,8,19,3,2,2,7,Casual Users
40212,6,66,659,5,5,5,15,Champions
40462,168,11,15,3,2,1,6,Casual Users
40466,2766,10,14,1,2,1,4,Lost
40937,475,95,343,2,5,5,12,At Risk
42106,157,26,105,4,4,4,12,Champions
42174,144,24,89,4,4,4,12,Champions
42179,644,5,5,2,1,1,4,Lost
42219,732,10,39,2,2,3,7,Lost
42246,2692,25,93,1,4,4,9,At Risk
42679,439,25,80,3,4,4,11,Loyal Users
42715,694,30,43,2,4,3,9,At Risk
42730,259,7,12,3,2,1,6,Casual Users
42792,49,122,436,5,5,5,15,Champions
42984,259,26,102,3,4,4,11,Loyal Users
43137,113,82,227,4,5,5,14,Champions
43425,1682,24,38,1,4,3,8,At Risk
43480,82,32,154,4,4,5,13,Champions
43577,972,11,24,2,2,2,6,Lost
43740,153,21,23,4,3,2,9,Loyal Users
43761,4526,5,12,1,1,1,3,Lost
44133,838,13,64,2,3,4,9,Casual Users
44340,1413,11,23,1,2,2,5,Lost
44351,146,26,38,4,4,3,11,Loyal Users
44453,44,21,70,5,3,4,12,Loyal Users
44813,2002,8,8,1,2,1,4,Lost
44958,256,25,85,3,4,4,11,Loyal Users
45008,254,90,199,3,5,5,13,Loyal Users
45102,26,236,455,5,5,5,15,Champions
45193,70,67,186,4,5,5,14,Champions
46003,1218,18,49,2,3,3,8,Casual Users
46375,2122,6,20,1,1,2,4,Lost
46431,152,8,16,4,2,2,8,Promising
46697,454,46,101,3,5,4,12,Loyal Users
47230,1973,18,51,1,3,3,7,Casual Users
47412,106,8,37,4,2,3,9,Promising
47668,64,135,219,5,5,5,15,Champions
47865,837,33,98,2,4,4,10,At Risk
47871,535,24,44,2,4,3,9,At Risk
48132,534,10,24,2,2,2,6,Lost
48165,573,56,97,2,5,4,11,At Risk
48351,57,19,57,5,3,3,11,Loyal Users
48656,412,19,75,3,3,4,10,Loyal Users
48730,125,10,31,4,2,2,8,Promising
48855,499,10,16,2,2,2,6,Lost
48966,128,8,41,4,2,3,9,Promising
49204,130,7,37,4,2,3,9,Promising
49334,1123,21,49,2,3,3,8,Casual Users
49483,1350,12,12,1,3,1,5,Casual Users
50266,1683,11,13,1,2,1,4,Lost
50621,151,52,96,4,5,4,13,Champions
50645,437,19,52,3,3,3,9,Loyal Users
50727,29,22,53,5,4,3,12,Loyal Users
51345,104,5,11,4,1,1,6,Promising
51461,91,107,393,4,5,5,14,Champions
51809,2748,9,23,1,2,2,5,Lost
52106,1323,5,33,1,1,3,5,Lost
40458,1129,14,16,2,3,2,7,Casual Users
40632,386,40,80,3,4,4,11,Loyal Users
40676,10,7,14,5,2,1,8,Promising
40986,105,40,64,4,4,4,12,Champions
41151,323,19,154,3,3,5,11,Loyal Users
41335,200,36,49,3,4,3,10,Loyal Users
41385,364,6,11,3,1,1,5,Casual Users
41387,719,16,27,2,3,2,7,Casual Users
41736,121,37,61,4,4,3,11,Loyal Users
41826,84,10,58,4,2,3,9,Promising
41987,127,62,111,4,5,4,13,Champions
42030,1216,6,8,2,1,1,4,Lost
42089,17,54,432,5,5,5,15,Champions
42138,46,69,103,5,5,4,14,Champions
42300,4154,10,18,1,2,2,5,Lost
42465,30,53,133,5,5,4,14,Champions
42531,71,6,8,4,1,1,6,Promising
42610,84,7,14,4,2,1,7,Promising
42821,1951,7,12,1,2,1,4,Lost
43171,153,37,40,4,4,3,11,Loyal Users
43224,406,7,14,3,2,1,6,Casual Users
43279,4698,50,91,1,5,4,10,At Risk
43736,130,31,125,4,4,4,12,Champions
43886,0,6,10,5,1,1,7,Promising
44078,102,29,113,4,4,4,12,Champions
44227,112,71,331,4,5,5,14,Champions
44295,77,27,138,4,4,4,12,Champions
44524,2155,12,15,1,3,1,5,Casual Users
44655,113,37,166,4,4,5,13,Champions
45047,1028,12,68,2,3,4,9,Casual Users
45369,1244,12,43,2,3,3,8,Casual Users
45748,376,34,124,3,4,4,11,Loyal Users
45957,1406,22,28,1,4,2,7,At Risk
46039,696,7,16,2,2,2,6,Lost
46630,56,64,280,5,5,5,15,Champions
46660,62,106,406,5,5,5,15,Champions
47061,1514,7,27,1,2,2,5,Lost
47205,80,60,244,4,5,5,14,Champions
47274,1597,5,8,1,1,1,3,Lost
47554,1647,5,5,1,1,1,3,Lost
47646,73,27,40,4,4,3,11,Loyal Users
47903,544,13,23,2,3,2,7,Casual Users
48024,130,13,45,4,3,3,10,Loyal Users
48063,137,59,137,4,5,4,13,Champions
48299,305,17,76,3,3,4,10,Loyal Users
48547,603,10,35,2,2,3,7,Lost
48572,13,39,56,5,4,3,12,Loyal Users
48821,119,18,24,4,3,2,9,Loyal Users
48882,2267,40,67,1,4,4,9,At Risk
49024,26,87,400,5,5,5,15,Champions
49065,1469,7,18,1,2,2,5,Lost
49111,424,20,41,3,3,3,9,Loyal Users
49153,118,58,186,4,5,5,14,Champions
49235,80,64,284,4,5,5,14,Champions
49314,1029,11,40,2,2,3,7,Lost
49655,704,9,60,2,2,3,7,Lost
49670,59,63,179,5,5,5,15,Champions
49940,534,68,134,2,5,4,11,At Risk
50043,1220,19,59,2,3,3,8,Casual Users
50097,1689,15,114,1,3,4,8,Casual Users
50174,8,117,312,5,5,5,15,Champions
50285,3,78,168,5,5,5,15,Champions
50401,263,11,16,3,2,2,7,Casual Users
50635,1,27,44,5,4,3,12,Loyal Users
50829,157,41,55,4,4,3,11,Loyal Users
51135,220,15,62,3,3,3,9,Loyal Users
51332,2665,6,10,1,1,1,3,Lost
51484,8,19,39,5,3,3,11,Loyal Users
51545,2408,6,12,1,1,1,3,Lost
51807,268,30,75,3,4,4,11,Loyal Users
51826,435,9,18,3,2,2,7,Casual Users
51870,20,19,19,5,3,2,10,Loyal Users
51943,1152,24,43,2,4,3,9,At Risk
51947,3386,5,16,1,1,2,4,Lost
39464,1668,5,34,1,1,3,5,Lost
39501,562,20,25,2,3,2,7,Casual Users
39620,1587,7,10,1,2,1,4,Lost
39823,412,16,29,3,3,2,8,Loyal Users
39861,1110,25,45,2,4,3,9,At Risk
40034,2986,7,16,1,2,2,5,Lost
40163,153,45,91,4,4,4,12,Champions
40347,9,153,289,5,5,5,15,Champions
40422,230,7,26,3,2,2,7,Casual Users
40424,231,6,41,3,1,3,7,Casual Users
40538,12,51,132,5,5,4,14,Champions
40629,23,60,227,5,5,5,15,Champions
40949,1407,5,7,1,1,1,3,Lost
41030,28,10,15,5,2,1,8,Promising
41044,1140,13,23,2,3,2,7,Casual Users
41121,689,7,9,2,2,1,5,Lost
41191,441,10,38,3,2,3,8,Casual Users
41249,397,19,44,3,3,3,9,Loyal Users
41443,40,72,342,5,5,5,15,Champions
41714,177,6,16,3,1,2,6,Casual Users
41807,2680,7,15,1,2,1,4,Lost
41833,102,6,17,4,1,2,7,Promising
42009,152,6,19,4,1,2,7,Promising
42133,16,180,807,5,5,5,15,Champions
42976,577,6,9,2,1,1,4,Lost
43001,150,7,11,4,2,1,7,Promising
43341,108,72,112,4,5,4,13,Champions
43515,3,103,289,5,5,5,15,Champions
43599,149,99,598,4,5,5,14,Champions
43693,655,13,34,2,3,3,8,Casual Users
43695,232,42,110,3,4,4,11,Loyal Users
43884,2272,8,35,1,2,3,6,Lost
44001,99,109,415,4,5,5,14,Champions
44177,7,32,46,5,4,3,12,Loyal Users
44302,702,10,56,2,2,3,7,Lost
44337,3,17,39,5,3,3,11,Loyal Users
44713,842,7,10,2,2,1,5,Lost
44787,107,28,55,4,4,3,11,Loyal Users
45042,868,5,6,2,1,1,4,Lost
45312,717,32,45,2,4,3,9,At Risk
46068,22,52,199,5,5,5,15,Champions
46101,256,15,31,3,3,2,8,Loyal Users
46519,72,54,249,4,5,5,14,Champions
46844,680,15,20,2,3,2,7,Casual Users
47109,3,76,309,5,5,5,15,Champions
47141,149,23,36,4,4,3,11,Loyal Users
47343,568,7,12,2,2,1,5,Lost
47460,2654,13,73,1,3,4,8,Casual Users
47538,449,8,22,3,2,2,7,Casual Users
47813,3408,5,7,1,1,1,3,Lost
47868,432,12,64,3,3,4,10,Loyal Users
47928,1527,10,45,1,2,3,6,Lost
47970,5170,9,55,1,2,3,6,Lost
48248,3228,8,37,1,2,3,6,Lost
48384,1582,7,20,1,2,2,5,Lost
48648,133,71,119,4,5,4,13,Champions
48674,742,6,18,2,1,2,5,Lost
48893,704,15,61,2,3,3,8,Casual Users
49227,444,27,43,3,4,3,10,Loyal Users
49390,132,40,112,4,4,4,12,Champions
49900,1181,14,40,2,3,3,8,Casual Users
50260,428,29,49,3,4,3,10,Loyal Users
50425,0,175,427,5,5,5,15,Champions
50452,111,12,24,4,3,2,9,Loyal Users
50455,1982,7,8,1,2,1,4,Lost
50525,547,19,38,2,3,3,8,Casual Users
50957,2830,25,56,1,4,3,8,At Risk
51144,14,30,115,5,4,4,13,Champions
51296,18,5,18,5,1,2,8,Promising
51519,486,10,16,2,2,2,6,Lost
51592,3138,15,61,1,3,3,7,Casual Users
51860,167,33,44,3,4,3,10,Loyal Users
51961,221,38,127,3,4,4,11,Loyal Users
52153,4,27,41,5,4,3,12,Loyal Users
52318,674,10,21,2,2,2,6,Lost
52323,106,97,361,4,5,5,14,Champions
39296,4665,6,12,1,1,1,3,Lost
39664,114,97,248,4,5,5,14,Champions
39818,31,41,270,5,4,5,14,Champions
39986,405,20,45,3,3,3,9,Loyal Users
40018,408,10,28,3,2,2,7,Casual Users
40360,503,5,9,2,1,1,4,Lost
40413,1094,12,69,2,3,4,9,Casual Users
40464,259,9,14,3,2,1,6,Casual Users
40522,963,12,19,2,3,2,7,Casual Users
40623,108,10,22,4,2,2,8,Promising
41317,9,140,319,5,5,5,15,Champions
41344,148,13,25,4,3,2,9,Loyal Users
42091,32,45,402,5,4,5,14,Champions
42109,1403,7,8,1,2,1,4,Lost
42249,108,69,132,4,5,4,13,Champions
42422,1121,17,89,2,3,4,9,Casual Users
42458,286,48,159,3,5,5,13,Loyal Users
42562,271,12,35,3,3,3,9,Loyal Users
42658,392,35,122,3,4,4,11,Loyal Users
42713,800,6,16,2,1,2,5,Lost
43032,3131,6,34,1,1,3,5,Lost
43043,2,319,729,5,5,5,15,Champions
43162,205,9,53,3,2,3,8,Casual Users
43184,303,13,16,3,3,2,8,Loyal Users
43880,304,68,124,3,5,4,12,Loyal Users
43941,5012,14,31,1,3,2,6,Casual Users
44038,1013,69,335,2,5,5,12,At Risk
44312,6,94,630,5,5,5,15,Champions
44388,60,122,332,5,5,5,15,Champions
44801,3,56,187,5,5,5,15,Champions
45311,10,234,594,5,5,5,15,Champions
45401,1866,11,11,1,2,1,4,Lost
45480,96,132,559,4,5,5,14,Champions
45491,3117,5,13,1,1,1,3,Lost
45505,879,7,7,2,2,1,5,Lost
45623,55,142,393,5,5,5,15,Champions
45805,400,12,20,3,3,2,8,Loyal Users
45838,65,8,22,5,2,2,9,Promising
46120,18,111,519,5,5,5,15,Champions
46121,41,33,63,5,4,4,13,Champions
46327,227,21,54,3,3,3,9,Loyal Users
46669,25,133,282,5,5,5,15,Champions
46699,15,38,171,5,4,5,14,Champions
47489,19,14,35,5,3,3,11,Loyal Users
47515,240,45,193,3,4,5,12,Loyal Users
47550,12,94,491,5,5,5,15,Champions
47976,159,17,28,4,3,2,9,Loyal Users
48303,2007,6,11,1,1,1,3,Lost
48835,38,128,278,5,5,5,15,Champions
49045,137,12,21,4,3,2,9,Loyal Users
49200,547,6,18,2,1,2,5,Lost
49246,135,17,40,4,3,3,10,Loyal Users
49291,3160,5,8,1,1,1,3,Lost
49724,12,157,454,5,5,5,15,Champions
49792,1587,12,32,1,3,3,7,Casual Users
49826,42,85,246,5,5,5,15,Champions
50199,410,12,30,3,3,2,8,Loyal Users
50290,714,22,62,2,4,3,9,At Risk
50325,1799,8,29,1,2,2,5,Lost
50403,23,18,82,5,3,4,12,Loyal Users
50460,990,5,14,2,1,1,4,Lost
51150,5,11,20,5,2,2,9,Promising
51364,408,90,149,3,5,5,13,Loyal Users
51391,271,92,191,3,5,5,13,Loyal Users
51507,2725,5,11,1,1,1,3,Lost
51515,818,21,55,2,3,3,8,Casual Users
51797,9,11,34,5,2,3,10,Promising
51871,31,89,195,5,5,5,15,Champions
51935,108,80,162,4,5,5,14,Champions
52001,123,14,46,4,3,3,10,Loyal Users
39293,28,5,93,5,1,4,10,Promising
39381,429,17,42,3,3,3,9,Loyal Users
39493,83,24,32,4,4,3,11,Loyal Users
39607,4994,8,23,1,2,2,5,Lost
40058,10,149,477,5,5,5,15,Champions
40108,14,47,84,5,5,4,14,Champions
40127,0,135,478,5,5,5,15,Champions
40286,72,14,24,4,3,2,9,Loyal Users
40301,132,20,22,4,3,2,9,Loyal Users
40825,424,23,112,3,4,4,11,Loyal Users
40870,70,14,27,4,3,2,9,Loyal Users
40919,127,25,41,4,4,3,11,Loyal Users
41345,489,17,49,2,3,3,8,Casual Users
42352,422,12,16,3,3,2,8,Loyal Users
42414,1402,17,34,1,3,3,7,Casual Users
42418,0,19,58,5,3,3,11,Loyal Users
42437,696,10,27,2,2,2,6,Lost
42449,4551,5,13,1,1,1,3,Lost
42778,858,5,72,2,1,4,7,Lost
43173,1444,6,9,1,1,1,3,Lost
43421,5505,6,6,1,1,1,3,Lost
43431,30,12,38,5,3,3,11,Loyal Users
43662,167,29,132,3,4,4,11,Loyal Users
43718,425,8,8,3,2,1,6,Casual Users
43823,3430,5,7,1,1,1,3,Lost
43867,277,14,55,3,3,3,9,Loyal Users
44077,827,8,18,2,2,2,6,Lost
44206,123,60,263,4,5,5,14,Champions
44551,113,5,34,4,1,3,8,Promising
44602,3568,9,19,1,2,2,5,Lost
44998,56,33,96,5,4,4,13,Champions
45146,143,15,19,4,3,2,9,Loyal Users
45424,398,42,103,3,4,4,11,Loyal Users
46219,13,56,198,5,5,5,15,Champions
46320,2220,8,18,1,2,2,5,Lost
46490,409,11,50,3,2,3,8,Casual Users
46683,7,20,63,5,3,4,12,Loyal Users
46835,3283,5,8,1,1,1,3,Lost
46854,81,56,117,4,5,4,13,Champions
47063,374,7,17,3,2,2,7,Casual Users
47079,148,41,125,4,4,4,12,Champions
47543,133,19,54,4,3,3,10,Loyal Users
47559,2124,5,7,1,1,1,3,Lost
48052,291,27,48,3,4,3,10,Loyal Users
48075,54,31,61,5,4,3,12,Loyal Users
48142,1130,17,24,2,3,2,7,Casual Users
48346,34,31,75,5,4,4,13,Champions
48453,7,94,351,5,5,5,15,Champions
48558,743,6,7,2,1,1,4,Lost
48732,691,10,15,2,2,1,5,Lost
48863,2306,12,47,1,3,3,7,Casual Users
48998,65,96,457,5,5,5,15,Champions
49104,165,28,102,4,4,4,12,Champions
49416,21,150,367,5,5,5,15,Champions
49604,0,125,335,5,5,5,15,Champions
49666,1,103,260,5,5,5,15,Champions
49995,2529,6,28,1,1,2,4,Lost
50601,5368,5,6,1,1,1,3,Lost
50668,376,32,120,3,4,4,11,Loyal Users
50730,1524,6,16,1,1,2,4,Lost
50872,18,145,231,5,5,5,15,Champions
50997,290,11,12,3,2,1,6,Casual Users
51147,676,55,100,2,5,4,11,At Risk
51172,945,37,66,2,4,4,10,At Risk
51563,125,59,596,4,5,5,14,Champions
51669,48,75,442,5,5,5,15,Champions
52138,365,16,148,3,3,5,11,Loyal Users
52296,12,122,321,5,5,5,15,Champions
39485,106,22,34,4,4,3,11,Loyal Users
39801,130,18,22,4,3,2,9,Loyal Users
39863,1084,90,147,2,5,5,12,At Risk
39953,417,12,43,3,3,3,9,Loyal Users
40092,396,19,56,3,3,3,9,Loyal Users
40314,1858,51,85,1,5,4,10,At Risk
40472,1873,17,46,1,3,3,7,Casual Users
40531,295,9,29,3,2,2,7,Casual Users
40719,1598,8,12,1,2,1,4,Lost
40962,875,25,41,2,4,3,9,At Risk
41452,669,11,19,2,2,2,6,Lost
41878,758,5,16,2,1,2,5,Lost
43035,299,17,55,3,3,3,9,Loyal Users
43091,166,17,35,3,3,3,9,Loyal Users
43111,119,44,134,4,4,4,12,Champions
43134,256,8,9,3,2,1,6,Casual Users
43244,160,7,13,4,2,1,7,Promising
43620,246,7,15,3,2,1,6,Casual Users
44210,348,9,16,3,2,2,7,Casual Users
44231,286,10,36,3,2,3,8,Casual Users
44569,266,40,69,3,4,4,11,Loyal Users
45033,84,31,88,4,4,4,12,Champions
45037,15,90,412,5,5,5,15,Champions
45607,11,70,278,5,5,5,15,Champions
45643,30,151,613,5,5,5,15,Champions
46026,419,18,50,3,3,3,9,Loyal Users
46212,56,27,140,5,4,4,13,Champions
46410,641,9,22,2,2,2,6,Lost
46539,1395,14,35,1,3,3,7,Casual Users
46627,1393,9,18,1,2,2,5,Lost
47123,3,43,109,5,4,4,13,Champions
47133,2,96,446,5,5,5,15,Champions
47195,354,22,151,3,4,5,12,Loyal Users
47270,10,137,222,5,5,5,15,Champions
47522,131,11,35,4,2,3,9,Promising
47659,74,38,85,4,4,4,12,Champions
47733,115,6,20,4,1,2,7,Promising
47754,3721,5,7,1,1,1,3,Lost
48091,557,23,79,2,4,4,10,At Risk
48245,5139,11,24,1,2,2,5,Lost
48256,838,7,17,2,2,2,6,Lost
48261,425,15,23,3,3,2,8,Loyal Users
48365,1041,15,59,2,3,3,8,Casual Users
48503,1,61,206,5,5,5,15,Champions
48608,398,36,163,3,4,5,12,Loyal Users
48793,335,30,80,3,4,4,11,Loyal Users
48984,229,28,41,3,4,3,10,Loyal Users
49287,119,8,18,4,2,2,8,Promising
49351,288,21,41,3,3,3,9,Loyal Users
49581,14,196,330,5,5,5,15,Champions
50242,19,16,23,5,3,2,10,Loyal Users
50293,109,151,458,4,5,5,14,Champions
50780,995,13,72,2,3,4,9,Casual Users
50817,1115,6,8,2,1,1,4,Lost
50901,25,54,106,5,5,4,14,Champions
51602,26,100,253,5,5,5,15,Champions
51608,548,7,63,2,2,4,8,Lost
51718,167,26,69,3,4,4,11,Loyal Users
51881,1975,5,24,1,1,2,4,Lost
52047,160,15,48,4,3,3,10,Loyal Users
52229,266,29,224,3,4,5,12,Loyal Users
52245,698,23,86,2,4,4,10,At Risk
52263,259,17,25,3,3,2,8,Loyal Users
52298,73,26,57,4,4,3,11,Loyal Users
39383,847,41,56,2,4,3,9,At Risk
39450,125,25,43,4,4,3,11,Loyal Users
39454,120,88,294,4,5,5,14,Champions
39509,4,165,343,5,5,5,15,Champions
39795,96,14,21,4,3,2,9,Loyal Users
40176,1278,16,34,1,3,3,7,Casual Users
40183,216,46,78,3,5,4,12,Loyal Users
40428,552,5,10,2,1,1,4,Lost
40560,166,17,21,3,3,2,8,Loyal Users
40654,133,115,334,4,5,5,14,Champions
40801,1299,8,14,1,2,1,4,Lost
40867,904,22,41,2,4,3,9,At Risk
41571,2460,9,12,1,2,1,4,Lost
41636,8,82,226,5,5,5,15,Champions
41777,3697,7,24,1,2,2,5,Lost
41790,91,28,101,4,4,4,12,Champions
42622,2976,5,19,1,1,2,4,Lost
42639,1689,26,98,1,4,4,9,At Risk
43075,699,20,33,2,3,3,8,Casual Users
43192,289,6,27,3,1,2,6,Casual Users
43418,120,37,101,4,4,4,12,Champions
43487,2273,6,16,1,1,2,4,Lost
43558,411,36,180,3,4,5,12,Loyal Users
43863,29,39,56,5,4,3,12,Loyal Users
43999,34,15,20,5,3,2,10,Loyal Users
44198,14,84,582,5,5,5,15,Champions
44365,426,43,74,3,4,4,11,Loyal Users
44378,1373,11,94,1,2,4,7,Lost
44581,149,34,70,4,4,4,12,Champions
44689,36,22,33,5,4,3,12,Loyal Users
44812,278,26,59,3,4,3,10,Loyal Users
44885,12,135,492,5,5,5,15,Champions
44983,127,22,45,4,4,3,11,Loyal Users
45023,557,18,105,2,3,4,9,Casual Users
45081,110,14,36,4,3,3,10,Loyal Users
45256,756,23,48,2,4,3,9,At Risk
45422,82,9,9,4,2,1,7,Promising
45739,267,6,19,3,1,2,6,Casual Users
45757,1125,12,57,2,3,3,8,Casual Users
46158,1465,38,40,1,4,3,8,At Risk
46671,43,84,133,5,5,4,14,Champions
46846,213,7,16,3,2,2,7,Casual Users
46879,814,11,23,2,2,2,6,Lost
47091,398,15,28,3,3,2,8,Loyal Users
47446,420,7,14,3,2,1,6,Casual Users
47502,4438,7,11,1,2,1,4,Lost
47649,13,8,35,5,2,3,10,Promising
47913,316,65,430,3,5,5,13,Loyal Users
47921,255,8,43,3,2,3,8,Casual Users
47965,1606,47,81,1,5,4,10,At Risk
48295,117,50,117,4,5,4,13,Champions
48321,121,11,59,4,2,3,9,Promising
48677,364,11,12,3,2,1,6,Casual Users
48803,738,17,66,2,3,4,9,Casual Users
48936,3422,7,11,1,2,1,4,Lost
49164,623,13,16,2,3,2,7,Casual Users
49245,701,7,11,2,2,1,5,Lost
49289,1128,10,20,2,2,2,6,Lost
49379,244,37,47,3,4,3,10,Loyal Users
49660,2847,11,40,1,2,3,6,Lost
50054,281,10,25,3,2,2,7,Casual Users
50145,3687,10,21,1,2,2,5,Lost
50400,570,10,10,2,2,1,5,Lost
50430,101,5,31,4,1,2,7,Promising
50443,250,33,117,3,4,4,11,Loyal Users
50473,224,30,51,3,4,3,10,Loyal Users
50556,72,35,148,4,4,5,13,Champions
50663,23,146,893,5,5,5,15,Champions
50821,381,36,136,3,4,4,11,Loyal Users
51186,696,12,23,2,3,2,7,Casual Users
51295,165,29,108,4,4,4,12,Champions
51442,2091,19,41,1,3,3,7,Casual Users
51756,415,6,8,3,1,1,5,Casual Users
51902,321,9,23,3,2,2,7,Casual Users
51986,422,12,34,3,3,3,9,Loyal Users
52177,4990,13,13,1,3,1,5,Casual Users
39242,569,28,47,2,4,3,9,At Risk
39604,22,33,46,5,4,3,12,Loyal Users
39651,389,26,44,3,4,3,10,Loyal Users
39739,129,10,33,4,2,3,9,Promising
39751,126,93,268,4,5,5,14,Champions
40073,81,64,186,4,5,5,14,Champions
40167,1218,5,23,2,1,2,5,Lost
40545,642,6,16,2,1,2,5,Lost
41201,455,91,213,3,5,5,13,Loyal Users
41291,1861,5,7,1,1,1,3,Lost
42016,535,14,32,2,3,3,8,Casual Users
42023,2396,5,9,1,1,1,3,Lost
42098,131,57,195,4,5,5,14,Champions
42186,56,20,55,5,3,3,11,Loyal Users
42569,807,14,26,2,3,2,7,Casual Users
43034,566,26,263,2,4,5,11,At Risk
43167,285,10,47,3,2,3,8,Casual Users
43549,581,5,6,2,1,1,4,Lost
43699,3953,14,22,1,3,2,6,Casual Users
43857,245,20,86,3,3,4,10,Loyal Users
43926,424,9,42,3,2,3,8,Casual Users
44039,158,7,18,4,2,2,8,Promising
44063,91,26,45,4,4,3,11,Loyal Users
44454,124,19,71,4,3,4,11,Loyal Users
44456,102,16,19,4,3,2,9,Loyal Users
44518,241,5,6,3,1,1,5,Casual Users
44555,4134,11,21,1,2,2,5,Lost
44560,95,69,99,4,5,4,13,Champions
44633,397,34,151,3,4,5,12,Loyal Users
44808,197,40,169,3,4,5,12,Loyal Users
46124,3399,6,14,1,1,1,3,Lost
46131,380,6,48,3,1,3,7,Casual Users
46224,183,13,80,3,3,4,10,Loyal Users
46294,153,19,48,4,3,3,10,Loyal Users
46403,368,23,63,3,4,4,11,Loyal Users
46516,44,17,22,5,3,2,10,Loyal Users
46518,70,49,311,4,5,5,14,Champions
46724,474,12,122,2,3,4,9,Casual Users
46776,839,37,121,2,4,4,10,At Risk
47313,8,20,41,5,3,3,11,Loyal Users
47351,188,19,33,3,3,3,9,Loyal Users
47439,7,67,195,5,5,5,15,Champions
48088,410,10,29,3,2,2,7,Casual Users
48212,492,35,115,2,4,4,10,At Risk
48416,116,18,51,4,3,3,10,Loyal Users
48786,1486,45,198,1,4,5,10,At Risk
49270,1858,12,42,1,3,3,7,Casual Users
49356,777,11,16,2,2,2,6,Lost
49371,129,14,18,4,3,2,9,Loyal Users
49415,224,28,121,3,4,4,11,Loyal Users
49440,975,19,58,2,3,3,8,Casual Users
49722,8,122,328,5,5,5,15,Champions
50227,325,12,44,3,3,3,9,Loyal Users
50722,25,161,610,5,5,5,15,Champions
51121,1097,5,12,2,1,1,4,Lost
51466,693,5,29,2,1,2,5,Lost
51575,58,25,80,5,4,4,13,Champions
51609,95,5,11,4,1,1,6,Promising
51909,19,56,89,5,5,4,14,Champions
52115,706,8,26,2,2,2,6,Lost
52151,326,15,129,3,3,4,10,Loyal Users
39447,2854,10,59,1,2,3,6,Lost
39583,2390,8,16,1,2,2,5,Lost
40402,877,15,19,2,3,2,7,Casual Users
40802,650,8,33,2,2,3,7,Lost
41035,1692,5,14,1,1,1,3,Lost
41432,827,7,15,2,2,1,5,Lost
41773,9,105,170,5,5,5,15,Champions
41873,1607,6,8,1,1,1,3,Lost
41936,703,7,31,2,2,2,6,Lost
42064,765,12,24,2,3,2,7,Casual Users
42273,268,35,40,3,4,3,10,Loyal Users
42296,1519,27,71,1,4,4,9,At Risk
42325,237,6,9,3,1,1,5,Casual Users
42457,1122,5,7,2,1,1,4,Lost
42875,291,7,47,3,2,3,8,Casual Users
42937,453,13,14,3,3,1,7,Loyal Users
43000,8,36,108,5,4,4,13,Champions
43092,102,18,47,4,3,3,10,Loyal Users
43093,1108,5,26,2,1,2,5,Lost
43221,824,11,46,2,2,3,7,Lost
43305,408,16,64,3,3,4,10,Loyal Users
43406,1112,6,7,2,1,1,4,Lost
43608,111,7,17,4,2,2,8,Promising
43623,263,48,150,3,5,5,13,Loyal Users
43805,516,17,50,2,3,3,8,Casual Users
43961,3810,10,10,1,2,1,4,Lost
44172,4439,14,22,1,3,2,6,Casual Users
44356,328,5,6,3,1,1,5,Casual Users
44400,160,33,78,4,4,4,12,Champions
44471,282,7,17,3,2,2,7,Casual Users
44902,1445,8,22,1,2,2,5,Lost
44951,134,13,17,4,3,2,9,Loyal Users
45099,4568,6,6,1,1,1,3,Lost
45318,1482,16,92,1,3,4,8,Casual Users
45410,135,9,31,4,2,2,8,Promising
45602,25,115,276,5,5,5,15,Champions
46038,851,20,51,2,3,3,8,Casual Users
46061,17,62,315,5,5,5,15,Champions
46620,279,37,114,3,4,4,11,Loyal Users
46792,695,20,77,2,3,4,9,Casual Users
46809,15,58,95,5,5,4,14,Champions
47232,1243,6,48,2,1,3,6,Lost
47299,29,10,90,5,2,4,11,Promising
47394,555,9,10,2,2,1,5,Lost
47398,1969,9,44,1,2,3,6,Lost
47475,126,24,113,4,4,4,12,Champions
47557,0,108,148,5,5,5,15,Champions
47869,132,65,141,4,5,4,13,Champions
47873,853,6,7,2,1,1,4,Lost
48171,263,32,45,3,4,3,10,Loyal Users
48218,149,5,6,4,1,1,6,Promising
48733,434,18,26,3,3,2,8,Loyal Users
48776,37,90,144,5,5,4,14,Champions
49162,435,63,92,3,5,4,12,Loyal Users
49296,1390,8,68,1,2,4,7,Lost
49430,112,30,93,4,4,4,12,Champions
49801,3108,11,35,1,2,3,6,Lost
49872,453,11,55,3,2,3,8,Casual Users
49959,1228,5,6,2,1,1,4,Lost
50007,531,21,105,2,3,4,9,Casual Users
50067,0,102,605,5,5,5,15,Champions
50068,1050,6,10,2,1,1,4,Lost
50130,309,13,22,3,3,2,8,Loyal Users
50152,2480,5,9,1,1,1,3,Lost
50579,54,84,532,5,5,5,15,Champions
50770,1950,5,5,1,1,1,3,Lost
51063,18,48,102,5,5,4,14,Champions
51225,3228,6,24,1,1,2,4,Lost
51500,2681,23,67,1,4,4,9,At Risk
51676,1865,37,83,1,4,4,9,At Risk
52026,441,8,29,3,2,2,7,Casual Users
52054,125,21,44,4,3,3,10,Loyal Users
52145,1276,10,40,1,2,3,6,Lost
39323,4024,6,16,1,1,2,4,Lost
39389,596,7,43,2,2,3,7,Lost
39492,27,6,54,5,1,3,9,Promising
40072,856,6,26,2,1,2,5,Lost
40209,81,44,171,4,4,5,13,Champions
40237,212,54,94,3,5,4,12,Loyal Users
40421,15,115,367,5,5,5,15,Champions
41216,265,65,219,3,5,5,13,Loyal Users
41263,4829,8,11,1,2,1,4,Lost
41365,641,44,72,2,4,4,10,At Risk
41415,137,12,84,4,3,4,11,Loyal Users
41441,633,6,9,2,1,1,4,Lost
41442,131,5,5,4,1,1,6,Promising
41964,223,12,130,3,3,4,10,Loyal Users
42211,480,22,34,2,4,3,9,At Risk
42389,242,14,79,3,3,4,10,Loyal Users
42392,1857,7,14,1,2,1,4,Lost
42476,983,25,50,2,4,3,9,At Risk
42500,384,26,93,3,4,4,11,Loyal Users
42574,4691,31,34,1,4,3,8,At Risk
42886,131,78,259,4,5,5,14,Champions
43894,875,9,18,2,2,2,6,Lost
43932,703,23,37,2,4,3,9,At Risk
43967,373,12,54,3,3,3,9,Loyal Users
44131,296,5,15,3,1,1,5,Casual Users
44196,26,77,342,5,5,5,15,Champions
44217,90,13,23,4,3,2,9,Loyal Users
44512,1849,17,66,1,3,4,8,Casual Users
44539,2,19,34,5,3,3,11,Loyal Users
44678,20,26,121,5,4,4,13,Champions
44704,408,7,14,3,2,1,6,Casual Users
45124,688,96,326,2,5,5,12,At Risk
45453,2732,8,15,1,2,1,4,Lost
45613,4084,5,5,1,1,1,3,Lost
45702,11,59,169,5,5,5,15,Champions
45808,18,28,33,5,4,3,12,Loyal Users
45965,26,76,211,5,5,5,15,Champions
46271,122,37,60,4,4,3,11,Loyal Users
46363,26,82,162,5,5,5,15,Champions
46434,85,25,53,4,4,3,11,Loyal Users
46438,129,5,13,4,1,1,6,Promising
46488,415,7,11,3,2,1,6,Casual Users
46653,1363,52,133,1,5,4,10,At Risk
46807,1414,7,27,1,2,2,5,Lost
46882,408,10,29,3,2,2,7,Casual Users
47032,122,7,10,4,2,1,7,Promising
47081,529,14,44,2,3,3,8,Casual Users
47204,1085,6,20,2,1,2,5,Lost
47897,2710,8,26,1,2,2,5,Lost
47949,116,95,392,4,5,5,14,Champions
48757,24,5,7,5,1,1,7,Promising
49114,1873,12,23,1,3,2,6,Casual Users
49118,17,42,106,5,4,4,13,Champions
49224,1499,7,7,1,2,1,4,Lost
49326,7,8,9,5,2,1,8,Promising
49495,740,29,49,2,4,3,9,At Risk
49496,615,25,50,2,4,3,9,At Risk
49773,362,19,203,3,3,5,11,Loyal Users
49877,1860,15,25,1,3,2,6,Casual Users
49895,55,18,53,5,3,3,11,Loyal Users
50162,135,39,84,4,4,4,12,Champions
50328,1295,16,48,1,3,3,7,Casual Users
50456,836,28,58,2,4,3,9,At Risk
50470,2604,6,6,1,1,1,3,Lost
50585,4675,5,7,1,1,1,3,Lost
51028,26,99,213,5,5,5,15,Champions
51227,122,40,197,4,4,5,13,Champions
51357,1129,7,12,2,2,1,5,Lost
51574,120,7,8,4,2,1,7,Promising
51667,296,20,37,3,3,3,9,Loyal Users
39456,131,31,60,4,4,3,11,Loyal Users
39660,174,25,68,3,4,4,11,Loyal Users
39744,55,49,98,5,5,4,14,Champions
39784,348,51,172,3,5,5,13,Loyal Users
39934,88,54,100,4,5,4,13,Champions
39945,1993,11,74,1,2,4,7,Lost
40200,64,84,431,5,5,5,15,Champions
40557,2421,11,23,1,2,2,5,Lost
40567,32,23,27,5,4,2,11,Loyal Users
40613,97,17,40,4,3,3,10,Loyal Users
40701,11,27,74,5,4,4,13,Champions
40988,2812,8,10,1,2,1,4,Lost
41154,405,21,78,3,3,4,10,Loyal Users
41422,411,13,17,3,3,2,8,Loyal Users
41425,90,64,186,4,5,5,14,Champions
41612,265,6,9,3,1,1,5,Casual Users
41694,74,7,10,4,2,1,7,Promising
42252,992,118,315,2,5,5,12,At Risk
42708,204,34,425,3,4,5,12,Loyal Users
42797,87,94,503,4,5,5,14,Champions
42872,146,20,30,4,3,2,9,Loyal Users
43618,18,98,231,5,5,5,15,Champions
43947,4018,5,7,1,1,1,3,Lost
44028,433,8,35,3,2,3,8,Casual Users
44031,23,9,22,5,2,2,9,Promising
44959,4347,5,5,1,1,1,3,Lost
45568,2227,21,46,1,3,3,7,Casual Users
45668,717,64,94,2,5,4,11,At Risk
45679,127,59,281,4,5,5,14,Champions
45711,320,20,63,3,3,4,10,Loyal Users
46059,1854,8,62,1,2,3,6,Lost
46184,1160,14,47,2,3,3,8,Casual Users
46188,1446,23,29,1,4,2,7,At Risk
46391,841,26,92,2,4,4,10,At Risk
46460,307,26,28,3,4,2,9,Loyal Users
46676,939,12,18,2,3,2,7,Casual Users
46861,5,29,57,5,4,3,12,Loyal Users
47243,416,5,21,3,1,2,6,Casual Users
47286,11,37,76,5,4,4,13,Champions
47513,440,6,20,3,1,2,6,Casual Users
47608,2280,16,31,1,3,2,6,Casual Users
47715,409,12,47,3,3,3,9,Loyal Users
48552,2257,6,16,1,1,2,4,Lost
48726,14,114,379,5,5,5,15,Champions
48935,1540,22,93,1,4,4,9,At Risk
49411,23,106,755,5,5,5,15,Champions
49612,957,7,10,2,2,1,5,Lost
49716,1818,13,64,1,3,4,8,Casual Users
49999,129,15,159,4,3,5,12,Loyal Users
50000,6141,5,7,1,1,1,3,Lost
50163,12,56,172,5,5,5,15,Champions
50219,5,102,437,5,5,5,15,Champions
50244,132,40,85,4,4,4,12,Champions
50289,10,108,557,5,5,5,15,Champions
50574,7,36,49,5,4,3,12,Loyal Users
51546,100,102,342,4,5,5,14,Champions
51692,2241,5,12,1,1,1,3,Lost
51848,1583,11,19,1,2,2,5,Lost
52056,68,34,78,5,4,4,13,Champions
52269,719,17,29,2,3,2,7,Casual Users
52324,2478,8,23,1,2,2,5,Lost
39799,376,7,20,3,2,2,7,Casual Users
39844,403,8,13,3,2,1,6,Casual Users
39985,522,15,20,2,3,2,7,Casual Users
40305,110,13,19,4,3,2,9,Loyal Users
40581,6,26,164,5,4,5,14,Champions
41392,1279,15,85,1,3,4,8,Casual Users
41607,135,46,94,4,5,4,13,Champions
41739,2987,31,59,1,4,3,8,At Risk
41971,309,6,12,3,1,1,5,Casual Users
42008,19,19,29,5,3,2,10,Loyal Users
42060,240,24,392,3,4,5,12,Loyal Users
42088,230,55,106,3,5,4,12,Loyal Users
42208,1,61,344,5,5,5,15,Champions
42587,514,27,115,2,4,4,10,At Risk
42670,123,73,222,4,5,5,14,Champions
42869,12,71,183,5,5,5,15,Champions
42967,98,8,13,4,2,1,7,Promising
43041,443,14,34,3,3,3,9,Loyal Users
43056,109,39,209,4,4,5,13,Champions
43202,188,66,128,3,5,4,12,Loyal Users
43422,287,41,82,3,4,4,11,Loyal Users
43517,82,13,31,4,3,2,9,Loyal Users
43694,6,7,13,5,2,1,8,Promising
43775,252,12,41,3,3,3,9,Loyal Users
43837,13,52,114,5,5,4,14,Champions
43849,76,153,625,4,5,5,14,Champions
43969,3365,9,9,1,2,1,4,Lost
44214,8,30,50,5,4,3,12,Loyal Users
44228,118,16,29,4,3,2,9,Loyal Users
44252,156,78,154,4,5,5,14,Champions
44458,87,35,69,4,4,4,12,Champions
44475,183,13,44,3,3,3,9,Loyal Users
44638,385,42,362,3,4,5,12,Loyal Users
44680,25,44,347,5,4,5,14,Champions
44799,365,8,17,3,2,2,7,Casual Users
44821,243,18,59,3,3,3,9,Loyal Users
44862,396,16,27,3,3,2,8,Loyal Users
45192,1414,17,53,1,3,3,7,Casual Users
45267,159,51,263,4,5,5,14,Champions
45396,4181,18,50,1,3,3,7,Casual Users
45411,2246,9,45,1,2,3,6,Lost
45417,27,40,116,5,4,4,13,Champions
45469,3492,6,20,1,1,2,4,Lost
45644,620,19,26,2,3,2,7,Casual Users
45662,1837,12,63,1,3,4,8,Casual Users
45791,56,78,414,5,5,5,15,Champions
45942,908,5,16,2,1,2,5,Lost
46406,539,9,19,2,2,2,6,Lost
46552,237,15,25,3,3,2,8,Loyal Users
46583,720,12,35,2,3,3,8,Casual Users
46903,1098,11,39,2,2,3,7,Lost
47057,3,73,443,5,5,5,15,Champions
47225,416,21,60,3,3,3,9,Loyal Users
48259,429,11,14,3,2,1,6,Casual Users
48273,2259,10,114,1,2,4,7,Lost
48371,216,11,108,3,2,4,9,Casual Users
48425,134,38,97,4,4,4,12,Champions
48462,82,29,33,4,4,3,11,Loyal Users
48819,2258,5,7,1,1,1,3,Lost
48943,412,21,22,3,3,2,8,Loyal Users
49253,107,55,101,4,5,4,13,Champions
49311,956,9,16,2,2,2,6,Lost
49573,1020,5,8,2,1,1,4,Lost
50211,15,96,271,5,5,5,15,Champions
50305,24,34,213,5,4,5,14,Champions
50392,37,62,238,5,5,5,15,Champions
50697,433,21,41,3,3,3,9,Loyal Users
50880,427,13,51,3,3,3,9,Loyal Users
51344,95,63,282,4,5,5,14,Champions
51698,565,50,374,2,5,5,12,At Risk
51804,386,22,45,3,4,3,10,Loyal Users
51876,4285,9,9,1,2,1,4,Lost
52159,1964,34,95,1,4,4,9,At Risk
52192,15,96,848,5,5,5,15,Champions
52210,75,11,20,4,2,2,8,Promising
39565,1,51,108,5,5,4,14,Champions
39587,2243,22,31,1,4,2,7,At Risk
39678,833,5,15,2,1,1,4,Lost
39709,20,26,115,5,4,4,13,Champions
39755,1,122,205,5,5,5,15,Champions
39872,0,41,56,5,4,3,12,Loyal Users
40056,44,18,86,5,3,4,12,Loyal Users
40059,3488,7,11,1,2,1,4,Lost
40352,4140,5,5,1,1,1,3,Lost
40363,551,5,14,2,1,1,4,Lost
40445,275,43,148,3,4,5,12,Loyal Users
40473,175,47,58,3,5,3,11,Loyal Users
40675,669,12,46,2,3,3,8,Casual Users
41184,887,9,11,2,2,1,5,Lost
41743,15,82,285,5,5,5,15,Champions
41851,153,16,110,4,3,4,11,Loyal Users
42380,2325,6,9,1,1,1,3,Lost
42394,1455,5,10,1,1,1,3,Lost
42535,63,59,200,5,5,5,15,Champions
43048,101,54,172,4,5,5,14,Champions
43081,589,6,11,2,1,1,4,Lost
44160,423,11,33,3,2,3,8,Casual Users
44432,84,96,178,4,5,5,14,Champions
44582,1981,13,15,1,3,1,5,Casual Users
44847,4470,6,10,1,1,1,3,Lost
44867,3147,5,12,1,1,1,3,Lost
45024,559,17,56,2,3,3,8,Casual Users
45107,331,9,28,3,2,2,7,Casual Users
45433,81,13,76,4,3,4,11,Loyal Users
45792,162,73,492,4,5,5,14,Champions
46237,79,20,67,4,3,4,11,Loyal Users
46270,199,6,19,3,1,2,6,Casual Users
46533,2390,9,14,1,2,1,4,Lost
46922,1548,55,108,1,5,4,10,At Risk
47148,52,96,128,5,5,4,14,Champions
47181,413,13,43,3,3,3,9,Loyal Users
47742,1017,25,101,2,4,4,10,At Risk
47880,306,27,138,3,4,4,11,Loyal Users
48000,188,80,490,3,5,5,13,Loyal Users
48169,2561,10,18,1,2,2,5,Lost
48363,67,38,156,5,4,5,14,Champions
48858,3162,5,12,1,1,1,3,Lost
48990,263,24,39,3,4,3,10,Loyal Users
49068,855,5,6,2,1,1,4,Lost
49233,687,17,26,2,3,2,7,Casual Users
49629,458,10,23,3,2,2,7,Casual Users
49635,1633,8,17,1,2,2,5,Lost
49875,105,21,107,4,3,4,11,Loyal Users
50122,995,5,15,2,1,1,4,Lost
50241,154,33,238,4,4,5,13,Champions
50406,250,10,30,3,2,2,7,Casual Users
50714,411,14,123,3,3,4,10,Loyal Users
50811,2477,6,11,1,1,1,3,Lost
50910,76,70,351,4,5,5,14,Champions
50925,218,20,58,3,3,3,9,Loyal Users
51059,359,60,210,3,5,5,13,Loyal Users
51435,41,52,108,5,5,4,14,Champions
51439,215,50,86,3,5,4,12,Loyal Users
51760,12,6,15,5,1,1,7,Promising
51824,323,21,42,3,3,3,9,Loyal Users
51886,11,15,28,5,3,2,10,Loyal Users
52035,2430,10,43,1,2,3,6,Lost
52299,0,5,12,5,1,1,7,Promising
39319,391,11,15,3,2,1,6,Casual Users
39522,4983,7,22,1,2,2,5,Lost
39644,789,14,20,2,3,2,7,Casual Users
40037,543,9,11,2,2,1,5,Lost
40190,1592,7,23,1,2,2,5,Lost
40234,147,84,118,4,5,4,13,Champions
40373,299,46,90,3,5,4,12,Loyal Users
40377,2417,13,89,1,3,4,8,Casual Users
40486,69,30,52,5,4,3,12,Loyal Users
40568,3303,32,52,1,4,3,8,At Risk
40660,961,11,15,2,2,1,5,Lost
40784,2268,8,11,1,2,1,4,Lost
40828,1016,6,22,2,1,2,5,Lost
40880,1008,10,16,2,2,2,6,Lost
41128,168,84,174,3,5,5,13,Loyal Users
41402,949,119,625,2,5,5,12,At Risk
41754,143,5,7,4,1,1,6,Promising
42291,832,7,8,2,2,1,5,Lost
42363,36,21,36,5,3,3,11,Loyal Users
42732,450,8,26,3,2,2,7,Casual Users
42795,874,22,30,2,4,2,8,At Risk
42983,15,41,95,5,4,4,13,Champions
43479,74,84,218,4,5,5,14,Champions
43520,647,30,35,2,4,3,9,At Risk
43627,2463,9,19,1,2,2,5,Lost
43810,851,10,23,2,2,2,6,Lost
44650,1931,10,85,1,2,4,7,Lost
45164,109,57,315,4,5,5,14,Champions
45262,820,20,84,2,3,4,9,Casual Users
45455,407,7,10,3,2,1,6,Casual Users
46991,544,10,14,2,2,1,5,Lost
47011,104,8,16,4,2,2,8,Promising
47574,82,77,108,4,5,4,13,Champions
47676,33,49,102,5,5,4,14,Champions
47858,167,36,240,3,4,5,12,Loyal Users
48229,834,7,38,2,2,3,7,Lost
48284,9,21,27,5,3,2,10,Loyal Users
48325,701,5,8,2,1,1,4,Lost
48375,356,22,99,3,4,4,11,Loyal Users
48581,165,12,17,4,3,2,9,Loyal Users
48588,1539,5,32,1,1,3,5,Lost
48641,4,5,7,5,1,1,7,Promising
48708,178,152,341,3,5,5,13,Loyal Users
48778,321,12,50,3,3,3,9,Loyal Users
49336,761,6,55,2,1,3,6,Lost
49534,52,15,47,5,3,3,11,Loyal Users
49706,1058,5,5,2,1,1,4,Lost
49806,0,37,110,5,4,4,13,Champions
50006,548,6,7,2,1,1,4,Lost
50480,1724,6,21,1,1,2,4,Lost
50828,2025,12,36,1,3,3,7,Casual Users
51247,405,45,101,3,4,4,11,Loyal Users
51272,596,20,43,2,3,3,8,Casual Users
51470,5242,12,41,1,3,3,7,Casual Users
51506,1855,6,11,1,1,1,3,Lost
51513,16,78,292,5,5,5,15,Champions
52122,1417,5,5,1,1,1,3,Lost
52169,0,281,590,5,5,5,15,Champions
52220,1086,12,22,2,3,2,7,Casual Users
39815,156,12,23,4,3,2,9,Loyal Users
39972,3622,9,33,1,2,3,6,Lost
40220,1586,8,24,1,2,2,5,Lost
40291,2291,11,15,1,2,1,4,Lost
40441,1149,32,71,2,4,4,10,At Risk
40539,416,14,26,3,3,2,8,Loyal Users
40624,694,16,26,2,3,2,7,Casual Users
40625,3546,5,9,1,1,1,3,Lost
40741,410,22,35,3,4,3,10,Loyal Users
40777,2049,6,8,1,1,1,3,Lost
40832,12,23,46,5,4,3,12,Loyal Users
40915,1430,15,15,1,3,1,5,Casual Users
41115,92,114,389,4,5,5,14,Champions
41816,3126,17,18,1,3,2,6,Casual Users
42183,197,19,28,3,3,2,8,Loyal Users
42185,972,11,17,2,2,2,6,Lost
42375,199,7,15,3,2,1,6,Casual Users
42837,1778,7,27,1,2,2,5,Lost
43351,1792,6,41,1,1,3,5,Lost
43845,87,94,293,4,5,5,14,Champions
44094,245,46,156,3,5,5,13,Loyal Users
44247,1645,11,51,1,2,3,6,Lost
44258,20,41,312,5,4,5,14,Champions
44419,2377,7,9,1,2,1,4,Lost
44446,130,91,395,4,5,5,14,Champions
44615,1121,5,8,2,1,1,4,Lost
44686,16,23,108,5,4,4,13,Champions
44700,6,40,346,5,4,5,14,Champions
44824,465,9,9,3,2,1,6,Casual Users
44909,1,38,116,5,4,4,13,Champions
45423,9,38,128,5,4,4,13,Champions
45558,4164,30,53,1,4,3,8,At Risk
45678,45,47,210,5,5,5,15,Champions
45697,5,21,62,5,3,3,11,Loyal Users
46060,781,5,6,2,1,1,4,Lost
46153,2112,7,17,1,2,2,5,Lost
46161,2042,9,11,1,2,1,4,Lost
46981,233,28,89,3,4,4,11,Loyal Users
47235,157,35,82,4,4,4,12,Champions
47465,108,59,539,4,5,5,14,Champions
47490,27,47,264,5,5,5,15,Champions
47566,1023,20,23,2,3,2,7,Casual Users
47735,167,81,428,3,5,5,13,Loyal Users
48201,14,53,85,5,5,4,14,Champions
48354,51,27,49,5,4,3,12,Loyal Users
48369,1849,7,11,1,2,1,4,Lost
48472,1508,26,67,1,4,4,9,At Risk
48507,865,10,23,2,2,2,6,Lost
48798,1422,6,53,1,1,3,5,Lost
48818,140,7,52,4,2,3,9,Promising
48824,71,79,311,4,5,5,14,Champions
48937,1061,9,39,2,2,3,7,Lost
49047,1402,54,117,1,5,4,10,At Risk
49146,682,61,185,2,5,5,12,At Risk
49327,277,12,68,3,3,4,10,Loyal Users
49480,3104,9,16,1,2,2,5,Lost
49590,32,5,7,5,1,1,7,Promising
49623,5,80,403,5,5,5,15,Champions
49910,227,46,129,3,5,4,12,Loyal Users
50352,595,10,14,2,2,1,5,Lost
50370,416,49,189,3,5,5,13,Loyal Users
50432,843,10,15,2,2,1,5,Lost
50681,679,10,18,2,2,2,6,Lost
50844,7,48,93,5,5,4,14,Champions
51149,2264,5,34,1,1,3,5,Lost
51447,1433,16,19,1,3,2,6,Casual Users
51463,32,116,183,5,5,5,15,Champions
51684,351,8,18,3,2,2,7,Casual Users
51688,0,122,369,5,5,5,15,Champions
52357,1495,5,6,1,1,1,3,Lost
39630,398,11,97,3,2,4,9,Casual Users
40025,1848,10,10,1,2,1,4,Lost
40091,439,15,20,3,3,2,8,Loyal Users
40303,219,13,27,3,3,2,8,Loyal Users
40404,418,8,53,3,2,3,8,Casual Users
40438,4665,7,16,1,2,2,5,Lost
40615,448,32,39,3,4,3,10,Loyal Users
40700,183,17,24,3,3,2,8,Loyal Users
41007,2744,15,23,1,3,2,6,Casual Users
41194,1246,10,13,2,2,1,5,Lost
41699,638,12,17,2,3,2,7,Casual Users
42194,18,68,372,5,5,5,15,Champions
42196,15,165,308,5,5,5,15,Champions
42350,314,9,20,3,2,2,7,Casual Users
42669,161,12,40,4,3,3,10,Loyal Users
42790,36,24,37,5,4,3,12,Loyal Users
43031,309,30,44,3,4,3,10,Loyal Users
43914,144,22,63,4,4,4,12,Champions
44042,121,153,351,4,5,5,14,Champions
44837,103,57,343,4,5,5,14,Champions
44904,136,34,229,4,4,5,13,Champions
44947,1028,7,15,2,2,1,5,Lost
45331,975,13,42,2,3,3,8,Casual Users
45601,16,23,41,5,4,3,12,Loyal Users
45821,13,6,26,5,1,2,8,Promising
46075,109,42,48,4,4,3,11,Loyal Users
46142,567,13,31,2,3,2,7,Casual Users
47491,653,44,95,2,4,4,10,At Risk
47510,32,14,58,5,3,3,11,Loyal Users
47556,176,55,192,3,5,5,13,Loyal Users
48018,888,5,5,2,1,1,4,Lost
48122,132,10,28,4,2,2,8,Promising
48124,152,62,401,4,5,5,14,Champions
48260,698,9,15,2,2,1,5,Lost
48734,24,5,7,5,1,1,7,Promising
48919,1056,7,11,2,2,1,5,Lost
48954,3716,23,129,1,4,4,9,At Risk
49515,39,52,74,5,5,4,14,Champions
49547,1011,25,111,2,4,4,10,At Risk
49555,2082,17,26,1,3,2,6,Casual Users
50304,288,30,37,3,4,3,10,Loyal Users
50324,1473,48,134,1,5,4,10,At Risk
50347,128,41,189,4,4,5,13,Champions
50420,2877,6,8,1,1,1,3,Lost
50716,59,74,220,5,5,5,15,Champions
50822,279,9,9,3,2,1,6,Casual Users
50874,97,10,65,4,2,4,10,Promising
51311,1011,39,67,2,4,4,10,At Risk
51762,93,23,128,4,4,4,12,Champions
51799,7,22,189,5,4,5,14,Champions
39410,153,24,72,4,4,4,12,Champions
39434,245,6,15,3,1,1,5,Casual Users
39569,23,26,39,5,4,3,12,Loyal Users
39570,2917,21,28,1,3,2,6,Casual Users
39667,1354,15,29,1,3,2,6,Casual Users
39843,1990,5,27,1,1,2,4,Lost
39967,129,5,25,4,1,2,7,Promising
40202,26,138,360,5,5,5,15,Champions
40204,102,5,6,4,1,1,6,Promising
40344,149,101,456,4,5,5,14,Champions
40514,836,17,27,2,3,2,7,Casual Users
40765,536,28,251,2,4,5,11,At Risk
40808,253,13,25,3,3,2,8,Loyal Users
40990,664,46,129,2,5,4,11,At Risk
41487,106,40,94,4,4,4,12,Champions
41712,536,42,93,2,4,4,10,At Risk
42253,47,63,95,5,5,4,14,Champions
42269,0,35,119,5,4,4,13,Champions
42565,794,10,32,2,2,3,7,Lost
42603,1069,27,70,2,4,4,10,At Risk
42819,4471,5,10,1,1,1,3,Lost
42885,425,20,75,3,3,4,10,Loyal Users
42954,484,7,11,2,2,1,5,Lost
43214,87,54,73,4,5,4,13,Champions
43228,1210,14,15,2,3,1,6,Casual Users
43293,3217,12,56,1,3,3,7,Casual Users
43366,578,28,40,2,4,3,9,At Risk
43372,287,8,22,3,2,2,7,Casual Users
43601,37,84,203,5,5,5,15,Champions
43860,914,35,86,2,4,4,10,At Risk
43881,724,14,31,2,3,2,7,Casual Users
43995,440,28,73,3,4,4,11,Loyal Users
44235,33,53,164,5,5,5,15,Champions
44945,1,43,162,5,4,5,14,Champions
45022,4251,10,11,1,2,1,4,Lost
45400,376,5,6,3,1,1,5,Casual Users
45563,89,44,78,4,4,4,12,Champions
45873,15,27,93,5,4,4,13,Champions
46080,343,42,92,3,4,4,11,Loyal Users
46323,40,78,608,5,5,5,15,Champions
46723,415,6,8,3,1,1,5,Casual Users
46755,79,90,349,4,5,5,14,Champions
46764,14,75,95,5,5,4,14,Champions
46770,1,9,15,5,2,1,8,Promising
46967,847,28,119,2,4,4,10,At Risk
47012,223,5,10,3,1,1,5,Casual Users
47073,442,17,49,3,3,3,9,Loyal Users
47157,415,11,96,3,2,4,9,Casual Users
47325,19,55,90,5,5,4,14,Champions
47370,5,14,32,5,3,3,11,Loyal Users
47654,1139,15,18,2,3,2,7,Casual Users
47827,1552,8,28,1,2,2,5,Lost
47905,1133,18,96,2,3,4,9,Casual Users
47940,3853,13,54,1,3,3,7,Casual Users
48576,61,64,347,5,5,5,15,Champions
48744,2283,13,32,1,3,3,7,Casual Users
48779,18,39,157,5,4,5,14,Champions
49170,236,40,70,3,4,4,11,Loyal Users
49176,1465,57,290,1,5,5,11,At Risk
49284,705,6,37,2,1,3,6,Lost
49431,620,7,39,2,2,3,7,Lost
50321,78,36,132,4,4,4,12,Champions
50332,153,17,25,4,3,2,9,Loyal Users
50703,699,7,12,2,2,1,5,Lost
50921,36,83,229,5,5,5,15,Champions
51026,3305,8,11,1,2,1,4,Lost
51112,178,7,24,3,2,2,7,Casual Users
51208,410,24,35,3,4,3,10,Loyal Users
51465,17,40,67,5,4,4,13,Champions
51745,1012,14,24,2,3,2,7,Casual Users
51913,65,50,144,5,5,4,14,Champions
51991,12,36,86,5,4,4,13,Champions
52019,709,5,7,2,1,1,4,Lost
52077,420,21,75,3,3,4,10,Loyal Users
52215,919,28,56,2,4,3,9,At Risk
39413,81,65,75,4,5,4,13,Champions
39431,4646,9,14,1,2,1,4,Lost
39480,433,12,76,3,3,4,10,Loyal Users
39584,148,46,93,4,5,4,13,Champions
40033,9,22,31,5,4,2,11,Loyal Users
40999,157,58,156,4,5,5,14,Champions
41086,112,47,256,4,5,5,14,Champions
41132,5116,16,35,1,3,3,7,Casual Users
41764,18,100,124,5,5,4,14,Champions
41914,148,5,25,4,1,2,7,Promising
41983,438,19,59,3,3,3,9,Loyal Users
43087,58,9,33,5,2,3,10,Promising
43101,112,7,7,4,2,1,7,Promising
43183,412,26,32,3,4,3,10,Loyal Users
43319,57,47,125,5,5,4,14,Champions
43373,266,20,37,3,3,3,9,Loyal Users
43375,115,35,55,4,4,3,11,Loyal Users
43575,2022,10,12,1,2,1,4,Lost
44129,421,9,15,3,2,1,6,Casual Users
44132,110,46,78,4,5,4,13,Champions
44495,1690,9,9,1,2,1,4,Lost
44575,422,36,45,3,4,3,10,Loyal Users
44580,321,8,37,3,2,3,8,Casual Users
44597,1076,7,28,2,2,2,6,Lost
44999,979,13,19,2,3,2,7,Casual Users
45165,56,41,276,5,4,5,14,Champions
45241,4421,8,9,1,2,1,4,Lost
46135,52,13,16,5,3,2,10,Loyal Users
46390,840,28,57,2,4,3,9,At Risk
46812,4019,5,6,1,1,1,3,Lost
46895,4528,8,46,1,2,3,6,Lost
46927,137,80,122,4,5,4,13,Champions
47033,246,9,25,3,2,2,7,Casual Users
47111,295,18,71,3,3,4,10,Loyal Users
47169,4,80,182,5,5,5,15,Champions
47767,2477,15,44,1,3,3,7,Casual Users
47997,131,14,27,4,3,2,9,Loyal Users
48292,144,8,46,4,2,3,9,Promising
48307,165,20,62,4,3,3,10,Loyal Users
48407,11,13,28,5,3,2,10,Loyal Users
48505,445,5,6,3,1,1,5,Casual Users
48612,296,9,13,3,2,1,6,Casual Users
48661,3986,6,14,1,1,1,3,Lost
48866,134,7,11,4,2,1,7,Promising
48901,787,8,18,2,2,2,6,Lost
49006,2789,9,10,1,2,1,4,Lost
49191,129,6,12,4,1,1,6,Promising
49632,4596,10,16,1,2,2,5,Lost
49749,4682,8,30,1,2,2,5,Lost
49970,154,13,37,4,3,3,10,Loyal Users
49974,39,11,20,5,2,2,9,Promising
50385,67,104,235,5,5,5,15,Champions
50671,229,6,20,3,1,2,6,Casual Users
50873,4147,9,20,1,2,2,5,Lost
51008,2601,5,6,1,1,1,3,Lost
51037,130,14,50,4,3,3,10,Loyal Users
51375,743,14,46,2,3,3,8,Casual Users
51456,84,21,73,4,3,4,11,Loyal Users
51526,91,95,222,4,5,5,14,Champions
51598,53,11,16,5,2,2,9,Promising
51711,122,15,20,4,3,2,9,Loyal Users
51784,2264,7,20,1,2,2,5,Lost
51835,150,46,131,4,5,4,13,Champions
52146,1096,18,93,2,3,4,9,Casual Users
52168,603,7,13,2,2,1,5,Lost
52196,32,83,1198,5,5,5,15,Champions
39412,406,23,73,3,4,4,11,Loyal Users
39734,2125,12,36,1,3,3,7,Casual Users
40117,1260,41,64,1,4,4,9,At Risk
40248,646,27,171,2,4,5,11,At Risk
40318,103,43,235,4,4,5,13,Champions
40535,20,39,77,5,4,4,13,Champions
40642,799,76,250,2,5,5,12,At Risk
40666,1837,5,15,1,1,1,3,Lost
40694,49,7,11,5,2,1,8,Promising
40712,632,53,158,2,5,5,12,At Risk
40896,1157,11,24,2,2,2,6,Lost
41313,3666,5,15,1,1,1,3,Lost
41538,71,105,749,4,5,5,14,Champions
41586,167,58,150,3,5,5,13,Loyal Users
41597,76,9,25,4,2,2,8,Promising
41702,253,5,23,3,1,2,6,Casual Users
41945,521,22,155,2,4,5,11,At Risk
42156,1869,5,30,1,1,2,4,Lost
42585,511,20,75,2,3,4,9,Casual Users
43086,5271,7,13,1,2,1,4,Lost
43189,0,110,636,5,5,5,15,Champions
43343,349,5,21,3,1,2,6,Casual Users
43357,63,9,25,5,2,2,9,Promising
43630,879,7,14,2,2,1,5,Lost
43767,4719,9,23,1,2,2,5,Lost
43811,1654,5,16,1,1,2,4,Lost
43864,3430,7,14,1,2,1,4,Lost
43866,137,20,59,4,3,3,10,Loyal Users
43885,29,94,125,5,5,4,14,Champions
44548,120,50,305,4,5,5,14,Champions
44651,5774,6,10,1,1,1,3,Lost
44726,437,7,48,3,2,3,8,Casual Users
44823,487,5,45,2,1,3,6,Lost
44878,46,69,90,5,5,4,14,Champions
45145,1184,17,45,2,3,3,8,Casual Users
45168,2575,7,29,1,2,2,5,Lost
45297,3,29,38,5,4,3,12,Loyal Users
45434,267,5,12,3,1,1,5,Casual Users
45472,270,34,58,3,4,3,10,Loyal Users
45683,15,125,1284,5,5,5,15,Champions
45742,29,32,66,5,4,4,13,Champions
46352,994,15,25,2,3,2,7,Casual Users
46417,499,7,25,2,2,2,6,Lost
46500,24,12,45,5,3,3,11,Loyal Users
46619,458,15,37,3,3,3,9,Loyal Users
46674,764,17,26,2,3,2,7,Casual Users
47008,134,28,100,4,4,4,12,Champions
47090,23,74,455,5,5,5,15,Champions
47783,212,81,137,3,5,4,12,Loyal Users
48008,461,19,26,3,3,2,8,Loyal Users
48101,2265,6,7,1,1,1,3,Lost
48215,139,114,177,4,5,5,14,Champions
48276,405,39,149,3,4,5,12,Loyal Users
48344,5,41,67,5,4,4,13,Champions
48364,3720,15,15,1,3,1,5,Casual Users
49228,2680,7,16,1,2,2,5,Lost
49667,32,25,48,5,4,3,12,Loyal Users
49772,215,22,61,3,4,3,10,Loyal Users
49996,105,50,106,4,5,4,13,Champions
50159,156,120,264,4,5,5,14,Champions
50441,98,151,411,4,5,5,14,Champions
50468,443,86,227,3,5,5,13,Loyal Users
50593,1019,14,34,2,3,3,8,Casual Users
51067,47,21,32,5,3,3,11,Loyal Users
51341,61,12,21,5,3,2,10,Loyal Users
51371,0,22,26,5,4,2,11,Loyal Users
51576,736,5,11,2,1,1,4,Lost
51875,77,30,176,4,4,5,13,Champions
52052,1444,5,5,1,1,1,3,Lost
52356,246,17,50,3,3,3,9,Loyal Users
39344,1201,14,28,2,3,2,7,Casual Users
39470,353,50,56,3,5,3,11,Loyal Users
39747,131,19,190,4,3,5,12,Loyal Users
39789,980,6,7,2,1,1,4,Lost
40571,3,33,50,5,4,3,12,Loyal Users
40598,48,45,112,5,4,4,13,Champions
40620,296,14,23,3,3,2,8,Loyal Users
40856,291,11,21,3,2,2,7,Casual Users
40925,860,28,352,2,4,5,11,At Risk
40968,14,63,116,5,5,4,14,Champions
42048,253,38,213,3,4,5,12,Loyal Users
42140,826,11,20,2,2,2,6,Lost
42676,5524,5,5,1,1,1,3,Lost
43136,3977,8,16,1,2,2,5,Lost
43913,172,13,38,3,3,3,9,Loyal Users
44105,229,17,30,3,3,2,8,Loyal Users
44124,254,10,17,3,2,2,7,Casual Users
44274,1222,19,68,2,3,4,9,Casual Users
44600,2,66,181,5,5,5,15,Champions
44893,1935,11,104,1,2,4,7,Lost
45076,401,39,156,3,4,5,12,Loyal Users
45366,2907,5,8,1,1,1,3,Lost
45431,152,20,89,4,3,4,11,Loyal Users
45460,2363,5,16,1,1,2,4,Lost
45507,160,21,38,4,3,3,10,Loyal Users
45924,607,24,27,2,4,2,8,At Risk
45981,599,40,141,2,4,4,10,At Risk
46369,405,7,9,3,2,1,6,Casual Users
46493,350,18,31,3,3,2,8,Loyal Users
46522,1880,7,8,1,2,1,4,Lost
46540,930,6,12,2,1,1,4,Lost
46836,433,15,46,3,3,3,9,Loyal Users
46973,254,15,16,3,3,2,8,Loyal Users
47453,1504,10,31,1,2,2,5,Lost
47885,457,50,111,3,5,4,12,Loyal Users
47975,48,80,116,5,5,4,14,Champions
48005,608,11,20,2,2,2,6,Lost
48028,28,24,49,5,4,3,12,Loyal Users
48468,17,26,63,5,4,4,13,Champions
48693,133,8,45,4,2,3,9,Promising
48982,147,10,16,4,2,2,8,Promising
49552,11,49,367,5,5,5,15,Champions
49591,1748,33,80,1,4,4,9,At Risk
49943,23,163,552,5,5,5,15,Champions
50074,36,172,315,5,5,5,15,Champions
50129,192,25,46,3,4,3,10,Loyal Users
50143,116,22,48,4,4,3,11,Loyal Users
50149,127,10,12,4,2,1,7,Promising
50652,221,13,52,3,3,3,9,Loyal Users
51032,527,20,53,2,3,3,8,Casual Users
51090,146,5,6,4,1,1,6,Promising
51549,150,100,433,4,5,5,14,Champions
51561,944,5,6,2,1,1,4,Lost
51656,7,6,12,5,1,1,7,Promising
51793,133,72,175,4,5,5,14,Champions
52002,2934,8,36,1,2,3,6,Lost
52103,29,15,18,5,3,2,10,Loyal Users
39469,1297,5,9,1,1,1,3,Lost
39776,2932,10,11,1,2,1,4,Lost
39882,133,42,55,4,4,3,11,Loyal Users
39950,564,14,25,2,3,2,7,Casual Users
40195,1085,10,18,2,2,2,6,Lost
40372,1993,6,53,1,1,3,5,Lost
40686,43,64,125,5,5,4,14,Champions
40841,706,29,182,2,4,5,11,At Risk
40866,8,24,50,5,4,3,12,Loyal Users
41022,175,11,26,3,2,2,7,Casual Users
41240,826,12,39,2,3,3,8,Casual Users
41359,665,5,6,2,1,1,4,Lost
41463,206,49,95,3,5,4,12,Loyal Users
41529,3505,5,30,1,1,2,4,Lost
41843,507,6,13,2,1,1,4,Lost
41896,1873,9,12,1,2,1,4,Lost
41977,441,10,15,3,2,1,6,Casual Users
42073,94,48,142,4,5,4,13,Champions
42484,357,45,117,3,4,4,11,Loyal Users
42641,74,10,20,4,2,2,8,Promising
42653,328,29,127,3,4,4,11,Loyal Users
43112,48,76,467,5,5,5,15,Champions
43138,542,13,22,2,3,2,7,Casual Users
43484,133,14,26,4,3,2,9,Loyal Users
43702,829,9,18,2,2,2,6,Lost
43739,229,44,109,3,4,4,11,Loyal Users
43986,18,12,22,5,3,2,10,Loyal Users
44507,157,37,136,4,4,4,12,Champions
44625,402,74,176,3,5,5,13,Loyal Users
45031,649,7,26,2,2,2,6,Lost
45545,891,8,35,2,2,3,7,Lost
45554,58,109,289,5,5,5,15,Champions
45809,3562,9,14,1,2,1,4,Lost
46201,2425,29,36,1,4,3,8,At Risk
46475,46,10,54,5,2,3,10,Promising
46623,713,5,21,2,1,2,5,Lost
46798,404,7,9,3,2,1,6,Casual Users
47174,149,13,55,4,3,3,10,Loyal Users
47533,974,17,46,2,3,3,8,Casual Users
47617,1285,11,19,1,2,2,5,Lost
47807,103,36,152,4,4,5,13,Champions
47942,41,16,54,5,3,3,11,Loyal Users
48025,1695,23,53,1,4,3,8,At Risk
48441,21,99,230,5,5,5,15,Champions
48635,16,100,508,5,5,5,15,Champions
48856,1308,5,63,1,1,4,6,Lost
48959,1119,37,163,2,4,5,11,At Risk
49000,245,23,67,3,4,4,11,Loyal Users
49185,3586,5,7,1,1,1,3,Lost
49209,17,135,339,5,5,5,15,Champions
49286,272,5,30,3,1,2,6,Casual Users
49414,2624,12,17,1,3,2,6,Casual Users
49444,535,30,185,2,4,5,11,At Risk
49523,3682,5,8,1,1,1,3,Lost
49542,50,59,266,5,5,5,15,Champions
49661,1158,9,63,2,2,4,8,Lost
49672,240,65,219,3,5,5,13,Loyal Users
49687,930,6,25,2,1,2,5,Lost
49785,13,30,57,5,4,3,12,Loyal Users
49873,68,10,65,5,2,4,11,Promising
49942,191,13,41,3,3,3,9,Loyal Users
50258,493,8,20,2,2,2,6,Lost
50265,4039,5,12,1,1,1,3,Lost
50416,552,8,14,2,2,1,5,Lost
51082,449,25,70,3,4,4,11,Loyal Users
51110,117,9,18,4,2,2,8,Promising
51790,998,20,71,2,3,4,9,Casual Users
39302,87,8,14,4,2,1,7,Promising
40208,1,109,310,5,5,5,15,Champions
40446,50,6,7,5,1,1,7,Promising
40447,683,41,81,2,4,4,10,At Risk
40882,4,18,49,5,3,3,11,Loyal Users
40981,16,8,46,5,2,3,10,Promising
41585,859,5,14,2,1,1,4,Lost
41941,3261,7,9,1,2,1,4,Lost
42141,341,33,50,3,4,3,10,Loyal Users
42668,1543,22,31,1,4,2,7,At Risk
42767,1651,7,8,1,2,1,4,Lost
42949,500,20,32,2,3,3,8,Casual Users
43064,0,17,30,5,3,2,10,Loyal Users
43326,143,9,24,4,2,2,8,Promising
43350,3,138,250,5,5,5,15,Champions
43408,2123,8,26,1,2,2,5,Lost
43469,130,26,150,4,4,5,13,Champions
43486,72,5,6,4,1,1,6,Promising
43541,463,6,16,3,1,2,6,Casual Users
43613,5778,5,26,1,1,2,4,Lost
43629,978,27,44,2,4,3,9,At Risk
43757,20,84,459,5,5,5,15,Champions
43797,569,5,7,2,1,1,4,Lost
43950,146,7,16,4,2,2,8,Promising
43977,384,18,54,3,3,3,9,Loyal Users
43994,2,99,205,5,5,5,15,Champions
44346,18,26,48,5,4,3,12,Loyal Users
44424,20,5,8,5,1,1,7,Promising
44558,848,10,11,2,2,1,5,Lost
44564,1,44,99,5,4,4,13,Champions
44609,161,11,19,4,2,2,8,Promising
44765,427,6,20,3,1,2,6,Casual Users
44957,141,23,42,4,4,3,11,Loyal Users
45188,1281,12,42,1,3,3,7,Casual Users
45718,466,13,41,3,3,3,9,Loyal Users
45798,412,5,28,3,1,2,6,Casual Users
45900,1475,15,16,1,3,2,6,Casual Users
45984,14,82,815,5,5,5,15,Champions
46125,1786,18,25,1,3,2,6,Casual Users
46269,271,5,5,3,1,1,5,Casual Users
46422,112,101,189,4,5,5,14,Champions
46544,2601,5,5,1,1,1,3,Lost
47534,375,35,52,3,4,3,10,Loyal Users
47714,37,75,113,5,5,4,14,Champions
47908,3449,5,7,1,1,1,3,Lost
48121,29,88,273,5,5,5,15,Champions
48291,9,57,113,5,5,4,14,Champions
48322,2483,6,7,1,1,1,3,Lost
48522,165,57,93,4,5,4,13,Champions
48591,487,14,83,2,3,4,9,Casual Users
48654,2988,8,17,1,2,2,5,Lost
48680,305,6,10,3,1,1,5,Casual Users
48917,140,42,239,4,4,5,13,Champions
49210,65,92,375,5,5,5,15,Champions
49278,141,26,41,4,4,3,11,Loyal Users
49321,79,7,10,4,2,1,7,Promising
49353,4,39,251,5,4,5,14,Champions
49741,102,37,55,4,4,3,11,Loyal Users
50264,227,11,14,3,2,1,6,Casual Users
50267,19,85,421,5,5,5,15,Champions
50273,65,65,607,5,5,5,15,Champions
50503,1555,12,58,1,3,3,7,Casual Users
50583,339,9,23,3,2,2,7,Casual Users
50638,79,46,101,4,5,4,13,Champions
50794,739,25,147,2,4,5,11,At Risk
51041,648,5,11,2,1,1,4,Lost
51287,165,7,32,4,2,3,9,Promising
51361,142,27,95,4,4,4,12,Champions
52064,2179,14,31,1,3,2,6,Casual Users
52697,24,38,182,5,4,5,14,Champions
53191,20,57,252,5,5,5,15,Champions
53565,208,95,162,3,5,5,13,Loyal Users
53634,2,63,332,5,5,5,15,Champions
53691,22,34,104,5,4,4,13,Champions
53963,1962,13,62,1,3,3,7,Casual Users
54190,9,13,49,5,3,3,11,Loyal Users
54264,199,24,38,3,4,3,10,Loyal Users
55155,2106,8,30,1,2,2,5,Lost
55265,1107,18,23,2,3,2,7,Casual Users
55283,276,88,130,3,5,4,12,Loyal Users
55869,17,45,78,5,4,4,13,Champions
56054,3,7,19,5,2,2,9,Promising
56110,77,11,33,4,2,3,9,Promising
56640,54,17,215,5,3,5,13,Loyal Users
56680,1837,8,21,1,2,2,5,Lost
56741,4126,6,7,1,1,1,3,Lost
56987,1127,12,26,2,3,2,7,Casual Users
57020,4021,5,5,1,1,1,3,Lost
57039,152,19,63,4,3,4,11,Loyal Users
57178,138,49,65,4,5,4,13,Champions
57201,2179,6,13,1,1,1,3,Lost
57370,250,16,49,3,3,3,9,Loyal Users
57380,3017,8,14,1,2,1,4,Lost
57693,1128,6,64,2,1,4,7,Lost
57984,6,40,138,5,4,4,13,Champions
58061,137,55,353,4,5,5,14,Champions
58305,6,15,116,5,3,4,12,Loyal Users
58665,122,5,5,4,1,1,6,Promising
58797,1143,8,17,2,2,2,6,Lost
58835,415,27,35,3,4,3,10,Loyal Users
59355,208,17,204,3,3,5,11,Loyal Users
59384,178,14,51,3,3,3,9,Loyal Users
59990,2939,6,7,1,1,1,3,Lost
60769,9,112,598,5,5,5,15,Champions
61051,377,10,16,3,2,2,7,Casual Users
61793,2214,9,20,1,2,2,5,Lost
62015,14,45,166,5,4,5,14,Champions
62680,20,56,191,5,5,5,15,Champions
62985,1580,8,10,1,2,1,4,Lost
63087,2636,9,14,1,2,1,4,Lost
63106,127,14,24,4,3,2,9,Loyal Users
63155,383,22,73,3,4,4,11,Loyal Users
63271,708,21,60,2,3,3,8,Casual Users
63574,4849,7,23,1,2,2,5,Lost
63645,23,22,33,5,4,3,12,Loyal Users
63964,136,10,28,4,2,2,8,Promising
64121,1591,11,20,1,2,2,5,Lost
64423,3,64,400,5,5,5,15,Champions
64519,2,75,292,5,5,5,15,Champions
64590,77,40,220,4,4,5,13,Champions
64628,2842,5,8,1,1,1,3,Lost
64822,1249,9,13,2,2,1,5,Lost
64859,140,29,65,4,4,4,12,Champions
65220,136,8,20,4,2,2,8,Promising
65241,116,10,35,4,2,3,9,Promising
65251,124,125,598,4,5,5,14,Champions
65408,122,16,102,4,3,4,11,Loyal Users
52507,5,27,183,5,4,5,14,Champions
53172,97,75,182,4,5,5,14,Champions
53299,2721,10,16,1,2,2,5,Lost
53338,416,8,29,3,2,2,7,Casual Users
53576,628,6,9,2,1,1,4,Lost
53620,1658,5,5,1,1,1,3,Lost
53630,1428,11,18,1,2,2,5,Lost
54258,138,16,59,4,3,3,10,Loyal Users
54518,4878,5,7,1,1,1,3,Lost
54844,699,6,8,2,1,1,4,Lost
55202,418,12,20,3,3,2,8,Loyal Users
55966,2136,7,14,1,2,1,4,Lost
56096,12,6,9,5,1,1,7,Promising
56203,438,5,12,3,1,1,5,Casual Users
56502,65,119,531,5,5,5,15,Champions
56687,685,33,117,2,4,4,10,At Risk
56768,4,24,30,5,4,2,11,Loyal Users
56941,1192,9,20,2,2,2,6,Lost
57513,1380,7,8,1,2,1,4,Lost
57771,4289,13,85,1,3,4,8,Casual Users
57877,807,27,73,2,4,4,10,At Risk
58039,14,23,45,5,4,3,12,Loyal Users
58196,288,17,24,3,3,2,8,Loyal Users
58395,23,13,60,5,3,3,11,Loyal Users
58486,170,76,162,3,5,5,13,Loyal Users
58572,120,9,29,4,2,2,8,Promising
58707,107,60,276,4,5,5,14,Champions
58905,398,20,62,3,3,3,9,Loyal Users
59345,634,43,170,2,4,5,11,At Risk
59748,2586,7,18,1,2,2,5,Lost
59754,420,22,184,3,4,5,12,Loyal Users
59896,279,8,11,3,2,1,6,Casual Users
60562,2246,34,60,1,4,3,8,At Risk
60596,549,18,76,2,3,4,9,Casual Users
60642,1209,11,62,2,2,3,7,Lost
60835,1498,6,15,1,1,1,3,Lost
60917,385,6,20,3,1,2,6,Casual Users
60965,1096,25,49,2,4,3,9,At Risk
61230,71,9,18,4,2,2,8,Promising
61330,259,17,25,3,3,2,8,Loyal Users
61365,111,30,170,4,4,5,13,Champions
61390,133,9,12,4,2,1,7,Promising
61682,122,20,45,4,3,3,10,Loyal Users
61745,413,23,43,3,4,3,10,Loyal Users
61766,803,10,71,2,2,4,8,Lost
61867,3868,10,16,1,2,2,5,Lost
61972,4,30,53,5,4,3,12,Loyal Users
62090,158,15,60,4,3,3,10,Loyal Users
62458,540,24,49,2,4,3,9,At Risk
62478,34,7,28,5,2,2,9,Promising
62526,1572,5,27,1,1,2,4,Lost
62780,1383,5,12,1,1,1,3,Lost
62880,125,10,23,4,2,2,8,Promising
63145,111,12,61,4,3,3,10,Loyal Users
63464,746,29,51,2,4,3,9,At Risk
63557,127,28,66,4,4,4,12,Champions
63781,152,13,21,4,3,2,9,Loyal Users
63905,12,101,266,5,5,5,15,Champions
64185,0,40,254,5,4,5,14,Champions
65300,362,10,31,3,2,2,7,Casual Users
65308,1690,11,23,1,2,2,5,Lost
65313,2544,5,20,1,1,2,4,Lost
52987,28,48,271,5,5,5,15,Champions
53056,17,210,468,5,5,5,15,Champions
53168,16,101,162,5,5,5,15,Champions
53528,176,13,77,3,3,4,10,Loyal Users
53741,132,13,15,4,3,1,8,Loyal Users
53906,11,83,318,5,5,5,15,Champions
54172,65,49,300,5,5,5,15,Champions
54212,63,15,19,5,3,2,10,Loyal Users
54231,671,8,8,2,2,1,5,Lost
54448,707,7,23,2,2,2,6,Lost
54551,159,33,95,4,4,4,12,Champions
54676,2566,9,18,1,2,2,5,Lost
54747,2101,10,76,1,2,4,7,Lost
54958,1432,5,6,1,1,1,3,Lost
54989,4192,13,95,1,3,4,8,Casual Users
55013,5,9,111,5,2,4,11,Promising
55272,86,34,65,4,4,4,12,Champions
55363,1660,11,30,1,2,2,5,Lost
55498,5,8,15,5,2,1,8,Promising
55539,3314,5,8,1,1,1,3,Lost
55622,1869,20,79,1,3,4,8,Casual Users
55879,1090,15,94,2,3,4,9,Casual Users
56022,118,50,88,4,5,4,13,Champions
56168,155,7,84,4,2,4,10,Promising
56204,1636,10,19,1,2,2,5,Lost
56259,1347,41,72,1,4,4,9,At Risk
56617,281,71,393,3,5,5,13,Loyal Users
56840,50,36,85,5,4,4,13,Champions
56943,186,14,17,3,3,2,8,Loyal Users
57306,2669,17,28,1,3,2,6,Casual Users
57412,10,59,313,5,5,5,15,Champions
57955,23,102,323,5,5,5,15,Champions
58021,198,7,11,3,2,1,6,Casual Users
58513,67,105,353,5,5,5,15,Champions
58694,2408,7,14,1,2,1,4,Lost
58811,828,14,23,2,3,2,7,Casual Users
58850,1696,12,18,1,3,2,6,Casual Users
59086,3909,5,6,1,1,1,3,Lost
59667,543,11,13,2,2,1,5,Lost
59680,837,15,20,2,3,2,7,Casual Users
59966,2,17,229,5,3,5,13,Loyal Users
60001,33,32,202,5,4,5,14,Champions
60068,336,22,133,3,4,4,11,Loyal Users
60455,114,7,63,4,2,4,10,Promising
60964,30,7,15,5,2,1,8,Promising
61202,2281,44,92,1,4,4,9,At Risk
61250,76,18,30,4,3,2,9,Loyal Users
61313,1861,13,25,1,3,2,6,Casual Users
61344,401,9,23,3,2,2,7,Casual Users
62172,504,12,60,2,3,3,8,Casual Users
62372,15,107,320,5,5,5,15,Champions
62462,22,90,228,5,5,5,15,Champions
62542,3449,6,8,1,1,1,3,Lost
62740,828,82,564,2,5,5,12,At Risk
62961,122,169,606,4,5,5,14,Champions
63017,2764,6,9,1,1,1,3,Lost
63111,566,11,15,2,2,1,5,Lost
63152,1426,10,38,1,2,3,6,Lost
63255,191,32,79,3,4,4,11,Loyal Users
63469,21,9,16,5,2,2,9,Promising
63854,427,31,46,3,4,3,10,Loyal Users
64354,1842,77,240,1,5,5,11,At Risk
64412,9,80,337,5,5,5,15,Champions
64648,125,67,298,4,5,5,14,Champions
65009,38,16,181,5,3,5,13,Loyal Users
65104,3240,17,149,1,3,5,9,Casual Users
65305,198,134,261,3,5,5,13,Loyal Users
65353,0,39,47,5,4,3,12,Loyal Users
52670,18,73,133,5,5,4,14,Champions
52675,491,33,83,2,4,4,10,At Risk
52855,30,31,331,5,4,5,14,Champions
53051,4968,8,25,1,2,2,5,Lost
53092,6,62,218,5,5,5,15,Champions
53098,608,10,42,2,2,3,7,Lost
53158,59,115,339,5,5,5,15,Champions
53340,158,8,12,4,2,1,7,Promising
53820,436,35,47,3,4,3,10,Loyal Users
53896,542,16,126,2,3,4,9,Casual Users
54051,268,7,7,3,2,1,6,Casual Users
54769,258,10,12,3,2,1,6,Casual Users
54980,122,14,102,4,3,4,11,Loyal Users
54984,667,38,86,2,4,4,10,At Risk
55197,140,28,66,4,4,4,12,Champions
55279,241,11,57,3,2,3,8,Casual Users
55547,288,14,29,3,3,2,8,Loyal Users
55669,2003,9,79,1,2,4,7,Lost
56297,138,17,67,4,3,4,11,Loyal Users
56350,694,18,21,2,3,2,7,Casual Users
56465,151,22,153,4,4,5,13,Champions
56490,106,13,50,4,3,3,10,Loyal Users
57202,118,21,31,4,3,2,9,Loyal Users
57398,30,22,83,5,4,4,13,Champions
57754,90,93,608,4,5,5,14,Champions
58066,1678,6,11,1,1,1,3,Lost
58072,325,7,70,3,2,4,9,Casual Users
58402,167,6,8,3,1,1,5,Casual Users
58517,1552,21,35,1,3,3,7,Casual Users
59115,4424,17,65,1,3,4,8,Casual Users
59229,166,40,144,3,4,4,11,Loyal Users
59244,1133,34,52,2,4,3,9,At Risk
59411,7,22,26,5,4,2,11,Loyal Users
59487,232,21,56,3,3,3,9,Loyal Users
59663,3195,5,10,1,1,1,3,Lost
59724,223,49,237,3,5,5,13,Loyal Users
59832,49,63,240,5,5,5,15,Champions
60962,317,6,16,3,1,2,6,Casual Users
61242,2652,7,49,1,2,3,6,Lost
61501,3963,7,24,1,2,2,5,Lost
62107,839,25,115,2,4,4,10,At Risk
62398,278,10,12,3,2,1,6,Casual Users
62400,2850,6,8,1,1,1,3,Lost
62606,285,80,211,3,5,5,13,Loyal Users
63055,60,206,365,5,5,5,15,Champions
63172,46,6,28,5,1,2,8,Promising
63197,18,13,21,5,3,2,10,Loyal Users
63345,4126,7,20,1,2,2,5,Lost
63388,2259,8,13,1,2,1,4,Lost
63505,186,25,151,3,4,5,12,Loyal Users
63588,156,22,53,4,4,3,11,Loyal Users
64067,104,36,46,4,4,3,11,Loyal Users
64536,490,21,90,2,3,4,9,Casual Users
64593,5296,10,10,1,2,1,4,Lost
64989,40,27,83,5,4,4,13,Champions
52471,72,147,456,4,5,5,14,Champions
52567,1184,7,7,2,2,1,5,Lost
52712,158,35,85,4,4,4,12,Champions
53316,3545,6,15,1,1,1,3,Lost
53381,964,10,17,2,2,2,6,Lost
53382,1106,25,59,2,4,3,9,At Risk
53496,381,42,113,3,4,4,11,Loyal Users
53546,524,18,65,2,3,4,9,Casual Users
53976,888,9,25,2,2,2,6,Lost
54404,51,11,40,5,2,3,10,Promising
54764,34,53,80,5,5,4,14,Champions
54932,410,19,37,3,3,3,9,Loyal Users
54941,1420,6,6,1,1,1,3,Lost
55198,5711,15,18,1,3,2,6,Casual Users
55443,367,15,209,3,3,5,11,Loyal Users
55597,126,18,41,4,3,3,10,Loyal Users
55607,98,49,137,4,5,4,13,Champions
55762,706,10,38,2,2,3,7,Lost
55963,75,83,339,4,5,5,14,Champions
56387,5,12,31,5,3,2,10,Loyal Users
56414,978,7,36,2,2,3,7,Lost
57566,711,5,6,2,1,1,4,Lost
57752,849,8,31,2,2,2,6,Lost
57783,80,15,96,4,3,4,11,Loyal Users
57885,37,101,207,5,5,5,15,Champions
58082,583,16,24,2,3,2,7,Casual Users
58119,135,61,237,4,5,5,14,Champions
58531,147,5,34,4,1,3,8,Promising
58789,1097,5,26,2,1,2,5,Lost
58944,277,7,26,3,2,2,7,Casual Users
59096,2567,17,24,1,3,2,6,Casual Users
59142,78,146,559,4,5,5,14,Champions
59157,420,26,33,3,4,3,10,Loyal Users
59194,1688,15,113,1,3,4,8,Casual Users
59547,2564,12,15,1,3,1,5,Casual Users
60048,538,20,38,2,3,3,8,Casual Users
60243,1528,5,17,1,1,2,4,Lost
60540,103,14,21,4,3,2,9,Loyal Users
60656,590,7,17,2,2,2,6,Lost
60681,2604,15,40,1,3,3,7,Casual Users
60702,837,8,10,2,2,1,5,Lost
60773,30,42,103,5,4,4,13,Champions
61314,2441,5,11,1,1,1,3,Lost
61715,129,44,155,4,4,5,13,Champions
62150,536,5,17,2,1,2,5,Lost
62436,3874,9,16,1,2,2,5,Lost
62620,451,20,30,3,3,2,8,Loyal Users
62757,275,10,15,3,2,1,6,Casual Users
62935,287,5,26,3,1,2,6,Casual Users
63146,174,20,45,3,3,3,9,Loyal Users
63191,553,20,91,2,3,4,9,Casual Users
63589,1875,16,35,1,3,3,7,Casual Users
64021,54,39,255,5,4,5,14,Champions
64045,140,7,33,4,2,3,9,Promising
64127,143,12,28,4,3,2,9,Loyal Users
64170,370,20,43,3,3,3,9,Loyal Users
64645,188,7,12,3,2,1,6,Casual Users
65037,75,56,66,4,5,4,13,Champions
65112,1144,11,19,2,2,2,6,Lost
65174,363,33,50,3,4,3,10,Loyal Users
65243,173,83,181,3,5,5,13,Loyal Users
65288,729,5,19,2,1,2,5,Lost
65321,934,16,25,2,3,2,7,Casual Users
52533,171,11,20,3,2,2,7,Casual Users
52648,182,43,178,3,4,5,12,Loyal Users
52882,15,19,61,5,3,3,11,Loyal Users
53083,113,18,71,4,3,4,11,Loyal Users
53642,4404,6,7,1,1,1,3,Lost
53658,48,58,105,5,5,4,14,Champions
53839,3010,5,20,1,1,2,4,Lost
53872,42,32,62,5,4,3,12,Loyal Users
53890,679,5,7,2,1,1,4,Lost
53957,298,32,81,3,4,4,11,Loyal Users
54125,7,42,150,5,4,5,14,Champions
54166,92,38,265,4,4,5,13,Champions
54232,5552,11,24,1,2,2,5,Lost
54340,4706,10,31,1,2,2,5,Lost
54342,577,10,16,2,2,2,6,Lost
54880,126,17,30,4,3,2,9,Loyal Users
55529,679,13,47,2,3,3,8,Casual Users
55647,1025,7,7,2,2,1,5,Lost
55726,2116,7,18,1,2,2,5,Lost
55773,23,148,224,5,5,5,15,Champions
56281,55,23,67,5,4,4,13,Champions
56468,90,21,31,4,3,2,9,Loyal Users
56661,30,6,7,5,1,1,7,Promising
56781,113,11,14,4,2,1,7,Promising
57150,14,44,82,5,4,4,13,Champions
57262,550,18,22,2,3,2,7,Casual Users
57448,217,24,104,3,4,4,11,Loyal Users
57530,1464,129,357,1,5,5,11,At Risk
57632,459,22,32,3,4,3,10,Loyal Users
58366,2713,6,7,1,1,1,3,Lost
58820,108,58,206,4,5,5,14,Champions
58825,89,59,122,4,5,4,13,Champions
58853,1989,10,17,1,2,2,5,Lost
58878,1124,7,9,2,2,1,5,Lost
58901,569,11,11,2,2,1,5,Lost
59008,241,7,9,3,2,1,6,Casual Users
59398,681,35,97,2,4,4,10,At Risk
59460,1418,7,24,1,2,2,5,Lost
59641,491,40,253,2,4,5,11,At Risk
59951,261,6,9,3,1,1,5,Casual Users
60107,584,17,36,2,3,3,8,Casual Users
61129,415,81,177,3,5,5,13,Loyal Users
61477,110,67,320,4,5,5,14,Champions
61492,321,24,30,3,4,2,9,Loyal Users
61493,592,17,103,2,3,4,9,Casual Users
61629,114,17,28,4,3,2,9,Loyal Users
61772,4146,9,30,1,2,2,5,Lost
61859,3984,33,65,1,4,4,9,At Risk
62002,441,5,6,3,1,1,5,Casual Users
62202,555,38,143,2,4,4,10,At Risk
62352,13,112,357,5,5,5,15,Champions
62387,71,21,39,4,3,3,10,Loyal Users
62432,415,8,27,3,2,2,7,Casual Users
62930,99,53,185,4,5,5,14,Champions
63032,16,136,386,5,5,5,15,Champions
63033,408,115,608,3,5,5,13,Loyal Users
63593,14,222,366,5,5,5,15,Champions
63817,1856,11,30,1,2,2,5,Lost
63829,988,20,38,2,3,3,8,Casual Users
63868,116,6,13,4,1,1,6,Promising
63963,573,29,36,2,4,3,9,At Risk
64236,1737,5,28,1,1,2,4,Lost
64555,93,42,60,4,4,3,11,Loyal Users
64727,1,107,344,5,5,5,15,Champions
64798,4301,6,16,1,1,2,4,Lost
64874,37,36,71,5,4,4,13,Champions
65169,1107,18,69,2,3,4,9,Casual Users
65203,405,16,67,3,3,4,10,Loyal Users
52794,101,9,141,4,2,4,10,Promising
52797,2103,14,23,1,3,2,6,Casual Users
53467,671,15,37,2,3,3,8,Casual Users
53547,617,22,36,2,4,3,9,At Risk
53708,25,57,434,5,5,5,15,Champions
53810,4630,5,7,1,1,1,3,Lost
53860,955,21,28,2,3,2,7,Casual Users
54110,812,44,168,2,4,5,11,At Risk
54146,1760,16,37,1,3,3,7,Casual Users
54208,105,57,153,4,5,5,14,Champions
54211,393,7,29,3,2,2,7,Casual Users
54361,130,58,97,4,5,4,13,Champions
54372,137,5,15,4,1,1,6,Promising
54376,141,12,18,4,3,2,9,Loyal Users
55131,17,38,66,5,4,4,13,Champions
55576,4810,5,17,1,1,2,4,Lost
55840,54,7,20,5,2,2,9,Promising
56148,2274,22,25,1,4,2,7,At Risk
56371,862,23,72,2,4,4,10,At Risk
56384,3190,23,152,1,4,5,10,At Risk
56603,134,42,61,4,4,3,11,Loyal Users
56933,857,20,35,2,3,3,8,Casual Users
57058,238,32,62,3,4,3,10,Loyal Users
57183,1137,12,25,2,3,2,7,Casual Users
57786,229,28,120,3,4,4,11,Loyal Users
57816,124,13,20,4,3,2,9,Loyal Users
58474,2515,7,16,1,2,2,5,Lost
58817,4091,13,24,1,3,2,6,Casual Users
58869,3442,5,5,1,1,1,3,Lost
58913,166,8,32,3,2,3,8,Casual Users
58985,145,11,71,4,2,4,10,Promising
59067,178,16,68,3,3,4,10,Loyal Users
59104,5135,6,11,1,1,1,3,Lost
59246,527,19,46,2,3,3,8,Casual Users
59448,142,25,97,4,4,4,12,Champions
59457,252,17,81,3,3,4,10,Loyal Users
59503,190,9,112,3,2,4,9,Casual Users
59562,116,36,100,4,4,4,12,Champions
59716,1561,5,17,1,1,2,4,Lost
59771,225,5,6,3,1,1,5,Casual Users
59878,1595,22,29,1,4,2,7,At Risk
60385,103,83,198,4,5,5,14,Champions
60853,1723,10,13,1,2,1,4,Lost
61102,104,8,21,4,2,2,8,Promising
61155,1201,16,53,2,3,3,8,Casual Users
61947,275,15,26,3,3,2,8,Loyal Users
61970,613,32,79,2,4,4,10,At Risk
62072,581,9,21,2,2,2,6,Lost
62125,1092,11,32,2,2,3,7,Lost
62263,405,24,55,3,4,3,10,Loyal Users
62467,3592,9,23,1,2,2,5,Lost
62673,1,104,296,5,5,5,15,Champions
62713,38,61,353,5,5,5,15,Champions
63220,166,109,275,3,5,5,13,Loyal Users
63658,1652,7,11,1,2,1,4,Lost
63696,1823,8,22,1,2,2,5,Lost
64019,80,15,120,4,3,4,11,Loyal Users
64363,6,13,31,5,3,2,10,Loyal Users
64535,107,41,208,4,4,5,13,Champions
65013,163,39,184,4,4,5,13,Champions
65086,1083,5,14,2,1,1,4,Lost
52424,18,114,491,5,5,5,15,Champions
52620,23,62,98,5,5,4,14,Champions
52682,2728,9,40,1,2,3,6,Lost
52739,3149,5,6,1,1,1,3,Lost
53127,740,6,20,2,1,2,5,Lost
53344,1537,9,51,1,2,3,6,Lost
53717,95,54,223,4,5,5,14,Champions
53995,4250,5,14,1,1,1,3,Lost
54061,1301,15,32,1,3,3,7,Casual Users
54194,1866,34,147,1,4,5,10,At Risk
54233,1423,10,16,1,2,2,5,Lost
54313,1270,7,9,1,2,1,4,Lost
55398,379,10,27,3,2,2,7,Casual Users
55972,1830,17,25,1,3,2,6,Casual Users
56337,140,138,215,4,5,5,14,Champions
56493,384,8,50,3,2,3,8,Casual Users
56652,112,5,13,4,1,1,6,Promising
56665,420,24,38,3,4,3,10,Loyal Users
57100,19,47,153,5,5,5,15,Champions
57298,3128,16,71,1,3,4,8,Casual Users
57690,30,50,120,5,5,4,14,Champions
57810,93,81,108,4,5,4,13,Champions
58054,976,7,7,2,2,1,5,Lost
58431,2259,8,16,1,2,2,5,Lost
58537,106,74,589,4,5,5,14,Champions
58747,142,116,203,4,5,5,14,Champions
58914,220,21,25,3,3,2,8,Loyal Users
59075,703,6,9,2,1,1,4,Lost
59111,12,59,152,5,5,5,15,Champions
59180,8,44,148,5,4,5,14,Champions
59189,48,12,30,5,3,2,10,Loyal Users
59416,187,82,247,3,5,5,13,Loyal Users
59647,1548,5,36,1,1,3,5,Lost
59666,5212,8,12,1,2,1,4,Lost
59778,290,56,206,3,5,5,13,Loyal Users
59929,2534,15,54,1,3,3,7,Casual Users
60270,131,7,12,4,2,1,7,Promising
60383,133,30,113,4,4,4,12,Champions
60577,730,10,15,2,2,1,5,Lost
60887,580,8,12,2,2,1,5,Lost
61453,29,59,203,5,5,5,15,Champions
61933,417,64,84,3,5,4,12,Loyal Users
62223,908,7,27,2,2,2,6,Lost
62259,180,13,18,3,3,2,8,Loyal Users
62306,401,5,9,3,1,1,5,Casual Users
62434,140,36,50,4,4,3,11,Loyal Users
62781,4409,10,22,1,2,2,5,Lost
62812,1133,52,173,2,5,5,12,At Risk
63016,164,10,20,4,2,2,8,Promising
63382,33,126,478,5,5,5,15,Champions
63458,2959,5,8,1,1,1,3,Lost
63577,869,7,44,2,2,3,7,Lost
63578,130,86,234,4,5,5,14,Champions
63592,77,34,94,4,4,4,12,Champions
63978,959,5,28,2,1,2,5,Lost
64148,235,14,40,3,3,3,9,Loyal Users
64919,251,34,103,3,4,4,11,Loyal Users
64975,14,10,22,5,2,2,9,Promising
65118,174,62,164,3,5,5,13,Loyal Users
52822,246,6,39,3,1,3,7,Casual Users
52829,8,143,675,5,5,5,15,Champions
52984,87,7,11,4,2,1,7,Promising
53784,705,7,33,2,2,3,7,Lost
54042,693,26,118,2,4,4,10,At Risk
54256,916,5,8,2,1,1,4,Lost
54346,250,9,10,3,2,1,6,Casual Users
54500,1569,10,32,1,2,3,6,Lost
54823,357,5,16,3,1,2,6,Casual Users
55035,475,7,34,2,2,3,7,Lost
55049,20,29,60,5,4,3,12,Loyal Users
55704,2746,7,13,1,2,1,4,Lost
55824,2706,7,7,1,2,1,4,Lost
55863,5,10,26,5,2,2,9,Promising
56049,304,11,65,3,2,4,9,Casual Users
56466,15,196,539,5,5,5,15,Champions
56496,1026,19,170,2,3,5,10,Casual Users
56522,42,47,111,5,5,4,14,Champions
56921,180,7,15,3,2,1,6,Casual Users
58302,44,121,407,5,5,5,15,Champions
58436,1643,6,36,1,1,3,5,Lost
58453,1046,13,20,2,3,2,7,Casual Users
58559,95,65,198,4,5,5,14,Champions
58568,678,29,253,2,4,5,11,At Risk
58642,76,45,180,4,4,5,13,Champions
58772,116,15,16,4,3,2,9,Loyal Users
59097,649,14,41,2,3,3,8,Casual Users
59795,12,37,69,5,4,4,13,Champions
60100,847,6,16,2,1,2,5,Lost
60203,68,11,20,5,2,2,9,Promising
60276,504,16,67,2,3,4,9,Casual Users
60382,579,10,23,2,2,2,6,Lost
60815,7,10,44,5,2,3,10,Promising
60938,101,31,60,4,4,3,11,Loyal Users
61224,89,5,5,4,1,1,6,Promising
61234,1440,9,22,1,2,2,5,Lost
61266,54,27,45,5,4,3,12,Loyal Users
61295,700,37,79,2,4,4,10,At Risk
61599,853,13,88,2,3,4,9,Casual Users
61654,680,5,6,2,1,1,4,Lost
61711,1293,8,10,1,2,1,4,Lost
61786,406,5,5,3,1,1,5,Casual Users
61880,3510,32,82,1,4,4,9,At Risk
61924,560,7,7,2,2,1,5,Lost
61958,2542,44,71,1,4,4,9,At Risk
62082,82,44,96,4,4,4,12,Champions
62203,27,25,202,5,4,5,14,Champions
62299,420,26,46,3,4,3,10,Loyal Users
62496,2539,5,13,1,1,1,3,Lost
62727,860,9,34,2,2,3,7,Lost
62771,851,14,22,2,3,2,7,Casual Users
63066,128,112,213,4,5,5,14,Champions
63579,1832,10,31,1,2,2,5,Lost
63835,124,45,68,4,4,4,12,Champions
64374,3572,10,30,1,2,2,5,Lost
64459,70,143,542,4,5,5,14,Champions
64741,695,8,14,2,2,1,5,Lost
64896,2136,6,6,1,1,1,3,Lost
65055,749,17,55,2,3,3,8,Casual Users
65333,97,5,7,4,1,1,6,Promising
52538,738,17,36,2,3,3,8,Casual Users
52573,4587,7,9,1,2,1,4,Lost
52593,100,49,163,4,5,5,14,Champions
52778,78,8,25,4,2,2,8,Promising
53264,278,43,81,3,4,4,11,Loyal Users
53481,0,45,87,5,4,4,13,Champions
53706,459,5,6,3,1,1,5,Casual Users
53845,1799,23,24,1,4,2,7,At Risk
53871,2156,12,14,1,3,1,5,Casual Users
53974,2995,16,60,1,3,3,7,Casual Users
54215,165,6,14,4,1,1,6,Promising
54624,326,33,135,3,4,4,11,Loyal Users
54642,865,40,119,2,4,4,10,At Risk
54896,83,16,48,4,3,3,10,Loyal Users
54938,1368,5,5,1,1,1,3,Lost
55569,23,12,171,5,3,5,13,Loyal Users
55928,373,22,74,3,4,4,11,Loyal Users
56045,1508,16,41,1,3,3,7,Casual Users
56105,585,13,21,2,3,2,7,Casual Users
56551,1605,43,70,1,4,4,9,At Risk
56674,116,114,397,4,5,5,14,Champions
57436,127,28,38,4,4,3,11,Loyal Users
57464,105,34,123,4,4,4,12,Champions
57774,113,13,123,4,3,4,11,Loyal Users
57951,65,45,511,5,4,5,14,Champions
58125,0,73,276,5,5,5,15,Champions
58371,431,65,180,3,5,5,13,Loyal Users
58422,237,19,48,3,3,3,9,Loyal Users
58819,2987,6,29,1,1,2,4,Lost
59178,1238,13,22,2,3,2,7,Casual Users
59496,66,130,584,5,5,5,15,Champions
59823,118,43,73,4,4,4,12,Champions
60097,128,114,261,4,5,5,14,Champions
60297,1123,16,27,2,3,2,7,Casual Users
60474,1213,10,22,2,2,2,6,Lost
60647,118,52,143,4,5,4,13,Champions
60865,143,43,115,4,4,4,12,Champions
60893,1122,29,59,2,4,3,9,At Risk
61491,1296,16,52,1,3,3,7,Casual Users
61559,38,93,283,5,5,5,15,Champions
61693,933,8,16,2,2,2,6,Lost
62564,389,5,12,3,1,1,5,Casual Users
62718,8,42,60,5,4,3,12,Loyal Users
63010,433,28,46,3,4,3,10,Loyal Users
63630,124,82,576,4,5,5,14,Champions
64230,687,11,18,2,2,2,6,Lost
64288,85,66,89,4,5,4,13,Champions
64726,227,17,70,3,3,4,10,Loyal Users
64983,126,74,130,4,5,4,13,Champions
65424,1832,55,99,1,5,4,10,At Risk
52421,846,8,18,2,2,2,6,Lost
52550,4417,5,12,1,1,1,3,Lost
52643,522,131,358,2,5,5,12,At Risk
52732,49,19,42,5,3,3,11,Loyal Users
53159,131,5,24,4,1,2,7,Promising
53208,2253,6,19,1,1,2,4,Lost
53592,711,23,34,2,4,3,9,At Risk
54272,282,33,139,3,4,4,11,Loyal Users
54429,2009,6,9,1,1,1,3,Lost
54734,285,55,147,3,5,5,13,Loyal Users
55075,784,29,155,2,4,5,11,At Risk
55237,975,14,17,2,3,2,7,Casual Users
55748,694,12,20,2,3,2,7,Casual Users
56183,87,61,103,4,5,4,13,Champions
56232,418,6,11,3,1,1,5,Casual Users
56264,11,46,204,5,5,5,15,Champions
56274,746,32,38,2,4,3,9,At Risk
56435,566,27,76,2,4,4,10,At Risk
56512,279,13,57,3,3,3,9,Loyal Users
56769,222,8,15,3,2,1,6,Casual Users
56864,885,12,26,2,3,2,7,Casual Users
56982,139,14,28,4,3,2,9,Loyal Users
57050,2920,9,14,1,2,1,4,Lost
57133,25,38,64,5,4,4,13,Champions
57389,2091,8,25,1,2,2,5,Lost
57851,382,71,108,3,5,4,12,Loyal Users
57866,57,52,129,5,5,4,14,Champions
57868,129,42,73,4,4,4,12,Champions
57919,360,28,63,3,4,4,11,Loyal Users
57965,2191,33,65,1,4,4,9,At Risk
58092,3,35,98,5,4,4,13,Champions
58118,178,14,29,3,3,2,8,Loyal Users
58365,117,49,132,4,5,4,13,Champions
58607,122,24,70,4,4,4,12,Champions
58821,86,12,30,4,3,2,9,Loyal Users
58919,460,167,420,3,5,5,13,Loyal Users
59233,250,48,70,3,5,4,12,Loyal Users
59488,4559,6,55,1,1,3,5,Lost
59515,154,19,33,4,3,3,10,Loyal Users
59561,1923,6,7,1,1,1,3,Lost
59940,67,28,40,5,4,3,12,Loyal Users
60156,120,62,98,4,5,4,13,Champions
60257,250,8,35,3,2,3,8,Casual Users
60627,2615,10,22,1,2,2,5,Lost
60683,2142,9,12,1,2,1,4,Lost
60833,342,25,40,3,4,3,10,Loyal Users
60872,815,8,18,2,2,2,6,Lost
61183,1459,6,12,1,1,1,3,Lost
62562,144,84,330,4,5,5,14,Champions
62752,584,7,13,2,2,1,5,Lost
62948,16,5,34,5,1,3,9,Promising
63094,408,10,15,3,2,1,6,Casual Users
63151,256,22,74,3,4,4,11,Loyal Users
63489,148,22,158,4,4,5,13,Champions
63623,703,8,42,2,2,3,7,Lost
64214,5307,8,13,1,2,1,4,Lost
64474,5,56,255,5,5,5,15,Champions
64622,2300,6,26,1,1,2,4,Lost
64694,358,31,223,3,4,5,12,Loyal Users
64768,35,49,360,5,5,5,15,Champions
65166,1870,8,16,1,2,2,5,Lost
65372,639,6,11,2,1,1,4,Lost
52767,7,80,513,5,5,5,15,Champions
52841,550,26,33,2,4,3,9,At Risk
52858,9,255,606,5,5,5,15,Champions
53578,937,6,21,2,1,2,5,Lost
53988,270,123,377,3,5,5,13,Loyal Users
54046,389,26,45,3,4,3,10,Loyal Users
54282,20,65,288,5,5,5,15,Champions
54353,436,11,13,3,2,1,6,Casual Users
54477,2388,8,17,1,2,2,5,Lost
54923,23,20,93,5,3,4,12,Loyal Users
55356,40,23,59,5,4,3,12,Loyal Users
55600,405,5,5,3,1,1,5,Casual Users
55648,328,18,33,3,3,3,9,Loyal Users
55701,794,10,93,2,2,4,8,Lost
56211,31,21,28,5,3,2,10,Loyal Users
56417,1712,10,73,1,2,4,7,Lost
56425,227,14,31,3,3,2,8,Loyal Users
56451,1550,6,8,1,1,1,3,Lost
56813,281,13,123,3,3,4,10,Loyal Users
57415,155,28,104,4,4,4,12,Champions
57728,4,49,175,5,5,5,15,Champions
57849,850,5,7,2,1,1,4,Lost
57933,367,6,19,3,1,2,6,Casual Users
57994,813,5,5,2,1,1,4,Lost
58491,334,32,121,3,4,4,11,Loyal Users
58538,297,38,131,3,4,4,11,Loyal Users
58752,147,35,170,4,4,5,13,Champions
58802,406,21,26,3,3,2,8,Loyal Users
59146,533,44,54,2,4,3,9,At Risk
59216,54,18,33,5,3,3,11,Loyal Users
59412,2159,16,45,1,3,3,7,Casual Users
59454,301,7,23,3,2,2,7,Casual Users
59459,273,54,86,3,5,4,12,Loyal Users
59548,83,136,764,4,5,5,14,Champions
59555,75,12,31,4,3,2,9,Loyal Users
60325,226,6,9,3,1,1,5,Casual Users
60395,977,6,19,2,1,2,5,Lost
60728,2134,26,34,1,4,3,8,At Risk
61785,706,7,10,2,2,1,5,Lost
61788,130,78,614,4,5,5,14,Champions
61841,861,6,10,2,1,1,4,Lost
62253,75,12,42,4,3,3,10,Loyal Users
62376,998,11,21,2,2,2,6,Lost
62418,337,11,64,3,2,4,9,Casual Users
62504,203,63,73,3,5,4,12,Loyal Users
62605,1808,15,20,1,3,2,6,Casual Users
62966,1,7,13,5,2,1,8,Promising
63074,2191,6,11,1,1,1,3,Lost
63346,514,15,72,2,3,4,9,Casual Users
63413,73,35,75,4,4,4,12,Champions
63697,91,17,47,4,3,3,10,Loyal Users
64435,7,7,13,5,2,1,8,Promising
64524,170,111,173,3,5,5,13,Loyal Users
64550,118,47,127,4,5,4,13,Champions
64800,146,45,194,4,4,5,13,Champions
65044,128,85,411,4,5,5,14,Champions
65147,58,160,380,5,5,5,15,Champions
65196,534,15,109,2,3,4,9,Casual Users
65296,14,25,90,5,4,4,13,Champions
65419,468,41,81,3,4,4,11,Loyal Users
52559,391,17,177,3,3,5,11,Loyal Users
52719,1056,12,20,2,3,2,7,Casual Users
53003,8,26,56,5,4,3,12,Loyal Users
53071,385,14,25,3,3,2,8,Loyal Users
53075,270,38,94,3,4,4,11,Loyal Users
53263,429,86,397,3,5,5,13,Loyal Users
53449,88,72,142,4,5,4,13,Champions
53479,124,27,118,4,4,4,12,Champions
53525,6123,6,14,1,1,1,3,Lost
53762,227,31,165,3,4,5,12,Loyal Users
54321,1864,9,19,1,2,2,5,Lost
54523,262,110,246,3,5,5,13,Loyal Users
55011,1859,5,37,1,1,3,5,Lost
55028,698,20,53,2,3,3,8,Casual Users
55317,10,82,192,5,5,5,15,Champions
55465,3,33,91,5,4,4,13,Champions
55577,73,40,49,4,4,3,11,Loyal Users
56549,188,46,97,3,5,4,12,Loyal Users
57278,408,7,15,3,2,1,6,Casual Users
57453,217,10,22,3,2,2,7,Casual Users
58107,283,39,223,3,4,5,12,Loyal Users
58123,117,68,174,4,5,5,14,Champions
58273,2044,7,34,1,2,3,6,Lost
58442,409,13,35,3,3,3,9,Loyal Users
58643,966,11,27,2,2,2,6,Lost
58971,63,16,27,5,3,2,10,Loyal Users
59081,376,29,41,3,4,3,10,Loyal Users
59198,0,52,369,5,5,5,15,Champions
59409,107,42,83,4,4,4,12,Champions
59522,9,71,150,5,5,5,15,Champions
59692,25,58,143,5,5,4,14,Champions
59712,1203,14,28,2,3,2,7,Casual Users
59821,2155,7,14,1,2,1,4,Lost
59839,4092,21,71,1,3,4,8,Casual Users
59910,728,5,5,2,1,1,4,Lost
59918,1417,10,29,1,2,2,5,Lost
60507,4,15,36,5,3,3,11,Loyal Users
60557,1567,5,9,1,1,1,3,Lost
60623,148,26,108,4,4,4,12,Champions
60834,175,11,22,3,2,2,7,Casual Users
61020,40,56,287,5,5,5,15,Champions
61163,2273,10,29,1,2,2,5,Lost
61361,988,5,14,2,1,1,4,Lost
61378,164,17,27,4,3,2,9,Loyal Users
61449,3,15,22,5,3,2,10,Loyal Users
61622,738,44,234,2,4,5,11,At Risk
61770,223,21,63,3,3,4,10,Loyal Users
61889,88,6,9,4,1,1,6,Promising
62003,4715,8,21,1,2,2,5,Lost
62484,133,58,132,4,5,4,13,Champions
62817,29,78,189,5,5,5,15,Champions
62836,3,18,35,5,3,3,11,Loyal Users
62989,278,49,61,3,5,3,11,Loyal Users
63101,14,195,356,5,5,5,15,Champions
63294,815,51,107,2,5,4,11,At Risk
63312,2096,6,46,1,1,3,5,Lost
63421,290,32,57,3,4,3,10,Loyal Users
63426,1248,9,14,2,2,1,5,Lost
63453,437,23,73,3,4,4,11,Loyal Users
63686,960,15,121,2,3,4,9,Casual Users
64117,5157,22,66,1,4,4,9,At Risk
64166,124,17,42,4,3,3,10,Loyal Users
64291,263,10,46,3,2,3,8,Casual Users
64365,163,32,103,4,4,4,12,Champions
64551,230,16,118,3,3,4,10,Loyal Users
64668,12,69,359,5,5,5,15,Champions
64812,255,23,47,3,4,3,10,Loyal Users
65110,133,26,48,4,4,3,11,Loyal Users
65168,299,15,27,3,3,2,8,Loyal Users
65359,1151,46,124,2,5,4,11,At Risk
52772,14,55,136,5,5,4,14,Champions
52884,1107,21,54,2,3,3,8,Casual Users
53110,2966,5,7,1,1,1,3,Lost
53218,1269,15,25,1,3,2,6,Casual Users
53242,2237,6,10,1,1,1,3,Lost
53294,301,27,61,3,4,3,10,Loyal Users
53591,8,83,221,5,5,5,15,Champions
53876,184,66,186,3,5,5,13,Loyal Users
53969,8,66,179,5,5,5,15,Champions
54000,414,17,31,3,3,2,8,Loyal Users
54050,75,76,216,4,5,5,14,Champions
54108,136,21,115,4,3,4,11,Loyal Users
54614,1464,22,45,1,4,3,8,At Risk
54685,1088,10,10,2,2,1,5,Lost
54719,322,10,19,3,2,2,7,Casual Users
54959,5250,8,16,1,2,2,5,Lost
55219,101,83,475,4,5,5,14,Champions
55550,384,18,184,3,3,5,11,Loyal Users
55742,237,13,35,3,3,3,9,Loyal Users
56121,54,97,212,5,5,5,15,Champions
56214,20,33,143,5,4,4,13,Champions
56351,127,61,262,4,5,5,14,Champions
56375,576,9,48,2,2,3,7,Lost
56716,272,15,82,3,3,4,10,Loyal Users
57060,30,159,524,5,5,5,15,Champions
57126,5,28,57,5,4,3,12,Loyal Users
57210,215,9,12,3,2,1,6,Casual Users
57271,446,13,22,3,3,2,8,Loyal Users
57395,41,105,545,5,5,5,15,Champions
57759,84,9,12,4,2,1,7,Promising
57969,422,5,11,3,1,1,5,Casual Users
58001,83,12,17,4,3,2,9,Loyal Users
58004,24,112,679,5,5,5,15,Champions
58382,5,10,29,5,2,2,9,Promising
58687,165,18,27,4,3,2,9,Loyal Users
58718,138,37,143,4,4,4,12,Champions
58816,4277,5,10,1,1,1,3,Lost
58876,2083,5,14,1,1,1,3,Lost
59330,504,57,81,2,5,4,11,At Risk
59838,9,84,324,5,5,5,15,Champions
59891,922,8,20,2,2,2,6,Lost
60024,119,21,132,4,3,4,11,Loyal Users
60055,153,8,31,4,2,2,8,Promising
60081,138,8,12,4,2,1,7,Promising
60195,548,10,30,2,2,2,6,Lost
60277,244,16,21,3,3,2,8,Loyal Users
60306,239,42,115,3,4,4,11,Loyal Users
60718,832,18,40,2,3,3,8,Casual Users
60766,13,34,52,5,4,3,12,Loyal Users
60771,678,6,9,2,1,1,4,Lost
60864,304,27,70,3,4,4,11,Loyal Users
61158,1096,9,49,2,2,3,7,Lost
61328,9,7,21,5,2,2,9,Promising
61813,5,69,126,5,5,4,14,Champions
61825,3534,16,57,1,3,3,7,Casual Users
62328,1148,5,8,2,1,1,4,Lost
62583,1076,6,24,2,1,2,5,Lost
62705,281,7,24,3,2,2,7,Casual Users
62791,92,10,39,4,2,3,9,Promising
62884,144,19,123,4,3,4,11,Loyal Users
63093,273,100,137,3,5,4,12,Loyal Users
63142,1152,7,45,2,2,3,7,Lost
63534,28,164,722,5,5,5,15,Champions
63768,118,21,32,4,3,3,10,Loyal Users
63818,174,20,39,3,3,3,9,Loyal Users
64608,309,5,6,3,1,1,5,Casual Users
64838,580,6,7,2,1,1,4,Lost
64842,134,42,94,4,4,4,12,Champions
65219,23,51,168,5,5,5,15,Champions
65330,174,23,29,3,4,2,9,Loyal Users
52453,688,7,16,2,2,2,6,Lost
52578,133,36,40,4,4,3,11,Loyal Users
52608,147,35,190,4,4,5,13,Champions
53048,2803,7,41,1,2,3,6,Lost
53175,73,73,94,4,5,4,13,Champions
53290,2389,29,71,1,4,4,9,At Risk
53334,126,68,180,4,5,5,14,Champions
53371,358,6,12,3,1,1,5,Casual Users
53597,2243,42,72,1,4,4,9,At Risk
53603,407,62,109,3,5,4,12,Loyal Users
54186,35,7,9,5,2,1,8,Promising
54439,133,47,140,4,5,4,13,Champions
54504,4986,10,12,1,2,1,4,Lost
54524,122,6,26,4,1,2,7,Promising
54644,133,29,46,4,4,3,11,Loyal Users
54713,13,113,235,5,5,5,15,Champions
54770,26,10,23,5,2,2,9,Promising
54784,837,19,90,2,3,4,9,Casual Users
55152,105,29,50,4,4,3,11,Loyal Users
55509,94,30,158,4,4,5,13,Champions
55579,0,101,383,5,5,5,15,Champions
56219,5,101,330,5,5,5,15,Champions
56266,608,42,61,2,4,3,9,At Risk
56309,697,73,182,2,5,5,12,At Risk
56410,949,30,91,2,4,4,10,At Risk
56678,5,36,66,5,4,4,13,Champions
56851,957,7,18,2,2,2,6,Lost
57028,5138,30,70,1,4,4,9,At Risk
57251,129,5,7,4,1,1,6,Promising
57273,676,8,14,2,2,1,5,Lost
57274,3842,7,9,1,2,1,4,Lost
57284,98,46,97,4,5,4,13,Champions
57490,1358,7,7,1,2,1,4,Lost
57659,104,18,92,4,3,4,11,Loyal Users
57661,2081,6,13,1,1,1,3,Lost
57742,86,11,58,4,2,3,9,Promising
57779,3286,7,7,1,2,1,4,Lost
57831,692,94,143,2,5,4,11,At Risk
57895,3039,45,77,1,4,4,9,At Risk
58548,152,31,89,4,4,4,12,Champions
58574,290,33,99,3,4,4,11,Loyal Users
59552,426,36,112,3,4,4,11,Loyal Users
59564,19,48,66,5,5,4,14,Champions
59575,179,11,39,3,2,3,8,Casual Users
59701,117,17,200,4,3,5,12,Loyal Users
60231,3588,5,17,1,1,2,4,Lost
60244,246,31,85,3,4,4,11,Loyal Users
60480,1508,6,20,1,1,2,4,Lost
60598,21,53,112,5,5,4,14,Champions
60640,1025,46,438,2,5,5,12,At Risk
60645,33,36,121,5,4,4,13,Champions
60842,41,139,233,5,5,5,15,Champions
61010,74,69,83,4,5,4,13,Champions
61145,8,165,353,5,5,5,15,Champions
61385,20,12,23,5,3,2,10,Loyal Users
61508,316,21,69,3,3,4,10,Loyal Users
61537,1086,6,16,2,1,2,5,Lost
62043,339,30,92,3,4,4,11,Loyal Users
62647,508,43,140,2,4,4,10,At Risk
62741,297,9,17,3,2,2,7,Casual Users
63007,843,10,27,2,2,2,6,Lost
63025,1251,7,18,2,2,2,6,Lost
63090,151,16,72,4,3,4,11,Loyal Users
63323,1121,6,24,2,1,2,5,Lost
63392,149,32,78,4,4,4,12,Champions
63492,3383,9,10,1,2,1,4,Lost
63501,419,20,47,3,3,3,9,Loyal Users
63726,1147,15,42,2,3,3,8,Casual Users
63867,4727,5,47,1,1,3,5,Lost
63937,3834,69,162,1,5,5,11,At Risk
64612,363,18,79,3,3,4,10,Loyal Users
64770,1405,43,241,1,4,5,10,At Risk
52362,408,114,426,3,5,5,13,Loyal Users
52388,76,31,37,4,4,3,11,Loyal Users
52634,839,33,303,2,4,5,11,At Risk
53291,3285,17,32,1,3,3,7,Casual Users
53734,406,5,5,3,1,1,5,Casual Users
53735,1187,63,250,2,5,5,12,At Risk
53987,405,62,133,3,5,4,12,Loyal Users
54013,472,18,24,2,3,2,7,Casual Users
54244,262,39,74,3,4,4,11,Loyal Users
54357,491,29,62,2,4,3,9,At Risk
54415,2762,9,11,1,2,1,4,Lost
54549,46,10,21,5,2,2,9,Promising
54570,661,5,7,2,1,1,4,Lost
54687,390,7,8,3,2,1,6,Casual Users
55313,357,6,15,3,1,1,5,Casual Users
55706,426,8,25,3,2,2,7,Casual Users
55815,2402,17,56,1,3,3,7,Casual Users
55871,146,8,26,4,2,2,8,Promising
55995,132,13,28,4,3,2,9,Loyal Users
56245,3434,5,8,1,1,1,3,Lost
56280,124,54,100,4,5,4,13,Champions
56308,428,6,21,3,1,2,6,Casual Users
56600,405,22,48,3,4,3,10,Loyal Users
56766,1727,7,71,1,2,4,7,Lost
57051,249,20,74,3,3,4,10,Loyal Users
57176,174,26,37,3,4,3,10,Loyal Users
57279,5538,5,17,1,1,2,4,Lost
57322,2410,9,13,1,2,1,4,Lost
57664,0,64,205,5,5,5,15,Champions
57696,2437,6,8,1,1,1,3,Lost
57833,1352,13,66,1,3,4,8,Casual Users
57988,387,15,82,3,3,4,10,Loyal Users
58070,248,59,387,3,5,5,13,Loyal Users
58166,137,140,320,4,5,5,14,Champions
58577,5122,9,28,1,2,2,5,Lost
58812,844,6,40,2,1,3,6,Lost
59353,21,99,432,5,5,5,15,Champions
59439,195,5,13,3,1,1,5,Casual Users
59837,1136,13,18,2,3,2,7,Casual Users
60005,78,7,8,4,2,1,7,Promising
60305,32,75,122,5,5,4,14,Champions
60625,295,25,31,3,4,2,9,Loyal Users
60803,3290,44,160,1,4,5,10,At Risk
60824,159,42,138,4,4,4,12,Champions
60980,326,18,125,3,3,4,10,Loyal Users
61165,3653,9,9,1,2,1,4,Lost
61169,979,109,296,2,5,5,12,At Risk
61609,3,23,45,5,4,3,12,Loyal Users
61637,7,11,11,5,2,1,8,Promising
62416,115,18,28,4,3,2,9,Loyal Users
62954,992,5,7,2,1,1,4,Lost
63368,430,28,55,3,4,3,10,Loyal Users
63403,822,15,56,2,3,3,8,Casual Users
63411,827,9,11,2,2,1,5,Lost
63451,19,57,80,5,5,4,14,Champions
63597,10,49,182,5,5,5,15,Champions
63913,2956,6,13,1,1,1,3,Lost
64033,279,5,5,3,1,1,5,Casual Users
64245,1685,34,116,1,4,4,9,At Risk
64317,394,12,32,3,3,3,9,Loyal Users
64534,133,5,5,4,1,1,6,Promising
65099,405,25,68,3,4,4,11,Loyal Users
52599,28,193,390,5,5,5,15,Champions
53095,5,44,68,5,4,4,13,Champions
53349,2564,6,10,1,1,1,3,Lost
53363,82,31,110,4,4,4,12,Champions
53416,967,10,25,2,2,2,6,Lost
53486,239,14,77,3,3,4,10,Loyal Users
53544,1180,7,15,2,2,1,5,Lost
53757,15,105,186,5,5,5,15,Champions
53782,421,21,40,3,3,3,9,Loyal Users
54106,25,46,138,5,5,4,14,Champions
54187,32,36,64,5,4,4,13,Champions
54440,2,8,18,5,2,2,9,Promising
54487,1,34,389,5,4,5,14,Champions
54785,127,153,233,4,5,5,14,Champions
55193,380,8,13,3,2,1,6,Casual Users
55259,130,30,51,4,4,3,11,Loyal Users
55709,107,52,203,4,5,5,14,Champions
55750,128,42,152,4,4,5,13,Champions
55810,452,20,33,3,3,3,9,Loyal Users
56217,6,49,101,5,5,4,14,Champions
56285,55,28,54,5,4,3,12,Loyal Users
56570,2501,17,23,1,3,2,6,Casual Users
56583,92,14,18,4,3,2,9,Loyal Users
56993,731,12,60,2,3,3,8,Casual Users
57314,282,88,299,3,5,5,13,Loyal Users
57542,2158,19,65,1,3,4,8,Casual Users
57981,48,19,72,5,3,4,12,Loyal Users
58030,495,25,48,2,4,3,9,At Risk
58345,1590,10,10,1,2,1,4,Lost
58483,593,10,24,2,2,2,6,Lost
58649,1424,13,34,1,3,3,7,Casual Users
58846,834,18,138,2,3,4,9,Casual Users
58949,1116,10,14,2,2,1,5,Lost
58961,565,5,6,2,1,1,4,Lost
59218,2955,5,9,1,1,1,3,Lost
59324,38,73,422,5,5,5,15,Champions
59351,727,30,107,2,4,4,10,At Risk
59427,231,20,43,3,3,3,9,Loyal Users
59799,15,86,143,5,5,4,14,Champions
59915,9,103,612,5,5,5,15,Champions
60219,11,71,147,5,5,5,15,Champions
60247,101,19,51,4,3,3,10,Loyal Users
60742,456,51,158,3,5,5,13,Loyal Users
60789,248,10,19,3,2,2,7,Casual Users
61354,2320,11,18,1,2,2,5,Lost
61413,124,81,241,4,5,5,14,Champions
61584,116,24,124,4,4,4,12,Champions
61953,1798,21,176,1,3,5,9,Casual Users
62004,96,39,129,4,4,4,12,Champions
62055,230,23,54,3,4,3,10,Loyal Users
62059,133,9,180,4,2,5,11,Promising
62061,0,117,211,5,5,5,15,Champions
62099,2720,11,13,1,2,1,4,Lost
62402,985,47,172,2,5,5,12,At Risk
62559,569,7,25,2,2,2,6,Lost
62682,1425,6,16,1,1,2,4,Lost
62691,547,50,180,2,5,5,12,At Risk
62699,285,12,38,3,3,3,9,Loyal Users
63447,1990,6,23,1,1,2,4,Lost
63530,2283,11,17,1,2,2,5,Lost
63900,857,25,144,2,4,4,10,At Risk
64015,123,11,19,4,2,2,8,Promising
64266,21,30,75,5,4,4,13,Champions
64351,3513,5,5,1,1,1,3,Lost
64411,26,36,52,5,4,3,12,Loyal Users
65405,14,75,474,5,5,5,15,Champions
52435,154,12,25,4,3,2,9,Loyal Users
52447,271,27,72,3,4,4,11,Loyal Users
52455,691,8,16,2,2,2,6,Lost
52519,202,5,7,3,1,1,5,Casual Users
52638,3,202,374,5,5,5,15,Champions
52640,279,35,442,3,4,5,12,Loyal Users
52723,2919,9,68,1,2,4,7,Lost
53052,4328,18,26,1,3,2,6,Casual Users
53133,2789,8,29,1,2,2,5,Lost
53179,327,19,82,3,3,4,10,Loyal Users
53458,738,18,26,2,3,2,7,Casual Users
53879,6,6,14,5,1,1,7,Promising
54242,112,6,13,4,1,1,6,Promising
54331,68,153,213,5,5,5,15,Champions
54660,13,10,52,5,2,3,10,Promising
55528,73,36,89,4,4,4,12,Champions
56102,226,60,162,3,5,5,13,Loyal Users
56131,512,37,106,2,4,4,10,At Risk
56764,590,8,26,2,2,2,6,Lost
56981,13,95,564,5,5,5,15,Champions
57766,45,68,217,5,5,5,15,Champions
58058,1302,12,31,1,3,2,6,Casual Users
58104,1497,35,73,1,4,4,9,At Risk
58455,84,40,279,4,4,5,13,Champions
58837,162,39,49,4,4,3,11,Loyal Users
59003,427,7,14,3,2,1,6,Casual Users
59272,129,12,78,4,3,4,11,Loyal Users
59440,14,176,400,5,5,5,15,Champions
59816,5870,5,8,1,1,1,3,Lost
60160,12,10,14,5,2,1,8,Promising
60191,77,34,60,4,4,3,11,Loyal Users
60498,109,28,37,4,4,3,11,Loyal Users
60527,376,24,175,3,4,5,12,Loyal Users
60904,1004,12,63,2,3,4,9,Casual Users
61118,2378,8,9,1,2,1,4,Lost
61237,393,11,39,3,2,3,8,Casual Users
61272,1413,5,22,1,1,2,4,Lost
61283,8,120,227,5,5,5,15,Champions
61358,70,79,256,4,5,5,14,Champions
61604,4424,6,21,1,1,2,4,Lost
61800,146,28,31,4,4,2,10,Loyal Users
61920,505,33,71,2,4,4,10,At Risk
62555,114,138,225,4,5,5,14,Champions
62813,135,50,117,4,5,4,13,Champions
62816,249,6,17,3,1,2,6,Casual Users
63161,423,15,68,3,3,4,10,Loyal Users
63266,55,228,339,5,5,5,15,Champions
63358,3460,6,11,1,1,1,3,Lost
63546,3289,5,7,1,1,1,3,Lost
63682,406,13,61,3,3,3,9,Loyal Users
63778,1269,8,25,1,2,2,5,Lost
63801,1030,119,341,2,5,5,12,At Risk
63931,257,108,335,3,5,5,13,Loyal Users
64226,5122,32,51,1,4,3,8,At Risk
64254,559,16,31,2,3,2,7,Casual Users
64368,2006,5,35,1,1,3,5,Lost
64413,329,9,54,3,2,3,8,Casual Users
64497,423,28,56,3,4,3,10,Loyal Users
64753,267,42,292,3,4,5,12,Loyal Users
64860,88,68,193,4,5,5,14,Champions
64940,860,11,20,2,2,2,6,Lost
65192,278,12,29,3,3,2,8,Loyal Users
65233,19,198,244,5,5,5,15,Champions
65269,1951,9,18,1,2,2,5,Lost
65283,1834,5,48,1,1,3,5,Lost
65291,512,13,54,2,3,3,8,Casual Users
52662,319,23,63,3,4,4,11,Loyal Users
52913,2,9,9,5,2,1,8,Promising
52952,241,8,29,3,2,2,7,Casual Users
53300,12,125,225,5,5,5,15,Champions
53417,0,19,35,5,3,3,11,Loyal Users
53712,308,5,5,3,1,1,5,Casual Users
53752,3,44,124,5,4,4,13,Champions
53874,1264,6,14,1,1,1,3,Lost
54393,110,22,54,4,4,3,11,Loyal Users
54424,3276,7,10,1,2,1,4,Lost
54598,414,17,25,3,3,2,8,Loyal Users
54944,16,49,148,5,5,5,15,Champions
55027,3414,5,12,1,1,1,3,Lost
55269,12,11,15,5,2,1,8,Promising
55346,277,20,60,3,3,3,9,Loyal Users
55503,574,8,21,2,2,2,6,Lost
55642,1555,7,10,1,2,1,4,Lost
55668,410,109,155,3,5,5,13,Loyal Users
55994,685,31,92,2,4,4,10,At Risk
56012,1428,6,9,1,1,1,3,Lost
56016,240,52,197,3,5,5,13,Loyal Users
56579,14,102,220,5,5,5,15,Champions
56727,1135,27,95,2,4,4,10,At Risk
56731,2136,16,20,1,3,2,6,Casual Users
56882,17,78,438,5,5,5,15,Champions
57276,544,36,76,2,4,4,10,At Risk
57329,719,12,29,2,3,2,7,Casual Users
57725,159,9,19,4,2,2,8,Promising
57738,34,60,107,5,5,4,14,Champions
57934,52,34,38,5,4,3,12,Loyal Users
58433,274,28,228,3,4,5,12,Loyal Users
58550,1487,6,17,1,1,2,4,Lost
58659,52,165,558,5,5,5,15,Champions
59030,62,18,37,5,3,3,11,Loyal Users
59368,19,16,20,5,3,2,10,Loyal Users
59476,1,160,317,5,5,5,15,Champions
59792,178,95,269,3,5,5,13,Loyal Users
59913,211,59,357,3,5,5,13,Loyal Users
59934,136,15,44,4,3,3,10,Loyal Users
60039,586,17,167,2,3,5,10,Casual Users
60182,418,20,215,3,3,5,11,Loyal Users
60293,1004,19,23,2,3,2,7,Casual Users
60381,37,53,361,5,5,5,15,Champions
60402,477,13,38,2,3,3,8,Casual Users
60658,129,23,59,4,4,3,11,Loyal Users
60840,234,50,219,3,5,5,13,Loyal Users
60926,20,16,38,5,3,3,11,Loyal Users
61032,9,22,141,5,4,4,13,Champions
61059,33,10,21,5,2,2,9,Promising
61174,163,8,44,4,2,3,9,Promising
61212,2,15,30,5,3,2,10,Loyal Users
61223,2476,6,19,1,1,2,4,Lost
61320,172,83,419,3,5,5,13,Loyal Users
61444,461,36,82,3,4,4,11,Loyal Users
61514,1844,37,60,1,4,3,8,At Risk
61628,156,31,172,4,4,5,13,Champions
61664,74,34,168,4,4,5,13,Champions
61865,716,43,58,2,4,3,9,At Risk
62021,318,18,23,3,3,2,8,Loyal Users
62397,416,18,50,3,3,3,9,Loyal Users
62456,101,22,62,4,4,3,11,Loyal Users
63091,135,58,119,4,5,4,13,Champions
63235,1856,22,128,1,4,4,9,At Risk
63236,105,35,227,4,4,5,13,Champions
63310,18,20,43,5,3,3,11,Loyal Users
63509,259,15,37,3,3,3,9,Loyal Users
63866,5,131,171,5,5,5,15,Champions
63934,226,16,38,3,3,3,9,Loyal Users
63981,234,72,125,3,5,4,12,Loyal Users
64006,616,8,9,2,2,1,5,Lost
64072,2265,7,8,1,2,1,4,Lost
64095,698,5,11,2,1,1,4,Lost
64223,952,7,14,2,2,1,5,Lost
64267,126,45,322,4,4,5,13,Champions
64294,750,9,10,2,2,1,5,Lost
64309,1741,9,10,1,2,1,4,Lost
64637,130,48,126,4,5,4,13,Champions
64882,688,5,5,2,1,1,4,Lost
65363,2359,16,32,1,3,3,7,Casual Users
52562,719,10,65,2,2,4,8,Lost
52980,139,53,145,4,5,4,13,Champions
53046,131,7,8,4,2,1,7,Promising
53397,115,12,17,4,3,2,9,Loyal Users
53504,124,16,49,4,3,3,10,Loyal Users
53833,640,20,38,2,3,3,8,Casual Users
53862,304,33,92,3,4,4,11,Loyal Users
54010,1126,6,10,2,1,1,4,Lost
54240,3451,7,7,1,2,1,4,Lost
54671,1881,7,9,1,2,1,4,Lost
54726,644,17,74,2,3,4,9,Casual Users
55120,1676,6,14,1,1,1,3,Lost
55141,262,13,39,3,3,3,9,Loyal Users
55314,31,36,122,5,4,4,13,Champions
55629,859,10,11,2,2,1,5,Lost
55683,1852,10,15,1,2,1,4,Lost
55703,130,42,173,4,4,5,13,Champions
55785,1020,12,33,2,3,3,8,Casual Users
56305,257,5,15,3,1,1,5,Casual Users
57012,123,194,485,4,5,5,14,Champions
57179,2,122,299,5,5,5,15,Champions
57972,519,10,47,2,2,3,7,Lost
58778,281,21,43,3,3,3,9,Loyal Users
58950,132,6,40,4,1,3,8,Promising
59084,279,22,60,3,4,3,10,Loyal Users
59145,460,50,85,3,5,4,12,Loyal Users
59161,172,17,93,3,3,4,10,Loyal Users
60155,4429,44,136,1,4,4,9,At Risk
60245,589,46,137,2,5,4,11,At Risk
60369,158,31,64,4,4,4,12,Champions
60525,2090,36,150,1,4,5,10,At Risk
60665,136,13,27,4,3,2,9,Loyal Users
61077,99,29,71,4,4,4,12,Champions
61112,28,46,124,5,5,4,14,Champions
61188,7,66,199,5,5,5,15,Champions
61510,608,7,8,2,2,1,5,Lost
61513,148,8,16,4,2,2,8,Promising
61774,803,7,26,2,2,2,6,Lost
61987,3083,8,13,1,2,1,4,Lost
62379,589,7,20,2,2,2,6,Lost
62447,16,26,129,5,4,4,13,Champions
62899,4,69,216,5,5,5,15,Champions
63485,121,70,530,4,5,5,14,Champions
63602,239,96,384,3,5,5,13,Loyal Users
63743,134,51,140,4,5,4,13,Champions
63805,135,20,72,4,3,4,11,Loyal Users
64112,102,18,50,4,3,3,10,Loyal Users
64177,174,7,21,3,2,2,7,Casual Users
64307,1153,11,11,2,2,1,5,Lost
64447,165,5,27,4,1,2,7,Promising
64739,101,11,29,4,2,2,8,Promising
52571,637,25,33,2,4,3,9,At Risk
52627,141,17,129,4,3,4,11,Loyal Users
53145,692,15,117,2,3,4,9,Casual Users
53548,360,9,18,3,2,2,7,Casual Users
53873,89,43,208,4,4,5,13,Champions
54520,34,27,112,5,4,4,13,Champions
54692,66,12,28,5,3,2,10,Loyal Users
54773,30,105,651,5,5,5,15,Champions
54949,396,31,78,3,4,4,11,Loyal Users
54952,1674,14,23,1,3,2,6,Casual Users
55230,81,16,35,4,3,3,10,Loyal Users
55416,265,21,83,3,3,4,10,Loyal Users
56155,115,35,132,4,4,4,12,Champions
56529,160,7,93,4,2,4,10,Promising
56880,1627,5,10,1,1,1,3,Lost
56979,2841,8,9,1,2,1,4,Lost
57287,106,32,78,4,4,4,12,Champions
57289,726,23,60,2,4,3,9,At Risk
57324,154,10,15,4,2,1,7,Promising
57926,3235,16,19,1,3,2,6,Casual Users
58130,101,72,430,4,5,5,14,Champions
58318,160,33,120,4,4,4,12,Champions
58430,424,41,102,3,4,4,11,Loyal Users
58555,71,34,85,4,4,4,12,Champions
59193,146,15,48,4,3,3,10,Loyal Users
59267,287,9,17,3,2,2,7,Casual Users
59868,2678,14,18,1,3,2,6,Casual Users
60600,740,11,34,2,2,3,7,Lost
60643,265,29,125,3,4,4,11,Loyal Users
60737,15,182,379,5,5,5,15,Champions
60780,394,28,145,3,4,4,11,Loyal Users
60859,5016,12,25,1,3,2,6,Casual Users
60935,1366,6,23,1,1,2,4,Lost
60985,86,10,27,4,2,2,8,Promising
61168,441,24,206,3,4,5,12,Loyal Users
61305,134,49,112,4,5,4,13,Champions
62038,2215,7,10,1,2,1,4,Lost
62291,1126,13,37,2,3,3,8,Casual Users
62546,1148,15,36,2,3,3,8,Casual Users
62599,31,39,154,5,4,5,14,Champions
62832,157,93,229,4,5,5,14,Champions
62955,69,56,361,5,5,5,15,Champions
63203,180,7,15,3,2,1,6,Casual Users
63204,1834,20,78,1,3,4,8,Casual Users
63441,6,201,742,5,5,5,15,Champions
63575,1139,43,82,2,4,4,10,At Risk
63664,1841,8,39,1,2,3,6,Lost
64003,343,14,14,3,3,1,7,Loyal Users
64138,1746,9,23,1,2,2,5,Lost
64560,553,6,12,2,1,1,4,Lost
64649,20,108,258,5,5,5,15,Champions
65268,117,67,304,4,5,5,14,Champions
65400,997,37,157,2,4,5,11,At Risk
52462,245,18,33,3,3,3,9,Loyal Users
52583,320,20,170,3,3,5,11,Loyal Users
52930,312,9,61,3,2,3,8,Casual Users
53177,27,28,44,5,4,3,12,Loyal Users
53209,807,14,47,2,3,3,8,Casual Users
53221,718,6,11,2,1,1,4,Lost
53538,247,16,48,3,3,3,9,Loyal Users
53552,2,23,82,5,4,4,13,Champions
53975,122,10,16,4,2,2,8,Promising
54116,254,35,83,3,4,4,11,Loyal Users
54129,16,15,32,5,3,3,11,Loyal Users
54130,420,9,11,3,2,1,6,Casual Users
54221,72,77,337,4,5,5,14,Champions
54777,702,22,26,2,4,2,8,At Risk
54898,26,28,63,5,4,4,13,Champions
55128,1139,6,32,2,1,3,6,Lost
55488,2965,7,10,1,2,1,4,Lost
56354,97,39,51,4,4,3,11,Loyal Users
56390,1,30,126,5,4,4,13,Champions
56455,4392,10,13,1,2,1,4,Lost
56474,3084,7,31,1,2,2,5,Lost
56479,1337,12,67,1,3,4,8,Casual Users
56528,821,8,14,2,2,1,5,Lost
56567,339,8,8,3,2,1,6,Casual Users
56630,64,22,34,5,4,3,12,Loyal Users
57272,225,32,79,3,4,4,11,Loyal Users
57368,39,18,48,5,3,3,11,Loyal Users
57571,1143,13,25,2,3,2,7,Casual Users
57600,0,18,88,5,3,4,12,Loyal Users
57652,450,7,8,3,2,1,6,Casual Users
57855,108,8,18,4,2,2,8,Promising
58098,283,54,146,3,5,4,12,Loyal Users
58114,119,46,73,4,5,4,13,Champions
58243,2115,5,65,1,1,4,6,Lost
58257,1318,5,32,1,1,3,5,Lost
58343,2410,7,34,1,2,3,6,Lost
58804,5635,7,32,1,2,3,6,Lost
59274,113,147,604,4,5,5,14,Champions
59817,88,33,109,4,4,4,12,Champions
59914,2360,6,7,1,1,1,3,Lost
60173,1369,44,165,1,4,5,10,At Risk
60208,825,5,12,2,1,1,4,Lost
60358,843,28,45,2,4,3,9,At Risk
60621,1593,18,36,1,3,3,7,Casual Users
60783,79,147,203,4,5,5,14,Champions
60807,3283,7,21,1,2,2,5,Lost
61217,3151,7,27,1,2,2,5,Lost
61238,421,55,313,3,5,5,13,Loyal Users
61289,1651,15,16,1,3,2,6,Casual Users
61308,1038,21,53,2,3,3,8,Casual Users
61398,17,10,22,5,2,2,9,Promising
62073,134,135,355,4,5,5,14,Champions
62106,158,40,84,4,4,4,12,Champions
62354,0,42,123,5,4,4,13,Champions
62363,82,94,208,4,5,5,14,Champions
62399,1715,9,12,1,2,1,4,Lost
62826,1116,11,28,2,2,2,6,Lost
62993,4920,23,70,1,4,4,9,At Risk
63021,3034,6,9,1,1,1,3,Lost
63676,2282,9,18,1,2,2,5,Lost
63944,135,9,9,4,2,1,7,Promising
63969,1953,10,28,1,2,2,5,Lost
64349,709,7,32,2,2,3,7,Lost
64399,694,22,35,2,4,3,9,At Risk
64606,501,8,28,2,2,2,6,Lost
65066,1108,42,73,2,4,4,10,At Risk
65234,0,70,353,5,5,5,15,Champions
65256,314,7,35,3,2,3,8,Casual Users
52446,411,19,25,3,3,2,8,Loyal Users
52488,159,7,25,4,2,2,8,Promising
52792,3093,146,263,1,5,5,11,At Risk
52820,1077,11,43,2,2,3,7,Lost
52919,262,38,59,3,4,3,10,Loyal Users
53174,3,7,17,5,2,2,9,Promising
53219,258,13,26,3,3,2,8,Loyal Users
53465,838,9,30,2,2,2,6,Lost
53601,2237,10,40,1,2,3,6,Lost
53687,497,54,126,2,5,4,11,At Risk
53690,136,11,31,4,2,2,8,Promising
54159,830,18,57,2,3,3,8,Casual Users
54238,1414,17,98,1,3,4,8,Casual Users
54545,81,21,39,4,3,3,10,Loyal Users
54717,50,29,124,5,4,4,13,Champions
54752,53,43,173,5,4,5,14,Champions
55124,416,5,13,3,1,1,5,Casual Users
55247,1,44,261,5,4,5,14,Champions
55250,2402,18,22,1,3,2,6,Casual Users
55500,26,8,28,5,2,2,9,Promising
55890,3276,17,34,1,3,3,7,Casual Users
56177,281,36,179,3,4,5,12,Loyal Users
56447,411,32,40,3,4,3,10,Loyal Users
56635,255,52,177,3,5,5,13,Loyal Users
56742,725,7,11,2,2,1,5,Lost
57180,3558,22,51,1,4,3,8,At Risk
57307,93,21,61,4,3,3,10,Loyal Users
57431,28,100,816,5,5,5,15,Champions
57846,141,139,531,4,5,5,14,Champions
57865,43,52,214,5,5,5,15,Champions
58278,278,68,132,3,5,4,12,Loyal Users
58630,331,7,84,3,2,4,9,Casual Users
58721,354,48,149,3,5,5,13,Loyal Users
59504,594,13,27,2,3,2,7,Casual Users
59573,125,15,72,4,3,4,11,Loyal Users
59862,1265,9,22,1,2,2,5,Lost
59939,90,79,244,4,5,5,14,Champions
60004,143,53,80,4,5,4,13,Champions
60161,122,12,43,4,3,3,10,Loyal Users
60284,419,6,12,3,1,1,5,Casual Users
60334,831,9,40,2,2,3,7,Lost
60359,1421,11,16,1,2,2,5,Lost
60456,996,13,28,2,3,2,7,Casual Users
60889,1146,12,15,2,3,1,6,Casual Users
61215,114,133,687,4,5,5,14,Champions
61297,949,13,23,2,3,2,7,Casual Users
61386,1280,30,187,1,4,5,10,At Risk
61395,111,92,278,4,5,5,14,Champions
61573,7,34,117,5,4,4,13,Champions
61621,140,5,5,4,1,1,6,Promising
61683,824,21,45,2,3,3,8,Casual Users
62037,3625,7,12,1,2,1,4,Lost
62047,24,84,295,5,5,5,15,Champions
62092,123,54,212,4,5,5,14,Champions
62459,699,6,15,2,1,1,4,Lost
62575,285,28,41,3,4,3,10,Loyal Users
62841,127,38,68,4,4,4,12,Champions
63012,917,12,43,2,3,3,8,Casual Users
63288,278,19,54,3,3,3,9,Loyal Users
63535,720,7,17,2,2,2,6,Lost
63547,1862,8,15,1,2,1,4,Lost
63713,1702,5,7,1,1,1,3,Lost
63724,5032,5,38,1,1,3,5,Lost
63779,59,46,303,5,5,5,15,Champions
63986,1008,18,22,2,3,2,7,Casual Users
64357,72,10,21,4,2,2,8,Promising
64487,2426,11,35,1,2,3,6,Lost
64605,2,110,251,5,5,5,15,Champions
65111,71,19,38,4,3,3,10,Loyal Users
65354,3556,8,17,1,2,2,5,Lost
52729,488,9,13,2,2,1,5,Lost
52765,287,53,348,3,5,5,13,Loyal Users
52849,1201,15,63,2,3,4,9,Casual Users
52888,3527,8,18,1,2,2,5,Lost
52914,2582,6,21,1,1,2,4,Lost
53377,2568,6,7,1,1,1,3,Lost
53435,1802,16,102,1,3,4,8,Casual Users
54024,9,14,146,5,3,4,12,Loyal Users
54255,1717,14,85,1,3,4,8,Casual Users
54473,413,44,69,3,4,4,11,Loyal Users
54541,19,83,431,5,5,5,15,Champions
54986,1647,9,23,1,2,2,5,Lost
55612,41,128,524,5,5,5,15,Champions
55670,260,10,24,3,2,2,7,Casual Users
55794,5725,7,54,1,2,3,6,Lost
56019,642,11,20,2,2,2,6,Lost
56130,81,35,251,4,4,5,13,Champions
56342,132,18,48,4,3,3,10,Loyal Users
56433,158,15,37,4,3,3,10,Loyal Users
56637,257,24,70,3,4,4,11,Loyal Users
57104,1992,7,12,1,2,1,4,Lost
57168,357,6,33,3,1,3,7,Casual Users
57259,291,6,7,3,1,1,5,Casual Users
57482,284,19,41,3,3,3,9,Loyal Users
57840,2874,6,7,1,1,1,3,Lost
57894,1970,12,14,1,3,1,5,Casual Users
58223,83,10,49,4,2,3,9,Promising
58328,3880,5,7,1,1,1,3,Lost
58565,40,24,168,5,4,5,14,Champions
58573,399,7,15,3,2,1,6,Casual Users
58595,5007,11,11,1,2,1,4,Lost
58674,441,21,66,3,3,4,10,Loyal Users
58757,69,117,583,5,5,5,15,Champions
59108,669,32,56,2,4,3,9,At Risk
59438,1395,9,19,1,2,2,5,Lost
60094,105,10,45,4,2,3,9,Promising
60398,544,8,35,2,2,3,7,Lost
60454,389,11,39,3,2,3,8,Casual Users
60522,242,33,127,3,4,4,11,Loyal Users
60528,107,19,35,4,3,3,10,Loyal Users
60724,3125,7,28,1,2,2,5,Lost
60877,1273,9,12,1,2,1,4,Lost
61128,97,17,58,4,3,3,10,Loyal Users
61611,1808,7,7,1,2,1,4,Lost
61657,240,41,175,3,4,5,12,Loyal Users
61728,859,11,23,2,2,2,6,Lost
61737,425,6,15,3,1,1,5,Casual Users
62117,681,5,24,2,1,2,5,Lost
62123,2121,8,22,1,2,2,5,Lost
62348,82,22,30,4,4,2,10,Loyal Users
63139,101,38,423,4,4,5,13,Champions
63148,284,5,5,3,1,1,5,Casual Users
63463,4377,16,61,1,3,3,7,Casual Users
63515,44,71,184,5,5,5,15,Champions
64182,1738,6,31,1,1,2,4,Lost
64212,414,7,12,3,2,1,6,Casual Users
64369,294,5,11,3,1,1,5,Casual Users
64588,30,70,87,5,5,4,14,Champions
64688,674,7,83,2,2,4,8,Lost
65004,226,7,22,3,2,2,7,Casual Users
65082,1220,6,24,2,1,2,5,Lost
65367,516,59,174,2,5,5,12,At Risk
52441,3585,8,12,1,2,1,4,Lost
52466,24,67,104,5,5,4,14,Champions
52766,241,34,81,3,4,4,11,Loyal Users
52897,1412,5,15,1,1,1,3,Lost
53296,138,24,80,4,4,4,12,Champions
53468,134,48,77,4,5,4,13,Champions
53475,38,45,106,5,4,4,13,Champions
53492,261,5,24,3,1,2,6,Casual Users
53616,175,5,11,3,1,1,5,Casual Users
53726,50,83,471,5,5,5,15,Champions
53780,0,72,225,5,5,5,15,Champions
54002,1575,7,12,1,2,1,4,Lost
54434,70,175,684,4,5,5,14,Champions
54446,17,176,537,5,5,5,15,Champions
54455,120,9,95,4,2,4,10,Promising
54592,2193,13,33,1,3,3,7,Casual Users
54838,233,48,300,3,5,5,13,Loyal Users
54850,698,24,42,2,4,3,9,At Risk
54963,409,21,40,3,3,3,9,Loyal Users
55129,695,9,55,2,2,3,7,Lost
55226,83,45,240,4,4,5,13,Champions
55492,127,40,73,4,4,4,12,Champions
55714,7,7,36,5,2,3,10,Promising
55867,277,5,18,3,1,2,6,Casual Users
56178,13,110,308,5,5,5,15,Champions
56610,5566,9,21,1,2,2,5,Lost
56644,73,59,273,4,5,5,14,Champions
56847,289,7,19,3,2,2,7,Casual Users
57086,15,45,105,5,4,4,13,Champions
57217,531,10,36,2,2,3,7,Lost
57386,260,86,183,3,5,5,13,Loyal Users
57559,1976,5,6,1,1,1,3,Lost
57654,626,29,53,2,4,3,9,At Risk
57852,1925,5,8,1,1,1,3,Lost
57882,5658,7,11,1,2,1,4,Lost
58225,110,23,127,4,4,4,12,Champions
58300,161,13,122,4,3,4,11,Loyal Users
58838,30,118,242,5,5,5,15,Champions
59087,542,21,38,2,3,3,8,Casual Users
59337,76,61,157,4,5,5,14,Champions
59617,2030,13,15,1,3,1,5,Casual Users
59739,56,33,42,5,4,3,12,Loyal Users
59829,136,55,133,4,5,4,13,Champions
59922,526,20,46,2,3,3,8,Casual Users
60183,403,65,173,3,5,5,13,Loyal Users
60304,1279,20,40,1,3,3,7,Casual Users
60460,23,59,160,5,5,5,15,Champions
60624,117,7,12,4,2,1,7,Promising
60751,696,21,63,2,3,4,9,Casual Users
60993,1812,6,8,1,1,1,3,Lost
61276,699,20,46,2,3,3,8,Casual Users
61298,252,45,281,3,4,5,12,Loyal Users
61337,1425,30,89,1,4,4,9,At Risk
61412,389,14,29,3,3,2,8,Loyal Users
61787,18,105,143,5,5,4,14,Champions
61792,69,9,21,5,2,2,9,Promising
62208,1259,7,23,1,2,2,5,Lost
62491,2295,64,102,1,5,4,10,At Risk
62645,63,30,49,5,4,3,12,Loyal Users
62769,706,12,19,2,3,2,7,Casual Users
62814,942,9,12,2,2,1,5,Lost
62815,1,134,393,5,5,5,15,Champions
62975,1241,7,17,2,2,2,6,Lost
63262,63,143,366,5,5,5,15,Champions
63394,869,5,10,2,1,1,4,Lost
63612,3462,26,48,1,4,3,8,At Risk
63637,67,15,48,5,3,3,11,Loyal Users
63671,253,78,132,3,5,4,12,Loyal Users
64113,1010,7,17,2,2,2,6,Lost
64493,309,7,15,3,2,1,6,Casual Users
64496,10,28,100,5,4,4,13,Champions
64531,32,37,60,5,4,3,12,Loyal Users
65058,73,19,19,4,3,2,9,Loyal Users
65113,273,19,29,3,3,2,8,Loyal Users
52469,546,30,250,2,4,5,11,At Risk
52965,417,15,33,3,3,3,9,Loyal Users
53212,1669,5,12,1,1,1,3,Lost
53594,148,30,64,4,4,4,12,Champions
54181,110,32,60,4,4,3,11,Loyal Users
55170,1267,11,29,1,2,2,5,Lost
55949,101,44,95,4,4,4,12,Champions
56050,101,16,54,4,3,3,10,Loyal Users
56165,108,71,388,4,5,5,14,Champions
56176,96,5,8,4,1,1,6,Promising
56373,147,24,25,4,4,2,10,Loyal Users
56523,5561,11,11,1,2,1,4,Lost
56604,128,17,95,4,3,4,11,Loyal Users
56869,20,34,67,5,4,4,13,Champions
56959,2303,14,42,1,3,3,7,Casual Users
57147,44,23,40,5,4,3,12,Loyal Users
57326,141,16,62,4,3,3,10,Loyal Users
57724,225,89,256,3,5,5,13,Loyal Users
57891,3818,17,24,1,3,2,6,Casual Users
58063,7,33,268,5,4,5,14,Champions
58128,1106,8,15,2,2,1,5,Lost
58400,2539,8,27,1,2,2,5,Lost
58625,97,126,269,4,5,5,14,Champions
58762,408,14,19,3,3,2,8,Loyal Users
59289,2181,8,47,1,2,3,6,Lost
59346,3738,5,13,1,1,1,3,Lost
59510,42,48,70,5,5,4,14,Champions
59559,79,100,342,4,5,5,14,Champions
59590,20,74,473,5,5,5,15,Champions
59630,1505,16,37,1,3,3,7,Casual Users
59664,402,8,19,3,2,2,7,Casual Users
60008,840,23,41,2,4,3,9,At Risk
60253,1042,16,32,2,3,3,8,Casual Users
60591,18,73,168,5,5,5,15,Champions
60739,98,20,125,4,3,4,11,Loyal Users
60880,96,56,212,4,5,5,14,Champions
61187,440,19,48,3,3,3,9,Loyal Users
61210,1832,8,16,1,2,2,5,Lost
61235,457,48,242,3,5,5,13,Loyal Users
61758,134,16,111,4,3,4,11,Loyal Users
62656,91,17,24,4,3,2,9,Loyal Users
62738,2230,18,20,1,3,2,6,Casual Users
63239,38,52,145,5,5,4,14,Champions
63269,135,6,19,4,1,2,7,Promising
63564,46,87,339,5,5,5,15,Champions
63580,1304,11,105,1,2,4,7,Lost
63668,120,95,424,4,5,5,14,Champions
63929,136,13,55,4,3,3,10,Loyal Users
64191,66,43,108,5,4,4,13,Champions
64293,2900,5,10,1,1,1,3,Lost
64345,226,19,78,3,3,4,10,Loyal Users
64372,3,117,316,5,5,5,15,Champions
64778,695,5,6,2,1,1,4,Lost
64829,2128,19,61,1,3,3,7,Casual Users
64958,863,45,73,2,4,4,10,At Risk
65096,1717,24,47,1,4,3,8,At Risk
65140,21,15,42,5,3,3,11,Loyal Users
52425,458,6,89,3,1,4,8,Casual Users
52896,20,130,235,5,5,5,15,Champions
52899,114,10,34,4,2,3,9,Promising
52940,26,75,164,5,5,5,15,Champions
53038,250,9,14,3,2,1,6,Casual Users
53109,2826,5,11,1,1,1,3,Lost
53482,98,155,271,4,5,5,14,Champions
53827,376,23,39,3,4,3,10,Loyal Users
53850,1003,7,27,2,2,2,6,Lost
54152,2,12,12,5,3,1,9,Loyal Users
54771,1392,12,24,1,3,2,6,Casual Users
55264,2152,11,21,1,2,2,5,Lost
55730,672,11,20,2,2,2,6,Lost
55837,75,57,89,4,5,4,13,Champions
55851,848,13,23,2,3,2,7,Casual Users
55870,703,11,17,2,2,2,6,Lost
55892,417,17,66,3,3,4,10,Loyal Users
55970,1425,7,20,1,2,2,5,Lost
56039,61,67,97,5,5,4,14,Champions
56243,148,5,14,4,1,1,6,Promising
56301,16,21,48,5,3,3,11,Loyal Users
56460,109,41,117,4,4,4,12,Champions
57090,104,19,39,4,3,3,10,Loyal Users
57111,1523,6,12,1,1,1,3,Lost
57130,238,13,29,3,3,2,8,Loyal Users
57171,123,10,20,4,2,2,8,Promising
57181,73,103,204,4,5,5,14,Champions
57239,3390,7,12,1,2,1,4,Lost
57432,884,7,18,2,2,2,6,Lost
57479,675,15,25,2,3,2,7,Casual Users
57539,930,15,38,2,3,3,8,Casual Users
57692,117,16,60,4,3,3,10,Loyal Users
57914,282,5,7,3,1,1,5,Casual Users
58188,1363,11,95,1,2,4,7,Lost
58435,1141,7,83,2,2,4,8,Lost
58564,832,64,262,2,5,5,12,At Risk
58716,1002,10,23,2,2,2,6,Lost
59473,19,29,70,5,4,4,13,Champions
59521,1711,5,13,1,1,1,3,Lost
59570,5431,5,12,1,1,1,3,Lost
59808,578,12,15,2,3,1,6,Casual Users
59890,133,40,123,4,4,4,12,Champions
59928,1168,29,78,2,4,4,10,At Risk
60060,433,105,188,3,5,5,13,Loyal Users
60217,1963,14,65,1,3,4,8,Casual Users
60720,2837,7,7,1,2,1,4,Lost
61124,139,69,420,4,5,5,14,Champions
61206,1598,12,13,1,3,1,5,Casual Users
61271,48,108,217,5,5,5,15,Champions
61700,2102,6,17,1,1,2,4,Lost
61848,31,12,13,5,3,1,9,Loyal Users
61870,1935,8,41,1,2,3,6,Lost
61892,45,50,217,5,5,5,15,Champions
61957,1573,25,50,1,4,3,8,At Risk
61961,406,21,36,3,3,3,9,Loyal Users
62101,3240,10,58,1,2,3,6,Lost
62655,173,16,23,3,3,2,8,Loyal Users
63000,2,49,271,5,5,5,15,Champions
63362,2545,8,9,1,2,1,4,Lost
63400,55,102,171,5,5,5,15,Champions
63638,458,27,43,3,4,3,10,Loyal Users
63720,2,5,9,5,1,1,7,Promising
63975,1440,13,19,1,3,2,6,Casual Users
64280,167,31,103,3,4,4,11,Loyal Users
64451,3,77,245,5,5,5,15,Champions
64453,99,31,43,4,4,3,11,Loyal Users
64978,2559,10,22,1,2,2,5,Lost
52399,6,96,251,5,5,5,15,Champions
52871,834,10,17,2,2,2,6,Lost
53224,0,36,176,5,4,5,14,Champions
53526,886,10,10,2,2,1,5,Lost
53572,1101,17,98,2,3,4,9,Casual Users
53875,511,8,14,2,2,1,5,Lost
53980,180,12,41,3,3,3,9,Loyal Users
54268,272,8,16,3,2,2,7,Casual Users
54297,251,25,104,3,4,4,11,Loyal Users
54305,1094,5,22,2,1,2,5,Lost
54587,806,11,24,2,2,2,6,Lost
54601,469,15,42,3,3,3,9,Loyal Users
54602,1828,6,25,1,1,2,4,Lost
54966,1373,8,9,1,2,1,4,Lost
55031,67,30,128,5,4,4,13,Champions
55042,52,74,270,5,5,5,15,Champions
55109,531,40,110,2,4,4,10,At Risk
55451,699,13,36,2,3,3,8,Casual Users
55514,348,34,94,3,4,4,11,Loyal Users
55650,14,46,54,5,5,3,13,Loyal Users
55659,854,6,28,2,1,2,5,Lost
55943,2039,6,8,1,1,1,3,Lost
56071,12,74,155,5,5,5,15,Champions
56265,1170,6,16,2,1,2,5,Lost
56348,3573,7,12,1,2,1,4,Lost
56498,133,6,10,4,1,1,6,Promising
56822,789,65,166,2,5,5,12,At Risk
57223,148,18,26,4,3,2,9,Loyal Users
57505,46,74,319,5,5,5,15,Champions
57834,31,164,394,5,5,5,15,Champions
58062,4444,5,5,1,1,1,3,Lost
58348,165,14,48,4,3,3,10,Loyal Users
58720,166,12,54,3,3,3,9,Loyal Users
58967,383,16,48,3,3,3,9,Loyal Users
59082,382,8,9,3,2,1,6,Casual Users
59435,1042,5,11,2,1,1,4,Lost
59603,273,42,231,3,4,5,12,Loyal Users
59683,794,5,7,2,1,1,4,Lost
59964,379,78,108,3,5,4,12,Loyal Users
60189,248,12,12,3,3,1,7,Loyal Users
60554,388,28,56,3,4,3,10,Loyal Users
60688,64,13,132,5,3,4,12,Loyal Users
60749,50,7,9,5,2,1,8,Promising
60947,1852,22,70,1,4,4,9,At Risk
61003,36,23,50,5,4,3,12,Loyal Users
61192,84,10,28,4,2,2,8,Promising
61536,204,27,275,3,4,5,12,Loyal Users
61594,160,22,281,4,4,5,13,Champions
62086,164,77,398,4,5,5,14,Champions
62466,17,71,438,5,5,5,15,Champions
62739,565,30,112,2,4,4,10,At Risk
62751,8,39,179,5,4,5,14,Champions
62774,305,8,23,3,2,2,7,Casual Users
62818,133,25,50,4,4,3,11,Loyal Users
62822,112,30,93,4,4,4,12,Champions
63027,4106,5,12,1,1,1,3,Lost
63124,120,23,57,4,4,3,11,Loyal Users
63407,34,75,265,5,5,5,15,Champions
63436,272,19,31,3,3,2,8,Loyal Users
63495,4605,5,26,1,1,2,4,Lost
63496,330,24,82,3,4,4,11,Loyal Users
63764,827,13,37,2,3,3,8,Casual Users
63842,875,15,35,2,3,3,8,Casual Users
63948,367,5,21,3,1,2,6,Casual Users
64165,118,86,237,4,5,5,14,Champions
64326,1501,6,11,1,1,1,3,Lost
64573,391,9,18,3,2,2,7,Casual Users
65204,8,61,80,5,5,4,14,Champions
52588,2608,7,14,1,2,1,4,Lost
52804,235,66,227,3,5,5,13,Loyal Users
52873,846,12,37,2,3,3,8,Casual Users
52917,12,73,176,5,5,5,15,Champions
53699,52,70,200,5,5,5,15,Champions
53863,538,17,21,2,3,2,7,Casual Users
53921,175,54,124,3,5,4,12,Loyal Users
54205,15,27,82,5,4,4,13,Champions
54360,228,34,125,3,4,4,11,Loyal Users
55374,865,8,11,2,2,1,5,Lost
55425,253,8,32,3,2,3,8,Casual Users
55511,780,14,69,2,3,4,9,Casual Users
55763,111,65,207,4,5,5,14,Champions
55838,279,8,10,3,2,1,6,Casual Users
55913,1061,38,91,2,4,4,10,At Risk
55938,218,7,11,3,2,1,6,Casual Users
55959,1411,22,59,1,4,3,8,At Risk
56175,403,13,37,3,3,3,9,Loyal Users
56324,1136,9,19,2,2,2,6,Lost
56388,1740,21,178,1,3,5,9,Casual Users
56398,248,31,73,3,4,4,11,Loyal Users
56641,837,18,41,2,3,3,8,Casual Users
56660,2543,6,23,1,1,2,4,Lost
56992,137,8,19,4,2,2,8,Promising
57118,670,7,9,2,2,1,5,Lost
57224,129,12,74,4,3,4,11,Loyal Users
57483,439,32,184,3,4,5,12,Loyal Users
57841,88,96,247,4,5,5,14,Champions
57858,9,74,134,5,5,4,14,Champions
58094,191,80,226,3,5,5,13,Loyal Users
58113,4,118,673,5,5,5,15,Champions
58237,146,54,146,4,5,4,13,Champions
58329,189,18,38,3,3,3,9,Loyal Users
58353,119,76,113,4,5,4,13,Champions
58494,273,25,118,3,4,4,11,Loyal Users
58652,272,31,114,3,4,4,11,Loyal Users
58713,2112,5,7,1,1,1,3,Lost
59147,44,34,41,5,4,3,12,Loyal Users
59441,166,51,245,3,5,5,13,Loyal Users
59474,568,19,35,2,3,3,8,Casual Users
60101,975,26,63,2,4,4,10,At Risk
60588,136,34,57,4,4,3,11,Loyal Users
60839,102,115,340,4,5,5,14,Champions
60950,2125,16,44,1,3,3,7,Casual Users
61011,662,7,11,2,2,1,5,Lost
61734,134,39,44,4,4,3,11,Loyal Users
61862,942,9,9,2,2,1,5,Lost
62261,106,15,29,4,3,2,9,Loyal Users
62679,181,16,49,3,3,3,9,Loyal Users
63097,198,30,109,3,4,4,11,Loyal Users
63137,4131,7,7,1,2,1,4,Lost
63299,256,16,19,3,3,2,8,Loyal Users
63552,116,31,92,4,4,4,12,Champions
63751,410,57,66,3,5,4,12,Loyal Users
63766,260,24,137,3,4,4,11,Loyal Users
64057,2430,6,13,1,1,1,3,Lost
64562,699,5,9,2,1,1,4,Lost
64585,432,12,23,3,3,2,8,Loyal Users
64681,266,28,86,3,4,4,11,Loyal Users
64714,56,148,510,5,5,5,15,Champions
64885,16,11,18,5,2,2,9,Promising
64932,528,51,95,2,5,4,11,At Risk
65011,117,24,45,4,4,3,11,Loyal Users
65165,511,52,84,2,5,4,11,At Risk
65213,705,5,5,2,1,1,4,Lost
52825,71,15,127,4,3,4,11,Loyal Users
53183,300,31,73,3,4,4,11,Loyal Users
53644,2341,6,10,1,1,1,3,Lost
54089,71,29,119,4,4,4,12,Champions
54229,5019,9,43,1,2,3,6,Lost
54239,1,48,245,5,5,5,15,Champions
54526,288,22,63,3,4,4,11,Loyal Users
54641,3130,5,5,1,1,1,3,Lost
54778,1144,5,11,2,1,1,4,Lost
54851,527,19,27,2,3,2,7,Casual Users
54956,420,12,17,3,3,2,8,Loyal Users
55026,213,9,17,3,2,2,7,Casual Users
55376,131,11,28,4,2,2,8,Promising
55437,684,16,152,2,3,5,10,Casual Users
55455,1149,15,25,2,3,2,7,Casual Users
55484,715,10,22,2,2,2,6,Lost
55883,1097,9,95,2,2,4,8,Lost
56571,455,24,55,3,4,3,10,Loyal Users
57570,539,12,27,2,3,2,7,Casual Users
58955,2723,7,7,1,2,1,4,Lost
58992,549,12,34,2,3,3,8,Casual Users
59020,2,54,267,5,5,5,15,Champions
59117,306,6,7,3,1,1,5,Casual Users
59207,105,28,152,4,4,5,13,Champions
59314,18,52,257,5,5,5,15,Champions
59357,2587,7,14,1,2,1,4,Lost
59900,2813,5,18,1,1,2,4,Lost
60249,31,17,101,5,3,4,12,Loyal Users
60597,18,97,463,5,5,5,15,Champions
60848,467,40,99,3,4,4,11,Loyal Users
61108,1693,22,62,1,4,3,8,At Risk
61574,424,5,11,3,1,1,5,Casual Users
61643,7,108,604,5,5,5,15,Champions
61835,1724,5,6,1,1,1,3,Lost
61858,112,46,264,4,5,5,14,Champions
61905,529,8,20,2,2,2,6,Lost
62102,2391,8,12,1,2,1,4,Lost
62250,11,94,246,5,5,5,15,Champions
62381,74,101,249,4,5,5,14,Champions
62660,3682,6,9,1,1,1,3,Lost
62777,4419,12,46,1,3,3,7,Casual Users
63037,1407,7,51,1,2,3,6,Lost
63121,255,14,21,3,3,2,8,Loyal Users
63253,4870,18,41,1,3,3,7,Casual Users
63470,34,63,157,5,5,5,15,Champions
63850,1732,9,11,1,2,1,4,Lost
64592,225,9,19,3,2,2,7,Casual Users
64650,71,20,35,4,3,3,10,Loyal Users
64719,90,17,40,4,3,3,10,Loyal Users
65131,415,15,43,3,3,3,9,Loyal Users
65348,858,22,48,2,4,3,9,At Risk
65368,52,61,171,5,5,5,15,Champions
52444,420,8,9,3,2,1,6,Casual Users
52463,1304,13,27,1,3,2,6,Casual Users
53022,846,43,102,2,4,4,10,At Risk
53029,449,5,7,3,1,1,5,Casual Users
53151,6,148,384,5,5,5,15,Champions
53231,2211,10,71,1,2,4,7,Lost
53877,266,6,12,3,1,1,5,Casual Users
54023,304,33,186,3,4,5,12,Loyal Users
54145,140,13,76,4,3,4,11,Loyal Users
54204,412,7,7,3,2,1,6,Casual Users
54546,716,8,16,2,2,2,6,Lost
54817,0,75,216,5,5,5,15,Champions
55100,1162,33,83,2,4,4,10,At Risk
55257,6117,11,20,1,2,2,5,Lost
56294,706,6,8,2,1,1,4,Lost
56672,118,55,175,4,5,5,14,Champions
57518,3,37,74,5,4,4,13,Champions
57546,189,101,226,3,5,5,13,Loyal Users
57735,470,10,116,3,2,4,9,Casual Users
57878,964,10,85,2,2,4,8,Lost
58006,1817,14,16,1,3,2,6,Casual Users
58080,133,13,23,4,3,2,9,Loyal Users
58192,446,9,18,3,2,2,7,Casual Users
58229,911,8,8,2,2,1,5,Lost
58232,298,5,8,3,1,1,5,Casual Users
58908,566,11,21,2,2,2,6,Lost
59177,40,103,271,5,5,5,15,Champions
59237,66,13,54,5,3,3,11,Loyal Users
59527,1,30,49,5,4,3,12,Loyal Users
59736,34,52,124,5,5,4,14,Champions
60003,243,5,9,3,1,1,5,Casual Users
60038,0,46,142,5,5,4,14,Champions
60509,569,6,26,2,1,2,5,Lost
61096,20,25,103,5,4,4,13,Champions
61564,395,6,19,3,1,2,6,Casual Users
61581,319,30,66,3,4,4,11,Loyal Users
62103,694,31,154,2,4,5,11,At Risk
62309,890,19,39,2,3,3,8,Casual Users
62535,400,29,56,3,4,3,10,Loyal Users
62611,9,90,849,5,5,5,15,Champions
62614,3836,7,7,1,2,1,4,Lost
62728,116,46,90,4,5,4,13,Champions
63221,1635,13,46,1,3,3,7,Casual Users
63223,901,17,36,2,3,3,8,Casual Users
63233,220,11,46,3,2,3,8,Casual Users
63359,13,55,102,5,5,4,14,Champions
63791,143,63,334,4,5,5,14,Champions
63827,1559,68,126,1,5,4,10,At Risk
64205,38,138,187,5,5,5,15,Champions
64219,220,5,17,3,1,2,6,Casual Users
64483,2181,5,17,1,1,2,4,Lost
64725,424,5,6,3,1,1,5,Casual Users
64843,415,12,32,3,3,3,9,Loyal Users
64962,84,9,16,4,2,2,8,Promising
65047,426,15,175,3,3,5,11,Loyal Users
65235,2052,15,39,1,3,3,7,Casual Users
65253,19,9,10,5,2,1,8,Promising
52775,2679,5,6,1,1,1,3,Lost
53108,68,54,166,5,5,5,15,Champions
53241,233,56,215,3,5,5,13,Loyal Users
53251,230,17,70,3,3,4,10,Loyal Users
53703,649,34,73,2,4,4,10,At Risk
53795,98,18,80,4,3,4,11,Loyal Users
54276,3,36,255,5,4,5,14,Champions
54432,36,15,20,5,3,2,10,Loyal Users
54465,50,64,240,5,5,5,15,Champions
55058,1243,5,6,2,1,1,4,Lost
55460,4734,5,15,1,1,1,3,Lost
55478,1136,6,7,2,1,1,4,Lost
55595,1468,6,11,1,1,1,3,Lost
55720,1513,8,8,1,2,1,4,Lost
55802,269,14,132,3,3,4,10,Loyal Users
55813,430,10,17,3,2,2,7,Casual Users
55924,19,18,24,5,3,2,10,Loyal Users
56041,296,40,70,3,4,4,11,Loyal Users
56198,78,32,126,4,4,4,12,Champions
56407,123,33,153,4,4,5,13,Champions
56928,2963,7,8,1,2,1,4,Lost
57463,427,9,16,3,2,2,7,Casual Users
57626,2223,5,7,1,1,1,3,Lost
58148,136,234,409,4,5,5,14,Champions
58150,44,121,334,5,5,5,15,Champions
58234,38,166,275,5,5,5,15,Champions
58241,935,9,12,2,2,1,5,Lost
58466,2411,18,45,1,3,3,7,Casual Users
58673,716,18,34,2,3,3,8,Casual Users
59166,117,10,24,4,2,2,8,Promising
59187,737,10,12,2,2,1,5,Lost
59196,2126,12,33,1,3,3,7,Casual Users
59582,1274,5,5,1,1,1,3,Lost
59589,916,6,22,2,1,2,5,Lost
59678,121,8,30,4,2,2,8,Promising
59750,430,84,411,3,5,5,13,Loyal Users
59755,277,41,90,3,4,4,11,Loyal Users
60428,1569,8,17,1,2,2,5,Lost
60576,159,95,233,4,5,5,14,Champions
60696,76,26,127,4,4,4,12,Champions
60706,2548,14,51,1,3,3,7,Casual Users
60805,126,56,81,4,5,4,13,Champions
60891,3024,15,16,1,3,2,6,Casual Users
60928,27,42,112,5,4,4,13,Champions
61014,5,19,53,5,3,3,11,Loyal Users
61220,3613,27,60,1,4,3,8,At Risk
61225,5,71,172,5,5,5,15,Champions
61239,290,8,15,3,2,1,6,Casual Users
61620,91,11,18,4,2,2,8,Promising
61842,0,13,41,5,3,3,11,Loyal Users
61918,1087,5,8,2,1,1,4,Lost
61923,321,9,17,3,2,2,7,Casual Users
62201,241,19,23,3,3,2,8,Loyal Users
62222,408,8,42,3,2,3,8,Casual Users
62471,1136,14,72,2,3,4,9,Casual Users
62502,938,8,9,2,2,1,5,Lost
62619,214,67,182,3,5,5,13,Loyal Users
62823,418,20,49,3,3,3,9,Loyal Users
62928,0,61,196,5,5,5,15,Champions
62929,114,7,22,4,2,2,8,Promising
63014,154,10,30,4,2,2,8,Promising
63071,1003,7,9,2,2,1,5,Lost
63422,16,32,93,5,4,4,13,Champions
63627,416,48,129,3,5,4,12,Loyal Users
63646,8,35,120,5,4,4,13,Champions
63730,2474,7,12,1,2,1,4,Lost
63870,121,6,10,4,1,1,6,Promising
63893,144,39,136,4,4,4,12,Champions
63917,60,118,419,5,5,5,15,Champions
64074,151,67,312,4,5,5,14,Champions
64631,1108,5,100,2,1,4,7,Lost
65043,305,19,40,3,3,3,9,Loyal Users
65212,230,5,21,3,1,2,6,Casual Users
52652,0,102,345,5,5,5,15,Champions
52773,37,50,146,5,5,4,14,Champions
52846,845,9,14,2,2,1,5,Lost
52864,835,11,12,2,2,1,5,Lost
53267,292,5,10,3,1,1,5,Casual Users
53589,19,73,257,5,5,5,15,Champions
53662,176,29,146,3,4,4,11,Loyal Users
53760,61,33,88,5,4,4,13,Champions
54101,881,14,116,2,3,4,9,Casual Users
54381,1285,6,7,1,1,1,3,Lost
54591,620,19,34,2,3,3,8,Casual Users
54650,126,121,538,4,5,5,14,Champions
54772,2003,16,65,1,3,4,8,Casual Users
54939,580,14,15,2,3,1,6,Casual Users
55029,1,201,377,5,5,5,15,Champions
55258,672,12,18,2,3,2,7,Casual Users
55338,2427,6,25,1,1,2,4,Lost
55490,26,118,395,5,5,5,15,Champions
55637,23,96,342,5,5,5,15,Champions
55698,86,8,15,4,2,1,7,Promising
55835,511,22,30,2,4,2,8,At Risk
55858,395,6,10,3,1,1,5,Casual Users
56226,65,6,26,5,1,2,8,Promising
56288,132,63,162,4,5,5,14,Champions
56327,1411,22,27,1,4,2,7,At Risk
56361,827,14,23,2,3,2,7,Casual Users
56780,301,9,16,3,2,2,7,Casual Users
56929,1100,14,40,2,3,3,8,Casual Users
57053,2482,8,17,1,2,2,5,Lost
57092,546,20,40,2,3,3,8,Casual Users
57187,7,44,169,5,4,5,14,Champions
57594,158,9,23,4,2,2,8,Promising
57973,167,10,12,3,2,1,6,Casual Users
58013,299,31,91,3,4,4,11,Loyal Users
58053,269,44,201,3,4,5,12,Loyal Users
58987,103,17,29,4,3,2,9,Loyal Users
59100,1692,11,11,1,2,1,4,Lost
59392,122,164,469,4,5,5,14,Champions
59785,37,107,296,5,5,5,15,Champions
59840,325,13,25,3,3,2,8,Loyal Users
60207,24,22,50,5,4,3,12,Loyal Users
60913,1271,38,120,1,4,4,9,At Risk
61197,425,5,43,3,1,3,7,Casual Users
61659,3037,5,80,1,1,4,6,Lost
61807,0,29,40,5,4,3,12,Loyal Users
61960,2981,7,43,1,2,3,6,Lost
61968,14,99,152,5,5,5,15,Champions
61977,1169,12,16,2,3,2,7,Casual Users
62153,108,55,145,4,5,4,13,Champions
62229,140,79,248,4,5,5,14,Champions
62333,495,12,12,2,3,1,6,Casual Users
62419,102,11,13,4,2,1,7,Promising
62485,285,34,84,3,4,4,11,Loyal Users
62588,2,31,45,5,4,3,12,Loyal Users
62666,404,36,93,3,4,4,11,Loyal Users
62957,1688,6,27,1,1,2,4,Lost
63216,1235,30,84,2,4,4,10,At Risk
63521,691,26,36,2,4,3,9,At Risk
63573,12,143,436,5,5,5,15,Champions
63605,626,23,210,2,4,5,11,At Risk
63741,240,47,223,3,5,5,13,Loyal Users
63765,3369,7,7,1,2,1,4,Lost
64156,34,109,301,5,5,5,15,Champions
64274,1838,18,21,1,3,2,6,Casual Users
64660,19,117,279,5,5,5,15,Champions
64689,2,27,101,5,4,4,13,Champions
64804,2552,21,35,1,3,3,7,Casual Users
64898,572,5,12,2,1,1,4,Lost
65001,118,44,74,4,4,4,12,Champions
52786,145,13,19,4,3,2,9,Loyal Users
52796,2,63,216,5,5,5,15,Champions
52933,260,8,35,3,2,3,8,Casual Users
53047,4840,14,18,1,3,2,6,Casual Users
53062,241,62,200,3,5,5,13,Loyal Users
53162,2703,8,20,1,2,2,5,Lost
53287,784,11,38,2,2,3,7,Lost
53724,3,5,19,5,1,2,8,Promising
53970,206,13,80,3,3,4,10,Loyal Users
54406,2420,5,9,1,1,1,3,Lost
54739,721,11,17,2,2,2,6,Lost
54822,95,111,309,4,5,5,14,Champions
55176,42,9,29,5,2,2,9,Promising
55209,36,50,132,5,5,4,14,Champions
55275,279,112,178,3,5,5,13,Loyal Users
55287,463,13,113,3,3,4,10,Loyal Users
55830,1927,6,20,1,1,2,4,Lost
55900,2833,5,12,1,1,1,3,Lost
55993,412,23,86,3,4,4,11,Loyal Users
56778,725,25,210,2,4,5,11,At Risk
56900,440,18,33,3,3,3,9,Loyal Users
57343,214,32,61,3,4,3,10,Loyal Users
57367,829,10,39,2,2,3,7,Lost
57581,335,6,14,3,1,1,5,Casual Users
57952,298,5,15,3,1,1,5,Casual Users
58228,2857,7,19,1,2,2,5,Lost
58414,509,31,71,2,4,4,10,At Risk
58440,52,8,23,5,2,2,9,Promising
58783,2404,6,17,1,1,2,4,Lost
58904,731,18,139,2,3,4,9,Casual Users
59566,271,48,98,3,5,4,12,Loyal Users
59606,4093,6,9,1,1,1,3,Lost
59650,1638,9,81,1,2,4,7,Lost
59996,6,46,87,5,5,4,14,Champions
60027,30,79,248,5,5,5,15,Champions
60559,128,30,64,4,4,4,12,Champions
60760,1123,10,26,2,2,2,6,Lost
61245,255,57,207,3,5,5,13,Loyal Users
61254,671,6,21,2,1,2,5,Lost
61368,12,47,95,5,5,4,14,Champions
61441,275,8,68,3,2,4,9,Casual Users
61672,1022,9,17,2,2,2,6,Lost
61992,742,47,318,2,5,5,12,At Risk
62122,579,6,23,2,1,2,5,Lost
62386,399,12,16,3,3,2,8,Loyal Users
62403,2,52,175,5,5,5,15,Champions
62570,130,99,219,4,5,5,14,Champions
62626,96,30,128,4,4,4,12,Champions
63049,5283,15,34,1,3,3,7,Casual Users
63118,1,28,109,5,4,4,13,Champions
63434,535,22,36,2,4,3,9,At Risk
63816,410,17,40,3,3,3,9,Loyal Users
63832,1417,13,19,1,3,2,6,Casual Users
63992,1762,7,22,1,2,2,5,Lost
64024,164,88,154,4,5,5,14,Champions
64048,217,6,22,3,1,2,6,Casual Users
64159,2286,19,150,1,3,5,9,Casual Users
64240,2325,11,21,1,2,2,5,Lost
64514,158,154,676,4,5,5,14,Champions
64640,571,9,16,2,2,2,6,Lost
64737,429,13,28,3,3,2,8,Loyal Users
64788,1256,27,89,2,4,4,10,At Risk
64848,5739,5,7,1,1,1,3,Lost
65270,3,58,126,5,5,4,14,Champions
65374,3414,12,22,1,3,2,6,Casual Users
52534,426,29,52,3,4,3,10,Loyal Users
52589,55,8,13,5,2,1,8,Promising
52618,5,118,189,5,5,5,15,Champions
52698,506,13,30,2,3,2,7,Casual Users
52859,134,5,6,4,1,1,6,Promising
52877,3543,32,54,1,4,3,8,At Risk
52880,127,23,73,4,4,4,12,Champions
53446,10,92,250,5,5,5,15,Champions
53622,1741,22,95,1,4,4,9,At Risk
53811,79,48,70,4,5,4,13,Champions
53979,3,21,26,5,3,2,10,Loyal Users
53996,83,44,74,4,4,4,12,Champions
54059,122,28,94,4,4,4,12,Champions
54137,516,17,70,2,3,4,9,Casual Users
54312,182,26,171,3,4,5,12,Loyal Users
54460,801,5,22,2,1,2,5,Lost
54756,1091,50,71,2,5,4,11,At Risk
55329,22,67,428,5,5,5,15,Champions
55635,234,45,142,3,4,4,11,Loyal Users
55680,261,80,170,3,5,5,13,Loyal Users
56249,277,17,64,3,3,4,10,Loyal Users
56291,139,48,152,4,5,5,14,Champions
56626,72,162,613,4,5,5,14,Champions
56789,460,7,23,3,2,2,7,Casual Users
56805,84,10,70,4,2,4,10,Promising
56916,32,96,386,5,5,5,15,Champions
57267,258,94,143,3,5,4,12,Loyal Users
57795,5847,5,14,1,1,1,3,Lost
57959,178,21,63,3,3,4,10,Loyal Users
57980,55,40,85,5,4,4,13,Champions
58055,424,9,11,3,2,1,6,Casual Users
58204,4267,6,17,1,1,2,4,Lost
58281,12,33,97,5,4,4,13,Champions
59426,81,20,99,4,3,4,11,Loyal Users
59814,23,62,155,5,5,5,15,Champions
60092,242,65,284,3,5,5,13,Loyal Users
60263,44,39,88,5,4,4,13,Champions
60463,2064,12,34,1,3,3,7,Casual Users
60983,573,12,53,2,3,3,8,Casual Users
61406,406,15,19,3,3,2,8,Loyal Users
61562,382,17,54,3,3,3,9,Loyal Users
61764,163,14,38,4,3,3,10,Loyal Users
62475,5,112,362,5,5,5,15,Champions
62623,4454,8,15,1,2,1,4,Lost
62913,167,16,103,3,3,4,10,Loyal Users
62938,230,11,26,3,2,2,7,Casual Users
63539,2450,23,34,1,4,3,8,At Risk
63702,23,11,18,5,2,2,9,Promising
63961,133,10,17,4,2,2,8,Promising
63994,3480,8,8,1,2,1,4,Lost
64046,39,9,29,5,2,2,9,Promising
64083,380,14,37,3,3,3,9,Loyal Users
64139,2414,5,30,1,1,2,4,Lost
64306,42,72,216,5,5,5,15,Champions
64565,4828,5,8,1,1,1,3,Lost
64644,91,44,113,4,4,4,12,Champions
64646,20,14,54,5,3,3,11,Loyal Users
64818,71,17,116,4,3,4,11,Loyal Users
65344,1996,5,31,1,1,2,4,Lost
65382,108,11,25,4,2,2,8,Promising
65393,158,13,69,4,3,4,11,Loyal Users
52752,233,45,125,3,4,4,11,Loyal Users
53100,1385,11,12,1,2,1,4,Lost
53268,3427,6,13,1,1,1,3,Lost
53318,566,10,10,2,2,1,5,Lost
53944,436,10,17,3,2,2,7,Casual Users
53959,146,36,68,4,4,4,12,Champions
54070,6,8,97,5,2,4,11,Promising
54091,423,52,207,3,5,5,13,Loyal Users
54230,685,8,26,2,2,2,6,Lost
54349,271,8,12,3,2,1,6,Casual Users
54469,1857,7,10,1,2,1,4,Lost
54766,661,20,21,2,3,2,7,Casual Users
55143,2,24,51,5,4,3,12,Loyal Users
55234,5416,6,16,1,1,2,4,Lost
55345,2808,6,8,1,1,1,3,Lost
55461,115,201,331,4,5,5,14,Champions
55591,43,228,268,5,5,5,15,Champions
55805,135,19,38,4,3,3,10,Loyal Users
55903,2679,7,31,1,2,2,5,Lost
55904,3277,22,57,1,4,3,8,At Risk
56109,823,9,45,2,2,3,7,Lost
56638,425,24,41,3,4,3,10,Loyal Users
56838,694,18,25,2,3,2,7,Casual Users
56850,1470,21,80,1,3,4,8,Casual Users
56909,133,6,10,4,1,1,6,Promising
57362,112,31,234,4,4,5,13,Champions
57511,166,62,355,3,5,5,13,Loyal Users
57512,386,5,27,3,1,2,6,Casual Users
57850,132,40,68,4,4,4,12,Champions
58038,2544,5,16,1,1,2,4,Lost
58144,405,14,65,3,3,4,10,Loyal Users
58287,434,18,66,3,3,4,10,Loyal Users
58376,831,22,51,2,4,3,9,At Risk
58711,1654,6,10,1,1,1,3,Lost
58810,81,14,47,4,3,3,10,Loyal Users
58923,3080,7,7,1,2,1,4,Lost
58936,1522,10,17,1,2,2,5,Lost
59170,833,34,84,2,4,4,10,At Risk
59445,48,72,241,5,5,5,15,Champions
59689,885,21,42,2,3,3,8,Casual Users
59863,514,15,78,2,3,4,9,Casual Users
60127,115,10,49,4,2,3,9,Promising
60422,68,57,115,5,5,4,14,Champions
61286,47,35,112,5,4,4,13,Champions
61517,159,132,328,4,5,5,14,Champions
61746,254,19,66,3,3,4,10,Loyal Users
61904,3606,9,14,1,2,1,4,Lost
62154,2360,6,11,1,1,1,3,Lost
62320,119,47,161,4,5,5,14,Champions
62516,74,196,394,4,5,5,14,Champions
62565,237,14,62,3,3,3,9,Loyal Users
62696,3364,11,23,1,2,2,5,Lost
62706,684,7,48,2,2,3,7,Lost
62794,17,45,75,5,4,4,13,Champions
62895,133,47,277,4,5,5,14,Champions
62951,118,34,75,4,4,4,12,Champions
63536,166,17,24,3,3,2,8,Loyal Users
63684,1191,6,28,2,1,2,5,Lost
63830,640,32,98,2,4,4,10,At Risk
63863,3951,6,13,1,1,1,3,Lost
64012,106,52,130,4,5,4,13,Champions
64198,73,62,236,4,5,5,14,Champions
64256,24,73,360,5,5,5,15,Champions
64264,3676,9,18,1,2,2,5,Lost
64287,49,32,239,5,4,5,14,Champions
64735,52,111,354,5,5,5,15,Champions
65303,312,15,36,3,3,3,9,Loyal Users
52380,120,49,326,4,5,5,14,Champions
52475,878,20,44,2,3,3,8,Casual Users
52672,718,7,41,2,2,3,7,Lost
52806,718,10,28,2,2,2,6,Lost
53069,65,6,36,5,1,3,9,Promising
53189,107,16,35,4,3,3,10,Loyal Users
53503,1842,16,55,1,3,3,7,Casual Users
54437,51,41,165,5,4,5,14,Champions
54586,106,53,379,4,5,5,14,Champions
54609,99,120,613,4,5,5,14,Champions
54688,690,9,19,2,2,2,6,Lost
54746,128,19,45,4,3,3,10,Loyal Users
54794,286,13,17,3,3,2,8,Loyal Users
54815,148,17,88,4,3,4,11,Loyal Users
55164,3844,5,6,1,1,1,3,Lost
55185,41,36,180,5,4,5,14,Champions
55307,406,18,50,3,3,3,9,Loyal Users
55476,2699,6,22,1,1,2,4,Lost
55487,130,32,164,4,4,5,13,Champions
55715,687,27,36,2,4,3,9,At Risk
56031,697,10,14,2,2,1,5,Lost
56277,150,28,146,4,4,4,12,Champions
56738,116,29,55,4,4,3,11,Loyal Users
56776,944,5,33,2,1,3,6,Lost
56804,502,9,19,2,2,2,6,Lost
56931,1022,15,47,2,3,3,8,Casual Users
57082,169,9,45,3,2,3,8,Casual Users
57107,5136,5,6,1,1,1,3,Lost
57218,196,38,175,3,4,5,12,Loyal Users
57238,329,13,24,3,3,2,8,Loyal Users
57487,88,111,246,4,5,5,14,Champions
57884,137,13,41,4,3,3,10,Loyal Users
58112,27,101,226,5,5,5,15,Champions
58282,650,14,55,2,3,3,8,Casual Users
58751,170,18,41,3,3,3,9,Loyal Users
58859,662,14,26,2,3,2,7,Casual Users
58976,68,62,306,5,5,5,15,Champions
59023,993,26,187,2,4,5,11,At Risk
59036,11,84,205,5,5,5,15,Champions
59356,114,34,153,4,4,5,13,Champions
59945,1129,15,43,2,3,3,8,Casual Users
60012,237,21,45,3,3,3,9,Loyal Users
60170,823,107,467,2,5,5,12,At Risk
60467,6,7,14,5,2,1,8,Promising
60514,381,15,36,3,3,3,9,Loyal Users
60788,1105,15,20,2,3,2,7,Casual Users
60992,241,12,27,3,3,2,8,Loyal Users
61116,16,29,69,5,4,4,13,Champions
61246,992,7,21,2,2,2,6,Lost
61982,138,12,15,4,3,1,8,Loyal Users
62215,461,63,130,3,5,4,12,Loyal Users
62241,132,36,293,4,4,5,13,Champions
62257,392,6,26,3,1,2,6,Casual Users
62264,154,39,112,4,4,4,12,Champions
62330,1206,5,6,2,1,1,4,Lost
62385,483,16,74,2,3,4,9,Casual Users
62453,380,40,80,3,4,4,11,Loyal Users
62651,1948,8,8,1,2,1,4,Lost
62839,40,42,449,5,4,5,14,Champions
62953,4865,11,11,1,2,1,4,Lost
63110,1606,9,26,1,2,2,5,Lost
63813,86,55,323,4,5,5,14,Champions
64178,129,97,123,4,5,4,13,Champions
64232,2525,5,17,1,1,2,4,Lost
64931,27,25,61,5,4,3,12,Loyal Users
65378,872,10,14,2,2,1,5,Lost
52514,152,37,114,4,4,4,12,Champions
52700,272,21,101,3,3,4,10,Loyal Users
52727,434,6,26,3,1,2,6,Casual Users
53053,46,48,170,5,5,5,15,Champions
53154,874,12,25,2,3,2,7,Casual Users
53321,2754,14,95,1,3,4,8,Casual Users
53672,778,5,7,2,1,1,4,Lost
53989,13,5,34,5,1,3,9,Promising
54038,582,53,150,2,5,5,12,At Risk
54401,9,65,97,5,5,4,14,Champions
54544,9,97,270,5,5,5,15,Champions
54584,777,5,14,2,1,1,4,Lost
55222,723,7,34,2,2,3,7,Lost
55253,856,6,9,2,1,1,4,Lost
55324,103,19,107,4,3,4,11,Loyal Users
55594,2454,12,32,1,3,3,7,Casual Users
55673,224,14,114,3,3,4,10,Loyal Users
55779,3558,12,12,1,3,1,5,Casual Users
56381,837,5,10,2,1,1,4,Lost
56487,1734,16,23,1,3,2,6,Casual Users
56656,295,15,86,3,3,4,10,Loyal Users
57025,1677,9,15,1,2,1,4,Lost
57046,720,9,26,2,2,2,6,Lost
57048,2442,17,44,1,3,3,7,Casual Users
57615,764,6,9,2,1,1,4,Lost
58700,129,27,53,4,4,3,11,Loyal Users
59321,418,6,36,3,1,3,7,Casual Users
59472,171,7,15,3,2,1,6,Casual Users
59554,130,8,13,4,2,1,7,Promising
59673,7,27,51,5,4,3,12,Loyal Users
59752,267,28,62,3,4,3,10,Loyal Users
60332,1164,12,22,2,3,2,7,Casual Users
60427,319,52,196,3,5,5,13,Loyal Users
60867,156,5,15,4,1,1,6,Promising
61046,353,5,11,3,1,1,5,Casual Users
61178,856,16,48,2,3,3,8,Casual Users
61332,85,39,94,4,4,4,12,Champions
61424,22,28,46,5,4,3,12,Loyal Users
61663,77,17,33,4,3,3,10,Loyal Users
62234,2,71,152,5,5,5,15,Champions
62256,1134,8,8,2,2,1,5,Lost
62576,811,5,6,2,1,1,4,Lost
62991,25,121,375,5,5,5,15,Champions
63991,28,44,182,5,4,5,14,Champions
64610,1,44,103,5,4,4,13,Champions
64957,106,8,22,4,2,2,8,Promising
65215,692,36,96,2,4,4,10,At Risk
65423,1301,14,20,1,3,2,6,Casual Users
52594,1635,35,60,1,4,3,8,At Risk
52626,524,6,30,2,1,2,5,Lost
52854,1164,5,7,2,1,1,4,Lost
53025,130,15,40,4,3,3,10,Loyal Users
53198,2120,5,13,1,1,1,3,Lost
53207,260,12,16,3,3,2,8,Loyal Users
53939,115,59,147,4,5,5,14,Champions
53951,409,59,321,3,5,5,13,Loyal Users
54066,790,54,138,2,5,4,11,At Risk
54306,128,6,31,4,1,2,7,Promising
54610,22,42,144,5,4,4,13,Champions
54704,1819,8,12,1,2,1,4,Lost
54768,594,37,64,2,4,4,10,At Risk
54788,0,109,194,5,5,5,15,Champions
55410,252,35,104,3,4,4,11,Loyal Users
55479,763,14,62,2,3,3,8,Casual Users
55580,128,26,46,4,4,3,11,Loyal Users
55639,512,5,32,2,1,3,6,Lost
56108,1329,5,18,1,1,2,4,Lost
56134,161,94,261,4,5,5,14,Champions
56273,100,50,149,4,5,5,14,Champions
56684,1600,7,19,1,2,2,5,Lost
56868,430,40,63,3,4,4,11,Loyal Users
56994,1448,5,9,1,1,1,3,Lost
57472,149,82,326,4,5,5,14,Champions
57819,231,27,34,3,4,3,10,Loyal Users
57989,510,8,16,2,2,2,6,Lost
58032,1304,9,31,1,2,2,5,Lost
58182,292,17,91,3,3,4,10,Loyal Users
58696,17,67,848,5,5,5,15,Champions
58761,126,31,115,4,4,4,12,Champions
59434,124,14,24,4,3,2,9,Loyal Users
59569,168,18,104,3,3,4,10,Loyal Users
59818,1114,18,117,2,3,4,9,Casual Users
59876,132,6,11,4,1,1,6,Promising
59886,884,12,22,2,3,2,7,Casual Users
60011,5,34,83,5,4,4,13,Champions
60274,379,13,61,3,3,3,9,Loyal Users
60295,566,10,40,2,2,3,7,Lost
60313,2121,8,41,1,2,3,6,Lost
60508,348,9,11,3,2,1,6,Casual Users
60844,58,54,62,5,5,3,13,Loyal Users
60862,424,64,309,3,5,5,13,Loyal Users
61422,142,25,38,4,4,3,11,Loyal Users
61487,144,100,287,4,5,5,14,Champions
61509,165,10,31,4,2,2,8,Promising
61516,4866,8,34,1,2,3,6,Lost
61652,87,14,24,4,3,2,9,Loyal Users
61836,406,22,99,3,4,4,11,Loyal Users
61950,906,11,15,2,2,1,5,Lost
61951,126,71,105,4,5,4,13,Champions
62285,1981,7,18,1,2,2,5,Lost
62326,3,105,222,5,5,5,15,Champions
62408,1053,52,97,2,5,4,11,At Risk
63036,74,23,146,4,4,4,12,Champions
63318,3,12,17,5,3,2,10,Loyal Users
64187,28,36,49,5,4,3,12,Loyal Users
64229,844,5,17,2,1,2,5,Lost
64250,172,23,39,3,4,3,10,Loyal Users
64698,3340,7,12,1,2,1,4,Lost
64850,281,43,124,3,4,4,11,Loyal Users
65038,698,13,39,2,3,3,8,Casual Users
65139,130,18,56,4,3,3,10,Loyal Users
65181,439,10,15,3,2,1,6,Casual Users
52376,640,13,43,2,3,3,8,Casual Users
52513,182,17,87,3,3,4,10,Loyal Users
52645,1490,10,21,1,2,2,5,Lost
52666,391,13,49,3,3,3,9,Loyal Users
52759,81,5,5,4,1,1,6,Promising
53261,428,10,41,3,2,3,8,Casual Users
53447,132,36,103,4,4,4,12,Champions
53522,993,10,28,2,2,2,6,Lost
53812,3159,20,58,1,3,3,7,Casual Users
53977,0,85,161,5,5,5,15,Champions
54293,123,8,25,4,2,2,8,Promising
54461,11,15,15,5,3,1,9,Loyal Users
54678,268,10,16,3,2,2,7,Casual Users
54759,701,9,9,2,2,1,5,Lost
54993,5528,20,20,1,3,2,6,Casual Users
55020,28,23,80,5,4,4,13,Champions
55091,118,5,10,4,1,1,6,Promising
55168,52,68,79,5,5,4,14,Champions
55721,277,26,131,3,4,4,11,Loyal Users
55744,5576,5,5,1,1,1,3,Lost
55853,813,29,78,2,4,4,10,At Risk
55857,2014,11,21,1,2,2,5,Lost
55976,6,19,28,5,3,2,10,Loyal Users
55984,3547,16,37,1,3,3,7,Casual Users
56338,489,25,56,2,4,3,9,At Risk
56382,682,38,173,2,4,5,11,At Risk
56419,570,6,9,2,1,1,4,Lost
56654,1736,6,15,1,1,1,3,Lost
56736,80,26,206,4,4,5,13,Champions
56866,2126,7,13,1,2,1,4,Lost
57270,244,33,111,3,4,4,11,Loyal Users
57461,483,7,38,2,2,3,7,Lost
57637,434,6,16,3,1,2,6,Casual Users
57733,232,23,79,3,4,4,11,Loyal Users
58026,668,5,7,2,1,1,4,Lost
58086,572,17,22,2,3,2,7,Casual Users
58231,147,11,29,4,2,2,8,Promising
58338,4418,8,14,1,2,1,4,Lost
58487,403,21,48,3,3,3,9,Loyal Users
59529,1,30,210,5,4,5,14,Champions
59723,318,48,113,3,5,4,12,Loyal Users
59772,785,43,55,2,4,3,9,At Risk
60072,5830,10,14,1,2,1,4,Lost
60091,2575,6,8,1,1,1,3,Lost
60154,40,78,442,5,5,5,15,Champions
60357,141,10,23,4,2,2,8,Promising
60639,822,9,12,2,2,1,5,Lost
60646,116,52,96,4,5,4,13,Champions
60731,658,13,42,2,3,3,8,Casual Users
60765,1906,6,10,1,1,1,3,Lost
60768,845,7,31,2,2,2,6,Lost
61265,1085,5,8,2,1,1,4,Lost
61615,80,30,103,4,4,4,12,Champions
61722,1282,6,9,1,1,1,3,Lost
61975,852,14,80,2,3,4,9,Casual Users
62028,402,27,101,3,4,4,11,Loyal Users
62058,2577,22,34,1,4,3,8,At Risk
62375,113,33,99,4,4,4,12,Champions
62445,1537,9,14,1,2,1,4,Lost
62773,698,5,15,2,1,1,4,Lost
63034,131,22,37,4,4,3,11,Loyal Users
63188,2850,9,17,1,2,2,5,Lost
63493,12,100,127,5,5,4,14,Champions
64269,400,13,29,3,3,2,8,Loyal Users
64325,842,11,106,2,2,4,8,Lost
64335,41,55,247,5,5,5,15,Champions
64647,133,25,105,4,4,4,12,Champions
64731,17,28,110,5,4,4,13,Champions
65008,648,9,24,2,2,2,6,Lost
65117,165,13,27,4,3,2,9,Loyal Users
65189,1151,5,6,2,1,1,4,Lost
65257,121,11,20,4,2,2,8,Promising
65297,263,7,22,3,2,2,7,Casual Users
52701,379,45,78,3,4,4,11,Loyal Users
52898,46,5,14,5,1,1,7,Promising
53141,112,30,112,4,4,4,12,Champions
53683,441,35,97,3,4,4,11,Loyal Users
54132,663,40,277,2,4,5,11,At Risk
54173,646,52,184,2,5,5,12,At Risk
54559,9,43,72,5,4,4,13,Champions
54561,715,11,29,2,2,2,6,Lost
54619,421,22,57,3,4,3,10,Loyal Users
54935,3591,96,334,1,5,5,11,At Risk
55150,286,9,17,3,2,2,7,Casual Users
55154,433,47,88,3,5,4,12,Loyal Users
55664,575,13,61,2,3,3,8,Casual Users
55684,2671,11,41,1,2,3,6,Lost
55765,118,10,56,4,2,3,9,Promising
56000,112,42,116,4,4,4,12,Champions
56008,683,9,18,2,2,2,6,Lost
56370,27,71,282,5,5,5,15,Champions
56400,582,9,19,2,2,2,6,Lost
56445,419,13,33,3,3,3,9,Loyal Users
56779,6,117,309,5,5,5,15,Champions
56996,15,73,98,5,5,4,14,Champions
57256,126,34,103,4,4,4,12,Champions
57360,23,23,136,5,4,4,13,Champions
57694,120,50,130,4,5,4,13,Champions
57710,793,20,96,2,3,4,9,Casual Users
57773,154,137,370,4,5,5,14,Champions
57832,1294,8,14,1,2,1,4,Lost
58064,2273,9,20,1,2,2,5,Lost
58136,97,20,41,4,3,3,10,Loyal Users
58512,566,72,102,2,5,4,11,At Risk
58725,518,6,9,2,1,1,4,Lost
58912,1444,7,22,1,2,2,5,Lost
58926,439,18,23,3,3,2,8,Loyal Users
59124,388,27,55,3,4,3,10,Loyal Users
59506,3274,6,19,1,1,2,4,Lost
59698,273,63,167,3,5,5,13,Loyal Users
59884,129,11,29,4,2,2,8,Promising
59974,659,13,89,2,3,4,9,Casual Users
60031,108,44,136,4,4,4,12,Champions
60150,608,18,30,2,3,2,7,Casual Users
60301,161,31,119,4,4,4,12,Champions
60363,221,69,415,3,5,5,13,Loyal Users
60405,1402,17,25,1,3,2,6,Casual Users
60419,805,15,112,2,3,4,9,Casual Users
60883,268,48,118,3,5,4,12,Loyal Users
61123,664,5,5,2,1,1,4,Lost
61363,2405,5,10,1,1,1,3,Lost
61897,2564,6,23,1,1,2,4,Lost
62113,152,15,24,4,3,2,9,Loyal Users
62429,322,48,228,3,5,5,13,Loyal Users
62591,454,15,49,3,3,3,9,Loyal Users
63270,178,73,81,3,5,4,12,Loyal Users
63477,29,50,146,5,5,4,14,Champions
63675,700,8,19,2,2,2,6,Lost
63793,276,21,55,3,3,3,9,Loyal Users
64342,2953,8,62,1,2,3,6,Lost
64667,1808,18,27,1,3,2,6,Casual Users
64701,32,19,51,5,3,3,11,Loyal Users
64736,1,54,93,5,5,4,14,Champions
64849,26,16,23,5,3,2,10,Loyal Users
64980,7,16,86,5,3,4,12,Loyal Users
65129,3229,8,9,1,2,1,4,Lost
52614,1595,19,45,1,3,3,7,Casual Users
52996,1304,27,40,1,4,3,8,At Risk
53948,245,13,68,3,3,4,10,Loyal Users
54157,868,14,20,2,3,2,7,Casual Users
54218,16,20,85,5,3,4,12,Loyal Users
54226,2020,13,15,1,3,1,5,Casual Users
54286,146,5,7,4,1,1,6,Promising
54502,5165,6,6,1,1,1,3,Lost
54560,108,141,639,4,5,5,14,Champions
55162,108,83,187,4,5,5,14,Champions
55171,137,31,72,4,4,4,12,Champions
55495,11,40,167,5,4,5,14,Champions
56271,1417,9,17,1,2,2,5,Lost
56586,48,51,155,5,5,5,15,Champions
56621,87,13,28,4,3,2,9,Loyal Users
57045,36,40,168,5,4,5,14,Champions
57323,2090,10,34,1,2,3,6,Lost
57677,85,6,22,4,1,2,7,Promising
57893,727,7,14,2,2,1,5,Lost
57960,267,5,16,3,1,2,6,Casual Users
58060,1,49,211,5,5,5,15,Champions
58065,532,5,42,2,1,3,6,Lost
58088,130,6,11,4,1,1,6,Promising
58160,3511,7,19,1,2,2,5,Lost
58323,2315,12,14,1,3,1,5,Casual Users
58957,104,168,269,4,5,5,14,Champions
59123,111,43,113,4,4,4,12,Champions
59167,0,10,14,5,2,1,8,Promising
59498,125,46,86,4,5,4,13,Champions
59779,5,97,402,5,5,5,15,Champions
59797,3414,5,5,1,1,1,3,Lost
59834,120,42,87,4,4,4,12,Champions
60149,232,6,46,3,1,3,7,Casual Users
60308,623,23,44,2,4,3,9,At Risk
60326,147,35,378,4,4,5,13,Champions
60750,1276,5,8,1,1,1,3,Lost
60854,12,169,662,5,5,5,15,Champions
60957,264,12,17,3,3,2,8,Loyal Users
60958,103,13,29,4,3,2,9,Loyal Users
61033,435,58,130,3,5,4,12,Loyal Users
61125,2683,7,15,1,2,1,4,Lost
61294,43,27,34,5,4,3,12,Loyal Users
61300,616,6,16,2,1,2,5,Lost
61415,87,45,133,4,4,4,12,Champions
61716,795,10,19,2,2,2,6,Lost
61726,7,158,365,5,5,5,15,Champions
61753,774,7,37,2,2,3,7,Lost
62195,262,22,38,3,4,3,10,Loyal Users
62292,271,8,42,3,2,3,8,Casual Users
62394,109,40,128,4,4,4,12,Champions
62612,124,101,269,4,5,5,14,Champions
62665,0,22,35,5,4,3,12,Loyal Users
62940,81,28,138,4,4,4,12,Champions
62977,419,24,83,3,4,4,11,Loyal Users
63081,4,87,177,5,5,5,15,Champions
63619,1275,8,18,1,2,2,5,Lost
63652,275,5,9,3,1,1,5,Casual Users
63705,46,23,100,5,4,4,13,Champions
63763,540,9,22,2,2,2,6,Lost
64123,667,8,13,2,2,1,5,Lost
64375,257,7,21,3,2,2,7,Casual Users
64599,106,9,27,4,2,2,8,Promising
65084,92,61,167,4,5,5,14,Champions
65388,3543,5,5,1,1,1,3,Lost
65420,2547,6,14,1,1,1,3,Lost
52910,278,60,90,3,5,4,12,Loyal Users
52976,3943,15,85,1,3,4,8,Casual Users
53211,2435,7,11,1,2,1,4,Lost
53478,1417,5,9,1,1,1,3,Lost
53524,3471,12,13,1,3,1,5,Casual Users
54163,522,32,103,2,4,4,10,At Risk
54411,148,7,9,4,2,1,7,Promising
54464,4312,6,39,1,1,3,5,Lost
54476,133,54,240,4,5,5,14,Champions
55108,3395,6,6,1,1,1,3,Lost
55367,743,13,24,2,3,2,7,Casual Users
55807,17,118,685,5,5,5,15,Champions
56237,92,17,30,4,3,2,9,Loyal Users
56401,531,8,48,2,2,3,7,Lost
56686,420,9,25,3,2,2,7,Casual Users
57534,397,8,21,3,2,2,7,Casual Users
57545,182,81,380,3,5,5,13,Loyal Users
57682,402,31,46,3,4,3,10,Loyal Users
57871,7,12,53,5,3,3,11,Loyal Users
57883,1010,7,77,2,2,4,8,Lost
58155,12,112,389,5,5,5,15,Champions
58457,101,14,37,4,3,3,10,Loyal Users
59558,364,33,70,3,4,4,11,Loyal Users
59789,41,70,501,5,5,5,15,Champions
59925,120,8,9,4,2,1,7,Promising
60089,297,17,33,3,3,3,9,Loyal Users
60123,1849,5,10,1,1,1,3,Lost
60339,2134,6,8,1,1,1,3,Lost
61043,593,13,35,2,3,3,8,Casual Users
61357,812,30,53,2,4,3,9,At Risk
61617,127,29,83,4,4,4,12,Champions
62054,56,41,196,5,4,5,14,Champions
62275,1133,7,39,2,2,3,7,Lost
62383,8,130,512,5,5,5,15,Champions
62792,683,6,13,2,1,1,4,Lost
63080,44,59,405,5,5,5,15,Champions
63096,438,32,55,3,4,3,10,Loyal Users
63319,294,15,73,3,3,4,10,Loyal Users
63710,2087,9,30,1,2,2,5,Lost
63841,821,24,36,2,4,3,9,At Risk
63966,808,7,26,2,2,2,6,Lost
64391,1597,14,19,1,3,2,6,Casual Users
64544,417,8,13,3,2,1,6,Casual Users
64579,1151,9,16,2,2,2,6,Lost
64700,158,14,34,4,3,3,10,Loyal Users
64880,93,83,272,4,5,5,14,Champions
64944,162,5,7,4,1,1,6,Promising
65200,1874,8,13,1,2,1,4,Lost
65418,107,26,31,4,4,2,10,Loyal Users
52479,125,88,382,4,5,5,14,Champions
52584,1550,6,8,1,1,1,3,Lost
52844,664,10,38,2,2,3,7,Lost
52927,575,6,6,2,1,1,4,Lost
53157,1244,5,5,2,1,1,4,Lost
53419,3018,5,6,1,1,1,3,Lost
53926,118,32,63,4,4,4,12,Champions
53949,873,15,19,2,3,2,7,Casual Users
54007,214,38,147,3,4,5,12,Loyal Users
54225,4,111,262,5,5,5,15,Champions
54351,127,24,65,4,4,4,12,Champions
54489,273,17,52,3,3,3,9,Loyal Users
54846,85,101,405,4,5,5,14,Champions
55079,132,69,137,4,5,4,13,Champions
55190,402,5,13,3,1,1,5,Casual Users
55300,131,14,25,4,3,2,9,Loyal Users
55599,130,30,138,4,4,4,12,Champions
55623,70,77,134,4,5,4,13,Champions
55809,251,9,12,3,2,1,6,Casual Users
55859,306,11,24,3,2,2,7,Casual Users
55865,269,9,34,3,2,3,8,Casual Users
56240,17,13,19,5,3,2,10,Loyal Users
56314,2580,11,20,1,2,2,5,Lost
56562,6,76,372,5,5,5,15,Champions
57105,3122,5,26,1,1,2,4,Lost
57123,83,36,165,4,4,5,13,Champions
57301,839,21,56,2,3,3,8,Casual Users
57351,1271,54,85,1,5,4,10,At Risk
58645,1091,9,16,2,2,2,6,Lost
58782,511,27,39,2,4,3,9,At Risk
58940,1301,7,9,1,2,1,4,Lost
59009,70,33,163,4,4,5,13,Champions
59685,52,49,99,5,5,4,14,Champions
59831,20,40,111,5,4,4,13,Champions
60465,192,10,20,3,2,2,7,Casual Users
60682,3711,8,14,1,2,1,4,Lost
60885,67,12,16,5,3,2,10,Loyal Users
61072,2010,6,6,1,1,1,3,Lost
61142,798,6,29,2,1,2,5,Lost
61760,3913,11,25,1,2,2,5,Lost
62190,117,14,18,4,3,2,9,Loyal Users
62236,96,62,121,4,5,4,13,Champions
62860,186,41,92,3,4,4,11,Loyal Users
62999,140,52,146,4,5,4,13,Champions
63114,128,75,156,4,5,5,14,Champions
63287,1105,9,13,2,2,1,5,Lost
63444,1377,9,24,1,2,2,5,Lost
63541,2580,10,31,1,2,2,5,Lost
63673,44,46,115,5,5,4,14,Champions
63871,39,33,93,5,4,4,13,Champions
64301,846,7,9,2,2,1,5,Lost
64449,3986,5,25,1,1,2,4,Lost
64866,140,5,22,4,1,2,7,Promising
65006,484,77,101,2,5,4,11,At Risk
65238,68,35,51,5,4,3,12,Loyal Users
65322,233,81,116,3,5,4,12,Loyal Users
65379,337,11,116,3,2,4,9,Casual Users
52474,124,16,68,4,3,4,11,Loyal Users
53368,933,5,5,2,1,1,4,Lost
53431,7,47,213,5,5,5,15,Champions
53488,83,49,110,4,5,4,13,Champions
53965,210,7,17,3,2,2,7,Casual Users
54270,2252,9,55,1,2,3,6,Lost
54386,296,10,38,3,2,3,8,Casual Users
54871,74,14,94,4,3,4,11,Loyal Users
54894,63,50,240,5,5,5,15,Champions
55311,414,22,114,3,4,4,11,Loyal Users
55573,1,17,34,5,3,3,11,Loyal Users
55686,1136,5,5,2,1,1,4,Lost
55710,10,43,217,5,4,5,14,Champions
55884,707,19,47,2,3,3,8,Casual Users
55910,253,9,39,3,2,3,8,Casual Users
56093,19,12,15,5,3,1,9,Loyal Users
56516,1719,5,7,1,1,1,3,Lost
56532,2111,5,10,1,1,1,3,Lost
56593,420,8,24,3,2,2,7,Casual Users
56930,239,45,84,3,4,4,11,Loyal Users
57205,642,41,175,2,4,5,11,At Risk
57247,307,24,60,3,4,3,10,Loyal Users
57308,66,8,8,5,2,1,8,Promising
57502,125,27,36,4,4,3,11,Loyal Users
57558,1196,9,23,2,2,2,6,Lost
57761,37,54,128,5,5,4,14,Champions
58045,1581,10,14,1,2,1,4,Lost
59186,0,84,111,5,5,4,14,Champions
59280,123,15,31,4,3,2,9,Loyal Users
59285,250,16,16,3,3,2,8,Loyal Users
59420,1278,19,21,1,3,2,6,Casual Users
59422,12,62,338,5,5,5,15,Champions
59478,3040,5,5,1,1,1,3,Lost
59971,103,76,409,4,5,5,14,Champions
60255,752,11,13,2,2,1,5,Lost
60542,5,81,478,5,5,5,15,Champions
60710,44,55,254,5,5,5,15,Champions
60721,348,10,35,3,2,3,8,Casual Users
60984,127,10,25,4,2,2,8,Promising
61056,1275,9,12,1,2,1,4,Lost
61082,53,38,65,5,4,4,13,Champions
61152,3057,5,8,1,1,1,3,Lost
61381,5,42,71,5,4,4,13,Champions
61552,7,13,23,5,3,2,10,Loyal Users
61762,2133,11,29,1,2,2,5,Lost
61916,713,16,25,2,3,2,7,Casual Users
62053,1689,12,27,1,3,2,6,Casual Users
62539,584,10,31,2,2,2,6,Lost
62695,2050,5,5,1,1,1,3,Lost
62892,160,13,21,4,3,2,9,Loyal Users
62915,132,35,193,4,4,5,13,Champions
63029,363,22,61,3,4,3,10,Loyal Users
63280,428,7,8,3,2,1,6,Casual Users
63497,0,38,257,5,4,5,14,Champions
63690,283,15,37,3,3,3,9,Loyal Users
63748,30,97,131,5,5,4,14,Champions
64396,837,16,33,2,3,3,8,Casual Users
64865,1842,8,8,1,2,1,4,Lost
64933,948,17,56,2,3,3,8,Casual Users
64973,264,28,51,3,4,3,10,Loyal Users
52576,484,22,45,2,4,3,9,At Risk
52692,15,11,38,5,2,3,10,Promising
52744,82,213,734,4,5,5,14,Champions
53014,132,30,106,4,4,4,12,Champions
53167,43,10,49,5,2,3,10,Promising
53322,228,34,68,3,4,4,11,Loyal Users
53364,1076,19,22,2,3,2,7,Casual Users
53950,129,27,55,4,4,3,11,Loyal Users
53961,5,116,557,5,5,5,15,Champions
54656,168,11,51,3,2,3,8,Casual Users
55121,139,24,61,4,4,3,11,Loyal Users
55357,468,15,43,3,3,3,9,Loyal Users
55406,0,35,152,5,4,5,14,Champions
55618,275,11,47,3,2,3,8,Casual Users
55685,53,40,61,5,4,3,12,Loyal Users
55707,3539,12,41,1,3,3,7,Casual Users
55831,553,9,19,2,2,2,6,Lost
56101,2561,5,13,1,1,1,3,Lost
56138,3213,12,13,1,3,1,5,Casual Users
56449,67,111,245,5,5,5,15,Champions
56685,2414,14,21,1,3,2,6,Casual Users
56787,3,42,119,5,4,4,13,Champions
56922,106,5,15,4,1,1,6,Promising
56939,398,10,35,3,2,3,8,Casual Users
58000,234,9,70,3,2,4,9,Casual Users
58023,296,70,216,3,5,5,13,Loyal Users
58193,18,7,96,5,2,4,11,Promising
58657,234,5,17,3,1,2,6,Casual Users
58704,1741,6,6,1,1,1,3,Lost
59064,165,21,37,4,3,3,10,Loyal Users
59413,2671,6,15,1,1,1,3,Lost
59567,78,25,88,4,4,4,12,Champions
59734,57,53,121,5,5,4,14,Champions
59960,678,88,273,2,5,5,12,At Risk
60046,205,30,67,3,4,4,11,Loyal Users
60181,1172,34,90,2,4,4,10,At Risk
60342,839,5,9,2,1,1,4,Lost
60601,1,94,243,5,5,5,15,Champions
60741,280,20,147,3,3,5,11,Loyal Users
60882,17,7,9,5,2,1,8,Promising
61042,6,51,198,5,5,5,15,Champions
61275,30,15,100,5,3,4,12,Loyal Users
61384,2975,19,69,1,3,4,8,Casual Users
61688,23,20,27,5,3,2,10,Loyal Users
61691,279,9,24,3,2,2,7,Casual Users
61756,530,7,12,2,2,1,5,Lost
61948,981,44,86,2,4,4,10,At Risk
61985,635,35,125,2,4,4,10,At Risk
62347,4823,5,7,1,1,1,3,Lost
62366,3409,34,44,1,4,3,8,At Risk
62675,2857,14,22,1,3,2,6,Casual Users
62681,4618,11,11,1,2,1,4,Lost
62819,1858,6,22,1,1,2,4,Lost
63102,223,19,26,3,3,2,8,Loyal Users
63158,797,8,48,2,2,3,7,Lost
63364,2209,8,9,1,2,1,4,Lost
64655,322,12,86,3,3,4,10,Loyal Users
64686,1,54,156,5,5,5,15,Champions
64828,1,11,88,5,2,4,11,Promising
64994,30,97,432,5,5,5,15,Champions
65016,457,23,206,3,4,5,12,Loyal Users
65087,1072,6,9,2,1,1,4,Lost
65106,1537,12,18,1,3,2,6,Casual Users
65152,819,5,14,2,1,1,4,Lost
65221,5311,6,8,1,1,1,3,Lost
65413,47,146,469,5,5,5,15,Champions
52537,137,23,30,4,4,2,10,Loyal Users
52718,490,45,195,2,4,5,11,At Risk
52762,142,26,71,4,4,4,12,Champions
53128,1285,40,56,1,4,3,8,At Risk
53173,5,6,56,5,1,3,9,Promising
53323,20,108,156,5,5,5,15,Champions
53530,24,133,287,5,5,5,15,Champions
53774,728,9,20,2,2,2,6,Lost
53901,29,131,696,5,5,5,15,Champions
54183,299,15,74,3,3,4,10,Loyal Users
54698,32,13,83,5,3,4,12,Loyal Users
55043,695,18,96,2,3,4,9,Casual Users
55097,1569,8,20,1,2,2,5,Lost
55350,95,6,27,4,1,2,7,Promising
55424,2,23,125,5,4,4,13,Champions
55767,723,8,9,2,2,1,5,Lost
56047,212,32,117,3,4,4,11,Loyal Users
56480,994,7,9,2,2,1,5,Lost
56643,2374,5,42,1,1,3,5,Lost
56874,627,8,29,2,2,2,6,Lost
56975,101,60,166,4,5,5,14,Champions
57861,150,36,66,4,4,4,12,Champions
57975,22,66,140,5,5,4,14,Champions
58405,123,14,24,4,3,2,9,Loyal Users
58446,633,30,47,2,4,3,9,At Risk
58702,395,23,45,3,4,3,10,Loyal Users
58729,271,6,28,3,1,2,6,Casual Users
59213,9,31,247,5,4,5,14,Champions
59305,26,49,377,5,5,5,15,Champions
60307,128,19,22,4,3,2,9,Loyal Users
60315,2665,11,34,1,2,3,6,Lost
60492,3,25,45,5,4,3,12,Loyal Users
60534,118,38,90,4,4,4,12,Champions
60915,160,57,449,4,5,5,14,Champions
61579,26,19,41,5,3,3,11,Loyal Users
61838,236,57,217,3,5,5,13,Loyal Users
61997,520,19,253,2,3,5,10,Casual Users
62069,265,13,43,3,3,3,9,Loyal Users
62194,25,25,65,5,4,4,13,Champions
62344,2854,9,17,1,2,2,5,Lost
62527,173,70,123,3,5,4,12,Loyal Users
62729,112,10,10,4,2,1,7,Promising
62870,1009,5,8,2,1,1,4,Lost
63320,17,97,295,5,5,5,15,Champions
63331,313,33,42,3,4,3,10,Loyal Users
63420,147,40,78,4,4,4,12,Champions
63621,840,192,624,2,5,5,12,At Risk
63629,690,13,62,2,3,3,8,Casual Users
63711,4977,8,18,1,2,2,5,Lost
63718,1383,5,7,1,1,1,3,Lost
63773,411,9,26,3,2,2,7,Casual Users
63941,130,19,55,4,3,3,10,Loyal Users
64025,92,5,10,4,1,1,6,Promising
64785,1124,24,75,2,4,4,10,At Risk
64864,122,197,852,4,5,5,14,Champions
52496,6,94,512,5,5,5,15,Champions
52961,492,24,32,2,4,3,9,At Risk
53302,1009,5,15,2,1,1,4,Lost
53370,1133,6,12,2,1,1,4,Lost
53533,1155,21,56,2,3,3,8,Casual Users
53721,6,37,119,5,4,4,13,Champions
54041,961,5,12,2,1,1,4,Lost
54261,108,9,31,4,2,2,8,Promising
54484,35,14,24,5,3,2,10,Loyal Users
54691,2284,8,10,1,2,1,4,Lost
54709,420,35,74,3,4,4,11,Loyal Users
54789,160,27,205,4,4,5,13,Champions
55295,255,41,153,3,4,5,12,Loyal Users
55355,2219,9,20,1,2,2,5,Lost
55915,275,16,45,3,3,3,9,Loyal Users
56032,2829,14,43,1,3,3,7,Casual Users
56091,1968,5,5,1,1,1,3,Lost
56452,133,49,202,4,5,5,14,Champions
56475,808,19,64,2,3,4,9,Casual Users
56595,1512,5,12,1,1,1,3,Lost
56896,6,147,839,5,5,5,15,Champions
56940,1844,5,7,1,1,1,3,Lost
57021,1374,10,29,1,2,2,5,Lost
57153,5,10,31,5,2,2,9,Promising
57177,8,19,38,5,3,3,11,Loyal Users
57190,147,110,347,4,5,5,14,Champions
57627,179,29,66,3,4,4,11,Loyal Users
57843,111,6,16,4,1,2,7,Promising
58612,8,116,335,5,5,5,15,Champions
58886,14,45,80,5,4,4,13,Champions
58903,1220,18,31,2,3,2,7,Casual Users
58969,2560,13,103,1,3,4,8,Casual Users
59154,413,19,55,3,3,3,9,Loyal Users
59442,1896,8,45,1,2,3,6,Lost
59477,184,7,8,3,2,1,6,Casual Users
59493,1089,5,6,2,1,1,4,Lost
59578,139,32,158,4,4,5,13,Champions
59679,4175,8,18,1,2,2,5,Lost
59870,507,11,25,2,2,2,6,Lost
60028,2963,9,13,1,2,1,4,Lost
60254,682,22,150,2,4,5,11,At Risk
60356,44,72,142,5,5,4,14,Champions
60388,121,150,266,4,5,5,14,Champions
60487,104,21,41,4,3,3,10,Loyal Users
60830,134,5,17,4,1,2,7,Promising
61005,92,30,52,4,4,3,11,Loyal Users
61067,84,54,231,4,5,5,14,Champions
61161,417,82,397,3,5,5,13,Loyal Users
61376,120,50,145,4,5,4,13,Champions
61815,469,15,68,3,3,4,10,Loyal Users
62517,133,30,142,4,4,4,12,Champions
62550,392,26,125,3,4,4,11,Loyal Users
62912,2108,16,52,1,3,3,7,Casual Users
63089,1530,11,38,1,2,3,6,Lost
63150,228,8,25,3,2,2,7,Casual Users
63551,1542,8,10,1,2,1,4,Lost
63790,877,12,23,2,3,2,7,Casual Users
64053,1534,8,8,1,2,1,4,Lost
64331,1788,5,47,1,1,3,5,Lost
64539,27,12,50,5,3,3,11,Loyal Users
64774,15,25,85,5,4,4,13,Champions
64795,246,19,46,3,3,3,9,Loyal Users
64893,18,41,142,5,4,4,13,Champions
65021,7,37,299,5,4,5,14,Champions
65142,97,16,31,4,3,2,9,Loyal Users
65414,14,21,80,5,3,4,12,Loyal Users
52397,97,10,25,4,2,2,8,Promising
52400,0,42,156,5,4,5,14,Champions
52509,3096,6,8,1,1,1,3,Lost
52983,658,6,6,2,1,1,4,Lost
53341,770,30,111,2,4,4,10,At Risk
53473,302,34,163,3,4,5,12,Loyal Users
53882,815,6,12,2,1,1,4,Lost
53942,1401,5,36,1,1,3,5,Lost
54138,710,5,9,2,1,1,4,Lost
54160,21,34,105,5,4,4,13,Champions
54548,656,16,27,2,3,2,7,Casual Users
55003,1520,7,19,1,2,2,5,Lost
55405,82,23,89,4,4,4,12,Champions
55630,125,9,29,4,2,2,8,Promising
55651,1099,10,13,2,2,1,5,Lost
55908,107,49,128,4,5,4,13,Champions
55957,564,39,57,2,4,3,9,At Risk
56190,541,8,43,2,2,3,7,Lost
56199,124,15,57,4,3,3,10,Loyal Users
56819,720,22,40,2,4,3,9,At Risk
56923,236,5,8,3,1,1,5,Casual Users
57057,56,139,569,5,5,5,15,Champions
57416,164,9,57,4,2,3,9,Promising
57732,1768,9,12,1,2,1,4,Lost
57767,306,18,51,3,3,3,9,Loyal Users
57856,3938,12,21,1,3,2,6,Casual Users
57996,2443,13,14,1,3,1,5,Casual Users
58051,39,11,30,5,2,2,9,Promising
58653,245,35,87,3,4,4,11,Loyal Users
59135,125,14,22,4,3,2,9,Loyal Users
59490,143,11,18,4,2,2,8,Promising
59530,26,32,58,5,4,3,12,Loyal Users
60199,104,7,31,4,2,2,8,Promising
60411,27,9,64,5,2,4,11,Promising
60602,267,37,95,3,4,4,11,Loyal Users
61170,251,35,45,3,4,3,10,Loyal Users
61634,96,102,236,4,5,5,14,Champions
62026,286,7,22,3,2,2,7,Casual Users
62120,2030,6,7,1,1,1,3,Lost
62486,1516,13,95,1,3,4,8,Casual Users
62933,102,74,329,4,5,5,14,Champions
63075,30,63,88,5,5,4,14,Champions
63193,784,12,60,2,3,3,8,Casual Users
63261,86,11,15,4,2,1,7,Promising
63268,120,208,405,4,5,5,14,Champions
63452,422,6,42,3,1,3,7,Casual Users
63486,144,13,14,4,3,1,8,Loyal Users
63774,1139,16,40,2,3,3,8,Casual Users
63787,2524,13,32,1,3,3,7,Casual Users
64014,5268,12,12,1,3,1,5,Casual Users
64204,543,10,11,2,2,1,5,Lost
64751,221,18,105,3,3,4,10,Loyal Users
65262,1397,19,29,1,3,2,6,Casual Users
65311,2406,8,14,1,2,1,4,Lost
52500,121,7,17,4,2,2,8,Promising
52745,247,17,24,3,3,2,8,Loyal Users
53020,1788,18,31,1,3,2,6,Casual Users
53553,5,43,129,5,4,4,13,Champions
53759,87,55,91,4,5,4,13,Champions
53814,29,27,69,5,4,4,13,Champions
53831,1826,5,5,1,1,1,3,Lost
54055,421,8,25,3,2,2,7,Casual Users
54358,364,58,88,3,5,4,12,Loyal Users
54847,283,16,119,3,3,4,10,Loyal Users
54922,246,5,24,3,1,2,6,Casual Users
55135,255,67,186,3,5,5,13,Loyal Users
55213,1466,5,10,1,1,1,3,Lost
55214,2,76,310,5,5,5,15,Champions
55412,1724,5,5,1,1,1,3,Lost
55784,550,17,71,2,3,4,9,Casual Users
55792,105,139,255,4,5,5,14,Champions
56236,15,25,35,5,4,3,12,Loyal Users
56262,1646,21,81,1,3,4,8,Casual Users
56415,112,20,53,4,3,3,10,Loyal Users
56613,127,13,15,4,3,1,8,Loyal Users
57003,67,66,366,5,5,5,15,Champions
57291,133,12,24,4,3,2,9,Loyal Users
57312,118,25,109,4,4,4,12,Champions
57444,1,126,670,5,5,5,15,Champions
57606,40,110,197,5,5,5,15,Champions
57906,413,32,71,3,4,4,11,Loyal Users
58403,59,54,142,5,5,4,14,Champions
58788,256,47,178,3,5,5,13,Loyal Users
59471,117,30,97,4,4,4,12,Champions
59947,145,145,249,4,5,5,14,Champions
59956,1054,8,9,2,2,1,5,Lost
60450,1070,107,197,2,5,5,12,At Risk
60451,91,25,100,4,4,4,12,Champions
60533,1,131,157,5,5,5,15,Champions
60599,554,13,26,2,3,2,7,Casual Users
60793,961,33,82,2,4,4,10,At Risk
60808,679,55,471,2,5,5,12,At Risk
60920,987,16,21,2,3,2,7,Casual Users
61122,1683,11,27,1,2,2,5,Lost
61257,2238,9,11,1,2,1,4,Lost
61478,1,48,93,5,5,4,14,Champions
61570,257,68,263,3,5,5,13,Loyal Users
61739,6,38,49,5,4,3,12,Loyal Users
61925,293,9,36,3,2,3,8,Casual Users
62587,434,47,69,3,5,4,12,Loyal Users
63136,992,30,124,2,4,4,10,At Risk
63525,2289,8,9,1,2,1,4,Lost
63626,2258,45,166,1,4,5,10,At Risk
63665,8,67,192,5,5,5,15,Champions
63797,119,32,178,4,4,5,13,Champions
63819,441,16,35,3,3,3,9,Loyal Users
63971,270,20,30,3,3,2,8,Loyal Users
63973,1659,9,31,1,2,2,5,Lost
64211,1539,6,10,1,1,1,3,Lost
64922,2460,6,10,1,1,1,3,Lost
65070,55,64,113,5,5,4,14,Champions
65072,243,57,144,3,5,4,12,Loyal Users
65278,3295,24,84,1,4,4,9,At Risk
52407,440,10,17,3,2,2,7,Casual Users
52426,84,15,20,4,3,2,9,Loyal Users
52432,722,7,14,2,2,1,5,Lost
52651,28,14,19,5,3,2,10,Loyal Users
52920,80,35,174,4,4,5,13,Champions
53165,107,16,23,4,3,2,9,Loyal Users
53249,1511,23,59,1,4,3,8,At Risk
53626,184,14,36,3,3,3,9,Loyal Users
53941,16,90,235,5,5,5,15,Champions
54365,676,6,15,2,1,1,4,Lost
54530,88,24,83,4,4,4,12,Champions
54568,703,29,79,2,4,4,10,At Risk
54919,110,51,245,4,5,5,14,Champions
54926,3132,10,14,1,2,1,4,Lost
54943,2139,7,16,1,2,2,5,Lost
54957,429,30,83,3,4,4,11,Loyal Users
55061,3934,11,43,1,2,3,6,Lost
55243,1795,5,36,1,1,3,5,Lost
55318,117,51,224,4,5,5,14,Champions
55328,1466,8,18,1,2,2,5,Lost
55442,721,8,24,2,2,2,6,Lost
55696,58,38,64,5,4,4,13,Champions
55901,138,50,417,4,5,5,14,Champions
56158,144,76,351,4,5,5,14,Champions
56302,872,8,18,2,2,2,6,Lost
56467,84,61,144,4,5,4,13,Champions
56790,1377,8,70,1,2,4,7,Lost
56853,52,109,900,5,5,5,15,Champions
56949,123,46,88,4,5,4,13,Champions
57036,139,13,16,4,3,2,9,Loyal Users
57940,4175,68,118,1,5,4,10,At Risk
58010,138,19,47,4,3,3,10,Loyal Users
58052,593,5,8,2,1,1,4,Lost
58122,6,21,84,5,3,4,12,Loyal Users
58219,242,8,11,3,2,1,6,Casual Users
58795,1800,19,49,1,3,3,7,Casual Users
58894,13,160,432,5,5,5,15,Champions
58931,1194,6,6,2,1,1,4,Lost
59240,1278,9,20,1,2,2,5,Lost
59296,3084,6,7,1,1,1,3,Lost
59297,181,8,11,3,2,1,6,Casual Users
59310,4,17,58,5,3,3,11,Loyal Users
59950,41,101,654,5,5,5,15,Champions
60099,412,10,29,3,2,2,7,Casual Users
60317,126,6,10,4,1,1,6,Promising
60855,525,13,90,2,3,4,9,Casual Users
61749,841,14,95,2,3,4,9,Casual Users
61750,3369,8,44,1,2,3,6,Lost
61946,136,5,12,4,1,1,6,Promising
62192,101,22,109,4,4,4,12,Champions
62258,9,28,103,5,4,4,13,Champions
62342,1179,10,31,2,2,2,6,Lost
62380,27,23,53,5,4,3,12,Loyal Users
62534,146,11,23,4,2,2,8,Promising
62949,438,6,10,3,1,1,5,Casual Users
63064,8,34,64,5,4,4,13,Champions
63284,325,7,12,3,2,1,6,Casual Users
63336,88,27,161,4,4,5,13,Champions
63339,268,90,356,3,5,5,13,Loyal Users
63429,89,89,150,4,5,5,14,Champions
63445,619,23,104,2,4,4,10,At Risk
63488,189,22,29,3,4,2,9,Loyal Users
63928,71,12,15,4,3,1,8,Loyal Users
64059,2453,10,23,1,2,2,5,Lost
64176,450,7,25,3,2,2,7,Casual Users
64208,109,54,89,4,5,4,13,Champions
64233,1846,9,24,1,2,2,5,Lost
64380,1131,6,11,2,1,1,4,Lost
64440,152,9,27,4,2,2,8,Promising
64533,1137,28,39,2,4,3,9,At Risk
64574,13,19,100,5,3,4,12,Loyal Users
64609,453,21,28,3,3,2,8,Loyal Users
64883,102,7,9,4,2,1,7,Promising
64894,217,77,172,3,5,5,13,Loyal Users
64974,26,5,13,5,1,1,7,Promising
65102,688,18,27,2,3,2,7,Casual Users
65395,71,41,155,4,4,5,13,Champions
52483,2092,9,23,1,2,2,5,Lost
52845,3657,10,18,1,2,2,5,Lost
52964,101,39,68,4,4,4,12,Champions
53388,117,14,104,4,3,4,11,Loyal Users
53571,3,35,97,5,4,4,13,Champions
53898,1092,12,39,2,3,3,8,Casual Users
54026,708,19,48,2,3,3,8,Casual Users
54082,536,36,88,2,4,4,10,At Risk
54509,1374,17,68,1,3,4,8,Casual Users
54640,4,51,83,5,5,4,14,Champions
54827,181,22,32,3,4,3,10,Loyal Users
54970,1266,5,15,1,1,1,3,Lost
55019,1731,11,15,1,2,1,4,Lost
55233,365,11,33,3,2,3,8,Casual Users
55343,714,6,11,2,1,1,4,Lost
55471,53,43,45,5,4,3,12,Loyal Users
56089,685,35,121,2,4,4,10,At Risk
56187,67,32,46,5,4,3,12,Loyal Users
56563,2860,10,15,1,2,1,4,Lost
56795,72,87,350,4,5,5,14,Champions
56861,832,29,46,2,4,3,9,At Risk
56977,859,15,53,2,3,3,8,Casual Users
57161,3413,20,48,1,3,3,7,Casual Users
57240,1296,17,27,1,3,2,6,Casual Users
57327,694,9,34,2,2,3,7,Lost
57909,98,22,88,4,4,4,12,Champions
57939,142,119,321,4,5,5,14,Champions
58031,486,5,6,2,1,1,4,Lost
58209,8,45,79,5,4,4,13,Champions
58347,32,40,258,5,4,5,14,Champions
58452,27,30,149,5,4,5,14,Champions
58475,22,39,190,5,4,5,14,Champions
58601,89,165,789,4,5,5,14,Champions
58863,1,47,117,5,5,4,14,Champions
59006,342,31,47,3,4,3,10,Loyal Users
59268,2510,13,49,1,3,3,7,Casual Users
59349,2435,5,22,1,1,2,4,Lost
59511,122,37,147,4,4,5,13,Champions
59537,130,41,117,4,4,4,12,Champions
59775,221,33,145,3,4,4,11,Loyal Users
59828,253,10,11,3,2,1,6,Casual Users
60032,127,14,19,4,3,2,9,Loyal Users
60121,248,17,23,3,3,2,8,Loyal Users
60129,2606,5,5,1,1,1,3,Lost
60193,565,14,87,2,3,4,9,Casual Users
60226,3078,6,21,1,1,2,4,Lost
60485,50,76,351,5,5,5,15,Champions
60488,1258,7,11,1,2,1,4,Lost
60609,1887,5,29,1,1,2,4,Lost
60614,105,59,536,4,5,5,14,Champions
60754,287,5,16,3,1,2,6,Casual Users
61006,280,83,234,3,5,5,13,Loyal Users
61306,478,23,35,2,4,3,9,At Risk
61560,835,18,48,2,3,3,8,Casual Users
61781,160,88,395,4,5,5,14,Champions
62178,12,90,222,5,5,5,15,Champions
62207,63,92,620,5,5,5,15,Champions
62273,672,7,11,2,2,1,5,Lost
62567,14,30,245,5,4,5,14,Champions
62579,710,12,15,2,3,1,6,Casual Users
62671,18,11,53,5,2,3,10,Promising
63005,104,14,162,4,3,5,12,Loyal Users
63109,37,7,8,5,2,1,8,Promising
63126,127,6,6,4,1,1,6,Promising
63267,427,17,82,3,3,4,10,Loyal Users
63821,492,39,68,2,4,4,10,At Risk
64295,1705,11,23,1,2,2,5,Lost
64576,16,59,85,5,5,4,14,Champions
64733,368,7,25,3,2,2,7,Casual Users
64749,246,119,253,3,5,5,13,Loyal Users
65209,12,88,472,5,5,5,15,Champions
65304,240,5,13,3,1,1,5,Casual Users
65306,192,27,54,3,4,3,10,Loyal Users
65309,2722,5,8,1,1,1,3,Lost
65320,264,10,18,3,2,2,7,Casual Users
65428,697,16,87,2,3,4,9,Casual Users
53134,1328,5,20,1,1,2,4,Lost
53187,231,11,17,3,2,2,7,Casual Users
53402,1717,7,21,1,2,2,5,Lost
54095,106,24,51,4,4,3,11,Loyal Users
54219,243,28,93,3,4,4,11,Loyal Users
54405,146,24,38,4,4,3,11,Loyal Users
54474,449,19,109,3,3,4,10,Loyal Users
54600,191,31,45,3,4,3,10,Loyal Users
54655,236,13,129,3,3,4,10,Loyal Users
54760,273,11,15,3,2,1,6,Casual Users
55506,68,19,55,5,3,3,11,Loyal Users
55724,13,48,68,5,5,4,14,Champions
55822,848,5,16,2,1,2,5,Lost
55875,1261,6,15,1,1,1,3,Lost
56450,2676,11,26,1,2,2,5,Lost
56488,2593,5,17,1,1,2,4,Lost
57016,417,12,15,3,3,1,7,Loyal Users
57294,148,7,15,4,2,1,7,Promising
57428,2667,7,26,1,2,2,5,Lost
57651,411,10,12,3,2,1,6,Casual Users
57740,7,150,492,5,5,5,15,Champions
57986,409,18,28,3,3,2,8,Loyal Users
58146,107,15,33,4,3,3,10,Loyal Users
58661,141,23,57,4,4,3,11,Loyal Users
59068,110,23,36,4,4,3,11,Loyal Users
59491,709,11,29,2,2,2,6,Lost
59534,391,13,81,3,3,4,10,Loyal Users
59602,696,10,41,2,2,3,7,Lost
59807,1401,5,7,1,1,1,3,Lost
60159,2133,7,7,1,2,1,4,Lost
60435,544,24,41,2,4,3,9,At Risk
60439,287,6,31,3,1,2,6,Casual Users
60613,271,16,35,3,3,3,9,Loyal Users
60674,5,25,65,5,4,4,13,Champions
60819,637,7,13,2,2,1,5,Lost
61228,1193,11,34,2,2,3,7,Lost
61417,14,7,34,5,2,3,10,Promising
61480,575,6,19,2,1,2,5,Lost
61520,4290,20,20,1,3,2,6,Casual Users
61606,1059,29,37,2,4,3,9,At Risk
61710,132,29,133,4,4,4,12,Champions
62050,4,23,103,5,4,4,13,Champions
62661,119,35,134,4,4,4,12,Champions
62676,76,6,12,4,1,1,6,Promising
62763,15,31,67,5,4,4,13,Champions
62883,808,17,30,2,3,2,7,Casual Users
63167,1256,23,69,2,4,4,10,At Risk
63307,1972,11,122,1,2,4,7,Lost
63372,3009,12,20,1,3,2,6,Casual Users
63516,7,29,54,5,4,3,12,Loyal Users
63775,160,61,232,4,5,5,14,Champions
63847,324,39,81,3,4,4,11,Loyal Users
64334,477,12,51,2,3,3,8,Casual Users
64613,81,83,391,4,5,5,14,Champions
64910,227,48,89,3,5,4,12,Loyal Users
65053,4867,22,28,1,4,2,7,At Risk
52377,1005,26,78,2,4,4,10,At Risk
52532,7,78,124,5,5,4,14,Champions
52579,38,24,53,5,4,3,12,Loyal Users
52686,1046,21,47,2,3,3,8,Casual Users
52907,2131,5,21,1,1,2,4,Lost
52949,2812,7,14,1,2,1,4,Lost
53188,2511,15,25,1,3,2,6,Casual Users
53265,2434,8,18,1,2,2,5,Lost
53401,229,65,167,3,5,5,13,Loyal Users
53514,315,5,7,3,1,1,5,Casual Users
54538,143,63,160,4,5,5,14,Champions
55047,122,8,8,4,2,1,7,Promising
55081,59,134,363,5,5,5,15,Champions
55504,105,49,62,4,5,3,12,Loyal Users
55719,713,17,27,2,3,2,7,Casual Users
55996,107,10,34,4,2,3,9,Promising
56068,15,66,210,5,5,5,15,Champions
56118,453,11,20,3,2,2,7,Casual Users
56194,327,17,68,3,3,4,10,Loyal Users
56649,13,20,64,5,3,4,12,Loyal Users
57002,865,6,63,2,1,4,7,Lost
57212,1415,8,10,1,2,1,4,Lost
57741,2774,6,6,1,1,1,3,Lost
58034,39,238,491,5,5,5,15,Champions
58258,182,17,41,3,3,3,9,Loyal Users
58843,132,16,34,4,3,3,10,Loyal Users
59322,44,102,298,5,5,5,15,Champions
59583,12,8,25,5,2,2,9,Promising
60162,106,20,103,4,3,4,11,Loyal Users
60746,542,9,53,2,2,3,7,Lost
60847,52,41,170,5,4,5,14,Champions
61325,227,84,122,3,5,4,12,Loyal Users
61538,4726,7,19,1,2,2,5,Lost
61613,724,14,84,2,3,4,9,Casual Users
61651,1520,29,43,1,4,3,8,At Risk
61738,152,9,16,4,2,2,8,Promising
61780,539,32,63,2,4,4,10,At Risk
61888,440,21,25,3,3,2,8,Loyal Users
61984,4034,5,5,1,1,1,3,Lost
62094,444,42,63,3,4,4,11,Loyal Users
62221,1801,8,68,1,2,4,7,Lost
62410,2415,5,10,1,1,1,3,Lost
62421,978,33,74,2,4,4,10,At Risk
62441,2471,8,12,1,2,1,4,Lost
62547,417,67,200,3,5,5,13,Loyal Users
62858,27,20,26,5,3,2,10,Loyal Users
63199,273,9,14,3,2,1,6,Casual Users
63353,30,8,13,5,2,1,8,Promising
63631,1627,8,11,1,2,1,4,Lost
63639,77,23,105,4,4,4,12,Champions
63685,3132,12,32,1,3,3,7,Casual Users
63729,191,7,7,3,2,1,6,Casual Users
63885,8,5,16,5,1,2,8,Promising
63997,0,36,42,5,4,3,12,Loyal Users
64087,1028,7,10,2,2,1,5,Lost
64260,6,92,247,5,5,5,15,Champions
64691,1165,9,15,2,2,1,5,Lost
64908,54,138,645,5,5,5,15,Champions
64979,568,10,10,2,2,1,5,Lost
65036,483,27,189,2,4,5,11,At Risk
65329,227,235,429,3,5,5,13,Loyal Users
65430,115,21,32,4,3,3,10,Loyal Users
52915,55,65,266,5,5,5,15,Champions
52948,108,67,302,4,5,5,14,Champions
53143,2074,17,52,1,3,3,7,Casual Users
53164,2010,6,17,1,1,2,4,Lost
53276,727,10,13,2,2,1,5,Lost
53278,612,23,45,2,4,3,9,At Risk
53674,133,38,57,4,4,3,11,Loyal Users
53832,260,33,98,3,4,4,11,Loyal Users
54079,670,5,14,2,1,1,4,Lost
54111,240,58,118,3,5,4,12,Loyal Users
54511,11,62,271,5,5,5,15,Champions
54604,307,39,113,3,4,4,11,Loyal Users
54727,1041,18,37,2,3,3,8,Casual Users
54732,3705,9,10,1,2,1,4,Lost
54972,1398,17,32,1,3,3,7,Casual Users
55036,902,6,8,2,1,1,4,Lost
55184,126,39,64,4,4,4,12,Champions
55446,111,45,73,4,4,4,12,Champions
55473,970,11,30,2,2,2,6,Lost
55620,135,13,76,4,3,4,11,Loyal Users
55761,125,8,11,4,2,1,7,Promising
56560,254,26,58,3,4,3,10,Loyal Users
57280,116,31,55,4,4,3,11,Loyal Users
57790,1,16,51,5,3,3,11,Loyal Users
57818,316,16,94,3,3,4,10,Loyal Users
57886,129,112,404,4,5,5,14,Champions
58974,597,6,30,2,1,2,5,Lost
59113,2535,5,7,1,1,1,3,Lost
59153,7,145,518,5,5,5,15,Champions
59203,108,12,119,4,3,4,11,Loyal Users
59211,12,130,612,5,5,5,15,Champions
59288,401,17,48,3,3,3,9,Loyal Users
59367,189,20,88,3,3,4,10,Loyal Users
59443,178,19,72,3,3,4,10,Loyal Users
60126,9,90,191,5,5,5,15,Champions
60133,1002,86,159,2,5,5,12,At Risk
60222,132,21,41,4,3,3,10,Loyal Users
60336,3237,9,17,1,2,2,5,Lost
60432,2544,5,6,1,1,1,3,Lost
60804,1057,6,25,2,1,2,5,Lost
60852,57,15,23,5,3,2,10,Loyal Users
61352,972,16,38,2,3,3,8,Casual Users
61419,55,21,149,5,3,5,13,Loyal Users
61890,22,43,198,5,4,5,14,Champions
61893,0,17,39,5,3,3,11,Loyal Users
62338,61,16,56,5,3,3,11,Loyal Users
62577,1042,5,19,2,1,2,5,Lost
62806,281,87,307,3,5,5,13,Loyal Users
62843,255,42,220,3,4,5,12,Loyal Users
62847,140,29,32,4,4,3,11,Loyal Users
62885,1402,9,14,1,2,1,4,Lost
62972,852,5,6,2,1,1,4,Lost
63596,136,53,153,4,5,5,14,Champions
63719,35,17,131,5,3,4,12,Loyal Users
63767,247,50,87,3,5,4,12,Loyal Users
64016,421,13,32,3,3,3,9,Loyal Users
64145,12,146,375,5,5,5,15,Champions
64636,455,14,16,3,3,2,8,Loyal Users
64665,65,54,108,5,5,4,14,Champions
64702,126,33,47,4,4,3,11,Loyal Users
64779,4413,18,58,1,3,3,7,Casual Users
64900,1702,9,21,1,2,2,5,Lost
64999,84,58,241,4,5,5,14,Champions
65035,3482,7,11,1,2,1,4,Lost
52501,26,227,452,5,5,5,15,Champions
52564,888,9,24,2,2,2,6,Lost
52830,397,5,10,3,1,1,5,Casual Users
53007,981,12,17,2,3,2,7,Casual Users
53091,878,23,34,2,4,3,9,At Risk
53152,439,17,68,3,3,4,10,Loyal Users
53194,259,91,164,3,5,5,13,Loyal Users
53306,3,52,124,5,5,4,14,Champions
53788,232,63,118,3,5,4,12,Loyal Users
53806,273,113,174,3,5,5,13,Loyal Users
53867,104,14,16,4,3,2,9,Loyal Users
54174,583,11,18,2,2,2,6,Lost
54475,224,7,32,3,2,3,8,Casual Users
54737,88,6,30,4,1,2,7,Promising
54933,717,30,120,2,4,4,10,At Risk
54954,849,7,10,2,2,1,5,Lost
55053,101,37,113,4,4,4,12,Champions
55227,22,92,175,5,5,5,15,Champions
55281,781,11,32,2,2,3,7,Lost
55316,633,34,48,2,4,3,9,At Risk
55527,1290,11,24,1,2,2,5,Lost
55998,335,8,14,3,2,1,6,Casual Users
56378,861,5,15,2,1,1,4,Lost
56389,3829,5,21,1,1,2,4,Lost
56690,1343,44,112,1,4,4,9,At Risk
56691,124,8,43,4,2,3,9,Promising
56747,173,41,120,3,4,4,11,Loyal Users
56968,419,7,11,3,2,1,6,Casual Users
57164,997,5,8,2,1,1,4,Lost
57515,110,89,282,4,5,5,14,Champions
57927,865,21,35,2,3,3,8,Casual Users
58902,132,38,76,4,4,4,12,Champions
59199,141,55,172,4,5,5,14,Champions
59266,2005,7,23,1,2,2,5,Lost
59308,439,6,26,3,1,2,6,Casual Users
59369,5581,5,9,1,1,1,3,Lost
59550,5113,6,6,1,1,1,3,Lost
59652,133,9,24,4,2,2,8,Promising
60080,525,10,19,2,2,2,6,Lost
60152,1656,6,22,1,1,2,4,Lost
60445,105,138,622,4,5,5,14,Champions
60722,327,13,27,3,3,2,8,Loyal Users
60799,157,8,23,4,2,2,8,Promising
61092,125,6,66,4,1,4,9,Promising
61180,127,47,138,4,5,4,13,Champions
61181,431,6,10,3,1,1,5,Casual Users
61966,113,46,72,4,5,4,13,Champions
62036,45,25,93,5,4,4,13,Champions
62087,8,117,198,5,5,5,15,Champions
62088,122,21,32,4,3,3,10,Loyal Users
62242,31,16,61,5,3,3,11,Loyal Users
62762,502,6,22,2,1,2,5,Lost
62844,118,33,152,4,4,5,13,Champions
62947,81,22,49,4,4,3,11,Loyal Users
62962,1491,15,36,1,3,3,7,Casual Users
63561,454,8,26,3,2,2,7,Casual Users
63758,1434,8,55,1,2,3,6,Lost
63923,213,10,22,3,2,2,7,Casual Users
64153,85,173,395,4,5,5,14,Champions
64314,1,127,299,5,5,5,15,Champions
64389,2103,5,12,1,1,1,3,Lost
64907,128,33,187,4,4,5,13,Champions
52451,534,5,6,2,1,1,4,Lost
52761,78,47,105,4,5,4,13,Champions
52839,4,89,553,5,5,5,15,Champions
52963,7,127,292,5,5,5,15,Champions
53067,260,26,66,3,4,4,11,Loyal Users
53436,2253,5,10,1,1,1,3,Lost
53844,2499,6,7,1,1,1,3,Lost
53855,408,5,21,3,1,2,6,Casual Users
54071,31,83,335,5,5,5,15,Champions
54314,1104,58,159,2,5,5,12,At Risk
54905,2240,5,11,1,1,1,3,Lost
55186,25,133,204,5,5,5,15,Champions
55291,94,23,27,4,4,2,10,Loyal Users
55917,604,24,53,2,4,3,9,At Risk
56014,0,116,324,5,5,5,15,Champions
56058,131,12,16,4,3,2,9,Loyal Users
56104,35,9,20,5,2,2,9,Promising
56169,1280,10,23,1,2,2,5,Lost
56326,1172,5,6,2,1,1,4,Lost
57255,282,28,58,3,4,3,10,Loyal Users
57403,1103,8,10,2,2,1,5,Lost
57499,242,52,88,3,5,4,12,Loyal Users
57541,95,5,24,4,1,2,7,Promising
57782,28,69,293,5,5,5,15,Champions
57872,126,6,49,4,1,3,8,Promising
57948,10,120,220,5,5,5,15,Champions
57990,12,111,208,5,5,5,15,Champions
58049,289,6,8,3,1,1,5,Casual Users
58116,233,27,52,3,4,3,10,Loyal Users
58195,65,60,378,5,5,5,15,Champions
58308,1163,26,88,2,4,4,10,At Risk
58447,124,64,247,4,5,5,14,Champions
58525,6,45,204,5,4,5,14,Champions
58551,140,17,47,4,3,3,10,Loyal Users
58727,2483,6,11,1,1,1,3,Lost
58791,203,7,8,3,2,1,6,Casual Users
59026,432,25,26,3,4,2,9,Loyal Users
59044,523,8,33,2,2,3,7,Lost
59489,419,25,47,3,4,3,10,Loyal Users
60188,341,42,51,3,4,3,10,Loyal Users
60267,1413,15,49,1,3,3,7,Casual Users
60368,1985,20,116,1,3,4,8,Casual Users
60399,2728,6,10,1,1,1,3,Lost
60531,51,51,216,5,5,5,15,Champions
60725,3231,6,22,1,1,2,4,Lost
60745,260,26,68,3,4,4,11,Loyal Users
60792,453,15,24,3,3,2,8,Loyal Users
61008,106,20,70,4,3,4,11,Loyal Users
61136,291,9,17,3,2,2,7,Casual Users
61233,3125,6,6,1,1,1,3,Lost
61438,1472,14,35,1,3,3,7,Casual Users
61935,95,111,240,4,5,5,14,Champions
62119,132,5,9,4,1,1,6,Promising
62442,11,97,194,5,5,5,15,Champions
62505,1996,15,41,1,3,3,7,Casual Users
62536,586,15,45,2,3,3,8,Casual Users
62553,7,86,121,5,5,4,14,Champions
62825,117,35,61,4,4,3,11,Loyal Users
62856,1,137,417,5,5,5,15,Champions
62904,266,16,33,3,3,3,9,Loyal Users
63173,694,58,137,2,5,4,11,At Risk
63184,27,80,448,5,5,5,15,Champions
63291,95,35,141,4,4,4,12,Champions
63313,741,26,50,2,4,3,9,At Risk
63321,174,21,91,3,3,4,10,Loyal Users
63378,158,38,57,4,4,3,11,Loyal Users
63402,357,18,87,3,3,4,10,Loyal Users
63709,1847,6,9,1,1,1,3,Lost
64224,571,48,148,2,5,5,12,At Risk
64323,690,50,236,2,5,5,12,At Risk
64509,109,24,70,4,4,4,12,Champions
64871,114,106,564,4,5,5,14,Champions
65052,21,22,122,5,4,4,13,Champions
65346,73,44,138,4,4,4,12,Champions
52364,129,19,98,4,3,4,11,Loyal Users
52540,2801,15,21,1,3,2,6,Casual Users
52552,1500,6,28,1,1,2,4,Lost
53070,139,64,254,4,5,5,14,Champions
53161,803,8,11,2,2,1,5,Lost
53204,1989,7,10,1,2,1,4,Lost
53347,122,86,179,4,5,5,14,Champions
53629,233,21,26,3,3,2,8,Loyal Users
53700,49,67,176,5,5,5,15,Champions
53866,6,13,26,5,3,2,10,Loyal Users
54037,38,9,15,5,2,1,8,Promising
54433,53,15,54,5,3,3,11,Loyal Users
54577,524,34,78,2,4,4,10,At Risk
54590,74,12,73,4,3,4,11,Loyal Users
54680,411,11,53,3,2,3,8,Casual Users
54931,762,8,10,2,2,1,5,Lost
55472,1154,7,11,2,2,1,5,Lost
55757,2123,18,47,1,3,3,7,Casual Users
55876,100,78,156,4,5,5,14,Champions
56003,4707,6,6,1,1,1,3,Lost
56048,42,34,49,5,4,3,12,Loyal Users
56094,1407,7,8,1,2,1,4,Lost
56279,38,187,678,5,5,5,15,Champions
56287,366,7,49,3,2,3,8,Casual Users
56463,6,7,9,5,2,1,8,Promising
56761,1985,8,8,1,2,1,4,Lost
56806,131,18,68,4,3,4,11,Loyal Users
56856,369,59,119,3,5,4,12,Loyal Users
57072,262,5,11,3,1,1,5,Casual Users
57320,21,116,561,5,5,5,15,Champions
57579,131,17,38,4,3,3,10,Loyal Users
57688,63,135,916,5,5,5,15,Champions
57943,529,20,29,2,3,2,7,Casual Users
57956,66,65,111,5,5,4,14,Champions
58024,156,19,41,4,3,3,10,Loyal Users
58202,131,46,220,4,5,5,14,Champions
58339,171,62,88,3,5,4,12,Loyal Users
58627,991,20,38,2,3,3,8,Casual Users
58896,2380,6,10,1,1,1,3,Lost
58900,1741,11,29,1,2,2,5,Lost
59318,788,27,63,2,4,4,10,At Risk
59361,2572,6,6,1,1,1,3,Lost
59651,674,57,266,2,5,5,12,At Risk
59873,272,45,90,3,4,4,11,Loyal Users
60252,7,13,15,5,3,1,9,Loyal Users
60327,132,41,87,4,4,4,12,Champions
60618,38,14,18,5,3,2,10,Loyal Users
60659,586,14,31,2,3,2,7,Casual Users
61007,531,114,771,2,5,5,12,At Risk
61063,28,16,27,5,3,2,10,Loyal Users
61078,1563,5,8,1,1,1,3,Lost
61247,167,36,48,3,4,3,10,Loyal Users
61578,8,89,266,5,5,5,15,Champions
61587,152,6,12,4,1,1,6,Promising
61860,115,80,116,4,5,4,13,Champions
61877,449,28,107,3,4,4,11,Loyal Users
61964,20,121,365,5,5,5,15,Champions
62327,846,5,10,2,1,1,4,Lost
62487,1124,7,21,2,2,2,6,Lost
62746,420,17,31,3,3,2,8,Loyal Users
62828,142,9,27,4,2,2,8,Promising
63076,1653,9,35,1,2,3,6,Lost
63342,763,9,18,2,2,2,6,Lost
63450,1691,12,33,1,3,3,7,Casual Users
63635,97,62,112,4,5,4,13,Champions
63814,4427,6,11,1,1,1,3,Lost
64400,65,23,54,5,4,3,12,Loyal Users
64971,739,6,16,2,1,2,5,Lost
65386,36,42,109,5,4,4,13,Champions
53146,91,13,30,4,3,2,9,Loyal Users
53441,82,72,330,4,5,5,14,Champions
53913,13,54,88,5,5,4,14,Champions
54563,26,79,420,5,5,5,15,Champions
54565,5552,5,6,1,1,1,3,Lost
54626,1343,5,10,1,1,1,3,Lost
54860,204,60,92,3,5,4,12,Loyal Users
55619,0,50,255,5,5,5,15,Champions
55708,104,74,633,4,5,5,14,Champions
55888,273,113,309,3,5,5,13,Loyal Users
56142,122,5,9,4,1,1,6,Promising
56143,413,10,28,3,2,2,7,Casual Users
56206,434,5,36,3,1,3,7,Casual Users
56360,12,8,24,5,2,2,9,Promising
56710,131,22,93,4,4,4,12,Champions
56745,1759,9,9,1,2,1,4,Lost
56758,1183,91,263,2,5,5,12,At Risk
57142,134,11,38,4,2,3,9,Promising
57535,5,25,54,5,4,3,12,Loyal Users
57655,3561,6,17,1,1,2,4,Lost
57967,288,15,32,3,3,3,9,Loyal Users
58245,295,13,24,3,3,2,8,Loyal Users
58356,1243,8,30,2,2,2,6,Lost
58608,20,61,301,5,5,5,15,Champions
58636,388,19,27,3,3,2,8,Loyal Users
58639,405,6,8,3,1,1,5,Casual Users
58688,310,50,219,3,5,5,13,Loyal Users
58927,82,22,58,4,4,3,11,Loyal Users
58959,954,8,39,2,2,3,7,Lost
59572,427,14,32,3,3,3,9,Loyal Users
59751,480,31,36,2,4,3,9,At Risk
59793,2519,31,188,1,4,5,10,At Risk
60000,109,10,41,4,2,3,9,Promising
60050,1277,11,19,1,2,2,5,Lost
60051,2,226,604,5,5,5,15,Champions
60512,379,10,73,3,2,4,9,Casual Users
60651,1983,20,80,1,3,4,8,Casual Users
60817,208,7,8,3,2,1,6,Casual Users
60851,160,22,178,4,4,5,13,Champions
60898,1243,17,32,2,3,3,8,Casual Users
60973,2838,7,15,1,2,1,4,Lost
60978,131,6,21,4,1,2,7,Promising
61083,567,7,40,2,2,3,7,Lost
61218,129,9,24,4,2,2,8,Promising
61364,683,7,10,2,2,1,5,Lost
61495,26,181,858,5,5,5,15,Champions
61527,26,91,405,5,5,5,15,Champions
61619,621,31,112,2,4,4,10,At Risk
61727,1951,17,85,1,3,4,8,Casual Users
61804,1547,13,18,1,3,2,6,Casual Users
62361,17,83,203,5,5,5,15,Champions
62404,262,32,65,3,4,4,11,Loyal Users
62677,281,17,74,3,3,4,10,Loyal Users
62849,131,18,37,4,3,3,10,Loyal Users
62874,256,14,129,3,3,4,10,Loyal Users
62980,2713,8,30,1,2,2,5,Lost
63030,236,63,104,3,5,4,12,Loyal Users
63054,11,37,209,5,4,5,14,Champions
63144,7,45,84,5,4,4,13,Champions
63230,413,17,24,3,3,2,8,Loyal Users
63836,115,27,43,4,4,3,11,Loyal Users
63837,1249,5,24,2,1,2,5,Lost
64066,59,92,182,5,5,5,15,Champions
64239,389,28,36,3,4,3,10,Loyal Users
64528,153,93,198,4,5,5,14,Champions
64596,91,8,9,4,2,1,7,Promising
64772,134,52,66,4,5,4,13,Champions
52813,190,12,18,3,3,2,8,Loyal Users
52928,131,13,23,4,3,2,9,Loyal Users
52972,844,18,53,2,3,3,8,Casual Users
53550,114,7,18,4,2,2,8,Promising
53685,210,39,99,3,4,4,11,Loyal Users
53767,273,20,35,3,3,3,9,Loyal Users
53920,4739,9,10,1,2,1,4,Lost
54723,532,18,136,2,3,4,9,Casual Users
54807,552,11,22,2,2,2,6,Lost
55826,1701,5,9,1,1,1,3,Lost
55967,3374,8,70,1,2,4,7,Lost
56316,157,18,32,4,3,3,10,Loyal Users
56319,116,17,47,4,3,3,10,Loyal Users
56437,4675,7,8,1,2,1,4,Lost
56936,41,43,76,5,4,4,13,Champions
57055,822,11,18,2,2,2,6,Lost
57149,421,11,25,3,2,2,7,Casual Users
57387,617,6,13,2,1,1,4,Lost
57488,284,14,62,3,3,3,9,Loyal Users
57494,28,41,144,5,4,4,13,Champions
57527,831,50,204,2,5,5,12,At Risk
57544,858,11,34,2,2,3,7,Lost
57549,1023,9,32,2,2,3,7,Lost
57749,136,72,231,4,5,5,14,Champions
57806,1551,10,15,1,2,1,4,Lost
57823,213,10,18,3,2,2,7,Casual Users
57958,260,29,58,3,4,3,10,Loyal Users
58090,3665,7,7,1,2,1,4,Lost
58263,240,18,20,3,3,2,8,Loyal Users
58307,334,18,37,3,3,3,9,Loyal Users
58398,424,9,16,3,2,2,7,Casual Users
58415,243,6,18,3,1,2,6,Casual Users
58473,2699,5,10,1,1,1,3,Lost
58490,167,77,170,3,5,5,13,Loyal Users
58492,270,95,258,3,5,5,13,Loyal Users
58648,429,24,75,3,4,4,11,Loyal Users
59171,291,6,31,3,1,2,6,Casual Users
59437,59,42,118,5,4,4,13,Champions
59447,227,9,72,3,2,4,9,Casual Users
59512,75,74,376,4,5,5,14,Champions
59557,9,19,43,5,3,3,11,Loyal Users
59591,140,48,117,4,5,4,13,Champions
60144,827,5,54,2,1,3,6,Lost
60361,256,105,194,3,5,5,13,Loyal Users
60503,18,6,10,5,1,1,7,Promising
60564,39,13,35,5,3,3,11,Loyal Users
60998,411,7,21,3,2,2,7,Casual Users
61196,2158,38,85,1,4,4,9,At Risk
61561,787,5,9,2,1,1,4,Lost
61708,534,15,45,2,3,3,8,Casual Users
61741,45,94,466,5,5,5,15,Champions
61868,1015,23,40,2,4,3,9,At Risk
61969,421,9,12,3,2,1,6,Casual Users
62032,18,36,89,5,4,4,13,Champions
62323,594,21,60,2,3,3,8,Casual Users
62329,4296,10,60,1,2,3,6,Lost
62744,683,8,17,2,2,2,6,Lost
62901,1578,8,10,1,2,1,4,Lost
63160,3014,32,41,1,4,3,8,At Risk
63192,388,7,10,3,2,1,6,Casual Users
63240,114,84,170,4,5,5,14,Champions
63620,105,44,58,4,4,3,11,Loyal Users
63809,3601,31,86,1,4,4,9,At Risk
64158,405,25,61,3,4,3,10,Loyal Users
64297,79,52,72,4,5,4,13,Champions
64382,1268,16,45,1,3,3,7,Casual Users
64478,287,13,24,3,3,2,8,Loyal Users
64777,7,32,47,5,4,3,12,Loyal Users
64831,111,35,77,4,4,4,12,Champions
64916,125,7,9,4,2,1,7,Promising
52465,6,26,73,5,4,4,13,Champions
52529,12,6,14,5,1,1,7,Promising
53383,91,186,760,4,5,5,14,Champions
53564,1115,19,27,2,3,2,7,Casual Users
53575,12,63,419,5,5,5,15,Champions
53608,228,16,24,3,3,2,8,Loyal Users
54290,822,6,9,2,1,1,4,Lost
54316,329,41,146,3,4,4,11,Loyal Users
54443,18,95,168,5,5,5,15,Champions
54456,13,70,364,5,5,5,15,Champions
54585,700,32,79,2,4,4,10,At Risk
54622,783,9,31,2,2,2,6,Lost
54736,11,34,44,5,4,3,12,Loyal Users
54745,1017,9,75,2,2,4,8,Lost
54782,269,43,177,3,4,5,12,Loyal Users
54821,459,28,153,3,4,5,12,Loyal Users
54862,110,39,72,4,4,4,12,Champions
55008,84,14,45,4,3,3,10,Loyal Users
55347,2743,6,13,1,1,1,3,Lost
55665,425,48,116,3,5,4,12,Loyal Users
56057,61,91,341,5,5,5,15,Champions
56250,2942,5,8,1,1,1,3,Lost
56515,116,10,34,4,2,3,9,Promising
56633,1456,13,21,1,3,2,6,Casual Users
56867,44,147,207,5,5,5,15,Champions
57114,126,43,88,4,4,4,12,Champions
57128,124,18,65,4,3,4,11,Loyal Users
57158,1735,6,24,1,1,2,4,Lost
57216,158,11,20,4,2,2,8,Promising
57286,117,6,6,4,1,1,6,Promising
57342,409,13,17,3,3,2,8,Loyal Users
57382,2587,7,27,1,2,2,5,Lost
57540,162,5,5,4,1,1,6,Promising
57574,1274,6,12,1,1,1,3,Lost
57636,158,94,481,4,5,5,14,Champions
57695,109,31,77,4,4,4,12,Champions
57705,125,19,62,4,3,3,10,Loyal Users
57788,1213,29,50,2,4,3,9,At Risk
58117,19,14,18,5,3,2,10,Loyal Users
58173,227,9,64,3,2,4,9,Casual Users
58276,1568,5,23,1,1,2,4,Lost
58364,235,23,68,3,4,4,11,Loyal Users
58477,156,53,99,4,5,4,13,Champions
58532,347,12,50,3,3,3,9,Loyal Users
58829,49,142,189,5,5,5,15,Champions
58970,379,10,33,3,2,3,8,Casual Users
59217,2890,6,12,1,1,1,3,Lost
59341,134,10,28,4,2,2,8,Promising
59364,540,7,15,2,2,1,5,Lost
60021,1706,7,37,1,2,3,6,Lost
60384,984,5,5,2,1,1,4,Lost
60457,807,21,108,2,3,4,9,Casual Users
60523,689,5,10,2,1,1,4,Lost
60982,179,76,125,3,5,4,12,Loyal Users
61837,408,18,33,3,3,3,9,Loyal Users
62042,2737,30,64,1,4,4,9,At Risk
62305,2,27,69,5,4,4,13,Champions
62566,2,36,82,5,4,4,13,Champions
62697,5,88,190,5,5,5,15,Champions
63070,0,30,100,5,4,4,13,Champions
63112,118,5,11,4,1,1,6,Promising
63650,22,48,160,5,5,5,15,Champions
63789,15,85,172,5,5,5,15,Champions
63968,102,83,209,4,5,5,14,Champions
64903,200,30,42,3,4,3,10,Loyal Users
64998,1876,6,6,1,1,1,3,Lost
65030,293,47,74,3,5,4,12,Loyal Users
65051,93,49,86,4,5,4,13,Champions
65201,1852,5,6,1,1,1,3,Lost
65316,3673,6,6,1,1,1,3,Lost
52370,1608,10,38,1,2,3,6,Lost
52423,360,11,25,3,2,2,7,Casual Users
52506,5006,9,11,1,2,1,4,Lost
52714,438,8,67,3,2,4,9,Casual Users
52832,1393,6,13,1,1,1,3,Lost
52834,9,41,170,5,4,5,14,Champions
53351,429,14,37,3,3,3,9,Loyal Users
53392,1087,21,22,2,3,2,7,Casual Users
54123,128,9,28,4,2,2,8,Promising
54418,2865,6,19,1,1,2,4,Lost
54514,1015,9,16,2,2,2,6,Lost
54869,90,103,360,4,5,5,14,Champions
55021,416,6,10,3,1,1,5,Casual Users
55084,2425,7,12,1,2,1,4,Lost
55085,91,28,70,4,4,4,12,Champions
55172,2939,6,18,1,1,2,4,Lost
55278,1129,19,59,2,3,3,8,Casual Users
55732,1858,6,10,1,1,1,3,Lost
55925,1761,12,34,1,3,3,7,Casual Users
56167,600,14,22,2,3,2,7,Casual Users
56224,958,26,90,2,4,4,10,At Risk
56272,545,24,50,2,4,3,9,At Risk
56905,384,16,30,3,3,2,8,Loyal Users
56997,72,72,363,4,5,5,14,Champions
57015,317,20,41,3,3,3,9,Loyal Users
57023,24,16,30,5,3,2,10,Loyal Users
57113,237,42,168,3,4,5,12,Loyal Users
57213,14,102,183,5,5,5,15,Champions
57236,1709,5,6,1,1,1,3,Lost
57465,984,22,30,2,4,2,8,At Risk
57485,3,46,119,5,5,4,14,Champions
57620,934,40,204,2,4,5,11,At Risk
57711,420,36,200,3,4,5,12,Loyal Users
58074,211,6,9,3,1,1,5,Casual Users
58181,5,43,121,5,4,4,13,Champions
58240,1,8,24,5,2,2,9,Promising
58352,177,93,271,3,5,5,13,Loyal Users
58784,690,45,74,2,4,4,10,At Risk
58823,217,64,206,3,5,5,13,Loyal Users
58851,518,7,10,2,2,1,5,Lost
59107,550,5,5,2,1,1,4,Lost
59370,1398,28,42,1,4,3,8,At Risk
59782,0,136,522,5,5,5,15,Champions
60135,5615,8,8,1,2,1,4,Lost
60372,13,16,60,5,3,3,11,Loyal Users
60493,1409,14,107,1,3,4,8,Casual Users
61177,225,52,614,3,5,5,13,Loyal Users
61284,12,80,366,5,5,5,15,Champions
61285,653,7,11,2,2,1,5,Lost
61541,4853,30,64,1,4,4,9,At Risk
61614,1577,7,10,1,2,1,4,Lost
62322,1706,9,33,1,2,3,6,Lost
62337,47,95,172,5,5,5,15,Champions
62593,466,5,7,3,1,1,5,Casual Users
62786,530,7,13,2,2,1,5,Lost
62821,298,41,75,3,4,4,11,Loyal Users
62863,2865,6,8,1,1,1,3,Lost
63069,330,20,42,3,3,3,9,Loyal Users
63482,134,19,44,4,3,3,10,Loyal Users
63522,6,7,15,5,2,1,8,Promising
63624,1439,6,40,1,1,3,5,Lost
63880,524,5,5,2,1,1,4,Lost
63888,406,14,44,3,3,3,9,Loyal Users
63940,106,90,372,4,5,5,14,Champions
63947,713,5,20,2,1,2,5,Lost
63955,4467,13,33,1,3,3,7,Casual Users
63970,3319,9,22,1,2,2,5,Lost
64061,5241,5,8,1,1,1,3,Lost
64437,6,109,392,5,5,5,15,Champions
64522,413,34,93,3,4,4,11,Loyal Users
64678,2252,17,208,1,3,5,9,Casual Users
64713,1889,7,8,1,2,1,4,Lost
64761,1903,6,17,1,1,2,4,Lost
64807,882,6,17,2,1,2,5,Lost
64845,5309,9,9,1,2,1,4,Lost
64969,649,20,73,2,3,4,9,Casual Users
65336,78,36,100,4,4,4,12,Champions
52649,1166,11,14,2,2,1,5,Lost
52656,2025,9,28,1,2,2,5,Lost
52696,149,60,133,4,5,4,13,Champions
53072,268,42,187,3,4,5,12,Loyal Users
54410,79,31,77,4,4,4,12,Champions
54414,80,54,98,4,5,4,13,Champions
55254,9,10,25,5,2,2,9,Promising
55371,1732,8,19,1,2,2,5,Lost
55486,11,20,53,5,3,3,11,Loyal Users
55522,1345,10,45,1,2,3,6,Lost
55747,46,69,538,5,5,5,15,Champions
55828,696,11,12,2,2,1,5,Lost
55981,206,14,67,3,3,4,10,Loyal Users
56184,290,73,97,3,5,4,12,Loyal Users
56376,118,122,271,4,5,5,14,Champions
56423,1362,5,6,1,1,1,3,Lost
56568,7,8,43,5,2,3,10,Promising
57560,5728,6,8,1,1,1,3,Lost
58040,167,50,164,3,5,5,13,Loyal Users
58141,12,81,110,5,5,4,14,Champions
58266,7,84,134,5,5,4,14,Champions
58306,1583,15,122,1,3,4,8,Casual Users
58309,1748,5,24,1,1,2,4,Lost
58421,17,130,176,5,5,5,15,Champions
58575,36,51,182,5,5,5,15,Champions
58606,3,33,91,5,4,4,13,Champions
58740,100,19,37,4,3,3,10,Loyal Users
58790,643,9,13,2,2,1,5,Lost
58891,3908,7,8,1,2,1,4,Lost
58979,74,27,58,4,4,3,11,Loyal Users
59463,6,145,446,5,5,5,15,Champions
59596,198,24,28,3,4,2,9,Loyal Users
59668,405,17,66,3,3,4,10,Loyal Users
60009,37,88,229,5,5,5,15,Champions
60033,120,15,75,4,3,4,11,Loyal Users
60041,118,60,210,4,5,5,14,Champions
60370,138,22,36,4,4,3,11,Loyal Users
60730,531,10,29,2,2,2,6,Lost
61400,5,102,173,5,5,5,15,Champions
61499,131,8,17,4,2,2,8,Promising
61956,83,18,50,4,3,3,10,Loyal Users
61981,299,5,5,3,1,1,5,Casual Users
62247,139,16,32,4,3,3,10,Loyal Users
62315,126,29,33,4,4,3,11,Loyal Users
62430,2,88,182,5,5,5,15,Champions
62541,534,12,27,2,3,2,7,Casual Users
62602,259,9,44,3,2,3,8,Casual Users
62642,148,23,63,4,4,4,12,Champions
62667,1579,30,164,1,4,5,10,At Risk
62776,1958,9,21,1,2,2,5,Lost
62840,14,18,52,5,3,3,11,Loyal Users
62939,176,59,106,3,5,4,12,Loyal Users
63219,123,7,12,4,2,1,7,Promising
63232,2703,6,39,1,1,3,5,Lost
63379,398,36,153,3,4,5,12,Loyal Users
63585,980,12,38,2,3,3,8,Casual Users
64055,233,43,58,3,4,3,10,Loyal Users
64081,97,35,67,4,4,4,12,Champions
64136,816,15,116,2,3,4,9,Casual Users
64137,141,19,28,4,3,2,9,Loyal Users
64180,405,74,99,3,5,4,12,Loyal Users
64353,70,51,79,4,5,4,13,Champions
64597,45,58,278,5,5,5,15,Champions
64618,527,18,24,2,3,2,7,Casual Users
64868,73,64,128,4,5,4,13,Champions
64946,186,69,112,3,5,4,12,Loyal Users
65039,1606,5,8,1,1,1,3,Lost
52530,414,26,81,3,4,4,11,Loyal Users
53019,2544,5,29,1,1,2,4,Lost
53088,127,14,19,4,3,2,9,Loyal Users
53137,170,22,33,3,4,3,10,Loyal Users
53362,1520,58,175,1,5,5,11,At Risk
53393,1029,47,74,2,5,4,11,At Risk
53395,7,60,89,5,5,4,14,Champions
53423,835,12,19,2,3,2,7,Casual Users
53549,4242,28,96,1,4,4,9,At Risk
53595,699,6,7,2,1,1,4,Lost
53899,87,98,430,4,5,5,14,Champions
54053,1175,7,14,2,2,1,5,Lost
54345,407,20,33,3,3,3,9,Loyal Users
54450,181,33,45,3,4,3,10,Loyal Users
54552,745,19,52,2,3,3,8,Casual Users
54865,0,118,295,5,5,5,15,Champions
54968,154,28,49,4,4,3,11,Loyal Users
55189,202,6,6,3,1,1,5,Casual Users
55206,843,6,6,2,1,1,4,Lost
55641,308,14,42,3,3,3,9,Loyal Users
55808,143,46,149,4,5,5,14,Champions
55989,2879,9,17,1,2,2,5,Lost
56159,4164,8,12,1,2,1,4,Lost
56283,34,44,113,5,4,4,13,Champions
56508,3507,8,24,1,2,2,5,Lost
56511,4579,8,22,1,2,2,5,Lost
56653,165,31,69,4,4,4,12,Champions
56689,12,86,182,5,5,5,15,Champions
56754,209,16,21,3,3,2,8,Loyal Users
56800,129,38,164,4,4,5,13,Champions
56829,362,59,146,3,5,4,12,Loyal Users
57316,63,26,78,5,4,4,13,Champions
57373,264,38,120,3,4,4,11,Loyal Users
57683,56,22,41,5,4,3,12,Loyal Users
58028,1129,5,6,2,1,1,4,Lost
58033,2153,5,15,1,1,1,3,Lost
58224,44,101,245,5,5,5,15,Champions
58310,1260,10,31,1,2,2,5,Lost
58599,1452,18,33,1,3,3,7,Casual Users
58748,402,17,42,3,3,3,9,Loyal Users
59072,2152,14,27,1,3,2,6,Casual Users
59073,301,20,34,3,3,3,9,Loyal Users
59214,1515,13,16,1,3,2,6,Casual Users
59260,203,5,5,3,1,1,5,Casual Users
59449,1855,10,92,1,2,4,7,Lost
60185,410,83,223,3,5,5,13,Loyal Users
61045,215,14,16,3,3,2,8,Loyal Users
61479,450,9,10,3,2,1,6,Casual Users
61519,153,92,253,4,5,5,14,Champions
62005,1839,10,17,1,2,2,5,Lost
62173,1080,11,63,2,2,4,8,Lost
62444,1736,6,15,1,1,1,3,Lost
62973,1748,10,16,1,2,2,5,Lost
63133,1439,11,23,1,2,2,5,Lost
63252,442,5,10,3,1,1,5,Casual Users
63330,141,74,380,4,5,5,14,Champions
63615,117,11,25,4,2,2,8,Promising
63843,230,6,13,3,1,1,5,Casual Users
63869,222,12,21,3,3,2,8,Loyal Users
64445,296,35,59,3,4,3,10,Loyal Users
64554,1106,27,75,2,4,4,10,At Risk
64672,136,8,13,4,2,1,7,Promising
64937,30,13,38,5,3,3,11,Loyal Users
64982,1726,8,31,1,2,2,5,Lost
64985,5,109,144,5,5,4,14,Champions
65392,3922,5,13,1,1,1,3,Lost
52452,279,60,121,3,5,4,12,Loyal Users
52554,540,6,8,2,1,1,4,Lost
53462,37,96,469,5,5,5,15,Champions
53487,350,13,86,3,3,4,10,Loyal Users
53854,511,10,25,2,2,2,6,Lost
54348,833,7,38,2,2,3,7,Lost
54505,3,9,24,5,2,2,9,Promising
54762,3133,5,23,1,1,2,4,Lost
55110,147,8,29,4,2,2,8,Promising
55166,253,36,46,3,4,3,10,Loyal Users
55187,98,29,83,4,4,4,12,Champions
55562,292,30,59,3,4,3,10,Loyal Users
55818,75,38,156,4,4,5,13,Champions
56202,2,42,165,5,4,5,14,Champions
56751,30,9,33,5,2,3,10,Promising
56883,105,11,69,4,2,4,10,Promising
57019,530,33,86,2,4,4,10,At Risk
57095,28,17,38,5,3,3,11,Loyal Users
57401,35,35,94,5,4,4,13,Champions
57645,990,9,24,2,2,2,6,Lost
57844,13,59,130,5,5,4,14,Champions
58133,549,30,51,2,4,3,9,At Risk
58294,406,29,81,3,4,4,11,Loyal Users
58583,2457,8,25,1,2,2,5,Lost
58617,132,34,134,4,4,4,12,Champions
58877,174,14,20,3,3,2,8,Loyal Users
59163,253,30,79,3,4,4,11,Loyal Users
59239,2713,7,24,1,2,2,5,Lost
60065,267,16,30,3,3,2,8,Loyal Users
60120,381,14,30,3,3,2,8,Loyal Users
60870,715,34,96,2,4,4,10,At Risk
61771,264,5,9,3,1,1,5,Casual Users
61871,387,18,54,3,3,3,9,Loyal Users
61915,23,22,57,5,4,3,12,Loyal Users
62237,73,54,123,4,5,4,13,Champions
62355,523,9,22,2,2,2,6,Lost
63067,413,18,73,3,3,4,10,Loyal Users
63251,409,14,68,3,3,4,10,Loyal Users
63634,999,8,10,2,2,1,5,Lost
63770,571,5,17,2,1,2,5,Lost
63823,2177,8,12,1,2,1,4,Lost
63983,4764,8,8,1,2,1,4,Lost
64450,1373,6,8,1,1,1,3,Lost
64886,1500,7,17,1,2,2,5,Lost
64960,1,8,17,5,2,2,9,Promising
65080,1116,5,9,2,1,1,4,Lost
65274,25,7,12,5,2,1,8,Promising
65356,1812,5,40,1,1,3,5,Lost
65380,2603,14,35,1,3,3,7,Casual Users
65409,1912,5,9,1,1,1,3,Lost
52392,309,27,60,3,4,3,10,Loyal Users
52622,2999,14,73,1,3,4,8,Casual Users
52641,30,5,8,5,1,1,7,Promising
52901,1274,10,50,1,2,3,6,Lost
52973,3936,6,24,1,1,2,4,Lost
53142,864,18,77,2,3,4,9,Casual Users
53282,39,13,60,5,3,3,11,Loyal Users
53301,187,24,49,3,4,3,10,Loyal Users
53358,155,36,60,4,4,3,11,Loyal Users
53375,509,34,58,2,4,3,9,At Risk
53612,143,64,188,4,5,5,14,Champions
53805,0,126,394,5,5,5,15,Champions
54039,122,70,193,4,5,5,14,Champions
54167,414,8,10,3,2,1,6,Casual Users
54263,67,13,16,5,3,2,10,Loyal Users
54288,275,16,40,3,3,3,9,Loyal Users
54304,125,19,64,4,3,4,11,Loyal Users
54392,3,55,324,5,5,5,15,Champions
54567,4277,6,15,1,1,1,3,Lost
55127,1016,22,27,2,4,2,8,At Risk
56456,8,13,31,5,3,2,10,Loyal Users
56500,1300,7,15,1,2,1,4,Lost
56575,5,156,309,5,5,5,15,Champions
56594,74,10,11,4,2,1,7,Promising
57328,110,6,7,4,1,1,6,Promising
57797,11,57,200,5,5,5,15,Champions
57802,0,85,176,5,5,5,15,Champions
58399,1114,15,20,2,3,2,7,Casual Users
58584,1005,12,27,2,3,2,7,Casual Users
58769,73,8,22,4,2,2,8,Promising
59010,1085,32,156,2,4,5,11,At Risk
59019,120,11,36,4,2,3,9,Promising
59078,1013,6,28,2,1,2,5,Lost
59553,2794,10,15,1,2,1,4,Lost
59659,147,66,191,4,5,5,14,Champions
59932,2430,9,17,1,2,2,5,Lost
59963,125,119,443,4,5,5,14,Champions
60147,505,23,42,2,4,3,9,At Risk
60413,224,16,100,3,3,4,10,Loyal Users
60592,658,7,16,2,2,2,6,Lost
60794,33,46,116,5,5,4,14,Champions
60863,3531,10,103,1,2,4,7,Lost
61258,3002,6,14,1,1,1,3,Lost
61410,25,49,140,5,5,4,14,Champions
61548,380,16,55,3,3,3,9,Loyal Users
61701,385,46,58,3,5,3,11,Loyal Users
61709,549,47,128,2,5,4,11,At Risk
61778,2161,7,59,1,2,3,6,Lost
62040,40,76,278,5,5,5,15,Champions
62114,146,69,232,4,5,5,14,Champions
62148,2240,6,25,1,1,2,4,Lost
62233,294,14,65,3,3,4,10,Loyal Users
62239,272,7,22,3,2,2,7,Casual Users
62343,147,17,26,4,3,2,9,Loyal Users
62481,3299,11,32,1,2,3,6,Lost
63264,352,18,70,3,3,4,10,Loyal Users
63317,182,12,36,3,3,3,9,Loyal Users
63366,587,6,78,2,1,4,7,Lost
63387,2064,6,9,1,1,1,3,Lost
63389,363,70,202,3,5,5,13,Loyal Users
63788,111,5,12,4,1,1,6,Promising
64039,319,17,79,3,3,4,10,Loyal Users
64154,203,11,28,3,2,2,7,Casual Users
64311,64,134,328,5,5,5,15,Champions
64376,1120,21,34,2,3,3,8,Casual Users
64436,1606,18,30,1,3,2,6,Casual Users
64542,1877,16,34,1,3,3,7,Casual Users
64635,741,5,7,2,1,1,4,Lost
64801,130,19,32,4,3,3,10,Loyal Users
64897,17,149,690,5,5,5,15,Champions
65018,352,13,16,3,3,2,8,Loyal Users
65151,54,40,82,5,4,4,13,Champions
52819,694,8,35,2,2,3,7,Lost
52868,139,7,78,4,2,4,10,Promising
53064,163,16,16,4,3,2,9,Loyal Users
53121,570,13,55,2,3,3,8,Casual Users
53439,2,39,96,5,4,4,13,Champions
53657,74,105,413,4,5,5,14,Champions
53715,368,17,33,3,3,3,9,Loyal Users
53748,1,100,423,5,5,5,15,Champions
53808,129,32,102,4,4,4,12,Champions
53858,1013,14,20,2,3,2,7,Casual Users
54391,25,66,121,5,5,4,14,Champions
54893,2828,5,16,1,1,2,4,Lost
55786,9,36,128,5,4,4,13,Champions
55969,11,41,136,5,4,4,13,Champions
56073,703,11,19,2,2,2,6,Lost
56082,135,82,159,4,5,5,14,Champions
56186,894,18,25,2,3,2,7,Casual Users
56278,3537,8,70,1,2,4,7,Lost
56918,1,43,105,5,4,4,13,Champions
56925,5252,5,19,1,1,2,4,Lost
57085,367,29,38,3,4,3,10,Loyal Users
57792,23,113,210,5,5,5,15,Champions
57824,47,116,500,5,5,5,15,Champions
58083,541,10,14,2,2,1,5,Lost
58176,388,44,53,3,4,3,10,Loyal Users
58250,191,6,12,3,1,1,5,Casual Users
58591,21,10,16,5,2,2,9,Promising
58685,155,25,55,4,4,3,11,Loyal Users
58706,409,14,66,3,3,4,10,Loyal Users
58743,289,9,10,3,2,1,6,Casual Users
58781,1018,8,14,2,2,1,5,Lost
58871,3129,5,14,1,1,1,3,Lost
59058,380,50,80,3,5,4,12,Loyal Users
59276,1502,17,105,1,3,4,8,Casual Users
60114,65,6,63,5,1,4,10,Promising
60260,208,9,30,3,2,2,7,Casual Users
60341,16,5,26,5,1,2,8,Promising
60364,246,22,53,3,4,3,10,Loyal Users
60425,86,29,87,4,4,4,12,Champions
60426,97,42,271,4,4,5,13,Champions
60572,4,11,47,5,2,3,10,Promising
60972,42,10,24,5,2,2,9,Promising
61030,196,67,174,3,5,5,13,Loyal Users
61373,7,84,138,5,5,4,14,Champions
61720,379,46,65,3,5,4,12,Loyal Users
62044,301,9,28,3,2,2,7,Casual Users
62212,45,71,203,5,5,5,15,Champions
62455,1432,22,35,1,4,3,8,At Risk
62476,403,12,36,3,3,3,9,Loyal Users
62708,2571,6,12,1,1,1,3,Lost
62789,30,11,44,5,2,3,10,Promising
63115,4293,7,7,1,2,1,4,Lost
63190,896,35,83,2,4,4,10,At Risk
63414,96,52,80,4,5,4,13,Champions
63479,427,30,67,3,4,4,11,Loyal Users
63618,2033,58,148,1,5,5,11,At Risk
63657,494,15,28,2,3,2,7,Casual Users
64656,5374,9,13,1,2,1,4,Lost
65170,21,117,318,5,5,5,15,Champions
65190,98,24,86,4,4,4,12,Champions
65290,262,9,35,3,2,3,8,Casual Users
52557,131,14,28,4,3,2,9,Loyal Users
52580,691,9,36,2,2,3,7,Lost
52994,439,15,29,3,3,2,8,Loyal Users
53284,111,44,96,4,4,4,12,Champions
53764,4693,6,8,1,1,1,3,Lost
54496,1004,7,25,2,2,2,6,Lost
54697,1688,12,12,1,3,1,5,Casual Users
54942,249,7,11,3,2,1,6,Casual Users
55195,2847,5,14,1,1,1,3,Lost
55657,1118,164,521,2,5,5,12,At Risk
55776,317,31,96,3,4,4,11,Loyal Users
56699,406,18,34,3,3,3,9,Loyal Users
56729,1701,8,33,1,2,3,6,Lost
56875,661,32,63,2,4,4,10,At Risk
57148,418,6,23,3,1,2,6,Casual Users
57361,12,137,461,5,5,5,15,Champions
57390,376,6,13,3,1,1,5,Casual Users
57608,129,17,89,4,3,4,11,Loyal Users
58085,193,5,10,3,1,1,5,Casual Users
58254,469,29,81,3,4,4,11,Loyal Users
58406,7,35,92,5,4,4,13,Champions
59131,3631,6,9,1,1,1,3,Lost
59319,718,84,129,2,5,4,11,At Risk
59381,66,33,160,5,4,5,14,Champions
59528,112,10,17,4,2,2,8,Promising
59693,3354,18,77,1,3,4,8,Casual Users
59707,90,17,113,4,3,4,11,Loyal Users
59741,411,9,53,3,2,3,8,Casual Users
59989,695,7,19,2,2,2,6,Lost
60040,138,13,19,4,3,2,9,Loyal Users
60551,104,62,135,4,5,4,13,Champions
60678,138,11,21,4,2,2,8,Promising
60806,84,20,111,4,3,4,11,Loyal Users
61114,1924,23,46,1,4,3,8,At Risk
61117,91,21,43,4,3,3,10,Loyal Users
61135,1160,8,9,2,2,1,5,Lost
61571,167,29,95,3,4,4,11,Loyal Users
61608,96,141,577,4,5,5,14,Champions
61874,49,14,23,5,3,2,10,Loyal Users
62066,3867,5,7,1,1,1,3,Lost
62357,1562,10,18,1,2,2,5,Lost
62515,40,54,177,5,5,5,15,Champions
62950,11,56,148,5,5,5,15,Champions
63258,2268,27,53,1,4,3,8,At Risk
63293,273,18,47,3,3,3,9,Loyal Users
63616,3263,11,16,1,2,2,5,Lost
63694,362,16,142,3,3,4,10,Loyal Users
63826,95,25,53,4,4,3,11,Loyal Users
64390,48,129,203,5,5,5,15,Champions
64624,1,76,238,5,5,5,15,Champions
64837,656,39,85,2,4,4,10,At Risk
64928,4882,9,10,1,2,1,4,Lost
65318,425,7,10,3,2,1,6,Casual Users
65365,56,87,320,5,5,5,15,Champions
52486,20,114,440,5,5,5,15,Champions
52632,1861,12,61,1,3,3,7,Casual Users
52748,317,17,42,3,3,3,9,Loyal Users
52787,265,99,330,3,5,5,13,Loyal Users
52969,853,5,6,2,1,1,4,Lost
53027,104,134,211,4,5,5,14,Champions
53105,1409,11,17,1,2,2,5,Lost
53295,682,23,82,2,4,4,10,At Risk
53337,2823,12,74,1,3,4,8,Casual Users
53360,112,180,227,4,5,5,14,Champions
53511,33,93,131,5,5,4,14,Champions
53517,1579,15,17,1,3,2,6,Casual Users
53628,1560,6,15,1,1,1,3,Lost
53673,293,10,22,3,2,2,7,Casual Users
53861,1733,5,7,1,1,1,3,Lost
53865,156,17,27,4,3,2,9,Loyal Users
53972,976,47,136,2,5,4,11,At Risk
53982,140,6,58,4,1,3,8,Promising
54318,1408,8,9,1,2,1,4,Lost
54603,292,10,93,3,2,4,9,Casual Users
54856,1012,7,62,2,2,3,7,Lost
55074,139,33,179,4,4,5,13,Champions
55132,274,28,51,3,4,3,10,Loyal Users
55632,284,8,16,3,2,2,7,Casual Users
55827,1494,33,63,1,4,4,9,At Risk
55948,422,20,30,3,3,2,8,Loyal Users
56056,1062,9,18,2,2,2,6,Lost
56160,642,20,91,2,3,4,9,Casual Users
56286,281,24,103,3,4,4,11,Loyal Users
56477,103,31,218,4,4,5,13,Champions
56671,679,21,37,2,3,3,8,Casual Users
56785,1661,10,16,1,2,2,5,Lost
56852,1557,8,11,1,2,1,4,Lost
57170,1610,26,100,1,4,4,9,At Risk
57282,125,24,34,4,4,3,11,Loyal Users
57459,3,17,30,5,3,2,10,Loyal Users
57564,291,17,62,3,3,3,9,Loyal Users
57596,246,40,244,3,4,5,12,Loyal Users
57880,128,18,69,4,3,4,11,Loyal Users
57982,126,10,23,4,2,2,8,Promising
57998,133,119,554,4,5,5,14,Champions
58048,0,96,384,5,5,5,15,Champions
58189,5,64,103,5,5,4,14,Champions
58312,67,8,31,5,2,2,9,Promising
58351,4,10,73,5,2,4,11,Promising
58460,963,6,9,2,1,1,4,Lost
58615,125,147,230,4,5,5,14,Champions
58909,422,19,49,3,3,3,9,Loyal Users
58924,4,22,33,5,4,3,12,Loyal Users
58953,112,51,222,4,5,5,14,Champions
58977,577,7,13,2,2,1,5,Lost
59287,225,18,68,3,3,4,10,Loyal Users
59316,1099,11,51,2,2,3,7,Lost
59425,291,18,74,3,3,4,10,Loyal Users
59452,1960,6,11,1,1,1,3,Lost
59494,8,61,199,5,5,5,15,Champions
59674,103,18,25,4,3,2,9,Loyal Users
59880,124,16,190,4,3,5,12,Loyal Users
60119,564,8,82,2,2,4,8,Lost
60337,847,5,7,2,1,1,4,Lost
60379,41,10,11,5,2,1,8,Promising
60953,581,11,49,2,2,3,7,Lost
61287,2043,8,18,1,2,2,5,Lost
61326,549,20,43,2,3,3,8,Casual Users
61458,440,5,63,3,1,4,8,Casual Users
61565,941,17,23,2,3,2,7,Casual Users
61686,1354,47,87,1,5,4,10,At Risk
61692,36,28,83,5,4,4,13,Champions
61740,2424,19,116,1,3,4,8,Casual Users
61878,144,7,27,4,2,2,8,Promising
62196,6,69,206,5,5,5,15,Champions
62650,3877,7,16,1,2,2,5,Lost
63229,421,10,44,3,2,3,8,Casual Users
63260,1148,10,31,2,2,2,6,Lost
63769,887,8,13,2,2,1,5,Lost
63886,120,56,219,4,5,5,14,Champions
63984,264,21,98,3,3,4,10,Loyal Users
64040,38,38,183,5,4,5,14,Champions
64124,96,92,145,4,5,4,13,Champions
64131,4084,5,11,1,1,1,3,Lost
64617,694,15,36,2,3,3,8,Casual Users
64917,485,9,16,2,2,2,6,Lost
64921,1015,8,16,2,2,2,6,Lost
52440,3258,5,26,1,1,2,4,Lost
52687,133,5,9,4,1,1,6,Promising
52934,522,5,13,2,1,1,4,Lost
52939,1115,31,45,2,4,3,9,At Risk
53074,373,12,28,3,3,2,8,Loyal Users
53456,98,74,144,4,5,4,13,Champions
53756,2769,6,8,1,1,1,3,Lost
53990,88,13,20,4,3,2,9,Loyal Users
54285,17,116,446,5,5,5,15,Champions
54427,3477,10,17,1,2,2,5,Lost
54479,23,102,634,5,5,5,15,Champions
54811,1557,12,44,1,3,3,7,Casual Users
54845,603,5,28,2,1,2,5,Lost
54882,698,10,14,2,2,1,5,Lost
55454,2730,5,25,1,1,2,4,Lost
55501,5040,20,20,1,3,2,6,Casual Users
55541,305,8,13,3,2,1,6,Casual Users
55796,2564,5,11,1,1,1,3,Lost
56163,95,19,26,4,3,2,9,Loyal Users
56340,167,61,109,3,5,4,12,Loyal Users
56871,499,55,396,2,5,5,12,At Risk
56898,2080,5,11,1,1,1,3,Lost
57157,1450,10,15,1,2,1,4,Lost
57175,279,5,22,3,1,2,6,Casual Users
57357,3375,6,9,1,1,1,3,Lost
57727,1282,9,12,1,2,1,4,Lost
57781,149,102,516,4,5,5,14,Champions
58101,112,67,322,4,5,5,14,Champions
58251,2166,7,8,1,2,1,4,Lost
58361,618,19,84,2,3,4,9,Casual Users
58499,7,160,448,5,5,5,15,Champions
58526,127,29,161,4,4,5,13,Champions
58993,123,43,173,4,4,5,13,Champions
59160,262,12,66,3,3,4,10,Loyal Users
59500,424,14,48,3,3,3,9,Loyal Users
59577,118,68,222,4,5,5,14,Champions
59615,10,67,260,5,5,5,15,Champions
59694,14,24,46,5,4,3,12,Loyal Users
59790,1140,25,57,2,4,3,9,At Risk
59853,334,12,18,3,3,2,8,Loyal Users
60064,998,13,70,2,3,4,9,Casual Users
60338,1696,5,19,1,1,2,4,Lost
60430,2414,17,28,1,3,2,6,Casual Users
60697,704,9,31,2,2,2,6,Lost
60967,1878,25,170,1,4,5,10,At Risk
61583,128,47,141,4,5,4,13,Champions
61616,2146,8,16,1,2,2,5,Lost
61687,476,8,12,2,2,1,5,Lost
61824,217,16,23,3,3,2,8,Loyal Users
61864,154,40,140,4,4,4,12,Champions
62063,576,6,49,2,1,3,6,Lost
62132,91,21,108,4,3,4,11,Loyal Users
62332,307,19,43,3,3,3,9,Loyal Users
62488,415,16,67,3,3,4,10,Loyal Users
62643,9,15,63,5,3,4,12,Loyal Users
62731,125,31,50,4,4,3,11,Loyal Users
62743,88,10,17,4,2,2,8,Promising
62944,252,14,51,3,3,3,9,Loyal Users
62969,2235,13,88,1,3,4,8,Casual Users
63473,371,15,35,3,3,3,9,Loyal Users
63601,190,5,9,3,1,1,5,Casual Users
63715,127,126,472,4,5,5,14,Champions
63897,2122,29,93,1,4,4,9,At Risk
64105,361,10,26,3,2,2,7,Casual Users
64251,154,8,8,4,2,1,7,Promising
64258,71,37,88,4,4,4,12,Champions
64387,20,26,43,5,4,3,12,Loyal Users
64454,1855,6,6,1,1,1,3,Lost
64695,694,13,19,2,3,2,7,Casual Users
65260,0,48,117,5,5,4,14,Champions
65314,221,239,335,3,5,5,13,Loyal Users
52542,46,6,9,5,1,1,7,Promising
52679,33,24,65,5,4,4,13,Champions
52814,3030,7,9,1,2,1,4,Lost
52879,128,5,15,4,1,1,6,Promising
53176,814,15,25,2,3,2,7,Casual Users
53234,72,36,115,4,4,4,12,Champions
53286,89,21,39,4,3,3,10,Loyal Users
53288,283,7,10,3,2,1,6,Casual Users
53378,21,11,18,5,2,2,9,Promising
53385,3433,5,10,1,1,1,3,Lost
53834,2709,6,7,1,1,1,3,Lost
54307,133,5,9,4,1,1,6,Promising
54320,3467,45,64,1,4,4,9,At Risk
54454,443,22,37,3,4,3,10,Loyal Users
54470,4027,8,10,1,2,1,4,Lost
54547,2157,13,19,1,3,2,6,Casual Users
54618,2254,5,8,1,1,1,3,Lost
54649,60,31,146,5,4,4,13,Champions
54825,86,7,69,4,2,4,10,Promising
55395,521,10,28,2,2,2,6,Lost
55617,1124,5,6,2,1,1,4,Lost
55649,505,23,56,2,4,3,9,At Risk
55692,33,57,109,5,5,4,14,Champions
55752,11,119,480,5,5,5,15,Champions
55790,538,8,19,2,2,2,6,Lost
56509,85,24,92,4,4,4,12,Champions
56615,130,9,26,4,2,2,8,Promising
56775,402,71,520,3,5,5,13,Loyal Users
57209,582,26,40,2,4,3,9,At Risk
57295,39,70,289,5,5,5,15,Champions
57311,117,70,242,4,5,5,14,Champions
57526,694,21,56,2,3,3,8,Casual Users
58640,8,5,20,5,1,2,8,Promising
58756,588,9,12,2,2,1,5,Lost
58963,642,30,51,2,4,3,9,At Risk
59132,66,8,38,5,2,3,10,Promising
59464,165,8,39,4,2,3,9,Promising
59599,310,15,61,3,3,3,9,Loyal Users
59627,302,8,37,3,2,3,8,Casual Users
59632,52,34,64,5,4,4,13,Champions
60058,128,12,162,4,3,5,12,Loyal Users
60237,82,8,28,4,2,2,8,Promising
60494,128,23,109,4,4,4,12,Champions
60744,12,52,411,5,5,5,15,Champions
60796,1964,20,62,1,3,3,7,Casual Users
61345,269,21,52,3,3,3,9,Loyal Users
61511,1511,9,10,1,2,1,4,Lost
61572,611,49,209,2,5,5,12,At Risk
61612,244,24,48,3,4,3,10,Loyal Users
61627,95,57,179,4,5,5,14,Champions
61765,2690,7,13,1,2,1,4,Lost
62163,19,8,19,5,2,2,9,Promising
62282,111,79,217,4,5,5,14,Champions
62334,3149,8,36,1,2,3,6,Lost
62653,209,29,162,3,4,5,12,Loyal Users
63201,86,6,13,4,1,1,6,Promising
63351,2233,9,40,1,2,3,6,Lost
63727,4635,11,19,1,2,2,5,Lost
64102,3031,5,10,1,1,1,3,Lost
64164,60,25,57,5,4,3,12,Loyal Users
64193,556,15,49,2,3,3,8,Casual Users
64394,2389,6,51,1,1,3,5,Lost
64397,224,71,441,3,5,5,13,Loyal Users
64663,1945,13,21,1,3,2,6,Casual Users
64682,4258,5,5,1,1,1,3,Lost
64826,29,59,145,5,5,4,14,Champions
52381,422,16,45,3,3,3,9,Loyal Users
52408,85,82,179,4,5,5,14,Champions
52443,486,5,20,2,1,2,5,Lost
52764,25,52,254,5,5,5,15,Champions
52946,974,5,18,2,1,2,5,Lost
52968,480,40,66,2,4,4,10,At Risk
53049,169,9,24,3,2,2,7,Casual Users
53309,3561,16,69,1,3,4,8,Casual Users
53519,1600,8,40,1,2,3,6,Lost
53541,441,66,148,3,5,5,13,Loyal Users
53688,31,143,199,5,5,5,15,Champions
53710,96,19,29,4,3,2,9,Loyal Users
53789,703,6,34,2,1,3,6,Lost
54085,135,6,9,4,1,1,6,Promising
54362,161,5,9,4,1,1,6,Promising
54974,1414,8,32,1,2,3,6,Lost
55319,143,8,13,4,2,1,7,Promising
55553,1104,39,56,2,4,3,9,At Risk
55584,89,37,85,4,4,4,12,Champions
55598,129,16,22,4,3,2,9,Loyal Users
55628,599,11,51,2,2,3,7,Lost
56396,408,5,12,3,1,1,5,Casual Users
57040,135,5,21,4,1,2,7,Promising
57116,68,41,63,5,4,4,13,Champions
57228,118,42,161,4,4,5,13,Champions
57350,174,14,44,3,3,3,9,Loyal Users
57474,372,15,27,3,3,2,8,Loyal Users
57478,1824,11,13,1,2,1,4,Lost
57622,67,9,27,5,2,2,9,Promising
57957,134,8,77,4,2,4,10,Promising
58669,30,68,372,5,5,5,15,Champions
58681,2408,16,54,1,3,3,7,Casual Users
59333,76,13,56,4,3,3,10,Loyal Users
59611,1422,16,73,1,3,4,8,Casual Users
59729,118,22,67,4,4,4,12,Champions
59774,5,38,64,5,4,4,13,Champions
59961,12,107,511,5,5,5,15,Champions
60093,123,48,146,4,5,4,13,Champions
60375,1715,10,10,1,2,1,4,Lost
60505,835,33,138,2,4,4,10,At Risk
60632,2557,7,9,1,2,1,4,Lost
60663,1092,9,13,2,2,1,5,Lost
60671,92,90,377,4,5,5,14,Champions
61131,289,5,21,3,1,2,6,Casual Users
61270,103,63,174,4,5,5,14,Champions
61391,96,12,15,4,3,1,8,Loyal Users
61464,1855,7,38,1,2,3,6,Lost
61557,405,44,138,3,4,4,11,Loyal Users
61563,2367,14,48,1,3,3,7,Casual Users
61814,2702,12,17,1,3,2,6,Casual Users
61949,52,17,83,5,3,4,12,Loyal Users
62185,896,17,72,2,3,4,9,Casual Users
62525,24,8,13,5,2,1,8,Promising
63086,1097,7,23,2,2,2,6,Lost
63333,420,13,38,3,3,3,9,Loyal Users
63695,208,17,46,3,3,3,9,Loyal Users
63703,123,56,173,4,5,5,14,Champions
63785,5151,5,17,1,1,2,4,Lost
63877,122,69,305,4,5,5,14,Champions
63910,113,17,93,4,3,4,11,Loyal Users
63998,17,10,11,5,2,1,8,Promising
63999,200,8,10,3,2,1,6,Casual Users
64020,31,82,132,5,5,4,14,Champions
64111,266,38,173,3,4,5,12,Loyal Users
64114,224,30,204,3,4,5,12,Loyal Users
64340,1207,6,14,2,1,1,4,Lost
64619,690,15,29,2,3,2,7,Casual Users
64661,591,8,19,2,2,2,6,Lost
65156,34,5,17,5,1,2,8,Promising
65397,708,9,26,2,2,2,6,Lost
52429,138,8,39,4,2,3,9,Promising
53225,69,96,175,5,5,5,15,Champions
53365,1984,12,24,1,3,2,6,Casual Users
53637,135,43,144,4,4,4,12,Champions
53697,686,25,123,2,4,4,10,At Risk
53840,1533,19,48,1,3,3,7,Casual Users
53864,48,32,85,5,4,4,13,Champions
54207,6,93,262,5,5,5,15,Champions
54371,1582,7,7,1,2,1,4,Lost
54383,132,40,160,4,4,5,13,Champions
54533,1745,41,124,1,4,4,9,At Risk
54637,1069,5,11,2,1,1,4,Lost
54751,104,7,14,4,2,1,7,Promising
55255,1105,5,7,2,1,1,4,Lost
55352,146,24,39,4,4,3,11,Loyal Users
55429,106,8,12,4,2,1,7,Promising
55566,121,23,84,4,4,4,12,Champions
55819,716,9,30,2,2,2,6,Lost
55945,5329,7,24,1,2,2,5,Lost
56006,7,145,662,5,5,5,15,Champions
56043,4634,5,14,1,1,1,3,Lost
56107,3938,8,11,1,2,1,4,Lost
56253,683,9,18,2,2,2,6,Lost
56296,402,11,48,3,2,3,8,Casual Users
56663,1465,8,25,1,2,2,5,Lost
56750,355,29,87,3,4,4,11,Loyal Users
56890,108,19,28,4,3,2,9,Loyal Users
56924,725,20,112,2,3,4,9,Casual Users
56970,773,8,68,2,2,4,8,Lost
57349,145,5,5,4,1,1,6,Promising
57510,1179,10,14,2,2,1,5,Lost
57801,1100,6,8,2,1,1,4,Lost
58077,985,13,18,2,3,2,7,Casual Users
58087,141,36,214,4,4,5,13,Champions
58103,3319,24,53,1,4,3,8,At Risk
58384,122,129,307,4,5,5,14,Champions
58593,905,10,20,2,2,2,6,Lost
58724,77,10,52,4,2,3,9,Promising
58895,872,82,208,2,5,5,12,At Risk
58991,3,54,93,5,5,4,14,Champions
59390,4,13,27,5,3,2,10,Loyal Users
59418,40,7,24,5,2,2,9,Promising
59588,804,7,37,2,2,3,7,Lost
59628,299,15,27,3,3,2,8,Loyal Users
59661,805,6,18,2,1,2,5,Lost
59749,2221,6,26,1,1,2,4,Lost
60090,1145,27,41,2,4,3,9,At Risk
60242,133,158,762,4,5,5,14,Champions
60275,131,50,189,4,5,5,14,Champions
60329,101,5,27,4,1,2,7,Promising
60650,418,36,83,3,4,4,11,Loyal Users
60667,306,13,25,3,3,2,8,Loyal Users
60761,3692,6,8,1,1,1,3,Lost
60836,288,8,13,3,2,1,6,Casual Users
60856,567,15,39,2,3,3,8,Casual Users
61251,1795,8,56,1,2,3,6,Lost
61676,16,73,176,5,5,5,15,Champions
61931,122,12,44,4,3,3,10,Loyal Users
62008,5072,5,32,1,1,3,5,Lost
62765,17,22,170,5,4,5,14,Champions
62796,380,12,58,3,3,3,9,Loyal Users
63103,1811,14,33,1,3,3,7,Casual Users
63250,79,24,52,4,4,3,11,Loyal Users
63316,119,35,175,4,4,5,13,Champions
63356,89,40,112,4,4,4,12,Champions
63524,80,44,91,4,4,4,12,Champions
63545,3859,6,9,1,1,1,3,Lost
63591,2411,11,34,1,2,3,6,Lost
63927,321,41,122,3,4,4,11,Loyal Users
63939,31,177,203,5,5,5,15,Champions
64162,115,12,29,4,3,2,9,Loyal Users
64540,27,142,502,5,5,5,15,Champions
64564,289,21,40,3,3,3,9,Loyal Users
64604,226,78,308,3,5,5,13,Loyal Users
64789,531,38,150,2,4,5,11,At Risk
64853,149,49,160,4,5,5,14,Champions
65067,47,11,11,5,2,1,8,Promising
52368,1273,8,9,1,2,1,4,Lost
52894,1161,18,70,2,3,4,9,Casual Users
52981,392,6,20,3,1,2,6,Casual Users
53122,2012,7,12,1,2,1,4,Lost
53730,126,30,151,4,4,5,13,Champions
53781,1115,7,34,2,2,3,7,Lost
54291,32,14,26,5,3,2,10,Loyal Users
54422,131,35,120,4,4,4,12,Champions
54483,1718,6,9,1,1,1,3,Lost
54653,479,7,46,2,2,3,7,Lost
54912,14,127,500,5,5,5,15,Champions
55034,850,8,55,2,2,3,7,Lost
55927,643,42,101,2,4,4,10,At Risk
55990,144,16,27,4,3,2,9,Loyal Users
56029,1413,5,8,1,1,1,3,Lost
56055,109,76,302,4,5,5,14,Champions
56147,585,38,62,2,4,3,9,At Risk
56404,108,8,48,4,2,3,9,Promising
56614,586,47,71,2,5,4,11,At Risk
56823,118,6,20,4,1,2,7,Promising
56903,413,20,52,3,3,3,9,Loyal Users
57056,301,42,144,3,4,4,11,Loyal Users
57215,148,11,43,4,2,3,9,Promising
57332,1,155,246,5,5,5,15,Champions
57640,4489,8,12,1,2,1,4,Lost
58005,1386,5,6,1,1,1,3,Lost
58260,1007,5,7,2,1,1,4,Lost
58346,178,6,22,3,1,2,6,Casual Users
58388,9,26,50,5,4,3,12,Loyal Users
58397,415,11,72,3,2,4,9,Casual Users
58881,1312,12,24,1,3,2,6,Casual Users
58885,151,85,191,4,5,5,14,Champions
58942,0,38,116,5,4,4,13,Champions
59002,1563,9,35,1,2,3,6,Lost
59407,843,8,62,2,2,3,7,Lost
59618,83,124,434,4,5,5,14,Champions
60239,122,54,361,4,5,5,14,Champions
60556,7,95,187,5,5,5,15,Champions
60566,130,18,24,4,3,2,9,Loyal Users
60568,113,13,50,4,3,3,10,Loyal Users
60723,812,17,139,2,3,4,9,Casual Users
60726,10,51,72,5,5,4,14,Champions
61044,2543,5,8,1,1,1,3,Lost
61115,102,22,118,4,4,4,12,Champions
61543,3082,7,20,1,2,2,5,Lost
61655,41,46,58,5,5,3,13,Loyal Users
62175,423,22,103,3,4,4,11,Loyal Users
62497,76,220,527,4,5,5,14,Champions
62586,270,6,12,3,1,1,5,Casual Users
62764,85,164,622,4,5,5,14,Champions
62891,309,28,51,3,4,3,10,Loyal Users
63301,418,44,84,3,4,4,11,Loyal Users
63398,29,51,190,5,5,5,15,Champions
63582,549,5,7,2,1,1,4,Lost
63734,11,67,240,5,5,5,15,Champions
63990,8,63,135,5,5,4,14,Champions
64142,144,46,101,4,5,4,13,Champions
64300,3944,5,14,1,1,1,3,Lost
64362,184,17,26,3,3,2,8,Loyal Users
64488,268,17,56,3,3,3,9,Loyal Users
64505,2274,6,11,1,1,1,3,Lost
64513,599,6,31,2,1,2,5,Lost
64530,1849,7,39,1,2,3,6,Lost
64546,216,15,73,3,3,4,10,Loyal Users
64570,569,16,29,2,3,2,7,Casual Users
64966,29,48,488,5,5,5,15,Champions
65202,1398,10,12,1,2,1,4,Lost
65404,1580,16,41,1,3,3,7,Casual Users
52490,696,9,21,2,2,2,6,Lost
52575,135,5,25,4,1,2,7,Promising
52590,981,25,39,2,4,3,9,At Risk
52753,99,7,14,4,2,1,7,Promising
53350,964,25,92,2,4,4,10,At Risk
53355,653,10,44,2,2,3,7,Lost
53787,1118,11,46,2,2,3,7,Lost
54227,1264,10,51,1,2,3,6,Lost
54397,14,41,113,5,4,4,13,Champions
54480,20,8,36,5,2,3,10,Promising
54648,5,40,421,5,4,5,14,Champions
55118,4864,16,30,1,3,2,6,Casual Users
55236,3,21,39,5,3,3,11,Loyal Users
55556,40,26,45,5,4,3,12,Loyal Users
55655,235,31,71,3,4,4,11,Loyal Users
55735,156,63,161,4,5,5,14,Champions
56078,834,9,13,2,2,1,5,Lost
56263,2203,6,10,1,1,1,3,Lost
56517,872,8,18,2,2,2,6,Lost
56694,290,11,17,3,2,2,7,Casual Users
56885,135,14,38,4,3,3,10,Loyal Users
57088,815,8,13,2,2,1,5,Lost
57103,89,79,309,4,5,5,14,Champions
57466,0,14,68,5,3,4,12,Loyal Users
57498,71,8,22,4,2,2,8,Promising
58043,454,19,40,3,3,3,9,Loyal Users
58602,1419,5,8,1,1,1,3,Lost
58662,566,12,17,2,3,2,7,Casual Users
59090,5896,5,10,1,1,1,3,Lost
59181,9,24,73,5,4,4,13,Champions
59298,844,5,12,2,1,1,4,Lost
59385,213,12,21,3,3,2,8,Loyal Users
59600,0,31,199,5,4,5,14,Champions
59642,401,6,14,3,1,1,5,Casual Users
59810,37,88,344,5,5,5,15,Champions
59811,69,5,15,5,1,1,7,Promising
60108,129,26,83,4,4,4,12,Champions
60206,2231,9,13,1,2,1,4,Lost
60377,2829,14,76,1,3,4,8,Casual Users
60476,141,17,62,4,3,3,10,Loyal Users
60637,1318,6,13,1,1,1,3,Lost
60787,2449,11,15,1,2,1,4,Lost
61195,1087,43,61,2,4,3,9,At Risk
61260,12,16,43,5,3,3,11,Loyal Users
61685,254,37,54,3,4,3,10,Loyal Users
61697,1283,5,7,1,1,1,3,Lost
61729,126,36,131,4,4,4,12,Champions
62133,2,11,69,5,2,4,11,Promising
62518,382,35,57,3,4,3,10,Loyal Users
62848,144,39,100,4,4,4,12,Champions
63195,212,62,107,3,5,4,12,Loyal Users
63367,258,20,95,3,3,4,10,Loyal Users
63776,29,94,656,5,5,5,15,Champions
63891,1533,13,32,1,3,3,7,Casual Users
64183,16,46,146,5,5,4,14,Champions
64410,303,5,6,3,1,1,5,Casual Users
64448,574,13,26,2,3,2,7,Casual Users
64492,699,12,65,2,3,4,9,Casual Users
64508,88,103,219,4,5,5,14,Champions
64718,75,134,281,4,5,5,14,Champions
64951,1,108,309,5,5,5,15,Champions
65042,59,13,29,5,3,2,10,Loyal Users
65065,107,52,210,4,5,5,14,Champions
65126,74,15,22,4,3,2,9,Loyal Users
65280,574,121,150,2,5,5,12,At Risk
65295,86,13,26,4,3,2,9,Loyal Users
52461,2605,5,35,1,1,3,5,Lost
52664,392,7,14,3,2,1,6,Casual Users
52742,671,26,37,2,4,3,9,At Risk
52795,215,5,7,3,1,1,5,Casual Users
53169,128,6,17,4,1,2,7,Promising
53410,993,46,105,2,5,4,11,At Risk
53509,15,93,367,5,5,5,15,Champions
53707,1854,41,254,1,4,5,10,At Risk
53937,3129,10,41,1,2,3,6,Lost
53955,1,127,268,5,5,5,15,Champions
54250,415,15,18,3,3,2,8,Loyal Users
54325,1235,46,285,2,5,5,12,At Risk
54494,13,33,125,5,4,4,13,Champions
54630,376,6,69,3,1,4,8,Casual Users
54675,19,108,226,5,5,5,15,Champions
54849,3415,7,24,1,2,2,5,Lost
54936,179,27,174,3,4,5,12,Loyal Users
55531,392,20,63,3,3,4,10,Loyal Users
55702,967,6,45,2,1,3,6,Lost
55950,76,42,68,4,4,4,12,Champions
55985,2978,5,8,1,1,1,3,Lost
56001,674,17,22,2,3,2,7,Casual Users
56260,407,47,133,3,5,4,12,Loyal Users
56701,559,6,11,2,1,1,4,Lost
56702,706,5,19,2,1,2,5,Lost
56721,448,6,7,3,1,1,5,Casual Users
56971,694,17,67,2,3,4,9,Casual Users
56978,1017,5,18,2,1,2,5,Lost
57211,859,12,21,2,3,2,7,Casual Users
57576,2071,5,10,1,1,1,3,Lost
57830,1128,5,6,2,1,1,4,Lost
57932,752,9,52,2,2,3,7,Lost
58419,583,5,57,2,1,3,6,Lost
58500,883,9,15,2,2,1,5,Lost
58656,140,95,149,4,5,5,14,Champions
58744,240,59,141,3,5,4,12,Loyal Users
58928,9,149,193,5,5,5,15,Champions
58995,979,30,102,2,4,4,10,At Risk
59281,177,6,11,3,1,1,5,Casual Users
59299,5285,8,12,1,2,1,4,Lost
59382,1397,10,59,1,2,3,6,Lost
59540,2690,7,14,1,2,1,4,Lost
59671,1081,8,25,2,2,2,6,Lost
59691,28,153,300,5,5,5,15,Champions
59815,2543,13,20,1,3,2,6,Casual Users
59850,1636,5,13,1,1,1,3,Lost
59969,12,60,158,5,5,5,15,Champions
60082,39,44,190,5,4,5,14,Champions
60225,530,5,7,2,1,1,4,Lost
60549,575,20,102,2,3,4,9,Casual Users
61002,177,15,60,3,3,3,9,Loyal Users
61016,841,5,34,2,1,3,6,Lost
61375,564,10,22,2,2,2,6,Lost
61442,27,141,167,5,5,5,15,Champions
61529,690,8,20,2,2,2,6,Lost
61601,1234,15,41,2,3,3,8,Casual Users
61646,2561,7,14,1,2,1,4,Lost
61680,664,23,185,2,4,5,11,At Risk
61790,0,5,9,5,1,1,7,Promising
61885,56,48,169,5,5,5,15,Champions
61914,735,16,65,2,3,4,9,Casual Users
62307,54,56,149,5,5,5,15,Champions
62790,2070,30,137,1,4,4,9,At Risk
62793,38,32,45,5,4,3,12,Loyal Users
62968,869,15,136,2,3,4,9,Casual Users
62998,96,36,117,4,4,4,12,Champions
63272,4607,5,5,1,1,1,3,Lost
63298,695,8,19,2,2,2,6,Lost
64064,256,68,207,3,5,5,13,Loyal Users
64100,1687,5,5,1,1,1,3,Lost
64905,208,10,12,3,2,1,6,Casual Users
64911,587,17,52,2,3,3,8,Casual Users
65247,1849,5,6,1,1,1,3,Lost
52394,126,40,142,4,4,4,12,Champions
52654,273,34,70,3,4,4,11,Loyal Users
52671,97,12,21,4,3,2,9,Loyal Users
52728,128,7,16,4,2,2,8,Promising
52769,135,10,17,4,2,2,8,Promising
53060,1125,87,348,2,5,5,12,At Risk
53076,1575,9,14,1,2,1,4,Lost
53558,147,62,149,4,5,5,14,Champions
53761,74,6,20,4,1,2,7,Promising
53798,18,16,37,5,3,3,11,Loyal Users
55485,842,22,48,2,4,3,9,At Risk
55729,86,44,76,4,4,4,12,Champions
55833,2269,5,6,1,1,1,3,Lost
56230,2123,5,7,1,1,1,3,Lost
56359,3992,6,6,1,1,1,3,Lost
57392,196,67,181,3,5,5,13,Loyal Users
57457,117,40,288,4,4,5,13,Champions
57477,1472,5,7,1,1,1,3,Lost
57731,104,73,216,4,5,5,14,Champions
57748,478,97,479,2,5,5,12,At Risk
57941,956,6,25,2,1,2,5,Lost
57974,185,27,81,3,4,4,11,Loyal Users
58253,4,77,180,5,5,5,15,Champions
58541,116,46,91,4,5,4,13,Champions
58629,812,9,15,2,2,1,5,Lost
58941,2490,10,25,1,2,2,5,Lost
59022,32,20,83,5,3,4,12,Loyal Users
59453,9,77,318,5,5,5,15,Champions
59505,218,6,14,3,1,1,5,Casual Users
59825,918,10,16,2,2,2,6,Lost
59975,415,11,17,3,2,2,7,Casual Users
60172,920,5,13,2,1,1,4,Lost
60477,290,6,7,3,1,1,5,Casual Users
60620,2645,12,50,1,3,3,7,Casual Users
60790,515,17,40,2,3,3,8,Casual Users
60888,131,49,143,4,5,4,13,Champions
61447,92,36,87,4,4,4,12,Champions
61662,468,36,93,3,4,4,11,Loyal Users
61665,44,53,118,5,5,4,14,Champions
61718,179,5,6,3,1,1,5,Casual Users
61803,131,56,76,4,5,4,13,Champions
62149,6,30,105,5,4,4,13,Champions
62321,160,83,162,4,5,5,14,Champions
62524,6,72,209,5,5,5,15,Champions
62865,141,13,31,4,3,2,9,Loyal Users
62986,363,15,39,3,3,3,9,Loyal Users
63004,103,79,519,4,5,5,14,Champions
63062,1137,7,16,2,2,2,6,Lost
63171,109,14,30,4,3,2,9,Loyal Users
63465,28,72,364,5,5,5,15,Champions
63606,974,9,14,2,2,1,5,Lost
63614,4161,5,5,1,1,1,3,Lost
63655,995,31,87,2,4,4,10,At Risk
64001,780,12,120,2,3,4,9,Casual Users
64062,691,21,43,2,3,3,8,Casual Users
64468,47,95,299,5,5,5,15,Champions
64669,132,24,47,4,4,3,11,Loyal Users
64693,1580,10,13,1,2,1,4,Lost
64754,2549,5,6,1,1,1,3,Lost
64889,150,67,102,4,5,4,13,Champions
64891,309,22,35,3,4,3,10,Loyal Users
65128,324,11,28,3,2,2,7,Casual Users
65191,27,5,9,5,1,1,7,Promising
65401,4,33,104,5,4,4,13,Champions
53326,281,8,28,3,2,2,7,Casual Users
53643,2,29,76,5,4,4,13,Champions
53773,128,11,31,4,2,2,8,Promising
53843,116,16,23,4,3,2,9,Loyal Users
53897,59,44,169,5,4,5,14,Champions
54620,86,24,49,4,4,3,11,Loyal Users
54710,3725,5,11,1,1,1,3,Lost
54985,145,5,6,4,1,1,6,Promising
55718,2990,6,38,1,1,3,5,Lost
55760,125,25,50,4,4,3,11,Loyal Users
55778,211,108,203,3,5,5,13,Loyal Users
56035,2071,5,8,1,1,1,3,Lost
56231,1,81,233,5,5,5,15,Champions
56625,2799,6,8,1,1,1,3,Lost
57026,994,13,25,2,3,2,7,Casual Users
57035,5065,6,10,1,1,1,3,Lost
57065,41,17,29,5,3,2,10,Loyal Users
57491,118,21,57,4,3,3,10,Loyal Users
57656,1857,14,51,1,3,3,7,Casual Users
58099,121,24,79,4,4,4,12,Champions
58214,571,47,217,2,5,5,12,At Risk
58463,163,7,13,4,2,1,7,Promising
58552,219,57,255,3,5,5,13,Loyal Users
58805,3,115,574,5,5,5,15,Champions
58883,673,26,44,2,4,3,9,At Risk
58981,34,113,519,5,5,5,15,Champions
58982,168,42,86,3,4,4,11,Loyal Users
59492,14,12,22,5,3,2,10,Loyal Users
59499,285,15,31,3,3,2,8,Loyal Users
59864,68,72,287,5,5,5,15,Champions
59883,5105,10,15,1,2,1,4,Lost
59931,1291,5,31,1,1,2,4,Lost
60389,878,12,47,2,3,3,8,Casual Users
60905,121,31,283,4,4,5,13,Champions
61259,249,18,95,3,3,4,10,Loyal Users
62896,0,14,24,5,3,2,10,Loyal Users
63061,269,13,86,3,3,4,10,Loyal Users
63279,81,47,284,4,5,5,14,Champions
63348,785,43,173,2,4,5,11,At Risk
63357,3187,13,76,1,3,4,8,Casual Users
63556,482,13,27,2,3,2,7,Casual Users
64206,69,45,71,5,4,4,13,Champions
64270,5,89,422,5,5,5,15,Champions
64324,6,22,63,5,4,4,13,Champions
64476,3,5,29,5,1,2,8,Promising
64742,174,13,19,3,3,2,8,Loyal Users
64870,453,21,41,3,3,3,9,Loyal Users
64965,435,11,44,3,2,3,8,Casual Users
65242,139,39,123,4,4,4,12,Champions
65264,925,5,27,2,1,2,5,Lost
65371,34,78,525,5,5,5,15,Champions
52724,164,31,316,4,4,5,13,Champions
53155,20,90,131,5,5,4,14,Champions
53186,35,82,192,5,5,5,15,Champions
53308,206,8,15,3,2,1,6,Casual Users
53373,308,8,11,3,2,1,6,Casual Users
53407,217,6,7,3,1,1,5,Casual Users
53512,30,25,80,5,4,4,13,Champions
53539,124,114,284,4,5,5,14,Champions
53573,405,23,39,3,4,3,10,Loyal Users
53598,89,80,187,4,5,5,14,Champions
53859,894,5,5,2,1,1,4,Lost
54074,49,91,247,5,5,5,15,Champions
54214,1054,5,9,2,1,1,4,Lost
54664,456,6,13,3,1,1,5,Casual Users
55261,13,46,162,5,5,5,15,Champions
55935,1656,17,81,1,3,4,8,Casual Users
55937,831,20,65,2,3,4,9,Casual Users
56307,270,16,27,3,3,2,8,Loyal Users
56589,1683,12,24,1,3,2,6,Casual Users
56628,0,78,313,5,5,5,15,Champions
56849,270,48,186,3,5,5,13,Loyal Users
57099,581,17,43,2,3,3,8,Casual Users
57429,284,51,190,3,5,5,13,Loyal Users
58168,607,6,6,2,1,1,4,Lost
58450,16,67,233,5,5,5,15,Champions
58581,1845,12,62,1,3,3,7,Casual Users
58597,420,27,213,3,4,5,12,Loyal Users
58683,1289,5,6,1,1,1,3,Lost
58758,1487,10,53,1,2,3,6,Lost
58792,1040,10,10,2,2,1,5,Lost
59858,76,149,500,4,5,5,14,Champions
59955,9,31,178,5,4,5,14,Champions
60131,81,46,192,4,5,5,14,Champions
60283,274,6,33,3,1,3,7,Casual Users
60733,1128,11,17,2,2,2,6,Lost
60735,69,16,47,5,3,3,11,Loyal Users
61029,448,29,71,3,4,4,11,Loyal Users
61109,814,50,103,2,5,4,11,At Risk
61113,2830,19,61,1,3,3,7,Casual Users
61132,883,19,29,2,3,2,7,Casual Users
61193,1264,5,5,1,1,1,3,Lost
61261,129,53,243,4,5,5,14,Champions
61312,303,10,39,3,2,3,8,Casual Users
61333,2129,12,14,1,3,1,5,Casual Users
61348,201,17,45,3,3,3,9,Loyal Users
61445,82,43,130,4,4,4,12,Champions
61515,586,10,20,2,2,2,6,Lost
61714,334,19,27,3,3,2,8,Loyal Users
61733,1252,18,28,2,3,2,7,Casual Users
62268,101,6,13,4,1,1,6,Promising
62499,1026,26,139,2,4,4,10,At Risk
62788,60,130,485,5,5,5,15,Champions
63183,8,45,80,5,4,4,13,Champions
63425,237,11,36,3,2,3,8,Casual Users
63568,5,45,72,5,4,4,13,Champions
63595,85,5,10,4,1,1,6,Promising
63752,397,12,19,3,3,2,8,Loyal Users
63771,40,15,19,5,3,2,10,Loyal Users
64190,117,26,29,4,4,2,10,Loyal Users
64561,344,9,70,3,2,4,9,Casual Users
64764,3118,10,29,1,2,2,5,Lost
64981,1267,10,35,1,2,3,6,Lost
64992,272,13,20,3,3,2,8,Loyal Users
65284,139,45,123,4,4,4,12,Champions
65407,84,11,23,4,2,2,8,Promising
52411,1139,21,25,2,3,2,7,Casual Users
52524,1506,14,23,1,3,2,6,Casual Users
52569,209,68,172,3,5,5,13,Loyal Users
52623,16,14,114,5,3,4,12,Loyal Users
52900,115,93,305,4,5,5,14,Champions
52982,150,10,154,4,2,5,11,Promising
53235,336,11,21,3,2,2,7,Casual Users
53418,124,31,129,4,4,4,12,Champions
53563,175,14,24,3,3,2,8,Loyal Users
53813,20,73,127,5,5,4,14,Champions
53984,1306,39,72,1,4,4,9,At Risk
54144,253,43,114,3,4,4,11,Loyal Users
54184,1395,12,76,1,3,4,8,Casual Users
54553,985,6,8,2,1,1,4,Lost
54708,3375,15,35,1,3,3,7,Casual Users
54776,4967,6,28,1,1,2,4,Lost
54858,724,29,127,2,4,4,10,At Risk
55251,44,52,144,5,5,4,14,Champions
55571,150,6,21,4,1,2,7,Promising
55929,569,9,11,2,2,1,5,Lost
56065,689,30,63,2,4,4,10,At Risk
56067,311,56,101,3,5,4,12,Loyal Users
56120,941,5,39,2,1,3,6,Lost
56225,276,7,10,3,2,1,6,Casual Users
56618,111,86,227,4,5,5,14,Champions
56755,20,21,42,5,3,3,11,Loyal Users
56774,16,21,42,5,3,3,11,Loyal Users
56841,127,6,10,4,1,1,6,Promising
56887,940,19,75,2,3,4,9,Casual Users
57064,783,5,35,2,1,3,6,Lost
57195,8,159,607,5,5,5,15,Champions
57197,23,82,204,5,5,5,15,Champions
57443,119,12,50,4,3,3,10,Loyal Users
57519,683,7,20,2,2,2,6,Lost
57723,16,196,624,5,5,5,15,Champions
57825,610,23,29,2,4,2,8,At Risk
57875,7,63,99,5,5,4,14,Champions
58167,5637,6,6,1,1,1,3,Lost
58671,513,10,25,2,2,2,6,Lost
58946,45,12,22,5,3,2,10,Loyal Users
59585,30,18,58,5,3,3,11,Loyal Users
60350,487,9,23,2,2,2,6,Lost
60574,436,49,145,3,5,4,12,Loyal Users
60831,274,28,41,3,4,3,10,Loyal Users
61004,163,17,107,4,3,4,11,Loyal Users
61534,183,10,24,3,2,2,7,Casual Users
61769,6131,9,9,1,2,1,4,Lost
61886,272,20,182,3,3,5,11,Loyal Users
62401,2848,5,11,1,1,1,3,Lost
62617,113,20,170,4,3,5,12,Loyal Users
62641,134,20,27,4,3,2,9,Loyal Users
63644,94,11,45,4,2,3,9,Promising
63858,195,6,6,3,1,1,5,Casual Users
63950,590,15,120,2,3,4,9,Casual Users
63982,756,5,5,2,1,1,4,Lost
64972,667,24,31,2,4,2,8,At Risk
64987,525,5,9,2,1,1,4,Lost
65045,3675,9,16,1,2,2,5,Lost
65153,612,6,22,2,1,2,5,Lost
65157,67,54,263,5,5,5,15,Champions
52367,1058,7,17,2,2,2,6,Lost
52395,64,6,15,5,1,1,7,Promising
52485,163,109,610,4,5,5,14,Champions
52566,1617,15,28,1,3,2,6,Casual Users
52625,2274,8,20,1,2,2,5,Lost
52677,49,155,728,5,5,5,15,Champions
53405,704,14,42,2,3,3,8,Casual Users
53588,1551,11,15,1,2,1,4,Lost
53611,112,48,134,4,5,4,13,Champions
53613,137,111,441,4,5,5,14,Champions
53821,1024,41,144,2,4,4,10,At Risk
54120,3960,8,9,1,2,1,4,Lost
54161,129,85,281,4,5,5,14,Champions
54643,141,15,23,4,3,2,9,Loyal Users
54673,225,95,280,3,5,5,13,Loyal Users
54878,101,12,203,4,3,5,12,Loyal Users
54955,5432,7,8,1,2,1,4,Lost
55073,594,8,58,2,2,3,7,Lost
55099,1007,8,42,2,2,3,7,Lost
55181,193,6,34,3,1,3,7,Casual Users
55266,219,29,48,3,4,3,10,Loyal Users
55510,1531,6,52,1,1,3,5,Lost
56015,307,9,39,3,2,3,8,Casual Users
56195,1815,11,17,1,2,2,5,Lost
56330,2269,7,22,1,2,2,5,Lost
56581,111,20,36,4,3,3,10,Loyal Users
56816,1289,11,14,1,2,1,4,Lost
56912,170,7,11,3,2,1,6,Casual Users
57166,294,10,20,3,2,2,7,Casual Users
57588,593,16,23,2,3,2,7,Casual Users
57729,270,8,22,3,2,2,7,Casual Users
58140,413,10,50,3,2,3,8,Casual Users
58180,128,19,161,4,3,5,12,Loyal Users
58524,153,10,14,4,2,1,7,Promising
58785,1024,18,114,2,3,4,9,Casual Users
58938,415,9,47,3,2,3,8,Casual Users
59051,421,12,29,3,3,2,8,Loyal Users
59083,2741,10,16,1,2,2,5,Lost
59130,104,45,119,4,4,4,12,Champions
59138,6,157,412,5,5,5,15,Champions
59191,2119,8,26,1,2,2,5,Lost
59391,2,71,308,5,5,5,15,Champions
59495,1395,5,9,1,1,1,3,Lost
59756,386,105,327,3,5,5,13,Loyal Users
60151,102,22,41,4,4,3,11,Loyal Users
60459,123,54,107,4,5,4,13,Champions
60756,1118,8,47,2,2,3,7,Lost
61084,5871,10,29,1,2,2,5,Lost
61130,883,10,16,2,2,2,6,Lost
61248,147,6,25,4,1,2,7,Promising
61546,1961,26,124,1,4,4,9,At Risk
61586,30,53,86,5,5,4,14,Champions
61603,212,63,330,3,5,5,13,Loyal Users
61713,8,7,105,5,2,4,11,Promising
61853,4687,18,22,1,3,2,6,Casual Users
61927,268,40,89,3,4,4,11,Loyal Users
61993,419,6,36,3,1,3,7,Casual Users
62118,1568,6,11,1,1,1,3,Lost
62390,134,48,294,4,5,5,14,Champions
62674,475,15,39,2,3,3,8,Casual Users
62908,716,6,8,2,1,1,4,Lost
62956,1425,7,9,1,2,1,4,Lost
63083,271,20,211,3,3,5,11,Loyal Users
63085,3,23,74,5,4,4,13,Champions
63166,153,14,139,4,3,4,11,Loyal Users
63688,90,16,22,4,3,2,9,Loyal Users
64186,570,6,28,2,1,2,5,Lost
64337,1462,15,23,1,3,2,6,Casual Users
64346,446,17,28,3,3,2,8,Loyal Users
64434,486,33,70,2,4,4,10,At Risk
52379,1532,11,71,1,2,4,7,Lost
52419,2004,11,19,1,2,2,5,Lost
53005,2031,5,9,1,1,1,3,Lost
53180,287,24,55,3,4,3,10,Loyal Users
53184,1192,27,154,2,4,5,11,At Risk
53577,3563,12,18,1,3,2,6,Casual Users
53671,297,47,137,3,5,4,12,Loyal Users
54073,2438,17,48,1,3,3,7,Casual Users
54253,332,6,13,3,1,1,5,Casual Users
54540,839,11,25,2,2,2,6,Lost
54798,26,140,420,5,5,5,15,Champions
55161,95,44,113,4,4,4,12,Champions
55218,110,74,208,4,5,5,14,Champions
55389,108,24,41,4,4,3,11,Loyal Users
55525,109,35,55,4,4,3,11,Loyal Users
55675,1354,7,19,1,2,2,5,Lost
56076,419,14,27,3,3,2,8,Loyal Users
56141,979,6,10,2,1,1,4,Lost
56174,406,23,58,3,4,3,10,Loyal Users
56550,98,112,948,4,5,5,14,Champions
56642,4003,5,5,1,1,1,3,Lost
56657,1260,15,60,1,3,3,7,Casual Users
57292,90,11,13,4,2,1,7,Promising
57297,618,12,15,2,3,1,6,Casual Users
57319,239,9,99,3,2,4,9,Casual Users
57446,3660,10,33,1,2,3,6,Lost
57660,1718,18,67,1,3,4,8,Casual Users
57964,1836,19,99,1,3,4,8,Casual Users
57970,9,97,511,5,5,5,15,Champions
58134,569,9,50,2,2,3,7,Lost
58238,814,17,64,2,3,4,9,Casual Users
59052,10,9,81,5,2,4,11,Promising
59133,88,45,79,4,4,4,12,Champions
59262,840,7,35,2,2,3,7,Lost
59543,44,107,479,5,5,5,15,Champions
60197,2405,8,20,1,2,2,5,Lost
60232,389,54,60,3,5,3,11,Loyal Users
60809,1304,11,29,1,2,2,5,Lost
60903,2,70,275,5,5,5,15,Champions
61244,79,16,26,4,3,2,9,Loyal Users
62585,1168,10,35,2,2,3,7,Lost
62621,414,9,22,3,2,2,7,Casual Users
62622,2303,11,19,1,2,2,5,Lost
63125,273,70,121,3,5,4,12,Loyal Users
63170,116,95,588,4,5,5,14,Champions
63304,2,104,236,5,5,5,15,Champions
63520,12,82,125,5,5,4,14,Champions
64329,1543,9,16,1,2,2,5,Lost
64503,112,70,161,4,5,5,14,Champions
64763,2235,6,68,1,1,4,6,Lost
65125,2503,14,34,1,3,3,7,Casual Users
65205,31,149,187,5,5,5,15,Champions
52647,14,33,95,5,4,4,13,Champions
52851,15,81,215,5,5,5,15,Champions
52895,856,32,111,2,4,4,10,At Risk
53081,51,6,9,5,1,1,7,Promising
53396,3203,9,13,1,2,1,4,Lost
53521,571,6,25,2,1,2,5,Lost
53624,275,10,28,3,2,2,7,Casual Users
53645,9,50,68,5,5,4,14,Champions
53799,41,22,83,5,4,4,13,Champions
54078,130,12,52,4,3,3,10,Loyal Users
54220,32,110,259,5,5,5,15,Champions
54499,282,25,29,3,4,2,9,Loyal Users
54714,56,65,336,5,5,5,15,Champions
54965,718,6,7,2,1,1,4,Lost
54971,246,6,34,3,1,3,7,Casual Users
54995,517,8,19,2,2,2,6,Lost
55201,123,54,152,4,5,5,14,Champions
55297,757,9,18,2,2,2,6,Lost
55399,2813,10,17,1,2,2,5,Lost
56079,56,18,52,5,3,3,11,Loyal Users
56136,744,5,5,2,1,1,4,Lost
56395,161,36,68,4,4,4,12,Champions
56409,1586,5,6,1,1,1,3,Lost
56481,163,85,119,4,5,4,13,Champions
56599,2556,8,11,1,2,1,4,Lost
57219,1094,12,57,2,3,3,8,Casual Users
57334,107,46,295,4,5,5,14,Champions
57409,569,16,52,2,3,3,8,Casual Users
57718,0,85,460,5,5,5,15,Champions
57809,972,7,27,2,2,2,6,Lost
57917,1102,7,13,2,2,1,5,Lost
57947,57,55,92,5,5,4,14,Champions
58129,3696,5,5,1,1,1,3,Lost
58197,386,9,27,3,2,2,7,Casual Users
58213,143,73,226,4,5,5,14,Champions
58445,18,42,78,5,4,4,13,Champions
58561,533,8,11,2,2,1,5,Lost
58628,207,13,59,3,3,3,9,Loyal Users
58798,4417,7,30,1,2,2,5,Lost
58925,0,14,68,5,3,4,12,Loyal Users
59025,2032,9,12,1,2,1,4,Lost
59098,0,131,160,5,5,5,15,Champions
59118,701,42,112,2,4,4,10,At Risk
59136,164,43,196,4,4,5,13,Champions
59264,1399,6,24,1,1,2,4,Lost
59332,445,19,32,3,3,3,9,Loyal Users
59485,1039,12,87,2,3,4,9,Casual Users
60115,538,18,105,2,3,4,9,Casual Users
60128,516,24,51,2,4,3,9,At Risk
60294,697,5,5,2,1,1,4,Lost
60655,831,7,11,2,2,1,5,Lost
60677,465,12,28,3,3,2,8,Loyal Users
60921,1958,116,194,1,5,5,11,At Risk
61140,2352,5,5,1,1,1,3,Lost
61176,113,65,202,4,5,5,14,Champions
61500,157,7,7,4,2,1,7,Promising
61585,4946,6,21,1,1,2,4,Lost
61699,2240,8,27,1,2,2,5,Lost
61818,64,30,44,5,4,3,12,Loyal Users
61850,633,7,7,2,2,1,5,Lost
62034,250,9,47,3,2,3,8,Casual Users
62129,614,22,108,2,4,4,10,At Risk
62898,0,101,301,5,5,5,15,Champions
63228,573,5,7,2,1,1,4,Lost
63681,1009,6,20,2,1,2,5,Lost
64234,114,14,36,4,3,3,10,Loyal Users
64358,14,26,57,5,4,3,12,Loyal Users
64473,2226,7,25,1,2,2,5,Lost
64480,4,53,476,5,5,5,15,Champions
64572,234,38,70,3,4,4,11,Loyal Users
64583,3588,10,22,1,2,2,5,Lost
65033,118,91,321,4,5,5,14,Champions
65088,137,14,21,4,3,2,9,Loyal Users
65387,131,32,49,4,4,3,11,Loyal Users
52807,1424,5,5,1,1,1,3,Lost
53116,255,5,23,3,1,2,6,Casual Users
53327,448,10,14,3,2,1,6,Casual Users
53394,996,6,10,2,1,1,4,Lost
53716,868,95,323,2,5,5,12,At Risk
54607,15,98,244,5,5,5,15,Champions
54608,64,131,295,5,5,5,15,Champions
55602,1698,8,12,1,2,1,4,Lost
55604,124,22,33,4,4,3,11,Loyal Users
55608,223,11,72,3,2,4,9,Casual Users
55614,808,9,12,2,2,1,5,Lost
55652,44,24,132,5,4,4,13,Champions
55832,2829,6,11,1,1,1,3,Lost
56215,122,70,176,4,5,5,14,Champions
56229,276,8,38,3,2,3,8,Casual Users
56258,2139,10,17,1,2,2,5,Lost
56794,410,19,240,3,3,5,11,Loyal Users
56827,1851,11,39,1,2,3,6,Lost
56920,3267,7,7,1,2,1,4,Lost
57125,567,18,225,2,3,5,10,Casual Users
57285,25,15,23,5,3,2,10,Loyal Users
57371,20,6,18,5,1,2,8,Promising
57616,497,11,30,2,2,2,6,Lost
57624,27,82,253,5,5,5,15,Champions
57839,1020,14,41,2,3,3,8,Casual Users
59201,687,32,46,2,4,3,9,At Risk
59283,149,25,43,4,4,3,11,Loyal Users
59383,4,150,282,5,5,5,15,Champions
59387,83,18,77,4,3,4,11,Loyal Users
59549,1259,30,92,1,4,4,9,At Risk
59708,408,8,15,3,2,1,6,Casual Users
60268,7,55,210,5,5,5,15,Champions
60590,241,15,45,3,3,3,9,Loyal Users
60698,542,13,32,2,3,3,8,Casual Users
60764,159,15,22,4,3,2,9,Loyal Users
61093,29,8,18,5,2,2,9,Promising
61094,1141,7,10,2,2,1,5,Lost
61317,871,10,26,2,2,2,6,Lost
61554,768,9,30,2,2,2,6,Lost
61588,77,5,27,4,1,2,7,Promising
61674,1094,7,26,2,2,2,6,Lost
61724,1012,57,164,2,5,5,12,At Risk
62181,3,95,145,5,5,4,14,Champions
62325,890,8,12,2,2,1,5,Lost
62590,422,5,23,3,1,2,6,Casual Users
62736,688,9,38,2,2,3,7,Lost
63098,161,69,333,4,5,5,14,Champions
63200,5551,7,7,1,2,1,4,Lost
63338,118,58,223,4,5,5,14,Champions
63417,56,17,26,5,3,2,10,Loyal Users
63926,5151,6,6,1,1,1,3,Lost
64000,115,40,100,4,4,4,12,Champions
64047,128,79,457,4,5,5,14,Champions
64221,0,100,215,5,5,5,15,Champions
64797,3,77,252,5,5,5,15,Champions
64954,1523,5,38,1,1,3,5,Lost
52517,23,49,129,5,5,4,14,Champions
52715,34,31,60,5,4,3,12,Loyal Users
52746,405,10,15,3,2,1,6,Casual Users
52817,3556,7,19,1,2,2,5,Lost
53193,124,34,153,4,4,5,13,Champions
53203,2396,7,18,1,2,2,5,Lost
53227,383,8,23,3,2,2,7,Casual Users
53437,62,48,88,5,5,4,14,Champions
53502,118,18,41,4,3,3,10,Loyal Users
53704,279,6,12,3,1,1,5,Casual Users
53750,408,13,20,3,3,2,8,Loyal Users
54063,3111,19,78,1,3,4,8,Casual Users
54139,4151,9,33,1,2,3,6,Lost
54177,1921,8,10,1,2,1,4,Lost
54516,12,61,203,5,5,5,15,Champions
54743,2523,5,5,1,1,1,3,Lost
54801,2098,14,17,1,3,2,6,Casual Users
54964,152,49,87,4,5,4,13,Champions
55023,188,5,7,3,1,1,5,Casual Users
55216,4706,15,62,1,3,3,7,Casual Users
55246,294,16,161,3,3,5,11,Loyal Users
55248,3124,5,5,1,1,1,3,Lost
55467,2005,9,37,1,2,3,6,Lost
55474,570,18,69,2,3,4,9,Casual Users
55653,231,31,53,3,4,3,10,Loyal Users
55728,1063,26,31,2,4,2,8,At Risk
55741,83,5,14,4,1,1,6,Promising
55798,1142,10,22,2,2,2,6,Lost
55965,395,14,40,3,3,3,9,Loyal Users
56837,1823,33,52,1,4,3,8,At Risk
56895,37,73,242,5,5,5,15,Champions
56899,547,6,11,2,1,1,4,Lost
57405,557,6,6,2,1,1,4,Lost
57612,391,7,14,3,2,1,6,Casual Users
57753,28,59,270,5,5,5,15,Champions
58076,162,152,240,4,5,5,14,Champions
58171,514,11,50,2,2,3,7,Lost
58200,38,7,15,5,2,1,8,Promising
58571,904,19,41,2,3,3,8,Casual Users
58587,30,150,566,5,5,5,15,Champions
58675,6,46,284,5,5,5,15,Champions
58858,127,115,134,4,5,4,13,Champions
59120,4146,17,43,1,3,3,7,Casual Users
59173,40,14,97,5,3,4,12,Loyal Users
59238,2128,6,14,1,1,1,3,Lost
59348,2233,15,23,1,3,2,6,Casual Users
59525,48,51,95,5,5,4,14,Champions
59594,998,9,11,2,2,1,5,Lost
59608,7,200,369,5,5,5,15,Champions
59699,83,41,159,4,4,5,13,Champions
59746,47,58,192,5,5,5,15,Champions
59827,112,7,15,4,2,1,7,Promising
59986,272,56,155,3,5,5,13,Loyal Users
60180,998,18,18,2,3,2,7,Casual Users
60213,1500,28,73,1,4,4,9,At Risk
60826,272,121,387,3,5,5,13,Loyal Users
60850,13,84,192,5,5,5,15,Champions
60997,415,27,65,3,4,4,11,Loyal Users
61090,295,37,193,3,4,5,12,Loyal Users
61280,430,7,43,3,2,3,8,Casual Users
61302,1419,5,8,1,1,1,3,Lost
61801,0,64,133,5,5,4,14,Champions
61829,677,11,30,2,2,2,6,Lost
62431,847,6,14,2,1,1,4,Lost
62644,340,15,140,3,3,4,10,Loyal Users
62805,822,29,120,2,4,4,10,At Risk
63285,241,31,146,3,4,4,11,Loyal Users
63432,105,64,374,4,5,5,14,Champions
63510,140,9,20,4,2,2,8,Promising
63669,13,10,16,5,2,2,9,Promising
63851,1009,18,20,2,3,2,7,Casual Users
64035,0,45,77,5,4,4,13,Champions
64421,740,11,29,2,2,2,6,Lost
64469,100,31,56,4,4,3,11,Loyal Users
64594,676,6,19,2,1,2,5,Lost
64967,234,35,194,3,4,5,12,Loyal Users
65232,260,39,77,3,4,4,11,Loyal Users
65335,136,34,141,4,4,4,12,Champions
52473,47,23,102,5,4,4,13,Champions
52489,1226,12,26,2,3,2,7,Casual Users
53015,411,19,32,3,3,3,9,Loyal Users
53545,269,6,15,3,1,1,5,Casual Users
53792,156,33,199,4,4,5,13,Champions
53908,2722,5,6,1,1,1,3,Lost
53931,4417,5,18,1,1,2,4,Lost
53986,17,109,394,5,5,5,15,Champions
54124,521,32,51,2,4,3,9,At Risk
54142,13,76,100,5,5,4,14,Champions
54492,401,14,28,3,3,2,8,Loyal Users
54599,57,134,505,5,5,5,15,Champions
55212,30,30,245,5,4,5,14,Champions
55603,61,119,255,5,5,5,15,Champions
55882,201,22,167,3,4,5,12,Loyal Users
56034,409,10,21,3,2,2,7,Casual Users
56115,171,10,17,3,2,2,7,Casual Users
56216,564,13,56,2,3,3,8,Casual Users
56238,423,16,42,3,3,3,9,Loyal Users
56569,87,10,104,4,2,4,10,Promising
56584,108,87,113,4,5,4,13,Champions
56712,11,38,92,5,4,4,13,Champions
57269,265,19,25,3,3,2,8,Loyal Users
57701,529,8,19,2,2,2,6,Lost
57758,3439,6,11,1,1,1,3,Lost
57770,6,29,60,5,4,3,12,Loyal Users
57805,256,18,128,3,3,4,10,Loyal Users
57923,1256,8,19,2,2,2,6,Lost
58369,110,13,112,4,3,4,11,Loyal Users
58518,296,5,19,3,1,2,6,Casual Users
58535,521,7,28,2,2,2,6,Lost
58676,5713,9,36,1,2,3,6,Lost
58733,292,5,35,3,1,3,7,Casual Users
58960,1199,5,8,2,1,1,4,Lost
59015,246,25,80,3,4,4,11,Loyal Users
59176,314,18,55,3,3,3,9,Loyal Users
59317,403,17,74,3,3,4,10,Loyal Users
59544,931,17,69,2,3,4,9,Casual Users
59601,1,17,48,5,3,3,11,Loyal Users
59624,264,21,146,3,3,4,10,Loyal Users
59686,389,15,50,3,3,3,9,Loyal Users
59697,108,8,41,4,2,3,9,Promising
59758,0,54,154,5,5,5,15,Champions
59762,73,33,116,4,4,4,12,Champions
59911,592,7,12,2,2,1,5,Lost
60397,26,49,107,5,5,4,14,Champions
60420,566,44,97,2,4,4,10,At Risk
60444,114,23,29,4,4,2,10,Loyal Users
60605,1113,39,44,2,4,3,9,At Risk
61103,2227,5,12,1,1,1,3,Lost
61162,252,58,182,3,5,5,13,Loyal Users
61282,675,11,13,2,2,1,5,Lost
61437,143,39,103,4,4,4,12,Champions
61544,124,5,15,4,1,1,6,Promising
61845,1575,15,18,1,3,2,6,Casual Users
61879,316,32,315,3,4,5,12,Loyal Users
62041,1189,12,26,2,3,2,7,Casual Users
62046,2410,7,17,1,2,2,5,Lost
62189,1121,5,12,2,1,1,4,Lost
62220,116,106,335,4,5,5,14,Champions
62654,1233,9,11,2,2,1,5,Lost
62809,63,32,105,5,4,4,13,Champions
63045,3208,10,24,1,2,2,5,Lost
63528,300,7,14,3,2,1,6,Casual Users
63717,90,29,210,4,4,5,13,Champions
64319,819,22,79,2,4,4,10,At Risk
64379,110,35,83,4,4,4,12,Champions
64479,5,59,200,5,5,5,15,Champions
64589,1385,11,20,1,2,2,5,Lost
64712,1430,5,6,1,1,1,3,Lost
64840,81,42,71,4,4,4,12,Champions
65163,399,7,27,3,2,2,7,Casual Users
65427,481,37,105,2,4,4,10,At Risk
52482,123,47,100,4,5,4,13,Champions
52610,1517,7,33,1,2,3,6,Lost
52615,614,9,42,2,2,3,7,Lost
52637,283,10,17,3,2,2,7,Casual Users
52747,282,11,24,3,2,2,7,Casual Users
52847,823,9,11,2,2,1,5,Lost
53123,270,10,25,3,2,2,7,Casual Users
53328,2039,8,14,1,2,1,4,Lost
53461,24,29,136,5,4,4,13,Champions
54335,1257,5,5,2,1,1,4,Lost
54519,1911,10,101,1,2,4,7,Lost
55052,143,6,33,4,1,3,8,Promising
55334,9,55,100,5,5,4,14,Champions
55444,916,19,165,2,3,5,10,Casual Users
55570,853,8,14,2,2,1,5,Lost
55616,35,18,52,5,3,3,11,Loyal Users
55631,276,14,21,3,3,2,8,Loyal Users
55681,409,19,25,3,3,2,8,Loyal Users
55791,1046,5,33,2,1,3,6,Lost
56188,284,18,74,3,3,4,10,Loyal Users
57942,572,67,198,2,5,5,12,At Risk
58249,6,53,212,5,5,5,15,Champions
58271,2721,15,39,1,3,3,7,Casual Users
58556,215,16,31,3,3,2,8,Loyal Users
58978,1011,17,37,2,3,3,8,Casual Users
59041,365,22,177,3,4,5,12,Loyal Users
59077,981,10,24,2,2,2,6,Lost
59134,1086,6,7,2,1,1,4,Lost
59144,4041,9,11,1,2,1,4,Lost
59271,542,18,30,2,3,2,7,Casual Users
59830,284,5,37,3,1,3,7,Casual Users
59844,20,13,67,5,3,4,12,Loyal Users
60010,311,73,143,3,5,4,12,Loyal Users
60320,1159,39,143,2,4,4,10,At Risk
60475,1531,13,22,1,3,2,6,Casual Users
60628,62,65,434,5,5,5,15,Champions
60949,240,100,161,3,5,5,13,Loyal Users
61839,2,183,466,5,5,5,15,Champions
62448,29,104,770,5,5,5,15,Champions
62629,2121,11,15,1,2,1,4,Lost
62632,452,21,52,3,3,3,9,Loyal Users
62687,1937,6,14,1,1,1,3,Lost
62784,132,37,108,4,4,4,12,Champions
62859,267,5,6,3,1,1,5,Casual Users
62919,341,5,8,3,1,1,5,Casual Users
63116,2488,18,34,1,3,3,7,Casual Users
63297,182,7,34,3,2,3,8,Casual Users
63371,2830,14,41,1,3,3,7,Casual Users
63438,116,65,178,4,5,5,14,Champions
63570,1561,5,6,1,1,1,3,Lost
63587,2403,6,7,1,1,1,3,Lost
63599,965,8,19,2,2,2,6,Lost
63712,148,5,9,4,1,1,6,Promising
63882,137,82,383,4,5,5,14,Champions
64161,125,34,141,4,4,4,12,Champions
64338,9,7,15,5,2,1,8,Promising
64408,15,25,97,5,4,4,13,Champions
64709,549,34,69,2,4,4,10,At Risk
64841,28,28,53,5,4,3,12,Loyal Users
64953,1089,11,14,2,2,1,5,Lost
65000,32,19,131,5,3,4,12,Loyal Users
65005,421,13,35,3,3,3,9,Loyal Users
65041,568,15,133,2,3,4,9,Casual Users
65074,17,53,169,5,5,5,15,Champions
65391,124,66,99,4,5,4,13,Champions
52384,2,53,371,5,5,5,15,Champions
52716,1112,7,17,2,2,2,6,Lost
52730,94,21,78,4,3,4,11,Loyal Users
52848,331,22,53,3,4,3,10,Loyal Users
53631,2687,13,21,1,3,2,6,Casual Users
53632,221,6,29,3,1,2,6,Casual Users
53772,576,21,52,2,3,3,8,Casual Users
53809,19,17,38,5,3,3,11,Loyal Users
54094,637,34,41,2,4,3,9,At Risk
54337,2422,11,11,1,2,1,4,Lost
54374,2283,9,17,1,2,2,5,Lost
54379,2792,6,10,1,1,1,3,Lost
54819,429,6,6,3,1,1,5,Casual Users
54839,29,19,50,5,3,3,11,Loyal Users
54991,320,10,166,3,2,5,10,Casual Users
55224,146,6,15,4,1,1,6,Promising
55284,28,49,98,5,5,4,14,Champions
55435,395,13,20,3,3,2,8,Loyal Users
55743,77,43,220,4,4,5,13,Champions
56484,1385,16,68,1,3,4,8,Casual Users
56486,399,8,12,3,2,1,6,Casual Users
56507,665,21,130,2,3,4,9,Casual Users
56697,7,15,34,5,3,3,11,Loyal Users
56759,546,10,66,2,2,4,8,Lost
56762,650,8,28,2,2,2,6,Lost
57061,8,13,52,5,3,3,11,Loyal Users
57069,160,105,253,4,5,5,14,Champions
57109,407,14,34,3,3,3,9,Loyal Users
57372,65,122,773,5,5,5,15,Champions
57445,138,13,54,4,3,3,10,Loyal Users
57899,2714,10,13,1,2,1,4,Lost
58221,313,11,48,3,2,3,8,Casual Users
58670,2,78,385,5,5,5,15,Champions
58742,49,37,80,5,4,4,13,Champions
58760,77,33,148,4,4,5,13,Champions
58779,1577,7,12,1,2,1,4,Lost
59444,98,7,21,4,2,2,8,Promising
59516,12,63,100,5,5,4,14,Champions
59935,687,5,6,2,1,1,4,Lost
60167,84,13,158,4,3,5,12,Loyal Users
60511,46,79,384,5,5,5,15,Champions
60565,127,35,159,4,4,5,13,Champions
60775,417,18,53,3,3,3,9,Loyal Users
61074,123,25,71,4,4,4,12,Champions
61484,131,11,37,4,2,3,9,Promising
61971,1851,6,7,1,1,1,3,Lost
62033,1439,28,205,1,4,5,10,At Risk
63249,5,7,9,5,2,1,8,Promising
63586,1147,10,32,2,2,3,7,Lost
63848,12,8,28,5,2,2,9,Promising
64056,256,23,43,3,4,3,10,Loyal Users
64101,193,14,54,3,3,3,9,Loyal Users
64122,1383,6,6,1,1,1,3,Lost
64786,131,78,154,4,5,5,14,Champions
64881,237,73,161,3,5,5,13,Loyal Users
65101,136,18,18,4,3,2,9,Loyal Users
65127,373,12,44,3,3,3,9,Loyal Users
65340,273,65,314,3,5,5,13,Loyal Users
65381,906,5,5,2,1,1,4,Lost
65410,1544,5,9,1,1,1,3,Lost
52430,226,29,218,3,4,5,12,Loyal Users
52553,1026,5,5,2,1,1,4,Lost
53126,543,7,8,2,2,1,5,Lost
53149,130,8,11,4,2,1,7,Promising
53689,447,25,54,3,4,3,10,Loyal Users
53903,297,15,49,3,3,3,9,Loyal Users
54162,1796,20,68,1,3,4,8,Casual Users
54317,585,37,161,2,4,5,11,At Risk
54363,0,50,114,5,5,4,14,Champions
54436,5650,6,6,1,1,1,3,Lost
54920,1810,7,10,1,2,1,4,Lost
55165,862,54,118,2,5,4,11,At Risk
55223,3504,8,17,1,2,2,5,Lost
55305,167,51,141,3,5,4,12,Loyal Users
55326,127,58,116,4,5,4,13,Champions
55420,213,81,376,3,5,5,13,Loyal Users
56172,401,29,39,3,4,3,10,Loyal Users
56197,26,70,156,5,5,5,15,Champions
56345,6,13,21,5,3,2,10,Loyal Users
56421,134,29,98,4,4,4,12,Champions
56524,7,8,30,5,2,2,9,Promising
56544,1250,12,60,2,3,3,8,Casual Users
56870,154,11,33,4,2,3,9,Promising
56878,0,40,166,5,4,5,14,Champions
56917,1560,7,9,1,2,1,4,Lost
57348,3,158,595,5,5,5,15,Champions
57460,489,11,14,2,2,1,5,Lost
57509,174,30,41,3,4,3,10,Loyal Users
57586,2,103,366,5,5,5,15,Champions
57686,457,7,12,3,2,1,6,Casual Users
57704,422,9,34,3,2,3,8,Casual Users
57842,8,10,11,5,2,1,8,Promising
58037,3722,6,13,1,1,1,3,Lost
58246,3127,32,180,1,4,5,10,At Risk
58897,18,34,74,5,4,4,13,Champions
58906,120,5,9,4,1,1,6,Promising
59071,82,6,7,4,1,1,6,Promising
59114,407,15,27,3,3,2,8,Loyal Users
59483,119,16,22,4,3,2,9,Loyal Users
59657,1132,12,14,2,3,1,6,Casual Users
59787,175,19,55,3,3,3,9,Loyal Users
59999,1449,9,19,1,2,2,5,Lost
60067,16,10,12,5,2,1,8,Promising
60303,1134,7,87,2,2,4,8,Lost
60310,4,24,79,5,4,4,13,Champions
60410,6100,5,5,1,1,1,3,Lost
60694,155,17,45,4,3,3,10,Loyal Users
60708,683,5,7,2,1,1,4,Lost
60999,166,36,147,3,4,5,12,Loyal Users
61185,74,30,132,4,4,4,12,Champions
61255,141,52,100,4,5,4,13,Champions
61382,12,153,939,5,5,5,15,Champions
61427,120,17,50,4,3,3,10,Loyal Users
61861,0,45,160,5,4,5,14,Champions
61910,409,57,141,3,5,4,12,Loyal Users
62246,3406,5,5,1,1,1,3,Lost
62604,542,14,20,2,3,2,7,Casual Users
62824,1150,10,25,2,2,2,6,Lost
62829,1433,19,23,1,3,2,6,Casual Users
62852,232,8,16,3,2,2,7,Casual Users
63048,349,5,6,3,1,1,5,Casual Users
63138,5462,5,6,1,1,1,3,Lost
63226,170,18,22,3,3,2,8,Loyal Users
63244,277,20,32,3,3,3,9,Loyal Users
63412,3799,5,10,1,1,1,3,Lost
63423,51,25,150,5,4,5,14,Champions
63689,91,25,62,4,4,3,11,Loyal Users
63840,112,76,143,4,5,4,13,Champions
63895,31,175,539,5,5,5,15,Champions
64225,1153,16,31,2,3,2,7,Casual Users
64246,149,123,243,4,5,5,14,Champions
64336,26,48,114,5,5,4,14,Champions
64723,21,64,117,5,5,4,14,Champions
64912,102,11,56,4,2,3,9,Promising
64993,493,5,9,2,1,1,4,Lost
65244,261,17,62,3,3,3,9,Loyal Users
65298,969,10,24,2,2,2,6,Lost
52476,59,34,113,5,4,4,13,Champions
52478,1295,7,26,1,2,2,5,Lost
52702,106,21,75,4,3,4,11,Loyal Users
52799,130,13,87,4,3,4,11,Loyal Users
52906,252,7,13,3,2,1,6,Casual Users
53057,126,67,102,4,5,4,13,Champions
53332,1144,11,11,2,2,1,5,Lost
53387,103,34,49,4,4,3,11,Loyal Users
53729,139,7,13,4,2,1,7,Promising
53846,479,32,127,2,4,4,10,At Risk
54155,126,56,90,4,5,4,13,Champions
54525,1489,8,17,1,2,2,5,Lost
54750,335,11,50,3,2,3,8,Casual Users
55277,730,5,6,2,1,1,4,Lost
55844,1667,10,22,1,2,2,5,Lost
55885,113,35,160,4,4,5,13,Champions
56533,389,34,221,3,4,5,12,Loyal Users
56587,793,6,8,2,1,1,4,Lost
56739,1797,15,45,1,3,3,7,Casual Users
56748,4033,7,13,1,2,1,4,Lost
56846,478,7,14,2,2,1,5,Lost
56937,2132,5,6,1,1,1,3,Lost
58156,406,44,56,3,4,3,10,Loyal Users
58165,1131,12,22,2,3,2,7,Casual Users
58207,238,44,52,3,4,3,10,Loyal Users
58420,497,25,111,2,4,4,10,At Risk
59004,76,17,53,4,3,3,10,Loyal Users
59128,410,8,16,3,2,2,7,Casual Users
59265,547,31,41,2,4,3,9,At Risk
59311,7,78,117,5,5,4,14,Champions
59401,5,60,108,5,5,4,14,Champions
59545,97,25,107,4,4,4,12,Champions
59672,1122,5,12,2,1,1,4,Lost
59803,138,27,70,4,4,4,12,Champions
59819,304,17,41,3,3,3,9,Loyal Users
60238,717,8,27,2,2,2,6,Lost
60829,361,8,19,3,2,2,7,Casual Users
60966,1994,8,31,1,2,2,5,Lost
61367,270,7,8,3,2,1,6,Casual Users
61468,191,41,125,3,4,4,11,Loyal Users
61523,140,21,86,4,3,4,11,Loyal Users
61706,18,29,55,5,4,3,12,Loyal Users
61809,1161,5,6,2,1,1,4,Lost
61988,240,57,221,3,5,5,13,Loyal Users
62065,268,21,103,3,3,4,10,Loyal Users
62244,95,37,178,4,4,5,13,Champions
62489,291,55,196,3,5,5,13,Loyal Users
62538,140,8,17,4,2,2,8,Promising
62571,1349,12,29,1,3,2,6,Casual Users
62596,178,40,136,3,4,4,11,Loyal Users
62608,1157,14,28,2,3,2,7,Casual Users
62725,309,6,7,3,1,1,5,Casual Users
62800,50,26,48,5,4,3,12,Loyal Users
62864,2,9,16,5,2,2,9,Promising
62916,278,35,103,3,4,4,11,Loyal Users
63254,224,17,46,3,3,3,9,Loyal Users
63562,1700,9,20,1,2,2,5,Lost
64173,152,19,47,4,3,3,10,Loyal Users
64518,5,72,316,5,5,5,15,Champions
65078,526,15,30,2,3,2,7,Casual Users
52502,102,17,67,4,3,4,11,Loyal Users
52658,831,5,14,2,1,1,4,Lost
52874,560,11,30,2,2,2,6,Lost
53078,205,32,64,3,4,4,11,Loyal Users
53217,215,46,55,3,5,3,11,Loyal Users
53339,388,21,35,3,3,3,9,Loyal Users
53408,272,11,30,3,2,2,7,Casual Users
53570,427,14,24,3,3,2,8,Loyal Users
54409,2107,17,30,1,3,2,6,Casual Users
54623,582,13,42,2,3,3,8,Casual Users
55014,1140,6,23,2,1,2,5,Lost
55083,433,27,62,3,4,3,10,Loyal Users
55263,529,22,45,2,4,3,9,At Risk
55428,73,5,16,4,1,2,7,Promising
55676,153,94,210,4,5,5,14,Champions
55951,8,71,142,5,5,4,14,Champions
56299,38,12,34,5,3,3,11,Loyal Users
56363,1703,7,13,1,2,1,4,Lost
56542,341,17,88,3,3,4,10,Loyal Users
56986,894,11,18,2,2,2,6,Lost
57068,160,18,246,4,3,5,12,Loyal Users
57079,834,17,23,2,3,2,7,Casual Users
57091,4655,6,8,1,1,1,3,Lost
57117,2794,6,8,1,1,1,3,Lost
57396,1443,8,22,1,2,2,5,Lost
57423,154,22,43,4,4,3,11,Loyal Users
57481,304,6,16,3,1,2,6,Casual Users
57486,252,39,95,3,4,4,11,Loyal Users
58215,58,75,129,5,5,4,14,Champions
58509,549,41,327,2,4,5,11,At Risk
58543,60,27,126,5,4,4,13,Champions
58545,427,17,31,3,3,2,8,Loyal Users
58898,3395,6,7,1,1,1,3,Lost
59410,1115,9,22,2,2,2,6,Lost
60484,15,33,139,5,4,4,13,Champions
60586,1,79,206,5,5,5,15,Champions
61293,569,11,13,2,2,1,5,Lost
61497,28,67,220,5,5,5,15,Champions
61625,1688,5,59,1,1,3,5,Lost
61626,411,37,67,3,4,4,11,Loyal Users
61784,141,19,38,4,3,3,10,Loyal Users
61863,117,33,71,4,4,4,12,Champions
61866,1303,19,48,1,3,3,7,Casual Users
62022,4081,6,6,1,1,1,3,Lost
62084,1561,12,27,1,3,2,6,Casual Users
62428,51,98,221,5,5,5,15,Champions
62662,1133,12,22,2,3,2,7,Casual Users
62742,4,13,35,5,3,3,11,Loyal Users
62965,3825,6,16,1,1,2,4,Lost
63410,90,12,29,4,3,2,9,Loyal Users
63558,72,84,323,4,5,5,14,Champions
63569,2,83,121,5,5,4,14,Champions
63572,157,80,151,4,5,5,14,Champions
63628,160,37,95,4,4,4,12,Champions
63839,412,76,169,3,5,5,13,Loyal Users
64332,2965,15,27,1,3,2,6,Casual Users
64716,1446,19,28,1,3,2,6,Casual Users
65281,143,7,62,4,2,3,9,Promising
65317,1495,5,5,1,1,1,3,Lost
52484,123,41,88,4,4,4,12,Champions
52709,267,5,9,3,1,1,5,Casual Users
52751,63,76,166,5,5,5,15,Champions
52876,414,8,40,3,2,3,8,Casual Users
53150,2962,6,9,1,1,1,3,Lost
53680,3104,9,13,1,2,1,4,Lost
53825,70,8,11,4,2,1,7,Promising
54254,1,90,259,5,5,5,15,Champions
54332,96,14,24,4,3,2,9,Loyal Users
54354,2714,8,17,1,2,2,5,Lost
54990,23,221,525,5,5,5,15,Champions
55077,124,99,172,4,5,5,14,Champions
55114,255,57,138,3,5,4,12,Loyal Users
55142,109,106,165,4,5,5,14,Champions
55225,979,7,39,2,2,3,7,Lost
55360,282,7,75,3,2,4,9,Casual Users
55411,666,11,21,2,2,2,6,Lost
55756,3,96,277,5,5,5,15,Champions
56005,45,60,260,5,5,5,15,Champions
56007,220,15,22,3,3,2,8,Loyal Users
56526,24,49,134,5,5,4,14,Champions
56670,410,35,78,3,4,4,11,Loyal Users
56862,1811,5,8,1,1,1,3,Lost
56935,52,77,239,5,5,5,15,Champions
56957,2306,19,29,1,3,2,6,Casual Users
57007,619,15,16,2,3,2,7,Casual Users
57233,169,24,35,3,4,3,10,Loyal Users
57261,2509,12,25,1,3,2,6,Casual Users
57359,406,10,39,3,2,3,8,Casual Users
57379,2608,41,247,1,4,5,10,At Risk
57388,51,57,107,5,5,4,14,Champions
58233,180,31,57,3,4,3,10,Loyal Users
58393,893,59,168,2,5,5,12,At Risk
58482,7,33,61,5,4,3,12,Loyal Users
58579,2417,6,23,1,1,2,4,Lost
58962,238,40,78,3,4,4,11,Loyal Users
59854,78,32,47,4,4,3,11,Loyal Users
60292,15,134,834,5,5,5,15,Champions
60314,140,21,102,4,3,4,11,Loyal Users
60530,5,53,142,5,5,4,14,Champions
60615,574,51,63,2,5,4,11,At Risk
61075,1573,5,12,1,1,1,3,Lost
61396,6,28,62,5,4,3,12,Loyal Users
61436,419,10,17,3,2,2,7,Casual Users
61592,1684,13,17,1,3,2,6,Casual Users
62098,531,52,278,2,5,5,12,At Risk
62240,257,80,214,3,5,5,13,Loyal Users
63058,3268,12,25,1,3,2,6,Casual Users
63117,2576,8,13,1,2,1,4,Lost
63202,118,70,467,4,5,5,14,Champions
64004,1561,12,22,1,3,2,6,Casual Users
64110,2147,11,35,1,2,3,6,Lost
64405,6,37,50,5,4,3,12,Loyal Users
65098,30,57,238,5,5,5,15,Champions
65237,38,95,218,5,5,5,15,Champions
65240,142,28,143,4,4,4,12,Champions
52598,907,23,122,2,4,4,10,At Risk
52991,453,68,385,3,5,5,13,Loyal Users
53006,81,58,149,4,5,5,14,Champions
53012,1120,6,43,2,1,3,6,Lost
53061,677,24,74,2,4,4,10,At Risk
53499,420,102,429,3,5,5,13,Loyal Users
53513,2099,7,43,1,2,3,6,Lost
53585,11,76,113,5,5,4,14,Champions
53746,633,7,10,2,2,1,5,Lost
54087,997,5,5,2,1,1,4,Lost
54447,365,21,50,3,3,3,9,Loyal Users
54564,100,8,13,4,2,1,7,Promising
55086,2,67,166,5,5,5,15,Champions
55335,281,23,40,3,4,3,10,Loyal Users
55512,112,67,236,4,5,5,14,Champions
55671,241,27,83,3,4,4,11,Loyal Users
55842,123,37,273,4,4,5,13,Champions
55987,124,35,107,4,4,4,12,Champions
56038,2266,5,10,1,1,1,3,Lost
56207,476,14,27,2,3,2,7,Casual Users
56483,40,120,649,5,5,5,15,Champions
56605,876,14,35,2,3,3,8,Casual Users
56606,1167,10,34,2,2,3,7,Lost
56735,20,17,37,5,3,3,11,Loyal Users
56821,405,5,9,3,1,1,5,Casual Users
56932,124,38,107,4,4,4,12,Champions
56958,911,15,31,2,3,2,7,Casual Users
56991,631,13,21,2,3,2,7,Casual Users
57189,541,41,64,2,4,4,10,At Risk
57232,27,48,82,5,5,4,14,Champions
57776,348,45,90,3,4,4,11,Loyal Users
58145,16,35,239,5,4,5,14,Champions
58616,1426,9,76,1,2,4,7,Lost
58626,358,14,45,3,3,3,9,Loyal Users
58765,258,10,17,3,2,2,7,Casual Users
59331,555,34,63,2,4,4,10,At Risk
59542,2,36,167,5,4,5,14,Champions
59612,91,68,323,4,5,5,14,Champions
60054,781,12,15,2,3,1,6,Casual Users
60153,138,6,6,4,1,1,6,Promising
60367,117,12,23,4,3,2,9,Loyal Users
60603,746,41,156,2,4,5,11,At Risk
60630,31,88,550,5,5,5,15,Champions
61186,9,68,140,5,5,4,14,Champions
61433,1867,7,27,1,2,2,5,Lost
61490,77,17,59,4,3,3,10,Loyal Users
61826,1315,26,39,1,4,3,8,At Risk
62027,291,6,6,3,1,1,5,Casual Users
62030,635,24,103,2,4,4,10,At Risk
62168,128,16,158,4,3,5,12,Loyal Users
62317,106,118,569,4,5,5,14,Champions
63507,211,7,10,3,2,1,6,Casual Users
63517,5260,11,36,1,2,3,6,Lost
63706,5,76,279,5,5,5,15,Champions
63824,4773,11,23,1,2,2,5,Lost
64415,219,20,102,3,3,4,10,Loyal Users
64456,671,20,23,2,3,2,7,Casual Users
65120,226,6,16,3,1,2,6,Casual Users
65343,118,41,178,4,4,5,13,Champions
65478,1016,10,20,2,2,2,6,Lost
65867,537,39,135,2,4,4,10,At Risk
66010,399,8,17,3,2,2,7,Casual Users
66166,65,102,386,5,5,5,15,Champions
66176,2844,6,25,1,1,2,4,Lost
67089,1286,6,8,1,1,1,3,Lost
67294,5016,23,23,1,4,2,7,At Risk
67376,2409,12,36,1,3,3,7,Casual Users
67492,814,10,17,2,2,2,6,Lost
67753,120,28,43,4,4,3,11,Loyal Users
67782,251,31,59,3,4,3,10,Loyal Users
67861,10,109,195,5,5,5,15,Champions
68090,389,16,68,3,3,4,10,Loyal Users
68098,12,5,13,5,1,1,7,Promising
68135,1694,8,32,1,2,3,6,Lost
68202,92,39,124,4,4,4,12,Champions
68579,1086,48,125,2,5,4,11,At Risk
68610,1634,13,13,1,3,1,5,Casual Users
69042,190,72,294,3,5,5,13,Loyal Users
69048,437,30,118,3,4,4,11,Loyal Users
69352,1943,10,20,1,2,2,5,Lost
69454,154,76,120,4,5,4,13,Champions
69478,30,25,35,5,4,3,12,Loyal Users
69637,661,6,8,2,1,1,4,Lost
70097,9,147,302,5,5,5,15,Champions
70355,412,13,49,3,3,3,9,Loyal Users
70863,125,13,25,4,3,2,9,Loyal Users
71510,5572,6,6,1,1,1,3,Lost
71527,559,22,47,2,4,3,9,At Risk
71995,0,89,371,5,5,5,15,Champions
72578,118,14,18,4,3,2,9,Loyal Users
72702,241,37,112,3,4,4,11,Loyal Users
72758,4163,10,25,1,2,2,5,Lost
72820,193,9,38,3,2,3,8,Casual Users
73048,4169,9,14,1,2,1,4,Lost
73091,19,36,116,5,4,4,13,Champions
73305,471,44,83,2,4,4,10,At Risk
73470,477,31,170,2,4,5,11,At Risk
73683,285,19,57,3,3,3,9,Loyal Users
73933,85,25,49,4,4,3,11,Loyal Users
74058,5,150,656,5,5,5,15,Champions
74166,288,121,301,3,5,5,13,Loyal Users
74251,2779,5,5,1,1,1,3,Lost
74281,70,6,39,4,1,3,8,Promising
74757,105,32,153,4,4,5,13,Champions
74775,121,81,140,4,5,4,13,Champions
74820,48,27,136,5,4,4,13,Champions
74836,603,12,18,2,3,2,7,Casual Users
74852,520,13,49,2,3,3,8,Casual Users
74904,449,11,18,3,2,2,7,Casual Users
75039,167,24,38,3,4,3,10,Loyal Users
75120,100,20,59,4,3,3,10,Loyal Users
75122,9,53,173,5,5,5,15,Champions
75149,2038,7,17,1,2,2,5,Lost
75294,7,112,181,5,5,5,15,Champions
75509,137,7,29,4,2,2,8,Promising
75614,119,9,19,4,2,2,8,Promising
75705,15,17,22,5,3,2,10,Loyal Users
76110,11,67,186,5,5,5,15,Champions
76143,105,55,135,4,5,4,13,Champions
76493,274,16,38,3,3,3,9,Loyal Users
76756,49,63,476,5,5,5,15,Champions
76885,518,12,73,2,3,4,9,Casual Users
77234,1145,25,164,2,4,5,11,At Risk
77422,303,10,28,3,2,2,7,Casual Users
77803,20,50,337,5,5,5,15,Champions
78064,232,27,154,3,4,5,12,Loyal Users
78113,1425,5,10,1,1,1,3,Lost
78120,2691,7,20,1,2,2,5,Lost
65486,156,30,195,4,4,5,13,Champions
65522,110,14,26,4,3,2,9,Loyal Users
65686,1529,7,14,1,2,1,4,Lost
65726,24,24,105,5,4,4,13,Champions
65771,449,8,26,3,2,2,7,Casual Users
65905,34,31,47,5,4,3,12,Loyal Users
65974,173,38,106,3,4,4,11,Loyal Users
66077,59,52,400,5,5,5,15,Champions
66277,120,27,50,4,4,3,11,Loyal Users
66400,35,67,185,5,5,5,15,Champions
66562,293,33,142,3,4,4,11,Loyal Users
66672,794,6,12,2,1,1,4,Lost
66751,895,10,14,2,2,1,5,Lost
66778,3,57,146,5,5,4,14,Champions
66967,600,15,52,2,3,3,8,Casual Users
67086,162,21,101,4,3,4,11,Loyal Users
67225,453,12,32,3,3,3,9,Loyal Users
67388,2096,8,15,1,2,1,4,Lost
67439,97,5,8,4,1,1,6,Promising
67663,42,11,12,5,2,1,8,Promising
68037,26,45,91,5,4,4,13,Champions
68047,115,5,13,4,1,1,6,Promising
68433,12,11,93,5,2,4,11,Promising
68485,143,79,238,4,5,5,14,Champions
68544,551,8,36,2,2,3,7,Lost
68575,1539,5,41,1,1,3,5,Lost
68609,971,8,22,2,2,2,6,Lost
68672,2277,5,13,1,1,1,3,Lost
68877,807,18,129,2,3,4,9,Casual Users
69035,1672,6,13,1,1,1,3,Lost
69204,33,164,211,5,5,5,15,Champions
69279,419,21,46,3,3,3,9,Loyal Users
69333,1088,6,12,2,1,1,4,Lost
69341,17,126,840,5,5,5,15,Champions
69481,138,11,33,4,2,3,9,Promising
69595,260,27,111,3,4,4,11,Loyal Users
69743,135,39,61,4,4,3,11,Loyal Users
70456,1396,6,7,1,1,1,3,Lost
70476,3653,6,15,1,1,1,3,Lost
70480,194,9,14,3,2,1,6,Casual Users
70830,108,10,45,4,2,3,9,Promising
71454,30,58,152,5,5,5,15,Champions
71468,4412,5,6,1,1,1,3,Lost
71565,21,14,42,5,3,3,11,Loyal Users
71580,134,5,29,4,1,2,7,Promising
71709,1602,31,54,1,4,3,8,At Risk
71984,365,21,31,3,3,2,8,Loyal Users
71987,1219,7,15,2,2,1,5,Lost
72546,1531,10,131,1,2,4,7,Lost
72610,428,26,43,3,4,3,10,Loyal Users
72996,558,5,18,2,1,2,5,Lost
73041,1339,19,39,1,3,3,7,Casual Users
73156,423,15,71,3,3,4,10,Loyal Users
73169,112,5,146,4,1,4,9,Promising
74009,692,31,122,2,4,4,10,At Risk
74440,303,7,10,3,2,1,6,Casual Users
74452,5,80,130,5,5,4,14,Champions
74595,2746,5,9,1,1,1,3,Lost
75070,277,18,32,3,3,3,9,Loyal Users
75250,1870,5,20,1,1,2,4,Lost
75321,1732,5,7,1,1,1,3,Lost
75620,108,56,154,4,5,5,14,Champions
76164,521,22,171,2,4,5,11,At Risk
76169,3034,5,22,1,1,2,4,Lost
76312,3,16,58,5,3,3,11,Loyal Users
76701,24,191,527,5,5,5,15,Champions
78185,302,63,229,3,5,5,13,Loyal Users
78272,87,39,103,4,4,4,12,Champions
66738,1542,9,55,1,2,3,6,Lost
67068,89,61,248,4,5,5,14,Champions
67231,108,21,130,4,3,4,11,Loyal Users
67278,233,7,9,3,2,1,6,Casual Users
67618,3095,6,9,1,1,1,3,Lost
67865,39,83,363,5,5,5,15,Champions
68078,2512,5,16,1,1,2,4,Lost
68471,430,7,57,3,2,3,8,Casual Users
68592,273,49,95,3,5,4,12,Loyal Users
68678,123,12,27,4,3,2,9,Loyal Users
68879,4,31,71,5,4,4,13,Champions
69247,4045,10,14,1,2,1,4,Lost
69338,868,7,7,2,2,1,5,Lost
69385,172,29,119,3,4,4,11,Loyal Users
70216,422,6,12,3,1,1,5,Casual Users
70844,195,9,29,3,2,2,7,Casual Users
70895,126,19,31,4,3,2,9,Loyal Users
71283,916,12,37,2,3,3,8,Casual Users
71600,5734,5,10,1,1,1,3,Lost
71670,166,8,13,3,2,1,6,Casual Users
71732,355,6,15,3,1,1,5,Casual Users
71821,1074,7,8,2,2,1,5,Lost
72232,3167,26,36,1,4,3,8,At Risk
72266,5015,7,8,1,2,1,4,Lost
72288,660,14,26,2,3,2,7,Casual Users
72688,1702,10,18,1,2,2,5,Lost
72785,125,5,6,4,1,1,6,Promising
72912,56,33,74,5,4,4,13,Champions
72981,2247,5,11,1,1,1,3,Lost
73436,276,14,19,3,3,2,8,Loyal Users
74097,285,41,98,3,4,4,11,Loyal Users
74411,1307,6,14,1,1,1,3,Lost
74826,360,5,15,3,1,1,5,Casual Users
74854,1046,75,234,2,5,5,12,At Risk
74948,637,6,6,2,1,1,4,Lost
75102,224,66,166,3,5,5,13,Loyal Users
75305,418,5,31,3,1,2,6,Casual Users
75498,913,10,97,2,2,4,8,Lost
75515,43,14,39,5,3,3,11,Loyal Users
75877,320,26,43,3,4,3,10,Loyal Users
75949,149,33,221,4,4,5,13,Champions
75969,292,5,6,3,1,1,5,Casual Users
75979,3,29,85,5,4,4,13,Champions
76236,183,9,11,3,2,1,6,Casual Users
76366,857,5,24,2,1,2,5,Lost
76989,69,82,366,5,5,5,15,Champions
77352,30,38,253,5,4,5,14,Champions
77488,18,40,64,5,4,4,13,Champions
77701,1129,28,72,2,4,4,10,At Risk
77851,103,12,104,4,3,4,11,Loyal Users
77939,21,45,250,5,4,5,14,Champions
78023,225,42,262,3,4,5,12,Loyal Users
78046,250,10,30,3,2,2,7,Casual Users
65454,110,30,86,4,4,4,12,Champions
65618,279,32,69,3,4,4,11,Loyal Users
65879,79,18,36,4,3,3,10,Loyal Users
66132,88,110,430,4,5,5,14,Champions
66289,731,6,12,2,1,1,4,Lost
66463,6,11,11,5,2,1,8,Promising
66469,263,16,24,3,3,2,8,Loyal Users
66594,409,19,32,3,3,3,9,Loyal Users
66613,4509,13,19,1,3,2,6,Casual Users
66755,303,53,163,3,5,5,13,Loyal Users
66828,440,30,99,3,4,4,11,Loyal Users
67050,698,10,29,2,2,2,6,Lost
67574,3711,7,16,1,2,2,5,Lost
67857,0,17,99,5,3,4,12,Loyal Users
68064,136,24,54,4,4,3,11,Loyal Users
68386,767,17,62,2,3,3,8,Casual Users
68804,87,31,175,4,4,5,13,Champions
69340,4268,6,6,1,1,1,3,Lost
69580,274,11,26,3,2,2,7,Casual Users
69601,2829,6,6,1,1,1,3,Lost
69828,5,6,7,5,1,1,7,Promising
70109,126,12,18,4,3,2,9,Loyal Users
70252,1378,7,23,1,2,2,5,Lost
70322,668,7,11,2,2,1,5,Lost
70442,27,51,117,5,5,4,14,Champions
70508,4744,9,15,1,2,1,4,Lost
70744,51,41,65,5,4,4,13,Champions
70803,8,50,74,5,5,4,14,Champions
70881,2855,29,188,1,4,5,10,At Risk
71106,1595,6,22,1,1,2,4,Lost
71571,3859,13,20,1,3,2,6,Casual Users
72053,72,94,331,4,5,5,14,Champions
72145,159,45,123,4,4,4,12,Champions
72254,126,64,146,4,5,4,13,Champions
72387,101,74,295,4,5,5,14,Champions
72938,19,55,156,5,5,5,15,Champions
72941,654,7,16,2,2,2,6,Lost
73289,131,27,53,4,4,3,11,Loyal Users
73341,6,57,452,5,5,5,15,Champions
73352,2,133,328,5,5,5,15,Champions
73452,132,36,65,4,4,4,12,Champions
73745,2894,9,15,1,2,1,4,Lost
73797,122,9,17,4,2,2,8,Promising
73878,1102,7,19,2,2,2,6,Lost
73900,476,86,174,2,5,5,12,At Risk
74264,2392,10,14,1,2,1,4,Lost
74318,66,56,64,5,5,4,14,Champions
74681,54,37,66,5,4,4,13,Champions
74912,69,93,503,5,5,5,15,Champions
75341,1017,139,476,2,5,5,12,At Risk
75541,3046,16,59,1,3,3,7,Casual Users
75589,656,10,27,2,2,2,6,Lost
75789,115,96,494,4,5,5,14,Champions
75852,15,12,43,5,3,3,11,Loyal Users
76083,71,87,128,4,5,4,13,Champions
76148,1576,10,53,1,2,3,6,Lost
76156,7,72,220,5,5,5,15,Champions
76187,575,10,41,2,2,3,7,Lost
76202,5097,27,71,1,4,4,9,At Risk
76293,536,6,13,2,1,1,4,Lost
76294,116,17,55,4,3,3,10,Loyal Users
76305,406,7,24,3,2,2,7,Casual Users
76530,725,33,119,2,4,4,10,At Risk
76541,119,20,42,4,3,3,10,Loyal Users
76739,48,42,59,5,4,3,12,Loyal Users
77057,1237,17,21,2,3,2,7,Casual Users
77064,3883,5,6,1,1,1,3,Lost
77231,20,16,50,5,3,3,11,Loyal Users
77373,2404,12,21,1,3,2,6,Casual Users
77535,566,5,14,2,1,1,4,Lost
77913,1695,5,8,1,1,1,3,Lost
78000,715,6,9,2,1,1,4,Lost
78149,2717,5,21,1,1,2,4,Lost
78269,133,13,16,4,3,2,9,Loyal Users
65602,242,10,37,3,2,3,8,Casual Users
65690,0,39,56,5,4,3,12,Loyal Users
65826,30,11,16,5,2,2,9,Promising
65991,371,37,124,3,4,4,11,Loyal Users
66036,8,14,27,5,3,2,10,Loyal Users
66978,164,24,253,4,4,5,13,Champions
67135,4283,16,40,1,3,3,7,Casual Users
67419,84,57,151,4,5,5,14,Champions
67549,272,5,12,3,1,1,5,Casual Users
67550,720,15,35,2,3,3,8,Casual Users
67594,229,5,6,3,1,1,5,Casual Users
67667,963,38,70,2,4,4,10,At Risk
67846,1760,16,23,1,3,2,6,Casual Users
68109,1108,10,18,2,2,2,6,Lost
68392,739,16,180,2,3,5,10,Casual Users
68445,147,8,10,4,2,1,7,Promising
68982,869,5,51,2,1,3,6,Lost
68990,425,5,21,3,1,2,6,Casual Users
69329,2,176,539,5,5,5,15,Champions
69377,195,82,227,3,5,5,13,Loyal Users
69626,128,154,309,4,5,5,14,Champions
69714,185,86,170,3,5,5,13,Loyal Users
70089,696,39,74,2,4,4,10,At Risk
70224,1265,6,14,1,1,1,3,Lost
70528,4960,7,24,1,2,2,5,Lost
70605,2547,11,39,1,2,3,6,Lost
70892,1665,11,62,1,2,3,6,Lost
70918,47,82,334,5,5,5,15,Champions
70959,70,20,49,4,3,3,10,Loyal Users
71115,1263,5,27,1,1,2,4,Lost
71151,97,38,73,4,4,4,12,Champions
71198,714,10,16,2,2,2,6,Lost
71746,412,5,5,3,1,1,5,Casual Users
71787,845,6,7,2,1,1,4,Lost
71808,147,35,250,4,4,5,13,Champions
71891,525,16,50,2,3,3,8,Casual Users
72132,23,18,51,5,3,3,11,Loyal Users
72140,118,34,52,4,4,3,11,Loyal Users
72158,2958,7,42,1,2,3,6,Lost
72406,144,9,17,4,2,2,8,Promising
72426,700,6,22,2,1,2,5,Lost
72433,59,23,89,5,4,4,13,Champions
72567,196,13,17,3,3,2,8,Loyal Users
72642,914,10,41,2,2,3,7,Lost
72681,58,32,92,5,4,4,13,Champions
72937,3873,11,17,1,2,2,5,Lost
73053,94,7,24,4,2,2,8,Promising
73185,224,26,90,3,4,4,11,Loyal Users
73566,82,30,69,4,4,4,12,Champions
73571,82,23,141,4,4,4,12,Champions
74266,2572,5,9,1,1,1,3,Lost
74432,123,43,66,4,4,4,12,Champions
74830,136,18,42,4,3,3,10,Loyal Users
74853,0,22,149,5,4,5,14,Champions
74939,215,11,25,3,2,2,7,Casual Users
74942,10,71,239,5,5,5,15,Champions
75369,1399,5,6,1,1,1,3,Lost
75442,394,7,35,3,2,3,8,Casual Users
75500,3,59,144,5,5,4,14,Champions
75531,381,7,9,3,2,1,6,Casual Users
75699,1328,21,126,1,3,4,8,Casual Users
75808,12,23,105,5,4,4,13,Champions
76000,1703,6,8,1,1,1,3,Lost
76092,2029,8,25,1,2,2,5,Lost
76228,444,32,118,3,4,4,11,Loyal Users
76310,566,26,111,2,4,4,10,At Risk
76334,3821,9,26,1,2,2,5,Lost
76676,2853,8,21,1,2,2,5,Lost
76751,46,137,534,5,5,5,15,Champions
76862,71,112,311,4,5,5,14,Champions
77034,670,11,183,2,2,5,9,Lost
77582,961,29,78,2,4,4,10,At Risk
77912,253,13,24,3,3,2,8,Loyal Users
77999,850,6,8,2,1,1,4,Lost
78042,3662,6,25,1,1,2,4,Lost
78201,297,9,17,3,2,2,7,Casual Users
78202,907,5,9,2,1,1,4,Lost
65491,175,131,432,3,5,5,13,Loyal Users
65764,223,47,236,3,5,5,13,Loyal Users
65820,1428,8,63,1,2,4,7,Lost
66003,149,7,19,4,2,2,8,Promising
66057,192,20,51,3,3,3,9,Loyal Users
66138,4,66,113,5,5,4,14,Champions
66226,834,20,73,2,3,4,9,Casual Users
66246,741,9,21,2,2,2,6,Lost
66322,180,6,15,3,1,1,5,Casual Users
66367,10,6,17,5,1,2,8,Promising
66800,583,7,14,2,2,1,5,Lost
66810,1228,14,151,2,3,5,10,Casual Users
66926,14,10,24,5,2,2,9,Promising
67556,7,27,53,5,4,3,12,Loyal Users
67625,4780,12,21,1,3,2,6,Casual Users
67656,1650,5,35,1,1,3,5,Lost
67734,536,100,284,2,5,5,12,At Risk
67863,73,26,90,4,4,4,12,Champions
68218,198,15,19,3,3,2,8,Loyal Users
68265,6,55,98,5,5,4,14,Champions
68272,4,101,477,5,5,5,15,Champions
68728,335,21,120,3,3,4,10,Loyal Users
69197,4181,8,14,1,2,1,4,Lost
69235,515,33,41,2,4,3,9,At Risk
69319,296,7,15,3,2,1,6,Casual Users
70005,138,9,29,4,2,2,8,Promising
70096,810,9,27,2,2,2,6,Lost
70293,3816,6,19,1,1,2,4,Lost
70342,963,9,13,2,2,1,5,Lost
70460,99,6,18,4,1,2,7,Promising
70715,1645,5,5,1,1,1,3,Lost
70850,705,8,11,2,2,1,5,Lost
70932,344,10,76,3,2,4,9,Casual Users
71007,829,30,113,2,4,4,10,At Risk
71349,277,16,24,3,3,2,8,Loyal Users
71508,33,10,59,5,2,3,10,Promising
71818,281,28,46,3,4,3,10,Loyal Users
71867,1699,7,14,1,2,1,4,Lost
71902,138,12,48,4,3,3,10,Loyal Users
72190,26,57,277,5,5,5,15,Champions
72345,1650,10,18,1,2,2,5,Lost
72349,2633,11,20,1,2,2,5,Lost
72464,2,25,121,5,4,4,13,Champions
72694,581,5,14,2,1,1,4,Lost
72861,291,21,31,3,3,2,8,Loyal Users
73036,56,57,175,5,5,5,15,Champions
73064,825,14,26,2,3,2,7,Casual Users
73086,259,8,15,3,2,1,6,Casual Users
73789,90,5,13,4,1,1,6,Promising
73830,176,37,233,3,4,5,12,Loyal Users
74303,1101,5,6,2,1,1,4,Lost
74388,5844,11,27,1,2,2,5,Lost
74800,153,10,53,4,2,3,9,Promising
75354,754,142,182,2,5,5,12,At Risk
75386,1137,12,104,2,3,4,9,Casual Users
75881,398,29,44,3,4,3,10,Loyal Users
76393,117,39,127,4,4,4,12,Champions
76467,472,7,10,2,2,1,5,Lost
76483,386,12,76,3,3,4,10,Loyal Users
76689,239,20,52,3,3,3,9,Loyal Users
76825,822,14,78,2,3,4,9,Casual Users
77032,153,29,78,4,4,4,12,Champions
77088,2096,9,10,1,2,1,4,Lost
77368,281,6,22,3,1,2,6,Casual Users
77417,398,44,119,3,4,4,11,Loyal Users
77430,399,6,8,3,1,1,5,Casual Users
77706,247,15,173,3,3,5,11,Loyal Users
77817,8,17,35,5,3,3,11,Loyal Users
78060,6,97,260,5,5,5,15,Champions
78187,4793,8,22,1,2,2,5,Lost
65657,534,12,12,2,3,1,6,Casual Users
65823,409,7,8,3,2,1,6,Casual Users
65824,65,100,121,5,5,4,14,Champions
65992,43,8,28,5,2,2,9,Promising
66080,2015,14,29,1,3,2,6,Casual Users
66152,143,6,10,4,1,1,6,Promising
66193,1975,18,52,1,3,3,7,Casual Users
66532,130,37,69,4,4,4,12,Champions
66556,965,22,60,2,4,3,9,At Risk
66590,104,7,18,4,2,2,8,Promising
66814,741,7,42,2,2,3,7,Lost
67169,132,138,493,4,5,5,14,Champions
67489,19,81,365,5,5,5,15,Champions
67567,155,28,123,4,4,4,12,Champions
67622,4151,5,14,1,1,1,3,Lost
67924,250,15,25,3,3,2,8,Loyal Users
67942,60,82,138,5,5,4,14,Champions
67988,969,23,134,2,4,4,10,At Risk
68087,4724,5,12,1,1,1,3,Lost
68599,125,48,140,4,5,4,13,Champions
68905,8,11,45,5,2,3,10,Promising
69165,130,145,562,4,5,5,14,Champions
69374,3683,6,13,1,1,1,3,Lost
69564,93,23,63,4,4,4,12,Champions
69755,3051,6,8,1,1,1,3,Lost
69880,128,78,204,4,5,5,14,Champions
70100,16,112,1136,5,5,5,15,Champions
70166,188,10,18,3,2,2,7,Casual Users
70659,1252,15,50,2,3,3,8,Casual Users
71050,1126,5,17,2,1,2,5,Lost
71091,80,133,1079,4,5,5,14,Champions
71428,575,31,67,2,4,4,10,At Risk
71498,95,7,7,4,2,1,7,Promising
71528,67,50,167,5,5,5,15,Champions
71700,516,12,22,2,3,2,7,Casual Users
72009,119,118,807,4,5,5,14,Champions
72147,2168,13,25,1,3,2,6,Casual Users
72197,3528,14,20,1,3,2,6,Casual Users
72257,36,64,110,5,5,4,14,Champions
72388,550,9,9,2,2,1,5,Lost
72477,101,6,33,4,1,3,8,Promising
72484,1966,40,126,1,4,4,9,At Risk
72595,1864,11,33,1,2,3,6,Lost
72655,44,108,310,5,5,5,15,Champions
72814,3695,5,20,1,1,2,4,Lost
73257,1412,10,23,1,2,2,5,Lost
73342,106,37,66,4,4,4,12,Champions
73349,21,102,539,5,5,5,15,Champions
73421,124,18,62,4,3,3,10,Loyal Users
73547,601,11,30,2,2,2,6,Lost
74099,994,5,12,2,1,1,4,Lost
74295,289,30,121,3,4,4,11,Loyal Users
74556,293,78,160,3,5,5,13,Loyal Users
74747,103,31,146,4,4,4,12,Champions
74799,18,9,65,5,2,4,11,Promising
74829,111,13,32,4,3,3,10,Loyal Users
74858,131,76,152,4,5,5,14,Champions
75411,1708,11,26,1,2,2,5,Lost
75564,325,36,188,3,4,5,12,Loyal Users
75934,2,26,43,5,4,3,12,Loyal Users
75960,156,76,181,4,5,5,14,Champions
76040,5548,6,8,1,1,1,3,Lost
76095,498,28,137,2,4,4,10,At Risk
76209,385,31,90,3,4,4,11,Loyal Users
76430,257,13,20,3,3,2,8,Loyal Users
76479,1931,22,99,1,4,4,9,At Risk
76636,943,11,29,2,2,2,6,Lost
76720,1851,8,13,1,2,1,4,Lost
76897,299,37,86,3,4,4,11,Loyal Users
76969,708,8,44,2,2,3,7,Lost
77028,9,15,25,5,3,2,10,Loyal Users
77091,5,174,419,5,5,5,15,Champions
77741,47,34,71,5,4,4,13,Champions
77975,239,7,16,3,2,2,7,Casual Users
78040,232,23,46,3,4,3,10,Loyal Users
78080,9,31,68,5,4,4,13,Champions
78158,1361,8,21,1,2,2,5,Lost
65445,229,26,70,3,4,4,11,Loyal Users
65525,1885,11,24,1,2,2,5,Lost
65604,132,29,138,4,4,4,12,Champions
65609,6,49,326,5,5,5,15,Champions
65625,591,6,10,2,1,1,4,Lost
65895,17,51,169,5,5,5,15,Champions
65996,1451,6,8,1,1,1,3,Lost
66280,309,6,31,3,1,2,6,Casual Users
66345,100,52,177,4,5,5,14,Champions
66477,972,9,52,2,2,3,7,Lost
66609,829,11,47,2,2,3,7,Lost
66779,158,52,98,4,5,4,13,Champions
67107,121,83,249,4,5,5,14,Champions
67263,281,29,60,3,4,3,10,Loyal Users
67552,1532,10,15,1,2,1,4,Lost
68160,1105,7,24,2,2,2,6,Lost
68174,757,28,53,2,4,3,9,At Risk
68230,717,8,26,2,2,2,6,Lost
68332,1701,17,172,1,3,5,9,Casual Users
68341,41,125,487,5,5,5,15,Champions
68534,316,6,18,3,1,2,6,Casual Users
68573,146,10,14,4,2,1,7,Promising
68605,92,7,14,4,2,1,7,Promising
68708,9,27,44,5,4,3,12,Loyal Users
68792,648,9,9,2,2,1,5,Lost
68795,147,96,319,4,5,5,14,Champions
68954,1093,45,109,2,4,4,10,At Risk
69004,286,9,58,3,2,3,8,Casual Users
69905,655,15,33,2,3,3,8,Casual Users
70049,1710,6,37,1,1,3,5,Lost
70060,255,103,405,3,5,5,13,Loyal Users
70358,1265,45,122,1,4,4,9,At Risk
70479,355,15,65,3,3,4,10,Loyal Users
70686,126,24,110,4,4,4,12,Champions
70974,2557,11,28,1,2,2,5,Lost
71276,5658,10,39,1,2,3,6,Lost
71374,88,8,13,4,2,1,7,Promising
71462,78,16,47,4,3,3,10,Loyal Users
72010,250,30,58,3,4,3,10,Loyal Users
72096,101,30,174,4,4,5,13,Champions
72407,119,28,106,4,4,4,12,Champions
72514,267,6,17,3,1,2,6,Casual Users
72955,132,25,87,4,4,4,12,Champions
72975,2278,17,33,1,3,3,7,Casual Users
73105,5305,5,6,1,1,1,3,Lost
73311,853,10,20,2,2,2,6,Lost
73560,282,9,32,3,2,3,8,Casual Users
73735,3556,7,9,1,2,1,4,Lost
74134,553,6,17,2,1,2,5,Lost
74784,454,20,101,3,3,4,10,Loyal Users
74814,120,30,124,4,4,4,12,Champions
75722,846,6,10,2,1,1,4,Lost
75842,26,69,92,5,5,4,14,Champions
76648,1008,5,10,2,1,1,4,Lost
76974,1426,5,13,1,1,1,3,Lost
77142,2931,14,27,1,3,2,6,Casual Users
77164,546,39,176,2,4,5,11,At Risk
77225,245,35,140,3,4,4,11,Loyal Users
77443,22,62,121,5,5,4,14,Champions
65532,2,87,389,5,5,5,15,Champions
65941,260,5,27,3,1,2,6,Casual Users
66155,1718,9,14,1,2,1,4,Lost
66433,1238,6,7,2,1,1,4,Lost
66699,5581,12,19,1,3,2,6,Casual Users
66760,1434,10,13,1,2,1,4,Lost
66797,424,45,73,3,4,4,11,Loyal Users
66941,264,30,51,3,4,3,10,Loyal Users
67864,10,121,258,5,5,5,15,Champions
67888,4,184,265,5,5,5,15,Champions
67911,2741,10,26,1,2,2,5,Lost
68247,113,9,35,4,2,3,9,Promising
68475,102,17,128,4,3,4,11,Loyal Users
68509,73,14,113,4,3,4,11,Loyal Users
68856,125,111,681,4,5,5,14,Champions
68866,2,24,32,5,4,3,12,Loyal Users
69073,30,42,126,5,4,4,13,Champions
69114,230,27,92,3,4,4,11,Loyal Users
69353,2284,8,19,1,2,2,5,Lost
69449,106,24,54,4,4,3,11,Loyal Users
69545,121,31,57,4,4,3,11,Loyal Users
69723,95,54,269,4,5,5,14,Champions
69773,847,10,48,2,2,3,7,Lost
70491,115,38,117,4,4,4,12,Champions
70914,120,23,187,4,4,5,13,Champions
71266,3,18,56,5,3,3,11,Loyal Users
71407,566,19,32,2,3,3,8,Casual Users
71613,472,67,200,2,5,5,12,At Risk
71704,1945,6,6,1,1,1,3,Lost
71990,2139,12,38,1,3,3,7,Casual Users
72052,2140,7,9,1,2,1,4,Lost
72630,1395,6,14,1,1,1,3,Lost
73201,123,56,79,4,5,4,13,Champions
73497,835,5,34,2,1,3,6,Lost
74202,154,77,172,4,5,5,14,Champions
74214,40,10,19,5,2,2,9,Promising
74354,383,15,28,3,3,2,8,Loyal Users
74849,145,42,151,4,4,5,13,Champions
74880,134,5,8,4,1,1,6,Promising
74898,889,13,25,2,3,2,7,Casual Users
75415,0,57,71,5,5,4,14,Champions
75523,121,19,46,4,3,3,10,Loyal Users
75961,2228,10,39,1,2,3,6,Lost
75962,966,16,24,2,3,2,7,Casual Users
76397,91,22,30,4,4,2,10,Loyal Users
76427,4291,13,23,1,3,2,6,Casual Users
76584,828,6,14,2,1,1,4,Lost
76587,69,6,19,5,1,2,8,Promising
76662,12,75,137,5,5,4,14,Champions
77029,5027,12,26,1,3,2,6,Casual Users
77210,51,9,20,5,2,2,9,Promising
77235,80,26,95,4,4,4,12,Champions
77594,72,40,202,4,4,5,13,Champions
77622,1429,21,56,1,3,3,7,Casual Users
77695,8,15,77,5,3,4,12,Loyal Users
77725,13,60,279,5,5,5,15,Champions
77790,124,37,109,4,4,4,12,Champions
77894,56,64,386,5,5,5,15,Champions
78170,15,108,187,5,5,5,15,Champions
65432,605,13,22,2,3,2,7,Casual Users
65766,29,126,469,5,5,5,15,Champions
65787,99,19,74,4,3,4,11,Loyal Users
65827,2141,9,18,1,2,2,5,Lost
65863,355,56,304,3,5,5,13,Loyal Users
65875,10,136,255,5,5,5,15,Champions
66076,455,10,35,3,2,3,8,Casual Users
66297,1827,56,248,1,5,5,11,At Risk
66435,16,78,267,5,5,5,15,Champions
66470,3,12,53,5,3,3,11,Loyal Users
66568,2286,9,20,1,2,2,5,Lost
66720,78,14,35,4,3,3,10,Loyal Users
66741,136,55,161,4,5,5,14,Champions
67065,4564,6,14,1,1,1,3,Lost
67091,289,12,45,3,3,3,9,Loyal Users
67110,6145,9,16,1,2,2,5,Lost
67373,1958,10,11,1,2,1,4,Lost
67628,560,5,5,2,1,1,4,Lost
67828,1084,40,136,2,4,4,10,At Risk
68428,2657,18,161,1,3,5,9,Casual Users
68631,1922,35,198,1,4,5,10,At Risk
69395,6,109,504,5,5,5,15,Champions
69731,115,12,13,4,3,1,8,Loyal Users
69769,702,13,33,2,3,3,8,Casual Users
69811,99,14,25,4,3,2,9,Loyal Users
70073,26,47,165,5,5,5,15,Champions
70131,792,10,26,2,2,2,6,Lost
70311,216,49,146,3,5,4,12,Loyal Users
70660,438,11,18,3,2,2,7,Casual Users
70688,228,40,305,3,4,5,12,Loyal Users
70793,1130,78,111,2,5,4,11,At Risk
70854,537,5,17,2,1,2,5,Lost
71142,4546,5,6,1,1,1,3,Lost
71854,813,14,27,2,3,2,7,Casual Users
72075,64,29,91,5,4,4,13,Champions
72344,280,26,34,3,4,3,10,Loyal Users
72424,102,50,294,4,5,5,14,Champions
72889,1508,5,6,1,1,1,3,Lost
73106,1013,5,13,2,1,1,4,Lost
73776,1286,13,53,1,3,3,7,Casual Users
73788,0,27,46,5,4,3,12,Loyal Users
73842,1833,20,23,1,3,2,6,Casual Users
74484,1836,5,28,1,1,2,4,Lost
74589,1,223,669,5,5,5,15,Champions
74592,1085,9,29,2,2,2,6,Lost
74768,1696,8,14,1,2,1,4,Lost
74930,1409,17,28,1,3,2,6,Casual Users
74933,75,69,231,4,5,5,14,Champions
75003,127,62,156,4,5,5,14,Champions
75234,642,10,17,2,2,2,6,Lost
75251,1604,11,16,1,2,2,5,Lost
75622,981,15,22,2,3,2,7,Casual Users
75757,408,25,29,3,4,2,9,Loyal Users
75848,1946,5,23,1,1,2,4,Lost
75863,257,48,76,3,5,4,12,Loyal Users
76121,0,41,166,5,4,5,14,Champions
76123,577,11,56,2,2,3,7,Lost
76203,109,10,17,4,2,2,8,Promising
76407,851,5,9,2,1,1,4,Lost
76470,1323,8,19,1,2,2,5,Lost
76899,1120,8,15,2,2,1,5,Lost
76965,10,127,470,5,5,5,15,Champions
76982,87,82,220,4,5,5,14,Champions
77011,293,87,345,3,5,5,13,Loyal Users
77144,240,37,141,3,4,4,11,Loyal Users
77362,431,29,130,3,4,4,11,Loyal Users
77743,140,49,134,4,5,4,13,Champions
77893,1030,9,15,2,2,1,5,Lost
65437,676,20,63,2,3,4,9,Casual Users
65900,115,5,12,4,1,1,6,Promising
65932,429,22,50,3,4,3,10,Loyal Users
66021,265,7,8,3,2,1,6,Casual Users
66826,67,13,132,5,3,4,12,Loyal Users
66830,645,12,43,2,3,3,8,Casual Users
67277,132,24,118,4,4,4,12,Champions
67436,49,108,702,5,5,5,15,Champions
67527,132,5,6,4,1,1,6,Promising
67532,517,6,11,2,1,1,4,Lost
67818,107,149,453,4,5,5,14,Champions
67833,19,10,37,5,2,3,10,Promising
67937,2111,8,11,1,2,1,4,Lost
67966,2409,78,251,1,5,5,11,At Risk
68069,137,30,81,4,4,4,12,Champions
68095,687,24,28,2,4,2,8,At Risk
68515,2443,15,24,1,3,2,6,Casual Users
68784,223,6,7,3,1,1,5,Casual Users
69410,647,6,9,2,1,1,4,Lost
69475,1752,8,39,1,2,3,6,Lost
69957,3299,13,17,1,3,2,6,Casual Users
70569,61,102,448,5,5,5,15,Champions
70906,242,13,31,3,3,2,8,Loyal Users
71480,2096,6,19,1,1,2,4,Lost
71491,93,22,94,4,4,4,12,Champions
71519,274,25,67,3,4,4,11,Loyal Users
71599,42,5,20,5,1,2,8,Promising
71832,70,60,194,4,5,5,14,Champions
72241,1146,5,33,2,1,3,6,Lost
72476,7,7,24,5,2,2,9,Promising
72693,14,5,19,5,1,2,8,Promising
72698,27,31,205,5,4,5,14,Champions
73205,1529,20,50,1,3,3,7,Casual Users
73320,14,130,222,5,5,5,15,Champions
73407,19,58,103,5,5,4,14,Champions
73410,248,38,120,3,4,4,11,Loyal Users
73606,1869,5,25,1,1,2,4,Lost
73614,2377,6,10,1,1,1,3,Lost
73705,5663,8,8,1,2,1,4,Lost
74312,3226,5,13,1,1,1,3,Lost
74368,132,7,87,4,2,4,10,Promising
74634,2225,5,14,1,1,1,3,Lost
75023,571,8,11,2,2,1,5,Lost
75024,690,6,18,2,1,2,5,Lost
75243,235,12,40,3,3,3,9,Loyal Users
75308,2552,5,31,1,1,2,4,Lost
75741,335,30,127,3,4,4,11,Loyal Users
75767,1277,11,42,1,2,3,6,Lost
76411,694,6,40,2,1,3,6,Lost
77132,2825,6,8,1,1,1,3,Lost
77257,6005,8,8,1,2,1,4,Lost
77383,256,114,315,3,5,5,13,Loyal Users
77408,420,6,7,3,1,1,5,Casual Users
77530,33,104,277,5,5,5,15,Champions
77667,128,78,122,4,5,4,13,Champions
77737,1490,18,38,1,3,3,7,Casual Users
77903,971,14,46,2,3,3,8,Casual Users
77945,256,9,12,3,2,1,6,Casual Users
78105,141,6,19,4,1,2,7,Promising
65653,15,89,163,5,5,5,15,Champions
65660,131,15,21,4,3,2,9,Loyal Users
65675,907,15,81,2,3,4,9,Casual Users
65821,123,9,13,4,2,1,7,Promising
66722,23,26,84,5,4,4,13,Champions
66841,361,12,50,3,3,3,9,Loyal Users
66980,3,41,130,5,4,4,13,Champions
66983,1576,23,87,1,4,4,9,At Risk
67167,138,7,13,4,2,1,7,Promising
67230,248,16,35,3,3,3,9,Loyal Users
67361,550,5,10,2,1,1,4,Lost
67569,29,125,400,5,5,5,15,Champions
67762,4147,6,10,1,1,1,3,Lost
67994,1599,21,113,1,3,4,8,Casual Users
69515,315,41,129,3,4,4,11,Loyal Users
69582,723,12,27,2,3,2,7,Casual Users
69642,701,7,11,2,2,1,5,Lost
70112,522,27,154,2,4,5,11,At Risk
70199,449,5,9,3,1,1,5,Casual Users
70395,1152,14,18,2,3,2,7,Casual Users
70497,2268,8,92,1,2,4,7,Lost
70554,20,74,190,5,5,5,15,Champions
70719,5,65,265,5,5,5,15,Champions
70807,610,11,36,2,2,3,7,Lost
71812,2263,6,13,1,1,1,3,Lost
71852,3462,5,7,1,1,1,3,Lost
72167,128,6,11,4,1,1,6,Promising
72217,443,75,168,3,5,5,13,Loyal Users
72233,2130,11,19,1,2,2,5,Lost
72337,54,125,201,5,5,5,15,Champions
72543,45,12,35,5,3,3,11,Loyal Users
72558,420,141,560,3,5,5,13,Loyal Users
72723,837,8,15,2,2,1,5,Lost
72841,287,10,51,3,2,3,8,Casual Users
72873,70,8,8,4,2,1,7,Promising
73247,437,13,21,3,3,2,8,Loyal Users
73277,13,55,93,5,5,4,14,Champions
73511,152,20,36,4,3,3,10,Loyal Users
73528,303,68,161,3,5,5,13,Loyal Users
73610,446,8,17,3,2,2,7,Casual Users
73880,164,32,127,4,4,4,12,Champions
74052,101,17,57,4,3,3,10,Loyal Users
74122,37,9,11,5,2,1,8,Promising
74428,8,141,398,5,5,5,15,Champions
74714,138,182,471,4,5,5,14,Champions
75027,77,31,59,4,4,3,11,Loyal Users
75298,305,9,35,3,2,3,8,Casual Users
75506,694,17,108,2,3,4,9,Casual Users
75636,1480,11,17,1,2,2,5,Lost
75872,116,16,23,4,3,2,9,Loyal Users
76066,38,23,161,5,4,5,14,Champions
76234,2531,48,178,1,5,5,11,At Risk
76403,115,41,186,4,4,5,13,Champions
76484,1946,9,9,1,2,1,4,Lost
77311,1423,12,22,1,3,2,6,Casual Users
77588,993,7,44,2,2,3,7,Lost
77714,688,105,174,2,5,5,12,At Risk
65479,285,100,241,3,5,5,13,Loyal Users
65753,773,5,6,2,1,1,4,Lost
65904,242,30,39,3,4,3,10,Loyal Users
65949,32,277,599,5,5,5,15,Champions
66026,271,36,64,3,4,4,11,Loyal Users
66199,434,25,78,3,4,4,11,Loyal Users
66667,408,17,86,3,3,4,10,Loyal Users
66668,287,15,126,3,3,4,10,Loyal Users
66964,1593,7,12,1,2,1,4,Lost
67054,2660,7,54,1,2,3,6,Lost
67175,436,16,75,3,3,4,10,Loyal Users
67375,724,12,33,2,3,3,8,Casual Users
67595,61,136,352,5,5,5,15,Champions
67715,2875,31,41,1,4,3,8,At Risk
67855,460,45,109,3,4,4,11,Loyal Users
67922,28,77,128,5,5,4,14,Champions
68063,136,27,83,4,4,4,12,Champions
68317,239,5,6,3,1,1,5,Casual Users
68327,22,71,262,5,5,5,15,Champions
68405,2667,8,41,1,2,3,6,Lost
68752,438,5,10,3,1,1,5,Casual Users
68915,7,21,72,5,3,4,12,Loyal Users
69371,1,69,95,5,5,4,14,Champions
69439,12,19,60,5,3,3,11,Loyal Users
69441,1563,6,22,1,1,2,4,Lost
69622,104,108,410,4,5,5,14,Champions
69708,4,119,275,5,5,5,15,Champions
69832,111,42,71,4,4,4,12,Champions
70046,840,11,23,2,2,2,6,Lost
70091,117,66,211,4,5,5,14,Champions
70346,101,8,58,4,2,3,9,Promising
70517,291,32,43,3,4,3,10,Loyal Users
70687,392,12,42,3,3,3,9,Loyal Users
70901,10,62,80,5,5,4,14,Champions
71905,118,6,16,4,1,2,7,Promising
71967,1123,13,13,2,3,1,6,Casual Users
72077,1973,6,13,1,1,1,3,Lost
72545,3704,6,21,1,1,2,4,Lost
72662,156,13,27,4,3,2,9,Loyal Users
72675,216,9,14,3,2,1,6,Casual Users
72729,2551,7,19,1,2,2,5,Lost
72793,2,33,164,5,4,5,14,Champions
73052,3384,6,18,1,1,2,4,Lost
73093,536,14,42,2,3,3,8,Casual Users
73296,112,11,31,4,2,2,8,Promising
73299,148,55,123,4,5,4,13,Champions
73365,120,37,60,4,4,3,11,Loyal Users
73480,1682,5,8,1,1,1,3,Lost
73600,18,134,314,5,5,5,15,Champions
73605,3017,6,8,1,1,1,3,Lost
73653,4,87,198,5,5,5,15,Champions
73862,67,13,100,5,3,4,12,Loyal Users
73884,366,7,11,3,2,1,6,Casual Users
74110,3413,5,6,1,1,1,3,Lost
74528,1164,10,58,2,2,3,7,Lost
75047,140,5,9,4,1,1,6,Promising
75105,709,15,20,2,3,2,7,Casual Users
75114,101,16,48,4,3,3,10,Loyal Users
75217,1674,8,23,1,2,2,5,Lost
75241,30,22,134,5,4,4,13,Champions
75304,1165,13,28,2,3,2,7,Casual Users
75416,416,11,34,3,2,3,8,Casual Users
75439,357,9,21,3,2,2,7,Casual Users
75617,481,6,52,2,1,3,6,Lost
76101,179,42,69,3,4,4,11,Loyal Users
76286,1525,20,30,1,3,2,6,Casual Users
76431,106,10,14,4,2,1,7,Promising
76432,996,5,5,2,1,1,4,Lost
76522,2233,7,34,1,2,3,6,Lost
76606,92,11,37,4,2,3,9,Promising
76680,130,22,133,4,4,4,12,Champions
76983,31,32,67,5,4,4,13,Champions
77167,6,123,457,5,5,5,15,Champions
77374,77,7,26,4,2,2,8,Promising
77479,104,52,135,4,5,4,13,Champions
77496,28,111,343,5,5,5,15,Champions
77503,286,5,6,3,1,1,5,Casual Users
77637,1119,6,20,2,1,2,5,Lost
77778,4402,31,89,1,4,4,9,At Risk
77943,3969,7,10,1,2,1,4,Lost
78157,993,7,17,2,2,2,6,Lost
78260,5173,5,6,1,1,1,3,Lost
65578,738,9,20,2,2,2,6,Lost
65587,671,16,30,2,3,2,7,Casual Users
65650,2300,5,8,1,1,1,3,Lost
65672,7,91,563,5,5,5,15,Champions
65699,317,8,9,3,2,1,6,Casual Users
65835,975,6,32,2,1,3,6,Lost
65856,1249,6,10,2,1,1,4,Lost
66396,30,13,22,5,3,2,10,Loyal Users
66471,1067,10,16,2,2,2,6,Lost
66500,270,16,30,3,3,2,8,Loyal Users
66542,32,97,494,5,5,5,15,Champions
66766,2125,13,31,1,3,2,6,Casual Users
67208,3136,7,19,1,2,2,5,Lost
67223,188,6,38,3,1,3,7,Casual Users
67583,214,54,122,3,5,4,12,Loyal Users
67635,51,121,586,5,5,5,15,Champions
67653,10,130,664,5,5,5,15,Champions
67982,840,19,25,2,3,2,7,Casual Users
68266,16,94,415,5,5,5,15,Champions
68550,3,97,155,5,5,5,15,Champions
68932,19,184,619,5,5,5,15,Champions
68956,965,14,19,2,3,2,7,Casual Users
69162,4846,5,13,1,1,1,3,Lost
69186,55,35,86,5,4,4,13,Champions
69422,0,23,53,5,4,3,12,Loyal Users
69429,1547,7,26,1,2,2,5,Lost
69599,147,48,159,4,5,5,14,Champions
70283,523,8,57,2,2,3,7,Lost
70532,179,31,86,3,4,4,11,Loyal Users
70573,126,14,46,4,3,3,10,Loyal Users
70662,17,16,35,5,3,3,11,Loyal Users
71668,949,13,20,2,3,2,7,Casual Users
71915,236,44,82,3,4,4,11,Loyal Users
72050,44,54,122,5,5,4,14,Champions
72051,34,21,93,5,3,4,12,Loyal Users
72627,1600,5,16,1,1,2,4,Lost
73008,1102,7,20,2,2,2,6,Lost
73235,78,17,29,4,3,2,9,Loyal Users
73313,2575,6,11,1,1,1,3,Lost
73440,207,26,109,3,4,4,11,Loyal Users
73947,14,18,44,5,3,3,11,Loyal Users
74073,2523,5,40,1,1,3,5,Lost
74114,2369,7,24,1,2,2,5,Lost
74271,606,77,325,2,5,5,12,At Risk
74588,32,90,484,5,5,5,15,Champions
75284,129,13,35,4,3,3,10,Loyal Users
75355,422,6,7,3,1,1,5,Casual Users
75367,290,14,24,3,3,2,8,Loyal Users
75382,382,15,54,3,3,3,9,Loyal Users
75713,224,8,13,3,2,1,6,Casual Users
75812,19,5,15,5,1,1,7,Promising
76318,81,88,238,4,5,5,14,Champions
76451,766,13,53,2,3,3,8,Casual Users
76828,968,9,39,2,2,3,7,Lost
77093,111,10,32,4,2,3,9,Promising
77471,13,14,70,5,3,4,12,Loyal Users
65593,52,99,397,5,5,5,15,Champions
66086,271,5,7,3,1,1,5,Casual Users
66332,272,7,10,3,2,1,6,Casual Users
66792,460,10,14,3,2,1,6,Casual Users
66806,230,6,50,3,1,3,7,Casual Users
66837,4,65,213,5,5,5,15,Champions
66947,127,16,20,4,3,2,9,Loyal Users
67131,75,295,618,4,5,5,14,Champions
67268,109,7,7,4,2,1,7,Promising
67347,16,35,50,5,4,3,12,Loyal Users
67385,35,82,293,5,5,5,15,Champions
67500,847,17,81,2,3,4,9,Casual Users
67531,544,6,23,2,1,2,5,Lost
67870,4,43,110,5,4,4,13,Champions
67928,5,20,33,5,3,3,11,Loyal Users
67980,1979,5,21,1,1,2,4,Lost
68269,3774,6,16,1,1,2,4,Lost
68796,2815,6,14,1,1,1,3,Lost
69182,1281,17,24,1,3,2,6,Casual Users
69216,4133,10,10,1,2,1,4,Lost
69326,248,57,469,3,5,5,13,Loyal Users
69456,341,21,36,3,3,3,9,Loyal Users
69596,26,63,124,5,5,4,14,Champions
69745,1115,8,33,2,2,3,7,Lost
69800,3,26,69,5,4,4,13,Champions
69814,2086,7,24,1,2,2,5,Lost
69991,2127,5,22,1,1,2,4,Lost
70188,154,38,103,4,4,4,12,Champions
70310,22,15,38,5,3,3,11,Loyal Users
70992,363,29,84,3,4,4,11,Loyal Users
71098,178,51,76,3,5,4,12,Loyal Users
71347,136,101,243,4,5,5,14,Champions
72098,409,17,47,3,3,3,9,Loyal Users
72164,2866,7,42,1,2,3,6,Lost
72165,149,23,51,4,4,3,11,Loyal Users
72620,146,29,40,4,4,3,11,Loyal Users
72794,240,6,7,3,1,1,5,Casual Users
72831,372,5,39,3,1,3,7,Casual Users
73141,395,13,28,3,3,2,8,Loyal Users
73148,69,22,163,5,4,5,14,Champions
73376,842,16,44,2,3,3,8,Casual Users
73469,1532,5,40,1,1,3,5,Lost
73803,101,52,88,4,5,4,13,Champions
74091,136,129,579,4,5,5,14,Champions
74098,406,8,16,3,2,2,7,Casual Users
74158,111,97,254,4,5,5,14,Champions
74178,891,13,33,2,3,3,8,Casual Users
75001,298,5,35,3,1,3,7,Casual Users
75245,20,77,294,5,5,5,15,Champions
75278,3294,8,15,1,2,1,4,Lost
75388,699,8,29,2,2,2,6,Lost
75465,2353,6,8,1,1,1,3,Lost
75468,1392,10,11,1,2,1,4,Lost
75731,4819,11,57,1,2,3,6,Lost
75734,153,5,8,4,1,1,6,Promising
76053,660,9,12,2,2,1,5,Lost
76633,152,75,224,4,5,5,14,Champions
76855,418,14,111,3,3,4,10,Loyal Users
76858,4491,10,10,1,2,1,4,Lost
77020,517,8,10,2,2,1,5,Lost
77860,289,53,133,3,5,4,12,Loyal Users
77925,1650,10,35,1,2,3,6,Lost
77972,116,20,129,4,3,4,11,Loyal Users
78092,1092,13,62,2,3,3,8,Casual Users
78095,145,7,37,4,2,3,9,Promising
65519,846,8,13,2,2,1,5,Lost
66559,124,22,72,4,4,4,12,Champions
66584,248,18,67,3,3,4,10,Loyal Users
66729,6,8,20,5,2,2,9,Promising
66854,81,97,357,4,5,5,14,Champions
67006,1214,13,30,2,3,2,7,Casual Users
67310,2783,8,8,1,2,1,4,Lost
67342,8,145,418,5,5,5,15,Champions
67475,549,25,57,2,4,3,9,At Risk
67495,3256,68,125,1,5,4,10,At Risk
68320,569,59,190,2,5,5,12,At Risk
68365,30,10,17,5,2,2,9,Promising
68762,22,11,96,5,2,4,11,Promising
68925,114,42,109,4,4,4,12,Champions
69602,27,49,113,5,5,4,14,Champions
69893,734,8,23,2,2,2,6,Lost
70168,3416,11,11,1,2,1,4,Lost
70208,143,29,103,4,4,4,12,Champions
70218,276,10,32,3,2,3,8,Casual Users
70592,35,43,285,5,4,5,14,Champions
70618,58,129,362,5,5,5,15,Champions
70847,36,11,17,5,2,2,9,Promising
70868,115,81,205,4,5,5,14,Champions
70964,26,85,194,5,5,5,15,Champions
70982,264,29,91,3,4,4,11,Loyal Users
70996,1101,12,31,2,3,2,7,Casual Users
71045,104,34,60,4,4,3,11,Loyal Users
71206,113,29,37,4,4,3,11,Loyal Users
71425,298,96,127,3,5,4,12,Loyal Users
71469,208,11,15,3,2,1,6,Casual Users
71524,136,33,73,4,4,4,12,Champions
71616,28,27,33,5,4,3,12,Loyal Users
71626,1111,8,17,2,2,2,6,Lost
71747,2357,5,16,1,1,2,4,Lost
71946,459,17,20,3,3,2,8,Loyal Users
72707,243,28,63,3,4,4,11,Loyal Users
72765,958,6,21,2,1,2,5,Lost
73298,267,21,64,3,3,4,10,Loyal Users
73394,113,86,301,4,5,5,14,Champions
73461,103,12,30,4,3,2,9,Loyal Users
73652,28,44,137,5,4,4,13,Champions
74131,142,101,263,4,5,5,14,Champions
74415,111,26,45,4,4,3,11,Loyal Users
74465,1981,32,134,1,4,4,9,At Risk
75265,1108,9,26,2,2,2,6,Lost
75408,1,55,221,5,5,5,15,Champions
75437,270,5,20,3,1,2,6,Casual Users
75613,1842,12,41,1,3,3,7,Casual Users
75684,379,18,255,3,3,5,11,Loyal Users
75700,146,11,15,4,2,1,7,Promising
75828,2552,8,9,1,2,1,4,Lost
75963,127,9,49,4,2,3,9,Promising
76535,102,98,483,4,5,5,14,Champions
77170,4255,6,20,1,1,2,4,Lost
77284,157,23,32,4,4,3,11,Loyal Users
77300,5,62,268,5,5,5,15,Champions
77551,65,162,378,5,5,5,15,Champions
77598,168,18,50,3,3,3,9,Loyal Users
77639,82,98,109,4,5,4,13,Champions
77744,0,19,80,5,3,4,12,Loyal Users
65791,4139,8,18,1,2,2,5,Lost
66108,432,13,29,3,3,2,8,Loyal Users
66123,419,11,19,3,2,2,7,Casual Users
66239,86,34,47,4,4,3,11,Loyal Users
66632,311,44,95,3,4,4,11,Loyal Users
66824,237,29,55,3,4,3,10,Loyal Users
66842,32,5,15,5,1,1,7,Promising
66897,523,72,106,2,5,4,11,At Risk
67074,44,123,685,5,5,5,15,Champions
67125,16,6,10,5,1,1,7,Promising
67465,78,43,106,4,4,4,12,Champions
67473,2007,6,6,1,1,1,3,Lost
67558,244,15,48,3,3,3,9,Loyal Users
67771,559,5,20,2,1,2,5,Lost
67784,632,33,76,2,4,4,10,At Risk
67884,420,28,43,3,4,3,10,Loyal Users
68128,16,159,599,5,5,5,15,Champions
68984,3524,12,17,1,3,2,6,Casual Users
69110,590,102,576,2,5,5,12,At Risk
69239,1003,6,13,2,1,1,4,Lost
69281,2421,10,35,1,2,3,6,Lost
69716,82,48,197,4,5,5,14,Champions
69920,1327,11,28,1,2,2,5,Lost
70495,1022,21,69,2,3,4,9,Casual Users
70944,391,5,44,3,1,3,7,Casual Users
71029,5,19,28,5,3,2,10,Loyal Users
71132,879,5,6,2,1,1,4,Lost
71140,2988,99,125,1,5,4,10,At Risk
71336,820,5,6,2,1,1,4,Lost
71404,88,159,334,4,5,5,14,Champions
71450,467,9,15,3,2,1,6,Casual Users
71483,4534,5,7,1,1,1,3,Lost
71531,3459,10,14,1,2,1,4,Lost
72056,99,21,47,4,3,3,10,Loyal Users
72149,125,30,72,4,4,4,12,Champions
72152,148,99,215,4,5,5,14,Champions
72894,546,30,104,2,4,4,10,At Risk
73089,146,12,53,4,3,3,10,Loyal Users
73128,81,53,110,4,5,4,13,Champions
73409,4134,5,5,1,1,1,3,Lost
73433,444,25,39,3,4,3,10,Loyal Users
74126,129,18,29,4,3,2,9,Loyal Users
74242,98,114,318,4,5,5,14,Champions
74265,435,14,24,3,3,2,8,Loyal Users
74602,123,28,134,4,4,4,12,Champions
74655,104,24,42,4,4,3,11,Loyal Users
74701,0,11,14,5,2,1,8,Promising
74833,1757,5,5,1,1,1,3,Lost
74995,249,24,48,3,4,3,10,Loyal Users
75099,1980,14,56,1,3,3,7,Casual Users
75320,5,14,38,5,3,3,11,Loyal Users
75639,17,16,21,5,3,2,10,Loyal Users
76475,12,168,478,5,5,5,15,Champions
77037,4099,5,7,1,1,1,3,Lost
77646,205,14,26,3,3,2,8,Loyal Users
77669,2669,5,7,1,1,1,3,Lost
77832,317,7,10,3,2,1,6,Casual Users
77955,1075,27,46,2,4,3,9,At Risk
78128,822,7,11,2,2,1,5,Lost
65528,426,14,18,3,3,2,8,Loyal Users
65570,5673,5,5,1,1,1,3,Lost
65630,972,23,31,2,4,2,8,At Risk
65714,225,7,11,3,2,1,6,Casual Users
66121,418,8,13,3,2,1,6,Casual Users
66136,21,127,453,5,5,5,15,Champions
66144,7,75,125,5,5,4,14,Champions
66247,285,10,15,3,2,1,6,Casual Users
66331,545,5,57,2,1,3,6,Lost
66338,825,18,213,2,3,5,10,Casual Users
66786,699,5,8,2,1,1,4,Lost
67069,1839,6,8,1,1,1,3,Lost
67253,84,11,23,4,2,2,8,Promising
67428,994,9,12,2,2,1,5,Lost
67474,211,46,171,3,5,5,13,Loyal Users
67639,414,6,34,3,1,3,7,Casual Users
67685,2,79,143,5,5,4,14,Champions
67981,124,25,62,4,4,3,11,Loyal Users
68431,48,45,144,5,4,4,13,Champions
68600,242,8,24,3,2,2,7,Casual Users
68646,695,5,5,2,1,1,4,Lost
68738,260,59,306,3,5,5,13,Loyal Users
68846,4,44,158,5,4,5,14,Champions
69215,1451,7,33,1,2,3,6,Lost
69636,967,33,138,2,4,4,10,At Risk
69971,2704,8,15,1,2,1,4,Lost
70056,176,83,218,3,5,5,13,Loyal Users
70276,55,6,13,5,1,1,7,Promising
70428,51,7,16,5,2,2,9,Promising
70543,3886,10,20,1,2,2,5,Lost
70561,159,97,208,4,5,5,14,Champions
70859,420,62,125,3,5,4,12,Loyal Users
70930,1836,20,37,1,3,3,7,Casual Users
71056,150,24,73,4,4,4,12,Champions
71433,1734,7,32,1,2,3,6,Lost
71535,130,17,20,4,3,2,9,Loyal Users
71692,39,96,204,5,5,5,15,Champions
71939,40,13,37,5,3,3,11,Loyal Users
72485,1373,7,8,1,2,1,4,Lost
72777,688,10,16,2,2,2,6,Lost
72842,4299,6,14,1,1,1,3,Lost
72906,296,9,24,3,2,2,7,Casual Users
73102,156,47,92,4,5,4,13,Champions
73173,129,7,14,4,2,1,7,Promising
73442,6,200,464,5,5,5,15,Champions
73626,7,60,283,5,5,5,15,Champions
73815,580,6,8,2,1,1,4,Lost
73817,426,27,36,3,4,3,10,Loyal Users
73856,1542,9,13,1,2,1,4,Lost
73952,12,26,55,5,4,3,12,Loyal Users
74162,0,10,17,5,2,2,9,Promising
74384,946,22,25,2,4,2,8,At Risk
74413,19,46,97,5,5,4,14,Champions
75327,81,5,21,4,1,2,7,Promising
75347,15,126,573,5,5,5,15,Champions
75471,3893,6,10,1,1,1,3,Lost
75529,729,5,6,2,1,1,4,Lost
76133,18,9,36,5,2,3,10,Promising
76211,2708,10,14,1,2,1,4,Lost
76367,283,27,45,3,4,3,10,Loyal Users
76480,274,26,57,3,4,3,10,Loyal Users
76971,115,83,286,4,5,5,14,Champions
77099,125,58,145,4,5,4,13,Champions
77130,247,8,32,3,2,3,8,Casual Users
77228,107,33,87,4,4,4,12,Champions
77399,102,94,236,4,5,5,14,Champions
77493,8,66,129,5,5,4,14,Champions
77649,1829,9,11,1,2,1,4,Lost
77950,24,115,275,5,5,5,15,Champions
77979,143,38,284,4,4,5,13,Champions
78026,404,14,16,3,3,2,8,Loyal Users
78089,46,30,65,5,4,4,13,Champions
78121,95,62,117,4,5,4,13,Champions
65566,95,74,148,4,5,5,14,Champions
65767,43,12,60,5,3,3,11,Loyal Users
66744,918,7,27,2,2,2,6,Lost
66931,78,28,67,4,4,4,12,Champions
67034,607,22,37,2,4,3,9,At Risk
67134,155,16,66,4,3,4,11,Loyal Users
67217,10,96,137,5,5,4,14,Champions
67630,90,49,90,4,5,4,13,Champions
67998,52,43,74,5,4,4,13,Champions
68209,149,22,44,4,4,3,11,Loyal Users
69126,116,43,227,4,4,5,13,Champions
69151,612,5,8,2,1,1,4,Lost
69193,2998,9,10,1,2,1,4,Lost
69304,26,17,28,5,3,2,10,Loyal Users
69317,620,20,38,2,3,3,8,Casual Users
69621,3297,22,22,1,4,2,7,At Risk
69780,834,10,22,2,2,2,6,Lost
69784,166,9,21,3,2,2,7,Casual Users
70078,246,14,56,3,3,3,9,Loyal Users
70182,77,55,82,4,5,4,13,Champions
70471,11,126,610,5,5,5,15,Champions
71002,355,8,95,3,2,4,9,Casual Users
71288,425,45,152,3,4,5,12,Loyal Users
71343,160,21,54,4,3,3,10,Loyal Users
71362,867,6,13,2,1,1,4,Lost
71592,2097,5,13,1,1,1,3,Lost
72111,422,10,36,3,2,3,8,Casual Users
72120,190,39,46,3,4,3,10,Loyal Users
72151,38,27,109,5,4,4,13,Champions
72279,151,45,130,4,4,4,12,Champions
72422,225,109,444,3,5,5,13,Loyal Users
72516,809,46,144,2,5,4,11,At Risk
72562,458,25,66,3,4,4,11,Loyal Users
72752,609,10,50,2,2,3,7,Lost
72775,133,19,80,4,3,4,11,Loyal Users
72977,74,128,495,4,5,5,14,Champions
73212,99,6,6,4,1,1,6,Promising
73319,0,18,44,5,3,3,11,Loyal Users
73584,90,18,45,4,3,3,10,Loyal Users
73972,229,6,16,3,1,2,6,Casual Users
73973,104,106,205,4,5,5,14,Champions
74163,146,26,55,4,4,3,11,Loyal Users
74363,0,73,243,5,5,5,15,Champions
74553,171,42,106,3,4,4,11,Loyal Users
75221,729,27,35,2,4,3,9,At Risk
75331,260,6,7,3,1,1,5,Casual Users
75463,2735,9,39,1,2,3,6,Lost
75469,486,28,60,2,4,3,9,At Risk
75837,29,10,94,5,2,4,11,Promising
76024,0,18,98,5,3,4,12,Loyal Users
76114,541,17,30,2,3,2,7,Casual Users
76340,2980,5,15,1,1,1,3,Lost
76373,18,8,58,5,2,3,10,Promising
76435,140,144,549,4,5,5,14,Champions
76549,79,13,14,4,3,1,8,Loyal Users
76550,138,6,16,4,1,2,7,Promising
77008,579,5,6,2,1,1,4,Lost
77233,246,107,372,3,5,5,13,Loyal Users
77241,0,172,380,5,5,5,15,Champions
77315,430,16,27,3,3,2,8,Loyal Users
77338,409,38,60,3,4,3,10,Loyal Users
77390,745,53,133,2,5,4,11,At Risk
77564,80,31,122,4,4,4,12,Champions
77719,733,26,173,2,4,5,11,At Risk
78141,5266,5,13,1,1,1,3,Lost
65550,256,5,9,3,1,1,5,Casual Users
66127,630,13,31,2,3,2,7,Casual Users
66218,4756,7,15,1,2,1,4,Lost
66326,1179,10,19,2,2,2,6,Lost
66596,100,16,36,4,3,3,10,Loyal Users
66611,135,91,107,4,5,4,13,Champions
66689,304,6,11,3,1,1,5,Casual Users
66748,2991,12,18,1,3,2,6,Casual Users
66875,108,104,320,4,5,5,14,Champions
67062,698,9,26,2,2,2,6,Lost
67212,90,88,172,4,5,5,14,Champions
67592,828,9,17,2,2,2,6,Lost
67647,18,25,124,5,4,4,13,Champions
67957,696,7,24,2,2,2,6,Lost
68660,105,28,152,4,4,5,13,Champions
69558,820,11,35,2,2,3,7,Lost
69816,4888,11,20,1,2,2,5,Lost
69863,263,110,440,3,5,5,13,Loyal Users
70115,123,68,184,4,5,5,14,Champions
70462,287,5,10,3,1,1,5,Casual Users
70797,927,5,35,2,1,3,6,Lost
71064,38,130,177,5,5,5,15,Champions
71177,219,13,76,3,3,4,10,Loyal Users
71208,774,13,18,2,3,2,7,Casual Users
71211,10,113,343,5,5,5,15,Champions
71538,173,19,35,3,3,3,9,Loyal Users
71560,566,9,14,2,2,1,5,Lost
71982,100,19,20,4,3,2,9,Loyal Users
72236,816,8,8,2,2,1,5,Lost
72319,89,73,385,4,5,5,14,Champions
72470,222,35,93,3,4,4,11,Loyal Users
72531,432,10,24,3,2,2,7,Casual Users
72638,1092,7,8,2,2,1,5,Lost
72949,47,18,22,5,3,2,10,Loyal Users
73194,132,9,9,4,2,1,7,Promising
73252,380,16,22,3,3,2,8,Loyal Users
73474,3100,5,7,1,1,1,3,Lost
73645,1181,5,17,2,1,2,5,Lost
73967,115,6,13,4,1,1,6,Promising
74250,1017,9,12,2,2,1,5,Lost
74291,91,21,46,4,3,3,10,Loyal Users
74643,4,31,90,5,4,4,13,Champions
74660,407,23,50,3,4,3,10,Loyal Users
74682,217,9,20,3,2,2,7,Casual Users
74867,116,12,23,4,3,2,9,Loyal Users
74916,350,87,308,3,5,5,13,Loyal Users
75061,72,46,263,4,5,5,14,Champions
75412,107,88,601,4,5,5,14,Champions
75413,1054,42,180,2,4,5,11,At Risk
75567,469,29,68,3,4,4,11,Loyal Users
75606,49,63,186,5,5,5,15,Champions
76029,2168,9,9,1,2,1,4,Lost
76200,1525,5,7,1,1,1,3,Lost
76428,70,28,94,4,4,4,12,Champions
76655,110,18,115,4,3,4,11,Loyal Users
76734,73,5,9,4,1,1,6,Promising
76748,254,11,18,3,2,2,7,Casual Users
77113,247,63,375,3,5,5,13,Loyal Users
77204,400,6,6,3,1,1,5,Casual Users
77407,46,25,131,5,4,4,13,Champions
78101,1397,41,201,1,4,5,10,At Risk
78230,52,129,425,5,5,5,15,Champions
65814,369,9,36,3,2,3,8,Casual Users
65975,107,42,156,4,4,5,13,Champions
66087,288,5,8,3,1,1,5,Casual Users
66363,28,13,50,5,3,3,11,Loyal Users
66578,828,5,11,2,1,1,4,Lost
66770,27,21,79,5,3,4,12,Loyal Users
67041,164,10,27,4,2,2,8,Promising
67382,382,19,64,3,3,4,10,Loyal Users
67448,46,31,105,5,4,4,13,Champions
67605,3540,5,6,1,1,1,3,Lost
67787,933,20,37,2,3,3,8,Casual Users
67822,237,30,145,3,4,4,11,Loyal Users
68288,2433,5,16,1,1,2,4,Lost
68334,2251,5,15,1,1,1,3,Lost
68367,148,12,22,4,3,2,9,Loyal Users
68569,110,20,28,4,3,2,9,Loyal Users
69016,255,19,41,3,3,3,9,Loyal Users
69145,1139,9,9,2,2,1,5,Lost
69713,1090,12,34,2,3,3,8,Casual Users
69719,245,14,84,3,3,4,10,Loyal Users
70081,412,15,97,3,3,4,10,Loyal Users
70522,3802,10,14,1,2,1,4,Lost
70525,2096,10,16,1,2,2,5,Lost
70674,416,9,25,3,2,2,7,Casual Users
70677,132,85,455,4,5,5,14,Champions
70713,1245,7,7,2,2,1,5,Lost
70818,669,5,6,2,1,1,4,Lost
71077,382,42,102,3,4,4,11,Loyal Users
71434,208,33,129,3,4,4,11,Loyal Users
71504,2604,6,9,1,1,1,3,Lost
71779,402,54,217,3,5,5,13,Loyal Users
71850,57,60,176,5,5,5,15,Champions
71883,4,22,92,5,4,4,13,Champions
71971,697,11,24,2,2,2,6,Lost
72487,1024,5,7,2,1,1,4,Lost
72500,91,29,242,4,4,5,13,Champions
72697,52,17,88,5,3,4,12,Loyal Users
72787,119,20,65,4,3,4,11,Loyal Users
72893,30,61,74,5,5,4,14,Champions
73220,114,14,43,4,3,3,10,Loyal Users
73250,2822,10,14,1,2,1,4,Lost
73453,533,11,39,2,2,3,7,Lost
73722,165,57,149,4,5,5,14,Champions
73851,347,5,41,3,1,3,7,Casual Users
74051,51,22,34,5,4,3,12,Loyal Users
74127,62,36,137,5,4,4,13,Champions
74284,740,15,28,2,3,2,7,Casual Users
74355,78,83,144,4,5,4,13,Champions
74913,132,18,85,4,3,4,11,Loyal Users
75263,795,27,50,2,4,3,9,At Risk
75271,144,14,34,4,3,3,10,Loyal Users
75665,2306,32,94,1,4,4,9,At Risk
75986,19,119,347,5,5,5,15,Champions
76033,1,6,14,5,1,1,7,Promising
76190,1549,5,7,1,1,1,3,Lost
76248,2590,8,23,1,2,2,5,Lost
76369,1971,6,11,1,1,1,3,Lost
76543,27,120,272,5,5,5,15,Champions
76793,339,6,15,3,1,1,5,Casual Users
77272,210,5,10,3,1,1,5,Casual Users
77591,103,30,190,4,4,5,13,Champions
77808,24,34,175,5,4,5,14,Champions
77899,246,22,32,3,4,3,10,Loyal Users
78188,2440,15,37,1,3,3,7,Casual Users
65459,155,11,22,4,2,2,8,Promising
65568,289,20,96,3,3,4,10,Loyal Users
65611,1690,7,7,1,2,1,4,Lost
65710,270,7,16,3,2,2,7,Casual Users
65784,1279,14,102,1,3,4,8,Casual Users
65806,1105,12,33,2,3,3,8,Casual Users
65933,117,8,14,4,2,1,7,Promising
65958,1183,15,31,2,3,2,7,Casual Users
65999,2457,7,14,1,2,1,4,Lost
66051,2096,13,40,1,3,3,7,Casual Users
66091,1232,6,17,2,1,2,5,Lost
66656,573,14,18,2,3,2,7,Casual Users
67160,5286,17,38,1,3,3,7,Casual Users
67301,25,44,69,5,4,4,13,Champions
67926,4305,5,21,1,1,2,4,Lost
67973,20,9,9,5,2,1,8,Promising
68146,3033,11,22,1,2,2,5,Lost
68432,14,54,141,5,5,4,14,Champions
68500,544,12,14,2,3,1,6,Casual Users
68802,684,24,52,2,4,3,9,At Risk
68972,565,12,38,2,3,3,8,Casual Users
69061,1429,10,11,1,2,1,4,Lost
69172,1426,9,13,1,2,1,4,Lost
69413,30,16,47,5,3,3,11,Loyal Users
69547,1988,8,23,1,2,2,5,Lost
69741,14,128,474,5,5,5,15,Champions
69902,267,11,36,3,2,3,8,Casual Users
70278,9,41,206,5,4,5,14,Champions
70287,683,16,21,2,3,2,7,Casual Users
70321,141,6,14,4,1,1,6,Promising
70838,5096,7,20,1,2,2,5,Lost
70980,47,10,86,5,2,4,11,Promising
71033,412,11,92,3,2,4,9,Casual Users
71073,5423,7,17,1,2,2,5,Lost
71239,152,69,318,4,5,5,14,Champions
71291,11,10,43,5,2,3,10,Promising
71348,813,7,16,2,2,2,6,Lost
71436,2700,13,59,1,3,3,7,Casual Users
71486,431,8,47,3,2,3,8,Casual Users
71752,2605,9,30,1,2,2,5,Lost
71859,2179,7,44,1,2,3,6,Lost
72318,831,5,48,2,1,3,6,Lost
72529,1,45,148,5,4,5,14,Champions
72548,124,24,49,4,4,3,11,Loyal Users
72848,147,36,141,4,4,4,12,Champions
72851,255,16,96,3,3,4,10,Loyal Users
73656,2701,14,24,1,3,2,6,Casual Users
74578,1077,7,12,2,2,1,5,Lost
74940,24,30,113,5,4,4,13,Champions
75404,1563,5,5,1,1,1,3,Lost
75745,96,100,251,4,5,5,14,Champions
75796,29,36,314,5,4,5,14,Champions
75900,4403,5,28,1,1,2,4,Lost
76388,719,10,16,2,2,2,6,Lost
76509,1962,27,56,1,4,3,8,At Risk
76581,267,31,130,3,4,4,11,Loyal Users
76728,2,66,131,5,5,4,14,Champions
76778,78,123,501,4,5,5,14,Champions
77255,1,16,80,5,3,4,12,Loyal Users
77305,178,21,72,3,3,4,10,Loyal Users
77387,528,20,53,2,3,3,8,Casual Users
77434,270,5,8,3,1,1,5,Casual Users
77627,2523,8,8,1,2,1,4,Lost
77683,13,26,119,5,4,4,13,Champions
77709,1599,8,29,1,2,2,5,Lost
77888,3,6,11,5,1,1,7,Promising
65789,14,61,86,5,5,4,14,Champions
66039,10,38,48,5,4,3,12,Loyal Users
66256,811,9,34,2,2,3,7,Lost
66561,9,154,478,5,5,5,15,Champions
66733,658,6,10,2,1,1,4,Lost
66849,1985,9,32,1,2,3,6,Lost
67106,149,77,183,4,5,5,14,Champions
67240,134,46,212,4,5,5,14,Champions
67321,1135,25,35,2,4,3,9,At Risk
67378,13,25,73,5,4,4,13,Champions
67461,1257,62,288,2,5,5,12,At Risk
67629,110,47,69,4,5,4,13,Champions
67675,152,7,27,4,2,2,8,Promising
67891,213,17,63,3,3,4,10,Loyal Users
67927,107,52,216,4,5,5,14,Champions
68003,12,80,386,5,5,5,15,Champions
68005,227,55,114,3,5,4,12,Loyal Users
68054,4,91,176,5,5,5,15,Champions
68094,158,35,243,4,4,5,13,Champions
68234,435,16,80,3,3,4,10,Loyal Users
68331,10,13,50,5,3,3,11,Loyal Users
68530,674,29,84,2,4,4,10,At Risk
68725,85,26,61,4,4,3,11,Loyal Users
68727,2440,9,10,1,2,1,4,Lost
68953,5159,35,47,1,4,3,8,At Risk
69038,44,9,52,5,2,3,10,Promising
69212,67,7,30,5,2,2,9,Promising
69896,264,15,28,3,3,2,8,Loyal Users
70281,224,53,88,3,5,4,12,Loyal Users
70359,166,38,76,3,4,4,11,Loyal Users
70425,295,15,142,3,3,4,10,Loyal Users
70500,42,7,14,5,2,1,8,Promising
70708,1,14,83,5,3,4,12,Loyal Users
70920,2162,28,56,1,4,3,8,At Risk
71061,1237,9,94,2,2,4,8,Lost
71209,3,79,179,5,5,5,15,Champions
71409,52,82,244,5,5,5,15,Champions
71606,2416,7,8,1,2,1,4,Lost
71619,25,48,159,5,5,5,15,Champions
71830,16,8,24,5,2,2,9,Promising
71932,164,15,54,4,3,3,10,Loyal Users
71968,238,21,81,3,3,4,10,Loyal Users
72025,106,47,256,4,5,5,14,Champions
72163,102,45,274,4,4,5,13,Champions
72637,258,41,118,3,4,4,11,Loyal Users
72897,96,21,42,4,3,3,10,Loyal Users
73040,147,18,155,4,3,5,12,Loyal Users
73431,418,10,70,3,2,4,9,Casual Users
73508,263,7,14,3,2,1,6,Casual Users
73655,59,96,248,5,5,5,15,Champions
73787,271,10,18,3,2,2,7,Casual Users
74144,371,54,101,3,5,4,12,Loyal Users
74209,1137,15,51,2,3,3,8,Casual Users
74422,435,30,46,3,4,3,10,Loyal Users
74510,140,24,53,4,4,3,11,Loyal Users
74923,399,16,29,3,3,2,8,Loyal Users
75315,807,5,10,2,1,1,4,Lost
75470,896,42,56,2,4,3,9,At Risk
75715,3123,11,20,1,2,2,5,Lost
75951,1861,8,49,1,2,3,6,Lost
76216,27,5,8,5,1,1,7,Promising
76771,17,57,271,5,5,5,15,Champions
76967,219,13,62,3,3,3,9,Loyal Users
77529,47,110,421,5,5,5,15,Champions
77555,11,82,108,5,5,4,14,Champions
77671,248,23,83,3,4,4,11,Loyal Users
77756,671,8,44,2,2,3,7,Lost
77935,717,8,25,2,2,2,6,Lost
78239,1664,7,23,1,2,2,5,Lost
65452,15,7,14,5,2,1,8,Promising
65882,5,22,151,5,4,5,14,Champions
66262,19,153,336,5,5,5,15,Champions
66337,27,77,202,5,5,5,15,Champions
66359,1141,8,10,2,2,1,5,Lost
66802,679,9,15,2,2,1,5,Lost
67027,437,79,106,3,5,4,12,Loyal Users
67234,1860,5,9,1,1,1,3,Lost
67478,118,14,149,4,3,5,12,Loyal Users
67713,646,6,10,2,1,1,4,Lost
67821,1292,8,17,1,2,2,5,Lost
68203,3856,9,23,1,2,2,5,Lost
68366,1142,35,158,2,4,5,11,At Risk
68624,681,9,21,2,2,2,6,Lost
69018,3895,10,17,1,2,2,5,Lost
69022,270,9,12,3,2,1,6,Casual Users
69065,1,25,155,5,4,5,14,Champions
69086,133,21,79,4,3,4,11,Loyal Users
69227,3025,5,5,1,1,1,3,Lost
69404,27,14,38,5,3,3,11,Loyal Users
69738,270,19,58,3,3,3,9,Loyal Users
69990,120,8,16,4,2,2,8,Promising
70040,704,10,30,2,2,2,6,Lost
70223,665,23,104,2,4,4,10,At Risk
70228,65,84,153,5,5,5,15,Champions
70787,295,11,30,3,2,2,7,Casual Users
70791,70,25,58,4,4,3,11,Loyal Users
70813,27,75,213,5,5,5,15,Champions
70912,2426,10,87,1,2,4,7,Lost
71110,22,15,28,5,3,2,10,Loyal Users
71179,141,28,60,4,4,3,11,Loyal Users
71182,258,25,44,3,4,3,10,Loyal Users
71427,47,165,794,5,5,5,15,Champions
71620,111,8,11,4,2,1,7,Promising
71625,3586,9,15,1,2,1,4,Lost
71684,110,40,103,4,4,4,12,Champions
71699,1200,12,16,2,3,2,7,Casual Users
72034,2844,25,51,1,4,3,8,At Risk
72247,405,11,120,3,2,4,9,Casual Users
72271,1586,8,13,1,2,1,4,Lost
72336,41,68,319,5,5,5,15,Champions
72679,3092,15,50,1,3,3,7,Casual Users
73045,836,5,5,2,1,1,4,Lost
73119,177,32,311,3,4,5,12,Loyal Users
73445,49,43,173,5,4,5,14,Champions
73572,3778,7,17,1,2,2,5,Lost
73596,13,26,117,5,4,4,13,Champions
73799,504,36,53,2,4,3,9,At Risk
74124,12,59,130,5,5,4,14,Champions
74982,104,10,27,4,2,2,8,Promising
74984,4093,8,17,1,2,2,5,Lost
75324,1282,42,79,1,4,4,9,At Risk
76401,127,129,236,4,5,5,14,Champions
76462,405,16,74,3,3,4,10,Loyal Users
76721,651,101,131,2,5,4,11,At Risk
76767,379,33,102,3,4,4,11,Loyal Users
76840,127,18,122,4,3,4,11,Loyal Users
77265,888,6,37,2,1,3,6,Lost
77517,3046,40,72,1,4,4,9,At Risk
77620,1026,11,15,2,2,1,5,Lost
77634,18,8,11,5,2,1,8,Promising
78043,279,71,458,3,5,5,13,Loyal Users
65473,1252,19,26,2,3,2,7,Casual Users
65543,1462,5,13,1,1,1,3,Lost
65718,1112,32,117,2,4,4,10,At Risk
65811,723,7,11,2,2,1,5,Lost
66282,4559,7,10,1,2,1,4,Lost
66317,3497,10,22,1,2,2,5,Lost
66716,5,65,102,5,5,4,14,Champions
67279,696,13,85,2,3,4,9,Casual Users
67340,3233,9,15,1,2,1,4,Lost
67617,8,27,39,5,4,3,12,Loyal Users
67652,1508,6,10,1,1,1,3,Lost
67680,104,8,13,4,2,1,7,Promising
67777,110,68,115,4,5,4,13,Champions
67781,271,12,20,3,3,2,8,Loyal Users
67813,232,68,187,3,5,5,13,Loyal Users
67887,1419,7,18,1,2,2,5,Lost
67892,154,39,119,4,4,4,12,Champions
68060,321,9,11,3,2,1,6,Casual Users
68690,117,18,20,4,3,2,9,Loyal Users
68947,1580,5,7,1,1,1,3,Lost
69493,47,21,23,5,3,2,10,Loyal Users
69536,857,9,28,2,2,2,6,Lost
69562,17,27,42,5,4,3,12,Loyal Users
69667,1132,15,43,2,3,3,8,Casual Users
69779,433,20,56,3,3,3,9,Loyal Users
70029,41,49,169,5,5,5,15,Champions
70828,1548,18,43,1,3,3,7,Casual Users
71204,79,15,52,4,3,3,10,Loyal Users
71282,412,11,119,3,2,4,9,Casual Users
71582,661,8,33,2,2,3,7,Lost
71865,965,12,15,2,3,1,6,Casual Users
71881,233,40,207,3,4,5,12,Loyal Users
72011,132,26,62,4,4,3,11,Loyal Users
72198,120,147,1019,4,5,5,14,Champions
72282,5624,5,18,1,1,2,4,Lost
72547,2720,5,6,1,1,1,3,Lost
72561,5,98,178,5,5,5,15,Champions
72784,4509,8,13,1,2,1,4,Lost
72826,252,9,41,3,2,3,8,Casual Users
72885,2,74,283,5,5,5,15,Champions
72963,420,22,46,3,4,3,10,Loyal Users
72980,278,29,50,3,4,3,10,Loyal Users
73130,374,7,30,3,2,2,7,Casual Users
73386,120,18,52,4,3,3,10,Loyal Users
73492,2,24,39,5,4,3,12,Loyal Users
74118,131,41,60,4,4,3,11,Loyal Users
74119,377,16,35,3,3,3,9,Loyal Users
74198,134,20,98,4,3,4,11,Loyal Users
74590,1509,7,31,1,2,2,5,Lost
75028,1266,8,18,1,2,2,5,Lost
75162,80,20,56,4,3,3,10,Loyal Users
75484,390,47,92,3,5,4,12,Loyal Users
75595,1649,7,15,1,2,1,4,Lost
75640,861,10,20,2,2,2,6,Lost
76222,5009,13,28,1,3,2,6,Casual Users
76385,29,87,599,5,5,5,15,Champions
76416,3648,5,8,1,1,1,3,Lost
76418,72,118,455,4,5,5,14,Champions
76515,130,53,259,4,5,5,14,Champions
76833,3286,5,10,1,1,1,3,Lost
76948,111,17,45,4,3,3,10,Loyal Users
76978,3,97,222,5,5,5,15,Champions
77016,103,149,402,4,5,5,14,Champions
77145,2987,7,27,1,2,2,5,Lost
77158,4639,5,13,1,1,1,3,Lost
77548,1098,8,17,2,2,2,6,Lost
77853,819,29,56,2,4,3,9,At Risk
77967,1817,11,63,1,2,4,7,Lost
78016,221,14,99,3,3,4,10,Loyal Users
78071,6,11,29,5,2,2,9,Promising
78193,5,114,267,5,5,5,15,Champions
78196,455,34,59,3,4,3,10,Loyal Users
65832,91,40,178,4,4,5,13,Champions
66049,378,111,244,3,5,5,13,Loyal Users
66220,206,11,22,3,2,2,7,Casual Users
66381,508,19,81,2,3,4,9,Casual Users
66608,4453,39,69,1,4,4,9,At Risk
66794,2408,5,17,1,1,2,4,Lost
66819,1697,11,25,1,2,2,5,Lost
66852,4409,9,10,1,2,1,4,Lost
66953,333,17,124,3,3,4,10,Loyal Users
67018,116,41,89,4,4,4,12,Champions
67250,1758,6,52,1,1,3,5,Lost
67545,1951,6,14,1,1,1,3,Lost
67752,176,35,69,3,4,4,11,Loyal Users
67931,26,99,186,5,5,5,15,Champions
68119,1985,11,75,1,2,4,7,Lost
68457,119,12,14,4,3,1,8,Loyal Users
69323,12,24,115,5,4,4,13,Champions
69809,415,9,18,3,2,2,7,Casual Users
69969,242,21,36,3,3,3,9,Loyal Users
70170,106,7,47,4,2,3,9,Promising
70211,286,6,30,3,1,2,6,Casual Users
70362,3,104,557,5,5,5,15,Champions
70392,30,26,38,5,4,3,12,Loyal Users
70658,65,70,542,5,5,5,15,Champions
70743,23,102,181,5,5,5,15,Champions
70836,598,11,13,2,2,1,5,Lost
71009,175,5,12,3,1,1,5,Casual Users
71170,88,5,8,4,1,1,6,Promising
71171,508,6,9,2,1,1,4,Lost
71226,126,24,39,4,4,3,11,Loyal Users
71281,1016,18,37,2,3,3,8,Casual Users
71426,1374,12,16,1,3,2,6,Casual Users
71572,15,38,85,5,4,4,13,Champions
71642,748,17,146,2,3,4,9,Casual Users
71978,1255,31,169,2,4,5,11,At Risk
72019,2426,6,8,1,1,1,3,Lost
72509,34,44,198,5,4,5,14,Champions
72845,14,29,230,5,4,5,14,Champions
73306,18,77,650,5,5,5,15,Champions
73309,30,36,205,5,4,5,14,Champions
73347,25,14,26,5,3,2,10,Loyal Users
73417,566,9,22,2,2,2,6,Lost
73491,2842,6,7,1,1,1,3,Lost
73595,86,53,168,4,5,5,14,Champions
73805,3224,5,27,1,1,2,4,Lost
74664,130,7,7,4,2,1,7,Promising
74910,335,21,36,3,3,3,9,Loyal Users
75220,3161,5,16,1,1,2,4,Lost
75266,57,32,123,5,4,4,13,Champions
75410,4728,5,10,1,1,1,3,Lost
75651,119,19,78,4,3,4,11,Loyal Users
75669,3,9,38,5,2,3,10,Promising
75781,709,10,12,2,2,1,5,Lost
75884,439,28,103,3,4,4,11,Loyal Users
76172,424,43,50,3,4,3,10,Loyal Users
76314,771,10,54,2,2,3,7,Lost
76593,168,10,24,3,2,2,7,Casual Users
77165,1007,6,11,2,1,1,4,Lost
77445,395,29,61,3,4,3,10,Loyal Users
77508,317,17,43,3,3,3,9,Loyal Users
77693,466,36,185,3,4,5,12,Loyal Users
78108,104,27,47,4,4,3,11,Loyal Users
78274,163,7,13,4,2,1,7,Promising
65737,122,73,189,4,5,5,14,Champions
65901,601,96,175,2,5,5,12,At Risk
66195,266,19,32,3,3,3,9,Loyal Users
66526,52,5,6,5,1,1,7,Promising
66631,435,8,56,3,2,3,8,Casual Users
66960,420,5,20,3,1,2,6,Casual Users
67040,691,12,24,2,3,2,7,Casual Users
67171,111,57,95,4,5,4,13,Champions
67466,259,9,17,3,2,2,7,Casual Users
67523,1954,9,9,1,2,1,4,Lost
67616,721,5,6,2,1,1,4,Lost
67640,85,14,31,4,3,2,9,Loyal Users
68206,199,66,126,3,5,4,12,Loyal Users
68480,837,11,22,2,2,2,6,Lost
68606,3912,5,7,1,1,1,3,Lost
68719,2856,7,33,1,2,3,6,Lost
68892,123,18,32,4,3,3,10,Loyal Users
68946,1865,6,9,1,1,1,3,Lost
69013,90,20,29,4,3,2,9,Loyal Users
69397,107,99,442,4,5,5,14,Champions
69484,3429,11,33,1,2,3,6,Lost
69668,836,13,29,2,3,2,7,Casual Users
69796,368,43,228,3,4,5,12,Loyal Users
69879,297,40,81,3,4,4,11,Loyal Users
70232,1258,22,130,1,4,4,9,At Risk
70249,1943,5,6,1,1,1,3,Lost
70374,1604,39,114,1,4,4,9,At Risk
70427,1310,8,18,1,2,2,5,Lost
70695,262,68,301,3,5,5,13,Loyal Users
70751,400,16,26,3,3,2,8,Loyal Users
70916,1595,8,14,1,2,1,4,Lost
71507,154,26,34,4,4,3,11,Loyal Users
72385,562,12,31,2,3,2,7,Casual Users
72469,804,14,83,2,3,4,9,Casual Users
72624,1674,30,52,1,4,3,8,At Risk
72734,14,7,37,5,2,3,10,Promising
72771,41,52,280,5,5,5,15,Champions
72795,416,15,25,3,3,2,8,Loyal Users
72813,529,33,106,2,4,4,10,At Risk
72974,275,122,305,3,5,5,13,Loyal Users
73415,107,12,72,4,3,4,11,Loyal Users
73438,67,31,46,5,4,3,12,Loyal Users
73589,4412,6,14,1,1,1,3,Lost
74176,124,67,169,4,5,5,14,Champions
74258,1533,9,48,1,2,3,6,Lost
74365,253,10,26,3,2,2,7,Casual Users
74426,136,52,110,4,5,4,13,Champions
74517,368,30,63,3,4,4,11,Loyal Users
74617,3947,6,17,1,1,2,4,Lost
74894,1384,10,45,1,2,3,6,Lost
74961,44,7,12,5,2,1,8,Promising
75563,1148,8,10,2,2,1,5,Lost
75629,241,45,62,3,4,3,10,Loyal Users
75871,1596,59,176,1,5,5,11,At Risk
75887,410,5,6,3,1,1,5,Casual Users
76198,78,7,17,4,2,2,8,Promising
76607,379,40,103,3,4,4,11,Loyal Users
76753,2032,8,13,1,2,1,4,Lost
76896,489,10,13,2,2,1,5,Lost
76911,137,47,232,4,5,5,14,Champions
77650,1265,6,47,1,1,3,5,Lost
77745,3842,6,18,1,1,2,4,Lost
78107,1059,6,11,2,1,1,4,Lost
78172,966,25,27,2,4,2,8,At Risk
65451,261,7,7,3,2,1,6,Casual Users
65683,700,12,30,2,3,2,7,Casual Users
65831,2478,16,22,1,3,2,6,Casual Users
65844,1590,5,8,1,1,1,3,Lost
65893,3,150,410,5,5,5,15,Champions
66122,104,21,51,4,3,3,10,Loyal Users
66279,1,132,414,5,5,5,15,Champions
66288,2248,5,7,1,1,1,3,Lost
66430,2778,7,31,1,2,2,5,Lost
66573,12,47,77,5,5,4,14,Champions
66998,282,15,28,3,3,2,8,Loyal Users
67654,1612,5,36,1,1,3,5,Lost
68068,57,44,62,5,4,3,12,Loyal Users
68089,565,17,28,2,3,2,7,Casual Users
68138,124,84,158,4,5,5,14,Champions
68220,494,5,5,2,1,1,4,Lost
68462,692,7,18,2,2,2,6,Lost
68819,114,29,65,4,4,4,12,Champions
68911,954,7,9,2,2,1,5,Lost
69108,20,135,956,5,5,5,15,Champions
69198,317,73,152,3,5,5,13,Loyal Users
69283,1273,5,23,1,1,2,4,Lost
69396,3260,5,13,1,1,1,3,Lost
69462,24,35,95,5,4,4,13,Champions
69508,313,11,11,3,2,1,6,Casual Users
69778,74,31,65,4,4,4,12,Champions
69891,292,39,88,3,4,4,11,Loyal Users
70625,974,34,84,2,4,4,10,At Risk
70766,44,151,522,5,5,5,15,Champions
71076,227,39,90,3,4,4,11,Loyal Users
71114,2124,5,5,1,1,1,3,Lost
71192,5718,5,5,1,1,1,3,Lost
71756,265,7,11,3,2,1,6,Casual Users
71792,2085,5,6,1,1,1,3,Lost
72374,986,11,11,2,2,1,5,Lost
72393,143,114,258,4,5,5,14,Champions
72520,33,84,522,5,5,5,15,Champions
72720,5122,6,12,1,1,1,3,Lost
72907,566,11,16,2,2,2,6,Lost
72994,1662,22,154,1,4,5,10,At Risk
73231,707,9,10,2,2,1,5,Lost
73326,5,166,564,5,5,5,15,Champions
73844,718,64,76,2,5,4,11,At Risk
73870,1,36,250,5,4,5,14,Champions
73896,128,56,81,4,5,4,13,Champions
73995,303,10,77,3,2,4,9,Casual Users
74185,260,11,73,3,2,4,9,Casual Users
74196,5724,5,10,1,1,1,3,Lost
74282,1633,8,12,1,2,1,4,Lost
74298,468,8,25,3,2,2,7,Casual Users
74545,2783,5,9,1,1,1,3,Lost
75042,836,7,9,2,2,1,5,Lost
75223,547,24,40,2,4,3,9,At Risk
75427,121,19,100,4,3,4,11,Loyal Users
75434,440,20,41,3,3,3,9,Loyal Users
75444,293,11,14,3,2,1,6,Casual Users
75973,86,22,75,4,4,4,12,Champions
76170,1303,8,13,1,2,1,4,Lost
76460,3291,6,9,1,1,1,3,Lost
76504,233,6,18,3,1,2,6,Casual Users
76687,1,41,223,5,4,5,14,Champions
76761,535,6,9,2,1,1,4,Lost
76842,126,41,107,4,4,4,12,Champions
76980,61,57,120,5,5,4,14,Champions
77084,1664,6,10,1,1,1,3,Lost
77354,1384,7,10,1,2,1,4,Lost
77543,1692,14,32,1,3,3,7,Casual Users
77647,143,14,17,4,3,2,9,Loyal Users
77978,1969,8,10,1,2,1,4,Lost
77993,0,176,635,5,5,5,15,Champions
78138,901,13,174,2,3,5,10,Casual Users
78206,1009,8,10,2,2,1,5,Lost
65588,17,60,215,5,5,5,15,Champions
65668,145,70,224,4,5,5,14,Champions
65738,146,5,10,4,1,1,6,Promising
66137,693,47,93,2,5,4,11,At Risk
66512,10,31,75,5,4,4,13,Champions
66808,124,52,156,4,5,5,14,Champions
67707,689,42,68,2,4,4,10,At Risk
67823,1179,15,37,2,3,3,8,Casual Users
67826,116,16,69,4,3,4,11,Loyal Users
67961,1012,6,7,2,1,1,4,Lost
68075,1418,6,13,1,1,1,3,Lost
68466,266,32,79,3,4,4,11,Loyal Users
68774,278,38,186,3,4,5,12,Loyal Users
68775,71,52,284,4,5,5,14,Champions
68862,136,34,166,4,4,5,13,Champions
69188,136,72,343,4,5,5,14,Champions
69208,139,10,21,4,2,2,8,Promising
69483,1,8,20,5,2,2,9,Promising
69529,405,23,62,3,4,3,10,Loyal Users
69692,3282,5,38,1,1,3,5,Lost
69790,2650,6,13,1,1,1,3,Lost
69915,301,33,149,3,4,5,12,Loyal Users
70111,342,11,12,3,2,1,6,Casual Users
70135,141,10,12,4,2,1,7,Promising
70239,1159,16,17,2,3,2,7,Casual Users
70718,878,14,23,2,3,2,7,Casual Users
70903,716,15,26,2,3,2,7,Casual Users
71413,421,30,130,3,4,4,11,Loyal Users
71769,2828,17,77,1,3,4,8,Casual Users
71895,117,29,134,4,4,4,12,Champions
71974,543,33,51,2,4,3,9,At Risk
72369,1716,7,19,1,2,2,5,Lost
72435,128,58,289,4,5,5,14,Champions
72659,801,17,70,2,3,4,9,Casual Users
72739,1697,10,13,1,2,1,4,Lost
72762,46,20,74,5,3,4,12,Loyal Users
72782,29,19,67,5,3,4,12,Loyal Users
72899,1857,5,17,1,1,2,4,Lost
72956,1,37,104,5,4,4,13,Champions
72993,15,23,43,5,4,3,12,Loyal Users
73044,31,14,49,5,3,3,11,Loyal Users
73259,409,38,84,3,4,4,11,Loyal Users
73372,21,37,118,5,4,4,13,Champions
73619,455,7,27,3,2,2,7,Casual Users
73739,770,11,13,2,2,1,5,Lost
73791,90,16,29,4,3,2,9,Loyal Users
73922,14,21,29,5,3,2,10,Loyal Users
74235,109,68,227,4,5,5,14,Champions
74772,1435,15,72,1,3,4,8,Casual Users
74990,1812,11,55,1,2,3,6,Lost
75228,1225,5,11,2,1,1,4,Lost
76078,13,8,9,5,2,1,8,Promising
76152,24,59,259,5,5,5,15,Champions
76269,133,34,152,4,4,5,13,Champions
76450,431,7,14,3,2,1,6,Casual Users
76552,101,26,34,4,4,3,11,Loyal Users
76700,19,40,62,5,4,3,12,Loyal Users
76869,50,5,42,5,1,3,9,Promising
76928,1424,7,30,1,2,2,5,Lost
76932,1886,9,15,1,2,1,4,Lost
78143,243,31,132,3,4,4,11,Loyal Users
65659,74,63,214,4,5,5,14,Champions
65888,112,8,11,4,2,1,7,Promising
65917,353,7,13,3,2,1,6,Casual Users
66621,967,21,81,2,3,4,9,Casual Users
66711,593,13,20,2,3,2,7,Casual Users
66745,19,30,47,5,4,3,12,Loyal Users
66907,179,5,7,3,1,1,5,Casual Users
67902,22,15,66,5,3,4,12,Loyal Users
68038,305,16,70,3,3,4,10,Loyal Users
68072,1031,5,5,2,1,1,4,Lost
68443,731,8,22,2,2,2,6,Lost
68460,101,14,27,4,3,2,9,Loyal Users
68578,3508,12,12,1,3,1,5,Casual Users
68786,384,53,115,3,5,4,12,Loyal Users
68816,711,5,18,2,1,2,5,Lost
69106,412,10,87,3,2,4,9,Casual Users
70226,84,83,240,4,5,5,14,Champions
70393,501,43,267,2,4,5,11,At Risk
70644,35,29,144,5,4,4,13,Champions
71189,47,14,39,5,3,3,11,Loyal Users
71287,5104,5,11,1,1,1,3,Lost
71828,984,5,6,2,1,1,4,Lost
72017,106,78,443,4,5,5,14,Champions
72251,1,122,482,5,5,5,15,Champions
73003,112,28,117,4,4,4,12,Champions
73098,566,28,81,2,4,4,10,At Risk
73190,576,5,5,2,1,1,4,Lost
73297,28,78,134,5,5,4,14,Champions
73831,90,21,43,4,3,3,10,Loyal Users
74705,683,8,12,2,2,1,5,Lost
74795,238,9,19,3,2,2,7,Casual Users
74824,525,36,104,2,4,4,10,At Risk
74952,123,46,77,4,5,4,13,Champions
75290,265,6,16,3,1,2,6,Casual Users
75451,2606,7,10,1,2,1,4,Lost
75675,244,16,107,3,3,4,10,Loyal Users
76519,78,17,54,4,3,3,10,Loyal Users
76708,18,60,200,5,5,5,15,Champions
76937,841,22,69,2,4,4,10,At Risk
77089,2390,5,14,1,1,1,3,Lost
77097,593,19,33,2,3,3,8,Casual Users
77147,3583,6,9,1,1,1,3,Lost
77640,247,8,9,3,2,1,6,Casual Users
77875,142,29,191,4,4,5,13,Champions
77881,843,7,15,2,2,1,5,Lost
78079,111,20,32,4,3,3,10,Loyal Users
78093,553,19,140,2,3,4,9,Casual Users
78183,126,64,129,4,5,4,13,Champions
66119,3437,5,72,1,1,4,6,Lost
66261,19,13,35,5,3,3,11,Loyal Users
66272,283,7,21,3,2,2,7,Casual Users
66302,675,29,81,2,4,4,10,At Risk
66304,1861,7,9,1,2,1,4,Lost
66347,265,99,311,3,5,5,13,Loyal Users
66348,321,19,74,3,3,4,10,Loyal Users
66369,150,10,22,4,2,2,8,Promising
66771,281,9,18,3,2,2,7,Casual Users
66892,497,24,34,2,4,3,9,At Risk
66975,4491,5,12,1,1,1,3,Lost
67182,39,49,152,5,5,5,15,Champions
67293,692,27,109,2,4,4,10,At Risk
67700,36,114,877,5,5,5,15,Champions
67943,274,32,121,3,4,4,11,Loyal Users
68318,812,9,32,2,2,3,7,Lost
68397,115,48,85,4,5,4,13,Champions
68520,1767,6,11,1,1,1,3,Lost
68757,839,26,104,2,4,4,10,At Risk
68863,281,170,276,3,5,5,13,Loyal Users
69313,88,53,204,4,5,5,14,Champions
69583,3701,7,26,1,2,2,5,Lost
69787,1980,9,128,1,2,4,7,Lost
69820,29,6,73,5,1,4,10,Promising
69914,210,175,383,3,5,5,13,Loyal Users
70292,90,7,76,4,2,4,10,Promising
70351,120,40,304,4,4,5,13,Champions
70770,239,10,19,3,2,2,7,Casual Users
70941,2210,7,11,1,2,1,4,Lost
71317,2,105,278,5,5,5,15,Champions
72013,10,37,237,5,4,5,14,Champions
72093,63,50,80,5,5,4,14,Champions
72252,292,99,358,3,5,5,13,Loyal Users
72265,79,16,31,4,3,2,9,Loyal Users
72661,2562,5,13,1,1,1,3,Lost
72692,116,19,38,4,3,3,10,Loyal Users
72719,2024,15,21,1,3,2,6,Casual Users
72755,4132,21,22,1,3,2,6,Casual Users
72766,16,52,77,5,5,4,14,Champions
73072,122,5,23,4,1,2,7,Promising
73087,6,122,289,5,5,5,15,Champions
73364,998,32,138,2,4,4,10,At Risk
73464,71,39,51,4,4,3,11,Loyal Users
73516,315,11,24,3,2,2,7,Casual Users
73581,301,12,41,3,3,3,9,Loyal Users
73642,148,12,29,4,3,2,9,Loyal Users
73689,2850,5,6,1,1,1,3,Lost
73702,1413,5,11,1,1,1,3,Lost
74031,143,14,39,4,3,3,10,Loyal Users
74034,533,17,31,2,3,2,7,Casual Users
74238,257,27,84,3,4,4,11,Loyal Users
74604,451,42,395,3,4,5,12,Loyal Users
74615,220,32,59,3,4,3,10,Loyal Users
74665,259,14,21,3,3,2,8,Loyal Users
74769,133,28,42,4,4,3,11,Loyal Users
74871,1828,8,12,1,2,1,4,Lost
74922,115,6,15,4,1,1,6,Promising
75050,55,12,72,5,3,4,12,Loyal Users
75287,2409,6,11,1,1,1,3,Lost
75521,399,8,29,3,2,2,7,Casual Users
75526,8,24,76,5,4,4,13,Champions
75765,30,148,572,5,5,5,15,Champions
76107,834,10,57,2,2,3,7,Lost
76189,140,22,69,4,4,4,12,Champions
76371,183,16,17,3,3,2,8,Loyal Users
76518,115,30,121,4,4,4,12,Champions
76758,2,61,98,5,5,4,14,Champions
76908,1216,11,28,2,2,2,6,Lost
76999,6,25,93,5,4,4,13,Champions
77199,1305,8,10,1,2,1,4,Lost
77291,102,117,183,4,5,5,14,Champions
77346,124,118,235,4,5,5,14,Champions
77547,86,20,39,4,3,3,10,Loyal Users
77947,117,27,96,4,4,4,12,Champions
65569,2421,17,54,1,3,3,7,Casual Users
65641,409,30,38,3,4,3,10,Loyal Users
66407,136,25,162,4,4,5,13,Champions
66528,79,9,13,4,2,1,7,Promising
66616,909,5,10,2,1,1,4,Lost
66809,120,13,86,4,3,4,11,Loyal Users
67132,1876,26,33,1,4,3,8,At Risk
67216,408,14,27,3,3,2,8,Loyal Users
67267,136,16,45,4,3,3,10,Loyal Users
67810,1256,18,19,2,3,2,7,Casual Users
68045,138,48,74,4,5,4,13,Champions
68170,412,48,97,3,5,4,12,Loyal Users
68541,116,16,83,4,3,4,11,Loyal Users
68939,120,45,93,4,4,4,12,Champions
69001,246,112,575,3,5,5,13,Loyal Users
69029,1220,34,129,2,4,4,10,At Risk
69271,137,40,202,4,4,5,13,Champions
69355,424,13,29,3,3,2,8,Loyal Users
70203,709,6,15,2,1,1,4,Lost
70716,891,20,58,2,3,3,8,Casual Users
71097,2,5,7,5,1,1,7,Promising
71367,405,7,9,3,2,1,6,Casual Users
71457,43,33,159,5,4,5,14,Champions
71518,420,6,43,3,1,3,7,Casual Users
71706,424,17,27,3,3,2,8,Loyal Users
71722,122,54,241,4,5,5,14,Champions
71892,444,85,159,3,5,5,13,Loyal Users
72449,354,10,14,3,2,1,6,Casual Users
72490,7,80,176,5,5,5,15,Champions
73747,1,144,347,5,5,5,15,Champions
73786,15,15,53,5,3,3,11,Loyal Users
74007,45,188,648,5,5,5,15,Champions
74554,15,151,313,5,5,5,15,Champions
75375,156,13,49,4,3,3,10,Loyal Users
75690,63,71,143,5,5,4,14,Champions
76249,220,36,54,3,4,3,10,Loyal Users
76632,3132,10,63,1,2,4,7,Lost
76691,4593,8,14,1,2,1,4,Lost
77120,43,57,227,5,5,5,15,Champions
77182,36,55,127,5,5,4,14,Champions
77419,142,13,35,4,3,3,10,Loyal Users
77423,405,62,95,3,5,4,12,Loyal Users
77798,166,48,85,3,5,4,12,Loyal Users
77878,28,109,392,5,5,5,15,Champions
78173,389,44,108,3,4,4,11,Loyal Users
78211,2872,6,9,1,1,1,3,Lost
65512,759,8,18,2,2,2,6,Lost
65518,41,86,545,5,5,5,15,Champions
65590,424,71,83,3,5,4,12,Loyal Users
66078,1089,5,5,2,1,1,4,Lost
66156,42,21,86,5,3,4,12,Loyal Users
66175,2037,5,7,1,1,1,3,Lost
66214,4,98,219,5,5,5,15,Champions
66264,1403,9,18,1,2,2,5,Lost
66339,442,38,368,3,4,5,12,Loyal Users
66375,9,106,175,5,5,5,15,Champions
66451,409,5,7,3,1,1,5,Casual Users
66508,1008,5,34,2,1,3,6,Lost
66707,32,52,129,5,5,4,14,Champions
66890,2300,6,13,1,1,1,3,Lost
66896,933,5,12,2,1,1,4,Lost
66950,2004,10,44,1,2,3,6,Lost
67070,4,23,37,5,4,3,12,Loyal Users
67142,1560,5,7,1,1,1,3,Lost
67193,1160,29,88,2,4,4,10,At Risk
67271,822,16,30,2,3,2,7,Casual Users
67305,389,18,77,3,3,4,10,Loyal Users
67690,238,6,60,3,1,3,7,Casual Users
67743,391,79,167,3,5,5,13,Loyal Users
67871,1464,10,19,1,2,2,5,Lost
68101,121,34,42,4,4,3,11,Loyal Users
68497,4027,5,11,1,1,1,3,Lost
68617,126,9,11,4,2,1,7,Promising
68653,432,8,28,3,2,2,7,Casual Users
68902,487,19,31,2,3,2,7,Casual Users
69158,951,8,16,2,2,2,6,Lost
69275,571,6,37,2,1,3,6,Lost
69514,222,6,28,3,1,2,6,Casual Users
69554,282,53,217,3,5,5,13,Loyal Users
69664,37,33,53,5,4,3,12,Loyal Users
69977,65,72,115,5,5,4,14,Champions
70043,418,15,161,3,3,5,11,Loyal Users
70323,151,36,178,4,4,5,13,Champions
70604,151,128,484,4,5,5,14,Champions
71540,415,29,49,3,4,3,10,Loyal Users
71550,302,9,17,3,2,2,7,Casual Users
71605,160,18,185,4,3,5,12,Loyal Users
71911,104,10,14,4,2,1,7,Promising
71921,120,51,96,4,5,4,13,Champions
72085,1165,17,28,2,3,2,7,Casual Users
72144,660,11,12,2,2,1,5,Lost
72154,122,18,24,4,3,2,9,Loyal Users
72416,560,7,25,2,2,2,6,Lost
72744,15,72,193,5,5,5,15,Champions
72811,84,5,14,4,1,1,6,Promising
73174,15,46,80,5,5,4,14,Champions
73429,1411,11,37,1,2,3,6,Lost
73532,4946,9,11,1,2,1,4,Lost
73827,5,9,11,5,2,1,8,Promising
74113,130,21,131,4,3,4,11,Loyal Users
74241,4,54,84,5,5,4,14,Champions
74348,10,10,25,5,2,2,9,Promising
74380,3860,6,8,1,1,1,3,Lost
74738,4,58,161,5,5,5,15,Champions
74985,424,7,10,3,2,1,6,Casual Users
75296,537,31,65,2,4,4,10,At Risk
75542,2533,15,28,1,3,2,6,Casual Users
75850,6,179,512,5,5,5,15,Champions
75888,16,68,106,5,5,4,14,Champions
76013,27,19,39,5,3,3,11,Loyal Users
76283,2452,7,15,1,2,1,4,Lost
76695,4000,6,9,1,1,1,3,Lost
76725,1562,5,5,1,1,1,3,Lost
76990,28,76,205,5,5,5,15,Champions
77012,3450,13,33,1,3,3,7,Casual Users
77049,3853,5,6,1,1,1,3,Lost
77193,703,9,27,2,2,2,6,Lost
77212,1843,5,8,1,1,1,3,Lost
77269,407,10,22,3,2,2,7,Casual Users
77321,18,6,18,5,1,2,8,Promising
77645,102,13,20,4,3,2,9,Loyal Users
77684,31,68,126,5,5,4,14,Champions
77907,4022,10,11,1,2,1,4,Lost
78276,574,9,12,2,2,1,5,Lost
65600,11,17,67,5,3,4,12,Loyal Users
65631,5,125,226,5,5,5,15,Champions
66082,1511,9,22,1,2,2,5,Lost
66240,0,80,163,5,5,5,15,Champions
66257,156,62,293,4,5,5,14,Champions
66486,137,6,6,4,1,1,6,Promising
66524,373,46,203,3,5,5,13,Loyal Users
66533,19,130,331,5,5,5,15,Champions
66535,25,38,114,5,4,4,13,Champions
66607,1407,14,20,1,3,2,6,Casual Users
66702,122,71,219,4,5,5,14,Champions
66752,640,12,27,2,3,2,7,Casual Users
66993,408,34,117,3,4,4,11,Loyal Users
67157,867,24,39,2,4,3,9,At Risk
67334,118,72,419,4,5,5,14,Champions
67346,749,5,11,2,1,1,4,Lost
67438,20,102,207,5,5,5,15,Champions
67642,1676,5,6,1,1,1,3,Lost
68118,727,29,66,2,4,4,10,At Risk
68130,654,6,7,2,1,1,4,Lost
68178,64,5,21,5,1,2,8,Promising
68481,854,17,170,2,3,5,10,Casual Users
68519,94,110,367,4,5,5,14,Champions
68612,458,60,97,3,5,4,12,Loyal Users
68652,3430,7,11,1,2,1,4,Lost
68959,94,18,47,4,3,3,10,Loyal Users
68978,1265,7,44,1,2,3,6,Lost
69222,251,41,191,3,4,5,12,Loyal Users
69458,0,61,323,5,5,5,15,Champions
70327,110,6,17,4,1,2,7,Promising
70603,49,84,233,5,5,5,15,Champions
70684,841,14,29,2,3,2,7,Casual Users
70767,258,27,110,3,4,4,11,Loyal Users
71603,72,39,72,4,4,4,12,Champions
71728,994,5,16,2,1,2,5,Lost
71729,75,12,105,4,3,4,11,Loyal Users
71765,6,164,197,5,5,5,15,Champions
71871,40,12,86,5,3,4,12,Loyal Users
71972,270,22,43,3,4,3,10,Loyal Users
72113,1969,36,126,1,4,4,9,At Risk
72347,120,5,27,4,1,2,7,Promising
72629,256,7,10,3,2,1,6,Casual Users
72824,17,46,184,5,5,5,15,Champions
72883,113,66,157,4,5,5,14,Champions
72896,1412,7,7,1,2,1,4,Lost
73002,829,18,56,2,3,3,8,Casual Users
73155,966,5,20,2,1,2,5,Lost
73509,310,60,124,3,5,4,12,Loyal Users
73882,4692,6,24,1,1,2,4,Lost
73990,670,7,11,2,2,1,5,Lost
73994,35,92,158,5,5,5,15,Champions
74475,4,36,101,5,4,4,13,Champions
74496,409,11,15,3,2,1,6,Casual Users
74828,10,23,173,5,4,5,14,Champions
74896,107,30,97,4,4,4,12,Champions
74999,30,30,47,5,4,3,12,Loyal Users
75254,1390,8,14,1,2,1,4,Lost
75318,812,22,41,2,4,3,9,At Risk
75502,1837,6,12,1,1,1,3,Lost
75581,1796,13,30,1,3,2,6,Casual Users
75909,881,22,98,2,4,4,10,At Risk
76221,1,140,753,5,5,5,15,Champions
76365,444,10,48,3,2,3,8,Casual Users
76414,79,131,475,4,5,5,14,Champions
76531,1809,19,105,1,3,4,8,Casual Users
76604,1445,13,20,1,3,2,6,Casual Users
77019,96,76,195,4,5,5,14,Champions
77078,1099,10,20,2,2,2,6,Lost
77159,35,125,377,5,5,5,15,Champions
77766,130,74,147,4,5,5,14,Champions
77954,29,13,37,5,3,3,11,Loyal Users
77968,736,19,35,2,3,3,8,Casual Users
78150,786,15,55,2,3,3,8,Casual Users
78194,107,40,187,4,4,5,13,Champions
65458,15,69,149,5,5,5,15,Champions
65715,826,28,79,2,4,4,10,At Risk
65978,1506,5,16,1,1,2,4,Lost
66128,2827,7,55,1,2,3,6,Lost
66440,94,21,146,4,3,4,11,Loyal Users
66482,20,31,93,5,4,4,13,Champions
66572,2349,9,18,1,2,2,5,Lost
66763,85,20,33,4,3,3,10,Loyal Users
66840,9,25,54,5,4,3,12,Loyal Users
66884,29,44,114,5,4,4,13,Champions
67400,93,6,12,4,1,1,6,Promising
67730,129,22,38,4,4,3,11,Loyal Users
67843,418,9,45,3,2,3,8,Casual Users
67992,849,29,82,2,4,4,10,At Risk
68007,1,158,425,5,5,5,15,Champions
68201,471,8,18,2,2,2,6,Lost
68224,1120,12,21,2,3,2,7,Casual Users
68242,300,45,94,3,4,4,11,Loyal Users
68623,257,28,81,3,4,4,11,Loyal Users
68906,440,18,28,3,3,2,8,Loyal Users
69064,164,10,59,4,2,3,9,Promising
69077,214,32,334,3,4,5,12,Loyal Users
69192,726,20,46,2,3,3,8,Casual Users
69510,12,44,449,5,4,5,14,Champions
69763,229,26,181,3,4,5,12,Loyal Users
69960,9,52,240,5,5,5,15,Champions
69970,133,15,58,4,3,3,10,Loyal Users
70197,3298,7,7,1,2,1,4,Lost
70256,103,32,59,4,4,3,11,Loyal Users
70266,509,9,33,2,2,3,7,Lost
70325,587,6,8,2,1,1,4,Lost
70530,35,6,14,5,1,1,7,Promising
70594,37,35,121,5,4,4,13,Champions
70632,7,105,314,5,5,5,15,Champions
70672,70,49,129,4,5,4,13,Champions
70935,423,6,19,3,1,2,6,Casual Users
71119,6,63,381,5,5,5,15,Champions
71499,21,6,8,5,1,1,7,Promising
71555,1287,5,27,1,1,2,4,Lost
71612,1115,41,102,2,4,4,10,At Risk
71960,2972,5,11,1,1,1,3,Lost
72431,43,181,384,5,5,5,15,Champions
72680,132,39,62,4,4,3,11,Loyal Users
72829,824,11,108,2,2,4,8,Lost
72892,85,31,71,4,4,4,12,Champions
73135,1284,22,58,1,4,3,8,At Risk
73157,19,62,162,5,5,5,15,Champions
73195,248,14,28,3,3,2,8,Loyal Users
73525,138,7,7,4,2,1,7,Promising
73543,1137,29,42,2,4,3,9,At Risk
73650,743,10,19,2,2,2,6,Lost
73661,15,15,17,5,3,2,10,Loyal Users
73846,5261,8,35,1,2,3,6,Lost
73865,312,5,8,3,1,1,5,Casual Users
74115,149,33,74,4,4,4,12,Champions
74364,169,19,28,3,3,2,8,Loyal Users
75100,6,7,8,5,2,1,8,Promising
75590,707,29,198,2,4,5,11,At Risk
75724,159,7,10,4,2,1,7,Promising
75904,34,23,42,5,4,3,12,Loyal Users
76182,2505,46,79,1,5,4,10,At Risk
76336,1118,12,26,2,3,2,7,Casual Users
76532,120,61,85,4,5,4,13,Champions
76732,276,97,155,3,5,5,13,Loyal Users
76871,65,26,64,5,4,4,13,Champions
77046,86,116,287,4,5,5,14,Champions
77067,1157,11,42,2,2,3,7,Lost
77129,5586,9,25,1,2,2,5,Lost
77674,43,95,178,5,5,5,15,Champions
77872,287,47,238,3,5,5,13,Loyal Users
78243,4,29,75,5,4,4,13,Champions
65504,1201,11,43,2,2,3,7,Lost
65572,991,5,23,2,1,2,5,Lost
65807,115,90,129,4,5,4,13,Champions
66360,2959,5,61,1,1,3,5,Lost
66386,107,64,147,4,5,5,14,Champions
66446,92,43,99,4,4,4,12,Champions
66861,165,16,23,4,3,2,9,Loyal Users
66957,4628,5,29,1,1,2,4,Lost
67002,48,63,181,5,5,5,15,Champions
67156,3242,6,14,1,1,1,3,Lost
67178,2246,9,20,1,2,2,5,Lost
67197,731,6,6,2,1,1,4,Lost
67619,4990,20,86,1,3,4,8,Casual Users
67666,435,6,9,3,1,1,5,Casual Users
68151,178,27,42,3,4,3,10,Loyal Users
68459,12,21,46,5,3,3,11,Loyal Users
68715,190,19,52,3,3,3,9,Loyal Users
68808,294,18,30,3,3,2,8,Loyal Users
69430,407,27,73,3,4,4,11,Loyal Users
69704,331,28,71,3,4,4,11,Loyal Users
69736,115,33,141,4,4,4,12,Champions
69781,33,18,51,5,3,3,11,Loyal Users
70086,4427,5,10,1,1,1,3,Lost
70121,491,97,788,2,5,5,12,At Risk
70305,921,7,16,2,2,2,6,Lost
70636,1547,6,14,1,1,1,3,Lost
70957,17,23,31,5,4,2,11,Loyal Users
71100,317,12,51,3,3,3,9,Loyal Users
71139,41,116,321,5,5,5,15,Champions
71576,4596,11,27,1,2,2,5,Lost
71737,8,45,128,5,4,4,13,Champions
71955,101,8,16,4,2,2,8,Promising
72191,262,29,48,3,4,3,10,Loyal Users
72243,1115,27,99,2,4,4,10,At Risk
72278,7,217,366,5,5,5,15,Champions
72441,870,34,142,2,4,4,10,At Risk
72614,701,13,23,2,3,2,7,Casual Users
72656,39,101,352,5,5,5,15,Champions
73101,165,14,31,4,3,2,9,Loyal Users
73686,944,6,26,2,1,2,5,Lost
73729,83,146,461,4,5,5,14,Champions
73746,4,53,245,5,5,5,15,Champions
74392,179,86,145,3,5,4,12,Loyal Users
74725,539,9,44,2,2,3,7,Lost
74778,730,23,52,2,4,3,9,At Risk
74810,145,39,424,4,4,5,13,Champions
74925,736,6,11,2,1,1,4,Lost
75335,520,9,10,2,2,1,5,Lost
75490,1138,5,23,2,1,2,5,Lost
75777,2701,6,29,1,1,2,4,Lost
76096,4,97,531,5,5,5,15,Champions
76502,309,15,25,3,3,2,8,Loyal Users
76594,0,79,340,5,5,5,15,Champions
76684,968,7,58,2,2,3,7,Lost
76940,29,73,291,5,5,5,15,Champions
77177,3007,16,62,1,3,3,7,Casual Users
77267,2903,12,46,1,3,3,7,Casual Users
77341,99,78,151,4,5,5,14,Champions
77679,951,40,55,2,4,3,9,At Risk
77771,1009,26,52,2,4,3,9,At Risk
77789,260,13,30,3,3,2,8,Loyal Users
77824,111,11,27,4,2,2,8,Promising
77859,147,29,98,4,4,4,12,Champions
77928,653,7,66,2,2,4,8,Lost
77995,15,78,498,5,5,5,15,Champions
78217,1222,6,63,2,1,4,7,Lost
65878,2066,35,73,1,4,4,9,At Risk
66058,262,18,25,3,3,2,8,Loyal Users
66210,133,40,225,4,4,5,13,Champions
66657,1093,15,33,2,3,3,8,Casual Users
66883,11,19,24,5,3,2,10,Loyal Users
67295,1145,8,18,2,2,2,6,Lost
67896,24,12,32,5,3,3,11,Loyal Users
67944,1159,13,21,2,3,2,7,Casual Users
67976,1270,5,8,1,1,1,3,Lost
68056,1,37,342,5,4,5,14,Champions
68259,400,9,12,3,2,1,6,Casual Users
68414,736,33,54,2,4,3,9,At Risk
68417,3607,8,37,1,2,3,6,Lost
68729,531,8,32,2,2,3,7,Lost
68769,32,9,97,5,2,4,11,Promising
68893,163,10,20,4,2,2,8,Promising
69069,719,42,98,2,4,4,10,At Risk
69123,965,86,307,2,5,5,12,At Risk
69303,484,26,57,2,4,3,9,At Risk
69347,5626,5,5,1,1,1,3,Lost
69372,90,24,114,4,4,4,12,Champions
69571,985,35,57,2,4,3,9,At Risk
70071,30,44,107,5,4,4,13,Champions
70220,26,53,302,5,5,5,15,Champions
70270,79,5,18,4,1,2,7,Promising
70615,311,10,15,3,2,1,6,Casual Users
70862,1022,5,12,2,1,1,4,Lost
70950,170,51,242,3,5,5,13,Loyal Users
71342,126,5,6,4,1,1,6,Promising
71420,30,115,357,5,5,5,15,Champions
71628,2,44,136,5,4,4,13,Champions
71629,68,64,312,5,5,5,15,Champions
71650,303,15,173,3,3,5,11,Loyal Users
71816,4885,9,28,1,2,2,5,Lost
71831,29,8,45,5,2,3,10,Promising
71933,211,5,8,3,1,1,5,Casual Users
71942,1161,39,291,2,4,5,11,At Risk
72166,1033,8,24,2,2,2,6,Lost
72179,394,8,25,3,2,2,7,Casual Users
72471,427,7,12,3,2,1,6,Casual Users
72488,410,8,12,3,2,1,6,Casual Users
72725,101,8,52,4,2,3,9,Promising
72961,150,57,139,4,5,4,13,Champions
72969,113,26,31,4,4,2,10,Loyal Users
73449,376,5,8,3,1,1,5,Casual Users
74330,4136,6,6,1,1,1,3,Lost
74359,5752,9,13,1,2,1,4,Lost
74406,79,56,219,4,5,5,14,Champions
74683,168,14,80,3,3,4,10,Loyal Users
75185,13,100,173,5,5,5,15,Champions
75262,531,16,35,2,3,3,8,Casual Users
75300,379,23,68,3,4,4,11,Loyal Users
75610,246,20,197,3,3,5,11,Loyal Users
75633,266,10,19,3,2,2,7,Casual Users
75823,23,33,119,5,4,4,13,Champions
75830,542,13,25,2,3,2,7,Casual Users
76622,71,20,43,4,3,3,10,Loyal Users
76678,124,73,377,4,5,5,14,Champions
77017,106,79,484,4,5,5,14,Champions
77155,2987,20,78,1,3,4,8,Casual Users
77454,95,12,30,4,3,2,9,Loyal Users
77603,127,7,20,4,2,2,8,Promising
77694,3,95,302,5,5,5,15,Champions
77804,454,9,21,3,2,2,7,Casual Users
77865,129,35,67,4,4,4,12,Champions
77904,833,14,29,2,3,2,7,Casual Users
77971,2126,10,19,1,2,2,5,Lost
77991,0,43,319,5,4,5,14,Champions
78045,445,9,43,3,2,3,8,Casual Users
78134,425,5,7,3,1,1,5,Casual Users
65509,513,9,29,2,2,2,6,Lost
65658,4,19,86,5,3,4,12,Loyal Users
65843,296,5,11,3,1,1,5,Casual Users
66372,611,6,6,2,1,1,4,Lost
66502,440,21,92,3,3,4,10,Loyal Users
66651,585,6,10,2,1,1,4,Lost
66662,4566,9,10,1,2,1,4,Lost
66685,116,46,274,4,5,5,14,Champions
66821,15,11,14,5,2,1,8,Promising
66829,42,69,94,5,5,4,14,Champions
66848,1097,7,7,2,2,1,5,Lost
66977,706,8,15,2,2,1,5,Lost
67076,65,67,223,5,5,5,15,Champions
67997,591,11,22,2,2,2,6,Lost
68124,241,55,249,3,5,5,13,Loyal Users
68360,1041,7,8,2,2,1,5,Lost
68398,134,16,33,4,3,3,10,Loyal Users
68705,339,42,104,3,4,4,11,Loyal Users
69262,389,6,31,3,1,2,6,Casual Users
69314,21,151,459,5,5,5,15,Champions
69399,453,21,46,3,3,3,9,Loyal Users
69491,3447,6,18,1,1,2,4,Lost
69544,128,60,94,4,5,4,13,Champions
69873,40,36,78,5,4,4,13,Champions
70028,74,24,194,4,4,5,13,Champions
70271,1040,6,18,2,1,2,5,Lost
70277,951,10,22,2,2,2,6,Lost
70402,531,17,32,2,3,3,8,Casual Users
70593,2049,12,18,1,3,2,6,Casual Users
70825,12,20,138,5,3,4,12,Loyal Users
71371,20,16,29,5,3,2,10,Loyal Users
71581,3965,7,23,1,2,2,5,Lost
71866,443,14,54,3,3,3,9,Loyal Users
71923,3249,7,7,1,2,1,4,Lost
71944,0,21,27,5,3,2,10,Loyal Users
71952,37,44,177,5,4,5,14,Champions
72109,893,6,7,2,1,1,4,Lost
72645,661,11,36,2,2,3,7,Lost
72664,247,8,32,3,2,3,8,Casual Users
72833,328,21,21,3,3,2,8,Loyal Users
73088,7,56,142,5,5,4,14,Champions
73095,751,46,128,2,5,4,11,At Risk
73374,18,11,44,5,2,3,10,Promising
73377,235,6,24,3,1,2,6,Casual Users
73396,38,18,24,5,3,2,10,Loyal Users
73478,115,98,192,4,5,5,14,Champions
73646,1850,5,16,1,1,2,4,Lost
74085,4825,14,66,1,3,4,8,Casual Users
74497,2817,18,25,1,3,2,6,Casual Users
74741,3157,15,72,1,3,4,8,Casual Users
75103,858,32,187,2,4,5,11,At Risk
75144,1133,8,20,2,2,2,6,Lost
75146,2837,5,17,1,1,2,4,Lost
75343,5,41,55,5,4,3,12,Loyal Users
75478,2554,7,10,1,2,1,4,Lost
75568,9,40,92,5,4,4,13,Champions
75997,104,17,39,4,3,3,10,Loyal Users
76192,221,50,91,3,5,4,12,Loyal Users
76207,394,11,13,3,2,1,6,Casual Users
76387,278,11,13,3,2,1,6,Casual Users
76489,1091,14,37,2,3,3,8,Casual Users
76597,313,21,68,3,3,4,10,Loyal Users
76651,842,36,106,2,4,4,10,At Risk
76755,955,21,65,2,3,4,9,Casual Users
76772,2503,8,16,1,2,2,5,Lost
76792,3157,5,18,1,1,2,4,Lost
77076,1299,6,9,1,1,1,3,Lost
77651,849,7,8,2,2,1,5,Lost
77833,302,5,15,3,1,1,5,Casual Users
77880,13,34,353,5,4,5,14,Champions
78235,8,69,298,5,5,5,15,Champions
78266,18,22,41,5,4,3,12,Loyal Users
65711,156,8,18,4,2,2,8,Promising
65746,824,8,24,2,2,2,6,Lost
65761,654,7,11,2,2,1,5,Lost
65891,411,59,131,3,5,4,12,Loyal Users
66320,231,8,87,3,2,4,9,Casual Users
66353,125,135,175,4,5,5,14,Champions
66414,41,40,60,5,4,3,12,Loyal Users
66582,8,38,326,5,4,5,14,Champions
66696,85,6,7,4,1,1,6,Promising
67417,28,11,16,5,2,2,9,Promising
67432,70,52,188,4,5,5,14,Champions
67485,433,19,42,3,3,3,9,Loyal Users
67678,147,100,283,4,5,5,14,Champions
67710,33,31,38,5,4,3,12,Loyal Users
67820,1077,7,21,2,2,2,6,Lost
68034,2852,5,15,1,1,1,3,Lost
68440,131,7,45,4,2,3,9,Promising
68548,1270,6,9,1,1,1,3,Lost
68616,307,18,56,3,3,3,9,Loyal Users
68785,3818,5,14,1,1,1,3,Lost
69040,1455,12,17,1,3,2,6,Casual Users
69060,141,75,204,4,5,5,14,Champions
69068,129,61,140,4,5,4,13,Champions
69258,2724,5,13,1,1,1,3,Lost
69666,156,5,35,4,1,3,8,Promising
69911,130,44,307,4,4,5,13,Champions
70010,5,14,32,5,3,3,11,Loyal Users
70143,597,13,40,2,3,3,8,Casual Users
70156,426,44,124,3,4,4,11,Loyal Users
70181,920,11,25,2,2,2,6,Lost
70288,126,69,151,4,5,5,14,Champions
70749,260,13,17,3,3,2,8,Loyal Users
71070,2682,5,15,1,1,1,3,Lost
71083,48,19,78,5,3,4,12,Loyal Users
71190,438,46,64,3,5,4,12,Loyal Users
71394,89,73,106,4,5,4,13,Champions
71516,304,6,79,3,1,4,8,Casual Users
71685,283,22,43,3,4,3,10,Loyal Users
71703,2552,5,8,1,1,1,3,Lost
72057,4338,21,36,1,3,3,7,Casual Users
72652,1887,5,27,1,1,2,4,Lost
72810,4296,6,6,1,1,1,3,Lost
72860,3067,6,20,1,1,2,4,Lost
72917,285,26,75,3,4,4,11,Loyal Users
73009,277,26,53,3,4,3,10,Loyal Users
73710,72,47,124,4,5,4,13,Champions
73898,121,92,116,4,5,4,13,Champions
74080,1627,8,14,1,2,1,4,Lost
74398,234,28,134,3,4,4,11,Loyal Users
74560,539,20,38,2,3,3,8,Casual Users
74949,267,13,41,3,3,3,9,Loyal Users
75495,1,120,387,5,5,5,15,Champions
75516,695,21,40,2,3,3,8,Casual Users
75579,15,83,381,5,5,5,15,Champions
75902,284,51,84,3,5,4,12,Loyal Users
75950,719,6,39,2,1,3,6,Lost
76178,1155,21,43,2,3,3,8,Casual Users
76307,83,54,243,4,5,5,14,Champions
76325,85,90,423,4,5,5,14,Champions
76380,3223,10,31,1,2,2,5,Lost
76629,126,18,50,4,3,3,10,Loyal Users
76726,188,35,78,3,4,4,11,Loyal Users
77262,247,27,165,3,4,5,12,Loyal Users
77317,840,9,17,2,2,2,6,Lost
77507,878,9,33,2,2,3,7,Lost
77932,168,11,23,3,2,2,7,Casual Users
78087,2409,7,15,1,2,1,4,Lost
65497,640,7,10,2,2,1,5,Lost
65580,410,10,19,3,2,2,7,Casual Users
65669,2682,9,62,1,2,3,6,Lost
65717,1127,57,192,2,5,5,12,At Risk
65985,215,9,56,3,2,3,8,Casual Users
66599,1137,15,83,2,3,4,9,Casual Users
66909,74,11,11,4,2,1,7,Promising
66911,4,30,100,5,4,4,13,Champions
67051,87,62,174,4,5,5,14,Champions
67060,516,9,65,2,2,4,8,Lost
67092,216,5,5,3,1,1,5,Casual Users
67138,3640,5,8,1,1,1,3,Lost
67152,230,6,14,3,1,1,5,Casual Users
67173,277,60,98,3,5,4,12,Loyal Users
67648,94,34,69,4,4,4,12,Champions
67689,429,9,17,3,2,2,7,Casual Users
67964,3,60,178,5,5,5,15,Champions
68310,259,29,50,3,4,3,10,Loyal Users
68424,149,21,63,4,3,4,11,Loyal Users
68437,1633,6,14,1,1,1,3,Lost
68778,4203,5,13,1,1,1,3,Lost
69137,863,6,6,2,1,1,4,Lost
69482,45,12,100,5,3,4,12,Loyal Users
69772,562,8,24,2,2,2,6,Lost
69878,1413,5,5,1,1,1,3,Lost
69986,308,26,93,3,4,4,11,Loyal Users
70867,1126,17,33,2,3,3,8,Casual Users
71259,124,18,121,4,3,4,11,Loyal Users
71332,35,26,133,5,4,4,13,Champions
71353,701,8,15,2,2,1,5,Lost
71411,99,9,15,4,2,1,7,Promising
71416,981,13,29,2,3,2,7,Casual Users
72178,9,83,289,5,5,5,15,Champions
72185,19,17,71,5,3,4,12,Loyal Users
72605,826,6,12,2,1,1,4,Lost
72615,88,14,135,4,3,4,11,Loyal Users
72871,498,5,29,2,1,2,5,Lost
73059,589,8,22,2,2,2,6,Lost
73329,927,16,47,2,3,3,8,Casual Users
73358,1,42,138,5,4,4,13,Champions
73613,428,20,70,3,3,4,10,Loyal Users
73704,57,19,46,5,3,3,11,Loyal Users
73854,682,10,35,2,2,3,7,Lost
73983,33,37,51,5,4,3,12,Loyal Users
74109,410,10,19,3,2,2,7,Casual Users
74159,577,14,25,2,3,2,7,Casual Users
74239,1432,8,17,1,2,2,5,Lost
74274,4657,5,6,1,1,1,3,Lost
74731,159,27,34,4,4,3,11,Loyal Users
74740,425,31,51,3,4,3,10,Loyal Users
74938,261,16,26,3,3,2,8,Loyal Users
75090,163,84,518,4,5,5,14,Champions
75389,225,27,99,3,4,4,11,Loyal Users
75626,1275,9,13,1,2,1,4,Lost
75988,3535,7,40,1,2,3,6,Lost
76109,108,10,21,4,2,2,8,Promising
76273,2141,7,35,1,2,3,6,Lost
76443,569,6,51,2,1,3,6,Lost
76625,267,7,10,3,2,1,6,Casual Users
76924,1113,11,32,2,2,3,7,Lost
77209,126,19,75,4,3,4,11,Loyal Users
78198,2555,5,18,1,1,2,4,Lost
65546,650,25,75,2,4,4,10,At Risk
65573,277,44,157,3,4,5,12,Loyal Users
66044,287,20,86,3,3,4,10,Loyal Users
66092,310,51,155,3,5,5,13,Loyal Users
66494,1697,5,9,1,1,1,3,Lost
66617,3018,13,62,1,3,3,7,Casual Users
66658,23,15,30,5,3,2,10,Loyal Users
66665,129,87,152,4,5,5,14,Champions
66777,127,14,39,4,3,3,10,Loyal Users
66781,467,23,36,3,4,3,10,Loyal Users
66910,778,22,157,2,4,5,11,At Risk
67401,3163,6,21,1,1,2,4,Lost
68987,131,34,135,4,4,4,12,Champions
69384,2,12,44,5,3,3,11,Loyal Users
69426,358,6,21,3,1,2,6,Casual Users
69523,1652,5,5,1,1,1,3,Lost
69603,139,99,288,4,5,5,14,Champions
69734,44,43,60,5,4,3,12,Loyal Users
69903,2,83,145,5,5,4,14,Champions
70119,837,13,15,2,3,1,6,Casual Users
70167,1547,5,12,1,1,1,3,Lost
70262,0,9,41,5,2,3,10,Promising
70394,3430,9,9,1,2,1,4,Lost
70590,134,8,32,4,2,3,9,Promising
70841,307,57,111,3,5,4,12,Loyal Users
71000,140,78,162,4,5,5,14,Champions
71533,22,59,305,5,5,5,15,Champions
71659,13,9,17,5,2,2,9,Promising
72187,245,5,6,3,1,1,5,Casual Users
72586,1458,7,21,1,2,2,5,Lost
73028,4688,14,60,1,3,3,7,Casual Users
73068,2467,6,12,1,1,1,3,Lost
73069,869,9,16,2,2,2,6,Lost
73682,877,21,48,2,3,3,8,Casual Users
73720,2,56,206,5,5,5,15,Champions
73985,15,36,181,5,4,5,14,Champions
74805,2032,10,25,1,2,2,5,Lost
74860,160,9,26,4,2,2,8,Promising
74972,119,31,71,4,4,4,12,Champions
75019,1717,9,17,1,2,2,5,Lost
75131,224,70,268,3,5,5,13,Loyal Users
75207,2,44,72,5,4,4,13,Champions
75972,107,6,6,4,1,1,6,Promising
76061,10,91,131,5,5,4,14,Champions
76240,3,34,40,5,4,3,12,Loyal Users
76417,672,19,30,2,3,2,7,Casual Users
76510,289,5,19,3,1,2,6,Casual Users
76984,416,20,46,3,3,3,9,Loyal Users
77502,736,16,29,2,3,2,7,Casual Users
77520,154,41,75,4,4,4,12,Champions
77573,13,39,68,5,4,4,13,Champions
78070,1545,18,70,1,3,4,8,Casual Users
65639,549,31,95,2,4,4,10,At Risk
65704,124,22,42,4,4,3,11,Loyal Users
66037,399,15,19,3,3,2,8,Loyal Users
66046,420,14,23,3,3,2,8,Loyal Users
66346,4978,5,27,1,1,2,4,Lost
66653,154,62,157,4,5,5,14,Champions
67359,776,14,43,2,3,3,8,Casual Users
67423,15,51,115,5,5,4,14,Champions
67494,866,6,6,2,1,1,4,Lost
68066,137,96,239,4,5,5,14,Champions
68183,1169,49,76,2,5,4,11,At Risk
68558,125,42,136,4,4,4,12,Champions
68869,1417,7,10,1,2,1,4,Lost
69401,21,81,203,5,5,5,15,Champions
69463,1003,5,5,2,1,1,4,Lost
69630,364,10,31,3,2,2,7,Casual Users
69887,117,37,171,4,4,5,13,Champions
70227,16,136,565,5,5,5,15,Champions
70546,467,11,32,3,2,3,8,Casual Users
70611,12,114,440,5,5,5,15,Champions
70742,29,136,317,5,5,5,15,Champions
70764,472,9,57,2,2,3,7,Lost
70809,57,35,48,5,4,3,12,Loyal Users
70824,4,128,346,5,5,5,15,Champions
71075,23,23,105,5,4,4,13,Champions
71096,197,8,14,3,2,1,6,Casual Users
71099,85,32,127,4,4,4,12,Champions
71105,46,49,66,5,5,4,14,Champions
71853,0,98,219,5,5,5,15,Champions
71934,88,93,414,4,5,5,14,Champions
71986,2428,9,17,1,2,2,5,Lost
72026,5,6,12,5,1,1,7,Promising
72327,76,6,9,4,1,1,6,Promising
72550,5751,6,7,1,1,1,3,Lost
72741,1482,7,19,1,2,2,5,Lost
72884,2299,70,174,1,5,5,11,At Risk
73575,4381,9,33,1,2,3,6,Lost
73993,20,67,613,5,5,5,15,Champions
74219,191,8,16,3,2,2,7,Casual Users
74370,44,16,37,5,3,3,11,Loyal Users
74461,267,17,61,3,3,3,9,Loyal Users
74622,1015,11,25,2,2,2,6,Lost
74886,199,60,110,3,5,4,12,Loyal Users
74889,1273,8,15,1,2,1,4,Lost
75630,455,20,34,3,3,3,9,Loyal Users
75742,6,30,73,5,4,4,13,Champions
75824,153,10,13,4,2,1,7,Promising
76521,5740,18,18,1,3,2,6,Casual Users
76615,1798,10,27,1,2,2,5,Lost
76654,514,21,34,2,3,3,8,Casual Users
76811,418,11,47,3,2,3,8,Casual Users
76995,789,15,40,2,3,3,8,Casual Users
77119,2435,32,66,1,4,4,9,At Risk
77221,121,5,11,4,1,1,6,Promising
78249,698,9,11,2,2,1,5,Lost
78257,2257,8,21,1,2,2,5,Lost
78275,1669,8,17,1,2,2,5,Lost
65934,246,8,19,3,2,2,7,Casual Users
65964,127,15,40,4,3,3,10,Loyal Users
65979,1362,10,20,1,2,2,5,Lost
65988,379,47,94,3,5,4,12,Loyal Users
66089,59,42,87,5,4,4,13,Champions
66728,731,14,69,2,3,4,9,Casual Users
66920,4173,10,54,1,2,3,6,Lost
67140,17,24,41,5,4,3,12,Loyal Users
67179,1744,22,61,1,4,3,8,At Risk
67198,229,21,40,3,3,3,9,Loyal Users
67247,132,5,17,4,1,2,7,Promising
67333,2572,5,5,1,1,1,3,Lost
67947,996,11,68,2,2,4,8,Lost
68533,1244,7,11,2,2,1,5,Lost
69205,172,7,20,3,2,2,7,Casual Users
69218,2438,12,44,1,3,3,7,Casual Users
69442,408,31,61,3,4,3,10,Loyal Users
69798,5,18,114,5,3,4,12,Loyal Users
69963,2128,7,19,1,2,2,5,Lost
70350,76,62,225,4,5,5,14,Champions
70431,289,27,50,3,4,3,10,Loyal Users
70696,105,13,53,4,3,3,10,Loyal Users
70745,60,54,115,5,5,4,14,Champions
70811,75,121,168,4,5,5,14,Champions
70888,3,12,13,5,3,1,9,Loyal Users
71020,1371,8,16,1,2,2,5,Lost
71218,79,62,131,4,5,4,13,Champions
71223,124,74,302,4,5,5,14,Champions
71529,309,88,165,3,5,5,13,Loyal Users
71759,444,8,20,3,2,2,7,Casual Users
71916,313,13,33,3,3,3,9,Loyal Users
72229,59,19,36,5,3,3,11,Loyal Users
72703,214,33,44,3,4,3,10,Loyal Users
72869,120,11,17,4,2,2,8,Promising
73152,296,53,72,3,5,4,12,Loyal Users
73291,126,22,70,4,4,4,12,Champions
73640,1438,6,16,1,1,2,4,Lost
74057,123,15,30,4,3,2,9,Loyal Users
74362,10,133,624,5,5,5,15,Champions
74479,109,25,80,4,4,4,12,Champions
74676,130,29,106,4,4,4,12,Champions
75073,115,72,97,4,5,4,13,Champions
75125,1406,15,42,1,3,3,7,Casual Users
75127,45,95,518,5,5,5,15,Champions
75202,1398,13,19,1,3,2,6,Casual Users
75592,384,70,575,3,5,5,13,Loyal Users
75695,124,16,21,4,3,2,9,Loyal Users
75966,1580,6,8,1,1,1,3,Lost
76115,1229,12,31,2,3,2,7,Casual Users
76141,531,18,152,2,3,5,10,Casual Users
76717,209,65,129,3,5,4,12,Loyal Users
76718,1283,7,16,1,2,2,5,Lost
76743,132,23,62,4,4,3,11,Loyal Users
76773,125,36,128,4,4,4,12,Champions
76830,730,6,9,2,1,1,4,Lost
77206,3490,6,12,1,1,1,3,Lost
77361,0,72,326,5,5,5,15,Champions
77470,325,59,169,3,5,5,13,Loyal Users
77528,17,40,174,5,4,5,14,Champions
77772,30,11,18,5,2,2,9,Promising
77838,111,18,47,4,3,3,10,Loyal Users
77976,1047,17,70,2,3,4,9,Casual Users
78061,423,21,67,3,3,4,10,Loyal Users
78065,225,11,42,3,2,3,8,Casual Users
65542,1002,5,11,2,1,1,4,Lost
65547,56,17,36,5,3,3,11,Loyal Users
65825,708,9,21,2,2,2,6,Lost
65881,8,17,106,5,3,4,12,Loyal Users
66141,5623,5,5,1,1,1,3,Lost
66739,278,6,10,3,1,1,5,Casual Users
66962,117,38,400,4,4,5,13,Champions
67005,537,7,16,2,2,2,6,Lost
67431,3161,35,85,1,4,4,9,At Risk
67490,291,61,112,3,5,4,12,Loyal Users
67770,114,47,105,4,5,4,13,Champions
67921,1273,18,21,1,3,2,6,Casual Users
67986,41,46,107,5,5,4,14,Champions
68085,279,120,281,3,5,5,13,Loyal Users
68132,1370,10,15,1,2,1,4,Lost
68179,93,6,8,4,1,1,6,Promising
68221,713,16,31,2,3,2,7,Casual Users
68302,393,5,11,3,1,1,5,Casual Users
68446,296,6,14,3,1,1,5,Casual Users
68486,80,31,77,4,4,4,12,Champions
68789,138,7,7,4,2,1,7,Promising
68801,846,10,21,2,2,2,6,Lost
68830,431,8,22,3,2,2,7,Casual Users
68840,1395,13,57,1,3,3,7,Casual Users
69169,5684,6,14,1,1,1,3,Lost
69282,57,22,37,5,4,3,12,Loyal Users
69576,33,7,13,5,2,1,8,Promising
69945,69,15,36,5,3,3,11,Loyal Users
70165,406,15,67,3,3,4,10,Loyal Users
70299,436,14,36,3,3,3,9,Loyal Users
70665,130,63,262,4,5,5,14,Champions
70758,966,5,11,2,1,1,4,Lost
70913,134,22,57,4,4,3,11,Loyal Users
71032,91,19,36,4,3,3,10,Loyal Users
71120,118,21,221,4,3,5,12,Loyal Users
71134,1246,6,8,2,1,1,4,Lost
71584,121,114,233,4,5,5,14,Champions
71654,418,6,31,3,1,2,6,Casual Users
71672,1282,5,20,1,1,2,4,Lost
71843,266,6,16,3,1,2,6,Casual Users
72323,4570,5,42,1,1,3,5,Lost
72346,2240,14,28,1,3,2,6,Casual Users
72421,35,25,54,5,4,3,12,Loyal Users
72711,1568,5,5,1,1,1,3,Lost
72991,272,76,396,3,5,5,13,Loyal Users
73094,52,41,256,5,4,5,14,Champions
73166,675,9,31,2,2,2,6,Lost
73187,4591,5,5,1,1,1,3,Lost
73307,1076,5,5,2,1,1,4,Lost
73432,2430,10,13,1,2,1,4,Lost
73734,986,9,18,2,2,2,6,Lost
73833,148,15,32,4,3,3,10,Loyal Users
74070,38,75,136,5,5,4,14,Champions
74275,112,21,79,4,3,4,11,Loyal Users
74473,125,48,299,4,5,5,14,Champions
74645,1350,30,64,1,4,4,9,At Risk
74684,37,62,219,5,5,5,15,Champions
74703,167,19,56,3,3,3,9,Loyal Users
74862,3280,29,57,1,4,3,8,At Risk
74974,393,7,10,3,2,1,6,Casual Users
75138,93,100,147,4,5,5,14,Champions
75203,8,14,19,5,3,2,10,Loyal Users
75400,2,35,93,5,4,4,13,Champions
75524,5080,9,36,1,2,3,6,Lost
76244,1433,6,11,1,1,1,3,Lost
76783,424,14,43,3,3,3,9,Loyal Users
76812,1134,5,14,2,1,1,4,Lost
76864,604,30,105,2,4,4,10,At Risk
77313,148,22,67,4,4,4,12,Champions
77565,71,12,20,4,3,2,9,Loyal Users
65508,26,21,47,5,3,3,11,Loyal Users
65523,96,23,82,4,4,4,12,Champions
65676,2554,25,75,1,4,4,9,At Risk
65898,5,51,93,5,5,4,14,Champions
66024,84,26,44,4,4,3,11,Loyal Users
66100,2571,23,33,1,4,3,8,At Risk
66384,100,19,29,4,3,2,9,Loyal Users
66627,1683,6,40,1,1,3,5,Lost
66735,1485,19,223,1,3,5,9,Casual Users
66869,4429,8,18,1,2,2,5,Lost
67016,18,163,632,5,5,5,15,Champions
67467,2,89,126,5,5,4,14,Champions
67641,75,30,35,4,4,3,11,Loyal Users
67672,416,14,28,3,3,2,8,Loyal Users
67687,20,8,20,5,2,2,9,Promising
67839,143,43,69,4,4,4,12,Champions
68264,1682,6,12,1,1,1,3,Lost
68642,944,8,16,2,2,2,6,Lost
68997,1128,6,10,2,1,1,4,Lost
69156,4,47,78,5,5,4,14,Champions
69929,1111,7,36,2,2,3,7,Lost
69937,1566,24,77,1,4,4,9,At Risk
70033,2209,5,22,1,1,2,4,Lost
70539,6,72,146,5,5,4,14,Champions
70619,35,5,8,5,1,1,7,Promising
71272,3699,10,44,1,2,3,6,Lost
71300,180,11,80,3,2,4,9,Casual Users
71385,88,132,178,4,5,5,14,Champions
71442,1211,5,7,2,1,1,4,Lost
71981,535,50,129,2,5,4,11,At Risk
72255,673,13,40,2,3,3,8,Casual Users
72555,77,114,598,4,5,5,14,Champions
72728,91,44,167,4,4,5,13,Champions
72800,442,18,28,3,3,2,8,Loyal Users
73413,7,131,394,5,5,5,15,Champions
73555,97,49,140,4,5,4,13,Champions
74140,113,122,594,4,5,5,14,Champions
74308,138,15,21,4,3,2,9,Loyal Users
74316,256,54,106,3,5,4,12,Loyal Users
74587,36,84,368,5,5,5,15,Champions
74601,6,175,642,5,5,5,15,Champions
74657,3338,6,34,1,1,3,5,Lost
74671,2014,8,14,1,2,1,4,Lost
74868,801,6,8,2,1,1,4,Lost
74931,952,7,19,2,2,2,6,Lost
74971,861,35,98,2,4,4,10,At Risk
75212,300,96,294,3,5,5,13,Loyal Users
75334,2654,14,16,1,3,2,6,Casual Users
75438,1508,16,26,1,3,2,6,Casual Users
75772,41,62,341,5,5,5,15,Champions
76223,7,30,48,5,4,3,12,Loyal Users
76245,2332,6,9,1,1,1,3,Lost
76376,0,24,55,5,4,3,12,Loyal Users
76378,598,29,121,2,4,4,10,At Risk
76592,116,86,123,4,5,4,13,Champions
77062,60,12,34,5,3,3,11,Loyal Users
77385,616,16,36,2,3,3,8,Casual Users
77436,407,75,130,3,5,4,12,Loyal Users
77473,1407,5,11,1,1,1,3,Lost
77638,298,20,29,3,3,2,8,Loyal Users
77884,70,37,63,4,4,4,12,Champions
65480,36,84,758,5,5,5,15,Champions
65584,4,73,211,5,5,5,15,Champions
65654,50,44,88,5,4,4,13,Champions
65709,71,40,207,4,4,5,13,Champions
66065,824,9,53,2,2,3,7,Lost
66088,2,67,265,5,5,5,15,Champions
66126,37,35,73,5,4,4,13,Champions
66412,268,48,146,3,5,4,12,Loyal Users
66634,156,28,73,4,4,4,12,Champions
66654,0,50,259,5,5,5,15,Champions
66791,126,63,110,4,5,4,13,Champions
66805,145,116,687,4,5,5,14,Champions
66871,1666,9,15,1,2,1,4,Lost
67056,413,15,50,3,3,3,9,Loyal Users
67215,2572,7,10,1,2,1,4,Lost
68521,152,5,6,4,1,1,6,Promising
68536,132,22,44,4,4,3,11,Loyal Users
68568,6,40,86,5,4,4,13,Champions
68873,3149,8,43,1,2,3,6,Lost
69238,4467,7,13,1,2,1,4,Lost
69296,3143,6,8,1,1,1,3,Lost
69318,19,39,112,5,4,4,13,Champions
69765,1266,11,17,1,2,2,5,Lost
69770,54,32,71,5,4,4,13,Champions
70069,132,21,153,4,3,5,12,Loyal Users
70206,21,32,180,5,4,5,14,Champions
70710,39,106,563,5,5,5,15,Champions
70727,4,68,192,5,5,5,15,Champions
70917,784,8,9,2,2,1,5,Lost
70923,516,6,12,2,1,1,4,Lost
71144,15,14,54,5,3,3,11,Loyal Users
71750,140,5,21,4,1,2,7,Promising
71940,2984,12,22,1,3,2,6,Casual Users
72129,2474,23,40,1,4,3,8,At Risk
72245,85,5,7,4,1,1,6,Promising
72331,57,83,355,5,5,5,15,Champions
72667,46,122,368,5,5,5,15,Champions
73042,5533,15,68,1,3,4,8,Casual Users
73134,1085,111,370,2,5,5,12,At Risk
73648,313,19,77,3,3,4,10,Loyal Users
73958,106,76,297,4,5,5,14,Champions
74307,1010,13,27,2,3,2,7,Casual Users
74310,315,9,11,3,2,1,6,Casual Users
74533,1801,30,219,1,4,5,10,At Risk
75108,241,16,37,3,3,3,9,Loyal Users
75744,12,18,19,5,3,2,10,Loyal Users
75858,90,6,8,4,1,1,6,Promising
76021,280,7,49,3,2,3,8,Casual Users
76206,1251,15,74,2,3,4,9,Casual Users
76377,732,11,24,2,2,2,6,Lost
76495,22,19,83,5,3,4,12,Loyal Users
76555,894,26,30,2,4,2,8,At Risk
76563,118,30,125,4,4,4,12,Champions
76934,635,8,104,2,2,4,8,Lost
77048,517,23,29,2,4,2,8,At Risk
77261,120,6,14,4,1,1,6,Promising
77604,274,40,61,3,4,3,10,Loyal Users
77792,8,12,34,5,3,3,11,Loyal Users
77812,41,10,15,5,2,1,8,Promising
78067,4019,9,20,1,2,2,5,Lost
78139,2357,7,8,1,2,1,4,Lost
78165,1400,16,16,1,3,2,6,Casual Users
65517,105,26,55,4,4,3,11,Loyal Users
65983,2087,8,11,1,2,1,4,Lost
66382,3146,50,170,1,5,5,11,At Risk
66787,127,89,114,4,5,4,13,Champions
66844,254,49,101,3,5,4,12,Loyal Users
66845,129,102,525,4,5,5,14,Champions
67033,3571,5,5,1,1,1,3,Lost
67044,119,98,461,4,5,5,14,Champions
67102,652,10,12,2,2,1,5,Lost
67120,834,8,24,2,2,2,6,Lost
67590,878,24,67,2,4,4,10,At Risk
67632,2097,20,26,1,3,2,6,Casual Users
67759,416,87,153,3,5,5,13,Loyal Users
67797,121,7,68,4,2,4,10,Promising
67799,90,8,22,4,2,2,8,Promising
67806,539,23,151,2,4,5,11,At Risk
67877,124,17,40,4,3,3,10,Loyal Users
68103,1240,7,7,2,2,1,5,Lost
68143,453,24,46,3,4,3,10,Loyal Users
68193,1441,6,44,1,1,3,5,Lost
68205,265,8,26,3,2,2,7,Casual Users
68388,47,90,122,5,5,4,14,Champions
70105,1732,9,11,1,2,1,4,Lost
70348,1218,5,10,2,1,1,4,Lost
70376,27,69,247,5,5,5,15,Champions
70641,3905,5,6,1,1,1,3,Lost
70720,28,10,11,5,2,1,8,Promising
70779,2406,8,58,1,2,3,6,Lost
70834,109,61,295,4,5,5,14,Champions
71054,142,7,38,4,2,3,9,Promising
71194,837,5,9,2,1,1,4,Lost
71200,151,10,13,4,2,1,7,Promising
71244,706,14,29,2,3,2,7,Casual Users
71330,42,49,148,5,5,5,15,Champions
71397,1097,8,28,2,2,2,6,Lost
71465,4,97,296,5,5,5,15,Champions
71652,62,114,280,5,5,5,15,Champions
71716,3499,18,28,1,3,2,6,Casual Users
71744,47,11,14,5,2,1,8,Promising
71754,2440,6,12,1,1,1,3,Lost
71896,541,16,57,2,3,3,8,Casual Users
72029,1180,7,14,2,2,1,5,Lost
72030,208,5,20,3,1,2,6,Casual Users
72170,19,55,139,5,5,4,14,Champions
72230,3131,7,10,1,2,1,4,Lost
72408,421,38,86,3,4,4,11,Loyal Users
72705,695,10,12,2,2,1,5,Lost
72819,249,39,51,3,4,3,10,Loyal Users
73580,106,17,40,4,3,3,10,Loyal Users
73588,157,24,66,4,4,4,12,Champions
74006,118,158,442,4,5,5,14,Champions
74116,794,55,166,2,5,5,12,At Risk
74644,5840,5,5,1,1,1,3,Lost
75133,503,7,39,2,2,3,7,Lost
76419,1870,9,20,1,2,2,5,Lost
76477,236,24,52,3,4,3,10,Loyal Users
76564,8,85,210,5,5,5,15,Champions
76596,1990,7,35,1,2,3,6,Lost
76617,1,51,217,5,5,5,15,Champions
76933,82,20,203,4,3,5,12,Loyal Users
77066,59,23,43,5,4,3,12,Loyal Users
77513,1674,8,9,1,2,1,4,Lost
77587,95,12,15,4,3,1,8,Loyal Users
77681,2987,5,6,1,1,1,3,Lost
77775,1045,17,27,2,3,2,7,Casual Users
78160,795,9,58,2,2,3,7,Lost
65439,1143,37,119,2,4,4,10,At Risk
65460,193,8,30,3,2,2,7,Casual Users
65500,18,113,378,5,5,5,15,Champions
65834,312,84,456,3,5,5,13,Loyal Users
65894,379,5,8,3,1,1,5,Casual Users
65899,106,6,30,4,1,2,7,Promising
66358,30,87,201,5,5,5,15,Champions
66496,2859,9,35,1,2,3,6,Lost
66544,261,48,64,3,5,4,12,Loyal Users
67021,129,30,114,4,4,4,12,Champions
67087,19,18,36,5,3,3,11,Loyal Users
67220,1657,7,41,1,2,3,6,Lost
67566,2687,5,7,1,1,1,3,Lost
67729,4001,29,42,1,4,3,8,At Risk
68191,159,5,6,4,1,1,6,Promising
68427,947,29,98,2,4,4,10,At Risk
68693,150,72,262,4,5,5,14,Champions
69148,4089,5,7,1,1,1,3,Lost
69415,246,131,222,3,5,5,13,Loyal Users
69614,817,6,9,2,1,1,4,Lost
69924,2,69,138,5,5,4,14,Champions
70025,2,141,356,5,5,5,15,Champions
70505,1,27,34,5,4,3,12,Loyal Users
70877,452,10,73,3,2,4,9,Casual Users
70898,10,33,141,5,4,4,13,Champions
70939,249,83,490,3,5,5,13,Loyal Users
71090,2793,5,29,1,1,2,4,Lost
71138,133,14,55,4,3,3,10,Loyal Users
71392,88,36,195,4,4,5,13,Champions
71490,2682,7,11,1,2,1,4,Lost
71733,1379,11,29,1,2,2,5,Lost
71927,1709,5,6,1,1,1,3,Lost
72391,283,110,318,3,5,5,13,Loyal Users
72466,1684,31,67,1,4,4,9,At Risk
72654,442,58,373,3,5,5,13,Loyal Users
72905,683,29,36,2,4,3,9,At Risk
73678,10,16,28,5,3,2,10,Loyal Users
73861,5395,10,52,1,2,3,6,Lost
73964,280,16,22,3,3,2,8,Loyal Users
74487,274,46,109,3,5,4,12,Loyal Users
74537,839,5,23,2,1,2,5,Lost
74715,3,128,180,5,5,5,15,Champions
74724,450,13,19,3,3,2,8,Loyal Users
74981,438,24,56,3,4,3,10,Loyal Users
75081,1431,16,26,1,3,2,6,Casual Users
75682,0,30,165,5,4,5,14,Champions
76063,145,12,26,4,3,2,9,Loyal Users
76276,95,21,91,4,3,4,11,Loyal Users
76482,431,9,59,3,2,3,8,Casual Users
76561,2119,12,18,1,3,2,6,Casual Users
77015,248,48,85,3,5,4,12,Loyal Users
77195,704,15,28,2,3,2,7,Casual Users
77306,451,27,326,3,4,5,12,Loyal Users
77345,415,9,10,3,2,1,6,Casual Users
78091,941,16,59,2,3,3,8,Casual Users
78111,33,24,216,5,4,5,14,Champions
78159,837,11,19,2,2,2,6,Lost
65629,16,178,472,5,5,5,15,Champions
65656,4316,5,9,1,1,1,3,Lost
65965,410,9,20,3,2,2,7,Casual Users
66150,82,8,34,4,2,3,9,Promising
66466,2947,6,8,1,1,1,3,Lost
66484,95,5,13,4,1,1,6,Promising
66589,406,7,22,3,2,2,7,Casual Users
66663,1945,5,14,1,1,1,3,Lost
66789,174,10,50,3,2,3,8,Casual Users
66872,227,13,26,3,3,2,8,Loyal Users
66900,3273,6,10,1,1,1,3,Lost
67059,172,5,35,3,1,3,7,Casual Users
67273,5,13,60,5,3,3,11,Loyal Users
67311,146,5,9,4,1,1,6,Promising
67606,20,45,130,5,4,4,13,Champions
67673,128,29,123,4,4,4,12,Champions
67723,0,44,96,5,4,4,13,Champions
67754,3172,6,10,1,1,1,3,Lost
68267,369,9,17,3,2,2,7,Casual Users
68411,293,30,57,3,4,3,10,Loyal Users
68463,41,11,11,5,2,1,8,Promising
68764,235,103,282,3,5,5,13,Loyal Users
69650,224,14,48,3,3,3,9,Loyal Users
69886,610,5,6,2,1,1,4,Lost
70190,693,9,37,2,2,3,7,Lost
70284,3958,15,34,1,3,3,7,Casual Users
70472,27,113,193,5,5,5,15,Champions
70484,3601,9,12,1,2,1,4,Lost
71359,225,14,29,3,3,2,8,Loyal Users
71478,416,21,61,3,3,3,9,Loyal Users
71633,273,52,279,3,5,5,13,Loyal Users
71719,281,8,63,3,2,4,9,Casual Users
72542,113,70,190,4,5,5,14,Champions
72585,80,23,129,4,4,4,12,Champions
72914,310,9,10,3,2,1,6,Casual Users
73251,417,8,42,3,2,3,8,Casual Users
73303,111,61,101,4,5,4,13,Champions
73314,247,38,249,3,4,5,12,Loyal Users
73360,654,8,12,2,2,1,5,Lost
73361,1699,12,43,1,3,3,7,Casual Users
73414,526,34,84,2,4,4,10,At Risk
73489,1698,10,11,1,2,1,4,Lost
73698,499,14,17,2,3,2,7,Casual Users
74168,992,23,53,2,4,3,9,At Risk
74375,2852,6,10,1,1,1,3,Lost
74391,113,38,193,4,4,5,13,Champions
74609,151,26,51,4,4,3,11,Loyal Users
74750,1313,5,13,1,1,1,3,Lost
74966,1793,8,9,1,2,1,4,Lost
75205,90,24,123,4,4,4,12,Champions
75552,4006,8,8,1,2,1,4,Lost
75678,2981,15,61,1,3,3,7,Casual Users
76292,828,19,32,2,3,3,8,Casual Users
76410,2951,6,8,1,1,1,3,Lost
76835,349,21,71,3,3,4,10,Loyal Users
76857,130,7,14,4,2,1,7,Promising
76895,768,10,15,2,2,1,5,Lost
76957,304,69,149,3,5,5,13,Loyal Users
76992,2216,87,280,1,5,5,11,At Risk
77322,285,25,65,3,4,4,11,Loyal Users
77521,1119,20,55,2,3,3,8,Casual Users
77599,1136,11,19,2,2,2,6,Lost
77764,850,96,333,2,5,5,12,At Risk
77782,1242,12,12,2,3,1,6,Casual Users
77919,264,13,24,3,3,2,8,Loyal Users
77920,668,7,8,2,2,1,5,Lost
65793,420,20,176,3,3,5,11,Loyal Users
65874,419,9,49,3,2,3,8,Casual Users
65883,128,107,174,4,5,5,14,Champions
66095,3841,38,72,1,4,4,9,At Risk
66547,700,69,289,2,5,5,12,At Risk
66682,1708,10,62,1,2,3,6,Lost
66746,727,7,16,2,2,2,6,Lost
67049,1654,22,97,1,4,4,9,At Risk
67093,27,54,127,5,5,4,14,Champions
67350,0,34,79,5,4,4,13,Champions
67420,343,14,65,3,3,4,10,Loyal Users
69087,511,13,16,2,3,2,7,Casual Users
69268,2821,6,24,1,1,2,4,Lost
69835,0,15,47,5,3,3,11,Loyal Users
69881,486,14,31,2,3,2,7,Casual Users
69888,49,11,43,5,2,3,10,Promising
69910,726,6,6,2,1,1,4,Lost
70042,2374,5,22,1,1,2,4,Lost
70044,1497,9,13,1,2,1,4,Lost
70198,815,15,27,2,3,2,7,Casual Users
70433,40,21,78,5,3,4,12,Loyal Users
70463,4691,6,6,1,1,1,3,Lost
70725,327,6,6,3,1,1,5,Casual Users
70985,57,35,135,5,4,4,13,Champions
71004,272,10,38,3,2,3,8,Casual Users
71051,29,19,29,5,3,2,10,Loyal Users
71202,1670,5,5,1,1,1,3,Lost
71381,566,8,12,2,2,1,5,Lost
71602,1295,16,78,1,3,4,8,Casual Users
71631,252,7,17,3,2,2,7,Casual Users
71837,59,6,66,5,1,4,10,Promising
71858,112,7,19,4,2,2,8,Promising
71966,406,14,104,3,3,4,10,Loyal Users
72127,16,23,36,5,4,3,12,Loyal Users
72205,1426,17,75,1,3,4,8,Casual Users
72329,134,38,173,4,4,5,13,Champions
72604,71,61,171,4,5,5,14,Champions
72663,607,15,69,2,3,4,9,Casual Users
72837,2149,9,23,1,2,2,5,Lost
72921,139,15,29,4,3,2,9,Loyal Users
72971,5513,62,86,1,5,4,10,At Risk
73681,822,5,9,2,1,1,4,Lost
74173,113,45,79,4,4,4,12,Champions
74464,1559,9,13,1,2,1,4,Lost
74526,29,53,222,5,5,5,15,Champions
74600,867,39,138,2,4,4,10,At Risk
74628,256,43,184,3,4,5,12,Loyal Users
74694,2684,6,8,1,1,1,3,Lost
74730,169,66,414,3,5,5,13,Loyal Users
75505,1003,13,45,2,3,3,8,Casual Users
75520,0,10,44,5,2,3,10,Promising
75580,375,15,146,3,3,4,10,Loyal Users
76086,66,13,22,5,3,2,10,Loyal Users
76274,2011,13,98,1,3,4,8,Casual Users
76516,2603,9,19,1,2,2,5,Lost
76542,11,18,68,5,3,4,12,Loyal Users
76788,10,99,310,5,5,5,15,Champions
77202,124,7,12,4,2,1,7,Promising
77735,256,7,11,3,2,1,6,Casual Users
77801,42,61,113,5,5,4,14,Champions
78083,587,5,16,2,1,2,5,Lost
65665,2668,10,12,1,2,1,4,Lost
65935,1118,10,15,2,2,1,5,Lost
65986,706,10,23,2,2,2,6,Lost
66151,17,96,591,5,5,5,15,Champions
66312,323,27,104,3,4,4,11,Loyal Users
66593,1815,9,33,1,2,3,6,Lost
66737,226,10,36,3,2,3,8,Casual Users
66976,144,25,72,4,4,4,12,Champions
67207,422,5,7,3,1,1,5,Casual Users
67224,112,15,61,4,3,3,10,Loyal Users
67409,366,71,145,3,5,4,12,Loyal Users
67468,102,53,221,4,5,5,14,Champions
67482,406,8,13,3,2,1,6,Casual Users
67501,156,140,290,4,5,5,14,Champions
67751,63,123,1126,5,5,5,15,Champions
67838,1481,13,30,1,3,2,6,Casual Users
68033,209,8,24,3,2,2,7,Casual Users
68154,1,29,80,5,4,4,13,Champions
68213,461,40,86,3,4,4,11,Loyal Users
68294,5407,5,5,1,1,1,3,Lost
68345,700,12,25,2,3,2,7,Casual Users
68387,42,72,242,5,5,5,15,Champions
68470,195,28,139,3,4,4,11,Loyal Users
68702,444,14,164,3,3,5,11,Loyal Users
69134,477,6,9,2,1,1,4,Lost
69177,60,56,223,5,5,5,15,Champions
69409,438,22,62,3,4,3,10,Loyal Users
69941,418,20,65,3,3,4,10,Loyal Users
70114,1683,8,18,1,2,2,5,Lost
70308,47,65,127,5,5,4,14,Champions
70675,2434,11,14,1,2,1,4,Lost
70954,109,63,112,4,5,4,13,Champions
70971,175,61,109,3,5,4,12,Loyal Users
71150,1986,5,7,1,1,1,3,Lost
71250,526,14,107,2,3,4,9,Casual Users
71365,201,64,123,3,5,4,12,Loyal Users
71989,43,25,177,5,4,5,14,Champions
72123,2537,11,16,1,2,2,5,Lost
72475,840,9,62,2,2,3,7,Lost
72510,502,9,16,2,2,2,6,Lost
72523,415,30,92,3,4,4,11,Loyal Users
72768,984,28,194,2,4,5,11,At Risk
72788,127,45,291,4,4,5,13,Champions
72846,881,8,13,2,2,1,5,Lost
72954,1536,6,10,1,1,1,3,Lost
73004,1975,5,7,1,1,1,3,Lost
73167,30,6,15,5,1,1,7,Promising
73419,300,75,96,3,5,4,12,Loyal Users
73534,69,22,96,5,4,4,13,Champions
73634,3608,6,8,1,1,1,3,Lost
73685,1149,11,21,2,2,2,6,Lost
73760,3,158,798,5,5,5,15,Champions
73945,585,10,12,2,2,1,5,Lost
74183,550,15,84,2,3,4,9,Casual Users
74336,534,5,15,2,1,1,4,Lost
74624,593,7,17,2,2,2,6,Lost
74779,3608,6,10,1,1,1,3,Lost
75049,6,111,570,5,5,5,15,Champions
75244,18,18,37,5,3,3,11,Loyal Users
75322,110,6,19,4,1,2,7,Promising
75454,477,8,12,2,2,1,5,Lost
75703,865,31,53,2,4,3,9,At Risk
75844,430,14,20,3,3,2,8,Loyal Users
75853,120,26,71,4,4,4,12,Champions
76057,4,142,308,5,5,5,15,Champions
76534,1345,11,127,1,2,4,7,Lost
76558,223,40,64,3,4,4,11,Loyal Users
76570,90,47,90,4,5,4,13,Champions
76573,3,65,383,5,5,5,15,Champions
76799,1593,8,8,1,2,1,4,Lost
77310,436,38,124,3,4,4,11,Loyal Users
77323,311,47,238,3,5,5,13,Loyal Users
77356,6,151,610,5,5,5,15,Champions
77642,1408,8,15,1,2,1,4,Lost
65560,30,18,81,5,3,4,12,Loyal Users
65920,990,11,12,2,2,1,5,Lost
66290,19,67,86,5,5,4,14,Champions
66558,1711,33,95,1,4,4,9,At Risk
66591,526,20,27,2,3,2,7,Casual Users
66709,691,32,115,2,4,4,10,At Risk
66782,411,16,83,3,3,4,10,Loyal Users
67291,3405,6,8,1,1,1,3,Lost
67486,412,58,181,3,5,5,13,Loyal Users
67555,1889,6,10,1,1,1,3,Lost
67646,541,20,66,2,3,4,9,Casual Users
67775,155,38,67,4,4,4,12,Champions
67802,32,9,20,5,2,2,9,Promising
67908,362,26,153,3,4,5,12,Loyal Users
68067,1622,57,216,1,5,5,11,At Risk
68666,28,33,72,5,4,4,13,Champions
68826,832,7,8,2,2,1,5,Lost
68975,224,12,56,3,3,3,9,Loyal Users
68976,42,59,153,5,5,5,15,Champions
69112,524,23,104,2,4,4,10,At Risk
69201,5179,5,6,1,1,1,3,Lost
69388,419,5,51,3,1,3,7,Casual Users
69895,131,48,295,4,5,5,14,Champions
70057,11,46,107,5,5,4,14,Champions
70136,25,64,317,5,5,5,15,Champions
70446,65,19,25,5,3,2,10,Loyal Users
70556,544,7,7,2,2,1,5,Lost
70601,150,8,11,4,2,1,7,Promising
70608,65,17,27,5,3,2,10,Loyal Users
71221,103,58,116,4,5,4,13,Champions
71541,1430,6,10,1,1,1,3,Lost
72169,16,88,213,5,5,5,15,Champions
72383,135,11,22,4,2,2,8,Promising
72399,101,5,7,4,1,1,6,Promising
72761,9,99,649,5,5,5,15,Champions
72802,741,11,45,2,2,3,7,Lost
72960,4400,8,16,1,2,2,5,Lost
72985,8,6,21,5,1,2,8,Promising
73124,159,47,172,4,5,5,14,Champions
73274,10,115,197,5,5,5,15,Champions
73290,3092,5,11,1,1,1,3,Lost
73514,1596,18,68,1,3,4,8,Casual Users
73564,37,5,7,5,1,1,7,Promising
74096,551,23,91,2,4,4,10,At Risk
74278,1309,7,72,1,2,4,7,Lost
74435,1431,7,11,1,2,1,4,Lost
74548,1406,5,5,1,1,1,3,Lost
74699,169,18,47,3,3,3,9,Loyal Users
74764,830,11,15,2,2,1,5,Lost
74845,319,12,12,3,3,1,7,Loyal Users
75346,3123,14,59,1,3,3,7,Casual Users
75353,92,92,269,4,5,5,14,Champions
75359,875,6,18,2,1,2,5,Lost
75779,3955,5,6,1,1,1,3,Lost
75896,1420,9,12,1,2,1,4,Lost
75933,142,41,84,4,4,4,12,Champions
76011,604,7,9,2,2,1,5,Lost
76102,472,8,14,2,2,1,5,Lost
76653,414,16,75,3,3,4,10,Loyal Users
76693,1981,5,28,1,1,2,4,Lost
76704,119,45,65,4,4,4,12,Champions
76946,147,25,110,4,4,4,12,Champions
76966,80,39,99,4,4,4,12,Champions
77000,288,15,103,3,3,4,10,Loyal Users
77131,2126,9,13,1,2,1,4,Lost
77420,2245,5,8,1,1,1,3,Lost
77524,155,36,165,4,4,5,13,Champions
77700,115,5,5,4,1,1,6,Promising
77985,1735,30,35,1,4,3,8,At Risk
77998,399,10,22,3,2,2,7,Casual Users
66116,5437,7,12,1,2,1,4,Lost
66645,65,45,302,5,4,5,14,Champions
66822,0,31,38,5,4,3,12,Loyal Users
66915,1300,7,37,1,2,3,6,Lost
66949,43,148,244,5,5,5,15,Champions
67228,167,47,95,3,5,4,12,Loyal Users
67336,2522,6,31,1,1,2,4,Lost
67397,747,9,135,2,2,4,8,Lost
67445,106,27,66,4,4,4,12,Champions
67607,264,13,22,3,3,2,8,Loyal Users
67645,358,32,102,3,4,4,11,Loyal Users
67670,1014,24,64,2,4,4,10,At Risk
67972,6,87,342,5,5,5,15,Champions
68104,240,15,39,3,3,3,9,Loyal Users
68369,141,42,146,4,4,4,12,Champions
68664,227,12,63,3,3,4,10,Loyal Users
69181,2292,5,17,1,1,2,4,Lost
69503,2005,6,6,1,1,1,3,Lost
69670,98,20,103,4,3,4,11,Loyal Users
69777,203,72,236,3,5,5,13,Loyal Users
70368,128,69,116,4,5,4,13,Champions
70983,234,37,133,3,4,4,11,Loyal Users
71018,134,42,195,4,4,5,13,Champions
71047,632,6,10,2,1,1,4,Lost
71111,1093,5,9,2,1,1,4,Lost
71265,79,126,282,4,5,5,14,Champions
71466,25,79,357,5,5,5,15,Champions
71525,2068,7,31,1,2,2,5,Lost
71530,134,37,61,4,4,3,11,Loyal Users
71548,27,47,218,5,5,5,15,Champions
71610,23,8,44,5,2,3,10,Promising
71708,1413,9,20,1,2,2,5,Lost
72076,105,11,31,4,2,2,8,Promising
72078,411,6,10,3,1,1,5,Casual Users
72225,3676,5,37,1,1,3,5,Lost
72511,910,8,10,2,2,1,5,Lost
73071,964,29,123,2,4,4,10,At Risk
73153,239,14,36,3,3,3,9,Loyal Users
73237,120,95,261,4,5,5,14,Champions
73397,2001,38,171,1,4,5,10,At Risk
73829,303,10,16,3,2,2,7,Casual Users
73837,17,30,201,5,4,5,14,Champions
73917,3702,6,8,1,1,1,3,Lost
73966,951,33,80,2,4,4,10,At Risk
73976,961,41,412,2,4,5,11,At Risk
74493,27,140,734,5,5,5,15,Champions
74625,4519,10,25,1,2,2,5,Lost
74652,2635,12,49,1,3,3,7,Casual Users
74662,28,126,355,5,5,5,15,Champions
74663,550,11,17,2,2,2,6,Lost
74783,711,25,42,2,4,3,9,At Risk
74908,224,6,7,3,1,1,5,Casual Users
75166,31,135,243,5,5,5,15,Champions
75723,379,12,26,3,3,2,8,Loyal Users
75775,439,32,41,3,4,3,10,Loyal Users
75825,2704,5,6,1,1,1,3,Lost
75870,520,68,391,2,5,5,12,At Risk
75893,109,63,212,4,5,5,14,Champions
75937,180,45,225,3,4,5,12,Loyal Users
76426,3144,6,8,1,1,1,3,Lost
77117,3343,10,60,1,2,3,6,Lost
77137,996,6,15,2,1,1,4,Lost
77504,584,5,7,2,1,1,4,Lost
77568,1431,10,11,1,2,1,4,Lost
77602,1866,13,69,1,3,4,8,Casual Users
78041,822,8,37,2,2,3,7,Lost
78074,879,14,16,2,3,2,7,Casual Users
78277,722,15,58,2,3,3,8,Casual Users
65564,95,39,182,4,4,5,13,Champions
65886,44,5,19,5,1,2,8,Promising
66355,2256,15,43,1,3,3,7,Casual Users
66717,36,17,27,5,3,2,10,Loyal Users
67245,1273,7,14,1,2,1,4,Lost
67287,35,23,60,5,4,3,12,Loyal Users
67440,314,32,37,3,4,3,10,Loyal Users
67463,16,5,10,5,1,1,7,Promising
67578,7,46,89,5,5,4,14,Champions
68052,139,78,602,4,5,5,14,Champions
68111,724,7,26,2,2,2,6,Lost
68133,3124,5,10,1,1,1,3,Lost
68884,463,12,18,3,3,2,8,Loyal Users
69101,66,27,65,5,4,4,13,Champions
69150,2309,6,16,1,1,2,4,Lost
69335,139,5,7,4,1,1,6,Promising
69537,2466,5,5,1,1,1,3,Lost
69739,2539,18,47,1,3,3,7,Casual Users
69785,15,91,238,5,5,5,15,Champions
69994,2913,7,7,1,2,1,4,Lost
70117,54,49,230,5,5,5,15,Champions
70776,16,38,225,5,4,5,14,Champions
70840,134,215,458,4,5,5,14,Champions
70857,233,34,123,3,4,4,11,Loyal Users
70861,3326,10,16,1,2,2,5,Lost
71046,567,12,81,2,3,4,9,Casual Users
71149,4734,15,28,1,3,2,6,Casual Users
71390,2014,19,75,1,3,4,8,Casual Users
71624,124,16,113,4,3,4,11,Loyal Users
71731,119,103,276,4,5,5,14,Champions
72071,222,24,62,3,4,3,10,Loyal Users
72253,16,34,49,5,4,3,12,Loyal Users
72287,970,6,95,2,1,4,7,Lost
72355,80,76,105,4,5,4,13,Champions
72379,647,6,33,2,1,3,6,Lost
72451,93,26,79,4,4,4,12,Champions
72482,399,10,43,3,2,3,8,Casual Users
72828,1565,14,28,1,3,2,6,Casual Users
73027,344,7,11,3,2,1,6,Casual Users
73230,598,13,61,2,3,3,8,Casual Users
73481,932,20,32,2,3,3,8,Casual Users
73557,220,12,33,3,3,3,9,Loyal Users
73620,25,129,296,5,5,5,15,Champions
74709,5,109,221,5,5,5,15,Champions
74790,245,7,10,3,2,1,6,Casual Users
74890,2458,6,7,1,1,1,3,Lost
75194,461,48,86,3,5,4,12,Loyal Users
75340,200,28,122,3,4,4,11,Loyal Users
75565,713,6,31,2,1,2,5,Lost
75650,5398,5,11,1,1,1,3,Lost
76281,145,57,95,4,5,4,13,Champions
76290,412,6,12,3,1,1,5,Casual Users
76313,115,137,472,4,5,5,14,Champions
76353,2407,9,19,1,2,2,5,Lost
76399,745,7,10,2,2,1,5,Lost
76408,3567,5,16,1,1,2,4,Lost
77586,831,6,9,2,1,1,4,Lost
77883,113,27,120,4,4,4,12,Champions
77906,3507,8,9,1,2,1,4,Lost
78068,49,31,71,5,4,4,13,Champions
78155,145,8,20,4,2,2,8,Promising
78156,740,19,50,2,3,3,8,Casual Users
78181,101,67,309,4,5,5,14,Champions
65433,435,25,54,3,4,3,10,Loyal Users
65470,308,8,18,3,2,2,7,Casual Users
65754,2975,10,22,1,2,2,5,Lost
65768,216,5,5,3,1,1,5,Casual Users
65798,242,86,138,3,5,4,12,Loyal Users
65868,2355,8,18,1,2,2,5,Lost
66031,4,42,101,5,4,4,13,Champions
66418,710,12,40,2,3,3,8,Casual Users
66889,364,38,120,3,4,4,11,Loyal Users
66985,668,59,197,2,5,5,12,At Risk
67746,27,5,17,5,1,2,8,Promising
67748,421,18,22,3,3,2,8,Loyal Users
67841,5,76,368,5,5,5,15,Champions
68008,1328,7,15,1,2,1,4,Lost
68125,103,31,106,4,4,4,12,Champions
68172,589,12,15,2,3,1,6,Casual Users
68323,193,20,48,3,3,3,9,Loyal Users
68396,14,147,401,5,5,5,15,Champions
68611,123,29,42,4,4,3,11,Loyal Users
68712,677,6,9,2,1,1,4,Lost
68794,854,54,209,2,5,5,12,At Risk
68868,1125,5,8,2,1,1,4,Lost
68887,333,5,56,3,1,3,7,Casual Users
69157,600,37,105,2,4,4,10,At Risk
69263,652,10,13,2,2,1,5,Lost
69864,1095,10,17,2,2,2,6,Lost
70113,383,29,63,3,4,4,11,Loyal Users
70533,1015,8,42,2,2,3,7,Lost
70602,4056,17,26,1,3,2,6,Casual Users
70729,2752,5,7,1,1,1,3,Lost
71094,3831,7,7,1,2,1,4,Lost
71122,241,10,38,3,2,3,8,Casual Users
71137,110,95,441,4,5,5,14,Champions
71175,96,65,114,4,5,4,13,Champions
71299,136,28,43,4,4,3,11,Loyal Users
71388,1683,5,5,1,1,1,3,Lost
71945,56,39,125,5,4,4,13,Champions
72104,67,45,81,5,4,4,13,Champions
72299,4989,8,32,1,2,3,6,Lost
72732,1361,36,57,1,4,3,8,At Risk
72778,296,14,39,3,3,3,9,Loyal Users
72930,20,90,282,5,5,5,15,Champions
73131,2464,9,27,1,2,2,5,Lost
73335,122,5,19,4,1,2,7,Promising
73561,3988,5,10,1,1,1,3,Lost
73570,19,33,155,5,4,5,14,Champions
73579,19,5,22,5,1,2,8,Promising
73721,1257,5,8,2,1,1,4,Lost
74112,449,7,11,3,2,1,6,Casual Users
74243,419,13,34,3,3,3,9,Loyal Users
74289,225,7,26,3,2,2,7,Casual Users
74739,55,7,15,5,2,1,8,Promising
74807,159,25,195,4,4,5,13,Champions
75209,40,19,63,5,3,4,12,Loyal Users
75771,179,5,26,3,1,2,6,Casual Users
76054,2982,5,51,1,1,3,5,Lost
76094,88,42,112,4,4,4,12,Champions
76105,3,45,208,5,4,5,14,Champions
76288,1301,22,38,1,4,3,8,At Risk
76356,422,37,74,3,4,4,11,Loyal Users
76429,617,7,7,2,2,1,5,Lost
76466,64,56,106,5,5,4,14,Champions
76831,244,126,442,3,5,5,13,Loyal Users
77337,3864,11,30,1,2,2,5,Lost
77663,579,19,31,2,3,2,7,Casual Users
77811,1,23,143,5,4,4,13,Champions
78099,2701,14,45,1,3,3,7,Casual Users
78175,1485,19,80,1,3,4,8,Casual Users
65482,671,5,12,2,1,1,4,Lost
65495,6,7,10,5,2,1,8,Promising
65610,4170,10,25,1,2,2,5,Lost
65620,80,24,41,4,4,3,11,Loyal Users
65751,230,16,28,3,3,2,8,Loyal Users
65861,1087,18,38,2,3,3,8,Casual Users
65909,23,11,32,5,2,3,10,Promising
65945,994,11,14,2,2,1,5,Lost
66221,286,8,14,3,2,1,6,Casual Users
66437,2531,5,8,1,1,1,3,Lost
66443,137,8,18,4,2,2,8,Promising
66647,611,24,88,2,4,4,10,At Risk
66710,652,11,19,2,2,2,6,Lost
66772,663,13,47,2,3,3,8,Casual Users
67542,4707,9,10,1,2,1,4,Lost
67873,85,34,61,4,4,3,11,Loyal Users
67978,610,6,46,2,1,3,6,Lost
67983,121,103,183,4,5,5,14,Champions
68584,790,15,31,2,3,2,7,Casual Users
68689,1896,11,100,1,2,4,7,Lost
68853,32,38,135,5,4,4,13,Champions
69130,638,21,98,2,3,4,9,Casual Users
69309,2521,7,7,1,2,1,4,Lost
69455,271,111,392,3,5,5,13,Loyal Users
69591,499,27,73,2,4,4,10,At Risk
69700,90,17,106,4,3,4,11,Loyal Users
69851,874,14,44,2,3,3,8,Casual Users
69962,140,101,226,4,5,5,14,Champions
69973,406,16,87,3,3,4,10,Loyal Users
70122,229,78,244,3,5,5,13,Loyal Users
70381,139,38,204,4,4,5,13,Champions
70802,628,62,83,2,5,4,11,At Risk
70879,597,10,98,2,2,4,8,Lost
70927,43,58,403,5,5,5,15,Champions
71176,40,17,20,5,3,2,10,Loyal Users
71273,38,32,103,5,4,4,13,Champions
71399,3582,8,22,1,2,2,5,Lost
71804,2942,5,48,1,1,3,5,Lost
72124,4991,7,15,1,2,1,4,Lost
72334,1505,10,12,1,2,1,4,Lost
72716,2288,7,20,1,2,2,5,Lost
72942,3321,10,22,1,2,2,5,Lost
73075,2142,12,91,1,3,4,8,Casual Users
73109,528,13,120,2,3,4,9,Casual Users
73687,15,62,272,5,5,5,15,Champions
73916,16,10,30,5,2,2,9,Promising
74231,151,43,116,4,4,4,12,Champions
74525,388,11,34,3,2,3,8,Casual Users
74742,1532,13,28,1,3,2,6,Casual Users
74840,244,11,15,3,2,1,6,Casual Users
75064,140,15,48,4,3,3,10,Loyal Users
75101,1411,9,16,1,2,2,5,Lost
75130,911,8,8,2,2,1,5,Lost
75136,39,43,136,5,4,4,13,Champions
75329,425,38,51,3,4,3,10,Loyal Users
75344,120,6,14,4,1,1,6,Promising
75348,3578,6,8,1,1,1,3,Lost
75518,148,21,122,4,3,4,11,Loyal Users
76052,1500,23,37,1,4,3,8,At Risk
76122,601,5,7,2,1,1,4,Lost
76379,2463,11,57,1,2,3,6,Lost
76461,41,149,976,5,5,5,15,Champions
76529,20,21,106,5,3,4,12,Loyal Users
76554,122,50,356,4,5,5,14,Champions
76936,1984,15,23,1,3,2,6,Casual Users
77224,159,12,46,4,3,3,10,Loyal Users
77256,132,6,11,4,1,1,6,Promising
77369,2899,9,40,1,2,3,6,Lost
77615,295,74,119,3,5,4,12,Loyal Users
77828,566,15,33,2,3,3,8,Casual Users
77891,167,19,27,3,3,2,8,Loyal Users
77915,28,58,187,5,5,5,15,Champions
78132,24,51,346,5,5,5,15,Champions
78264,534,7,13,2,2,1,5,Lost
65632,2,8,32,5,2,3,10,Promising
65846,2388,17,26,1,3,2,6,Casual Users
65892,3701,6,18,1,1,2,4,Lost
66067,575,17,47,2,3,3,8,Casual Users
66197,14,58,252,5,5,5,15,Champions
66266,1904,7,9,1,2,1,4,Lost
66390,159,48,59,4,5,3,12,Loyal Users
66527,522,17,20,2,3,2,7,Casual Users
66649,112,56,109,4,5,4,13,Champions
66891,127,93,210,4,5,5,14,Champions
66995,12,81,132,5,5,4,14,Champions
67081,315,51,69,3,5,4,12,Loyal Users
67309,2103,5,9,1,1,1,3,Lost
67451,419,33,94,3,4,4,11,Loyal Users
67477,232,5,33,3,1,3,7,Casual Users
67591,713,10,14,2,2,1,5,Lost
67694,15,219,608,5,5,5,15,Champions
67774,38,73,374,5,5,5,15,Champions
67837,333,25,52,3,4,3,10,Loyal Users
67848,675,23,186,2,4,5,11,At Risk
68263,14,23,52,5,4,3,12,Loyal Users
68720,1970,39,52,1,4,3,8,At Risk
69159,836,23,103,2,4,4,10,At Risk
69252,2170,11,97,1,2,4,7,Lost
69337,3373,9,9,1,2,1,4,Lost
69387,930,9,20,2,2,2,6,Lost
69625,42,126,406,5,5,5,15,Champions
69649,3406,6,30,1,1,2,4,Lost
69871,524,85,290,2,5,5,12,At Risk
69934,1834,7,16,1,2,2,5,Lost
69946,581,33,246,2,4,5,11,At Risk
69965,419,7,17,3,2,2,7,Casual Users
70003,30,20,86,5,3,4,12,Loyal Users
70125,76,143,623,4,5,5,14,Champions
70274,1619,5,5,1,1,1,3,Lost
70280,79,51,153,4,5,5,14,Champions
70568,1,5,24,5,1,2,8,Promising
71084,339,13,23,3,3,2,8,Loyal Users
71263,224,25,149,3,4,5,12,Loyal Users
71316,539,7,17,2,2,2,6,Lost
71979,28,100,734,5,5,5,15,Champions
72044,89,13,23,4,3,2,9,Loyal Users
72290,221,23,42,3,4,3,10,Loyal Users
72541,416,8,87,3,2,4,9,Casual Users
72579,3180,10,30,1,2,2,5,Lost
72686,137,25,69,4,4,4,12,Champions
72706,1207,13,69,2,3,4,9,Casual Users
73013,414,9,13,3,2,1,6,Casual Users
73015,704,9,35,2,2,3,7,Lost
73022,686,28,58,2,4,3,9,At Risk
73266,118,155,297,4,5,5,14,Champions
73339,1480,14,24,1,3,2,6,Casual Users
73486,2563,5,7,1,1,1,3,Lost
73488,421,26,31,3,4,2,9,Loyal Users
73644,27,24,42,5,4,3,12,Loyal Users
73703,710,5,16,2,1,2,5,Lost
73810,79,50,146,4,5,4,13,Champions
73859,14,9,15,5,2,1,8,Promising
73872,1010,50,104,2,5,4,11,At Risk
73881,853,7,61,2,2,3,7,Lost
73936,11,28,65,5,4,4,13,Champions
73951,580,6,14,2,1,1,4,Lost
74294,4,5,8,5,1,1,7,Promising
74374,4,72,324,5,5,5,15,Champions
74424,2044,14,20,1,3,2,6,Casual Users
74514,110,27,52,4,4,3,11,Loyal Users
74787,11,130,849,5,5,5,15,Champions
74821,262,18,58,3,3,3,9,Loyal Users
74848,1986,10,12,1,2,1,4,Lost
75303,1382,14,22,1,3,2,6,Casual Users
75409,719,7,24,2,2,2,6,Lost
76077,130,6,20,4,1,2,7,Promising
76259,1396,9,17,1,2,2,5,Lost
76296,138,64,88,4,5,4,13,Champions
76711,287,5,8,3,1,1,5,Casual Users
77984,341,28,161,3,4,5,12,Loyal Users
65736,27,14,23,5,3,2,10,Loyal Users
66885,125,7,48,4,2,3,9,Promising
67370,3,10,10,5,2,1,8,Promising
67548,28,5,16,5,1,2,8,Promising
67572,1119,12,41,2,3,3,8,Casual Users
67603,2001,5,6,1,1,1,3,Lost
67661,1241,5,10,2,1,1,4,Lost
67716,872,7,36,2,2,3,7,Lost
68233,110,7,16,4,2,2,8,Promising
68399,416,8,8,3,2,1,6,Casual Users
68451,4097,8,24,1,2,2,5,Lost
68776,130,24,116,4,4,4,12,Champions
69174,125,22,92,4,4,4,12,Champions
69884,3630,7,26,1,2,2,5,Lost
69948,135,39,67,4,4,4,12,Champions
69993,822,7,19,2,2,2,6,Lost
70106,11,56,103,5,5,4,14,Champions
70153,152,74,386,4,5,5,14,Champions
70314,2414,5,10,1,1,1,3,Lost
70349,2867,6,6,1,1,1,3,Lost
70366,2394,10,17,1,2,2,5,Lost
70409,40,60,333,5,5,5,15,Champions
70420,12,41,74,5,4,4,13,Champions
70609,1040,30,139,2,4,4,10,At Risk
70852,550,7,7,2,2,1,5,Lost
71268,89,32,55,4,4,3,11,Loyal Users
71325,143,5,10,4,1,1,6,Promising
71424,44,12,19,5,3,2,10,Loyal Users
71449,75,115,402,4,5,5,14,Champions
71522,424,5,6,3,1,1,5,Casual Users
72348,41,146,335,5,5,5,15,Champions
72552,9,90,433,5,5,5,15,Champions
72683,118,45,112,4,4,4,12,Champions
72736,266,8,14,3,2,1,6,Casual Users
72854,71,10,53,4,2,3,9,Promising
72881,115,6,15,4,1,1,6,Promising
72926,77,52,187,4,5,5,14,Champions
73172,16,15,38,5,3,3,11,Loyal Users
73276,293,22,85,3,4,4,11,Loyal Users
73457,292,16,77,3,3,4,10,Loyal Users
73616,21,153,245,5,5,5,15,Champions
73738,4371,8,23,1,2,2,5,Lost
73905,33,35,183,5,4,5,14,Champions
73919,36,52,410,5,5,5,15,Champions
73977,106,15,82,4,3,4,11,Loyal Users
74441,12,105,462,5,5,5,15,Champions
74485,20,9,36,5,2,3,10,Promising
74499,40,36,104,5,4,4,13,Champions
75174,99,35,51,4,4,3,11,Loyal Users
75190,576,9,13,2,2,1,5,Lost
75230,41,96,160,5,5,5,15,Champions
75259,465,62,110,3,5,4,12,Loyal Users
75654,83,133,668,4,5,5,14,Champions
75685,1639,12,27,1,3,2,6,Casual Users
75883,395,37,62,3,4,3,10,Loyal Users
75947,846,25,36,2,4,3,9,At Risk
76262,2516,9,26,1,2,2,5,Lost
76664,53,89,710,5,5,5,15,Champions
76797,36,26,56,5,4,3,12,Loyal Users
76918,1393,38,53,1,4,3,8,At Risk
77143,89,37,165,4,4,5,13,Champions
77200,148,10,64,4,2,4,10,Promising
77227,189,9,12,3,2,1,6,Casual Users
77483,108,78,256,4,5,5,14,Champions
77713,291,41,55,3,4,3,10,Loyal Users
77900,23,51,84,5,5,4,14,Champions
78191,19,114,217,5,5,5,15,Champions
78280,109,15,46,4,3,3,10,Loyal Users
65634,37,15,28,5,3,2,10,Loyal Users
65725,66,17,95,5,3,4,12,Loyal Users
66754,1598,8,28,1,2,2,5,Lost
66811,704,17,63,2,3,4,9,Casual Users
67282,1130,9,20,2,2,2,6,Lost
67472,690,16,20,2,3,2,7,Casual Users
67602,82,65,148,4,5,5,14,Champions
67720,873,7,17,2,2,2,6,Lost
68594,171,18,34,3,3,3,9,Loyal Users
69079,0,68,189,5,5,5,15,Champions
69098,2,85,360,5,5,5,15,Champions
69178,43,80,597,5,5,5,15,Champions
69267,82,104,354,4,5,5,14,Champions
69541,228,10,11,3,2,1,6,Casual Users
69568,12,30,52,5,4,3,12,Loyal Users
69663,118,9,40,4,2,3,9,Promising
70155,190,61,248,3,5,5,13,Loyal Users
70267,352,28,47,3,4,3,10,Loyal Users
70340,17,112,757,5,5,5,15,Champions
70606,355,40,71,3,4,4,11,Loyal Users
70638,529,9,19,2,2,2,6,Lost
70667,1433,7,8,1,2,1,4,Lost
70747,582,12,23,2,3,2,7,Casual Users
70909,1150,10,15,2,2,1,5,Lost
70952,1,34,157,5,4,5,14,Champions
70984,61,7,9,5,2,1,8,Promising
71212,140,20,27,4,3,2,9,Loyal Users
71460,272,65,233,3,5,5,13,Loyal Users
71687,126,73,300,4,5,5,14,Champions
71775,124,6,8,4,1,1,6,Promising
71985,713,14,15,2,3,1,6,Casual Users
72148,422,28,160,3,4,5,12,Loyal Users
72216,2689,5,6,1,1,1,3,Lost
72326,2420,12,20,1,3,2,6,Casual Users
72394,78,61,223,4,5,5,14,Champions
73011,133,23,28,4,4,2,10,Loyal Users
73388,1852,8,19,1,2,2,5,Lost
73950,825,24,143,2,4,4,10,At Risk
74067,753,7,43,2,2,3,7,Lost
74317,279,17,81,3,3,4,10,Loyal Users
74361,1440,19,52,1,3,3,7,Casual Users
74491,260,27,68,3,4,4,11,Loyal Users
74639,6,48,133,5,5,4,14,Champions
74831,1165,6,9,2,1,1,4,Lost
74917,208,76,135,3,5,4,12,Loyal Users
75082,22,65,299,5,5,5,15,Champions
75199,121,16,104,4,3,4,11,Loyal Users
75507,397,31,46,3,4,3,10,Loyal Users
75788,1651,22,60,1,4,3,8,At Risk
76093,146,27,38,4,4,3,11,Loyal Users
76434,153,18,159,4,3,5,12,Loyal Users
76455,1386,26,30,1,4,2,7,At Risk
76513,372,32,166,3,4,5,12,Loyal Users
76754,0,19,31,5,3,2,10,Loyal Users
76867,1006,7,23,2,2,2,6,Lost
76889,835,19,45,2,3,3,8,Casual Users
77127,1131,14,21,2,3,2,7,Casual Users
77218,599,7,13,2,2,1,5,Lost
77276,823,5,17,2,1,2,5,Lost
77353,829,14,14,2,3,1,6,Casual Users
77384,127,28,48,4,4,3,11,Loyal Users
65750,129,26,80,4,4,4,12,Champions
65956,422,27,127,3,4,4,11,Loyal Users
66167,112,5,6,4,1,1,6,Promising
66349,415,12,27,3,3,2,8,Loyal Users
66514,701,17,42,2,3,3,8,Casual Users
66633,309,9,18,3,2,2,7,Casual Users
66676,136,63,374,4,5,5,14,Champions
67143,20,79,242,5,5,5,15,Champions
67206,143,15,34,4,3,3,10,Loyal Users
67306,20,81,296,5,5,5,15,Champions
67441,515,16,53,2,3,3,8,Casual Users
67454,64,104,139,5,5,4,14,Champions
67692,222,53,96,3,5,4,12,Loyal Users
68303,427,17,61,3,3,3,9,Loyal Users
68306,1151,8,27,2,2,2,6,Lost
68394,413,5,53,3,1,3,7,Casual Users
68450,12,34,76,5,4,4,13,Champions
68524,85,16,94,4,3,4,11,Loyal Users
68567,12,123,475,5,5,5,15,Champions
68716,28,10,47,5,2,3,10,Promising
68723,1283,7,17,1,2,2,5,Lost
68741,615,29,85,2,4,4,10,At Risk
68790,103,29,49,4,4,3,11,Loyal Users
69277,146,32,40,4,4,3,11,Loyal Users
69504,123,62,254,4,5,5,14,Champions
69733,293,51,284,3,5,5,13,Loyal Users
69844,185,11,86,3,2,4,9,Casual Users
70162,8,28,32,5,4,3,12,Loyal Users
70163,438,6,7,3,1,1,5,Casual Users
70248,128,10,16,4,2,2,8,Promising
70339,419,47,139,3,5,4,12,Loyal Users
70375,226,12,63,3,3,4,10,Loyal Users
70380,987,9,17,2,2,2,6,Lost
70401,586,10,20,2,2,2,6,Lost
70473,1363,6,15,1,1,1,3,Lost
71006,86,70,116,4,5,4,13,Champions
71017,69,81,242,5,5,5,15,Champions
71326,254,16,34,3,3,3,9,Loyal Users
71439,59,54,89,5,5,4,14,Champions
71489,1359,57,199,1,5,5,11,At Risk
71526,9,18,123,5,3,4,12,Loyal Users
72094,101,129,265,4,5,5,14,Champions
72246,89,20,55,4,3,3,10,Loyal Users
72508,642,29,80,2,4,4,10,At Risk
72612,11,33,72,5,4,4,13,Champions
72733,130,15,26,4,3,2,9,Loyal Users
72867,2253,7,8,1,2,1,4,Lost
73260,9,17,25,5,3,2,10,Loyal Users
73548,948,5,8,2,1,1,4,Lost
73625,701,7,21,2,2,2,6,Lost
73913,25,14,26,5,3,2,10,Loyal Users
73960,793,6,20,2,1,2,5,Lost
74246,4786,9,9,1,2,1,4,Lost
74335,43,11,30,5,2,2,9,Promising
74500,1007,26,125,2,4,4,10,At Risk
74693,959,12,18,2,3,2,7,Casual Users
75118,421,9,31,3,2,2,7,Casual Users
75123,104,25,86,4,4,4,12,Champions
75179,2,44,112,5,4,4,13,Champions
75535,2398,5,9,1,1,1,3,Lost
75694,108,74,134,4,5,4,13,Champions
76263,74,41,216,4,4,5,13,Champions
76272,160,11,131,4,2,4,10,Promising
76603,21,102,323,5,5,5,15,Champions
76657,3,157,941,5,5,5,15,Champions
76699,94,7,20,4,2,2,8,Promising
76762,118,69,320,4,5,5,14,Champions
77124,93,42,63,4,4,4,12,Champions
77349,259,117,256,3,5,5,13,Loyal Users
77760,847,6,13,2,1,1,4,Lost
78253,1708,16,17,1,3,2,6,Casual Users
65603,432,53,289,3,5,5,13,Loyal Users
65713,509,8,42,2,2,3,7,Lost
65837,717,11,22,2,2,2,6,Lost
65841,605,10,13,2,2,1,5,Lost
65906,49,84,166,5,5,5,15,Champions
65922,136,18,37,4,3,3,10,Loyal Users
65930,386,71,392,3,5,5,13,Loyal Users
66022,15,113,276,5,5,5,15,Champions
66042,72,16,114,4,3,4,11,Loyal Users
66503,272,20,148,3,3,5,11,Loyal Users
67032,714,13,21,2,3,2,7,Casual Users
67118,342,10,17,3,2,2,7,Casual Users
67256,2672,6,35,1,1,3,5,Lost
67341,102,75,394,4,5,5,14,Champions
67725,650,21,92,2,3,4,9,Casual Users
67934,434,21,55,3,3,3,9,Loyal Users
68115,670,7,36,2,2,3,7,Lost
68157,601,15,23,2,3,2,7,Casual Users
68647,68,131,356,5,5,5,15,Champions
68721,520,7,24,2,2,2,6,Lost
68957,3,127,403,5,5,5,15,Champions
69284,42,9,23,5,2,2,9,Promising
69361,589,30,72,2,4,4,10,At Risk
70076,942,33,65,2,4,4,10,At Risk
70149,8,32,120,5,4,4,13,Champions
70244,2099,10,11,1,2,1,4,Lost
70273,1081,8,56,2,2,3,7,Lost
70357,128,57,223,4,5,5,14,Champions
70566,235,56,209,3,5,5,13,Loyal Users
70574,153,41,106,4,4,4,12,Champions
70588,3,107,268,5,5,5,15,Champions
70723,3107,7,11,1,2,1,4,Lost
70752,6,5,12,5,1,1,7,Promising
70781,88,35,108,4,4,4,12,Champions
70894,416,7,38,3,2,3,8,Casual Users
70938,1853,9,19,1,2,2,5,Lost
71566,331,18,20,3,3,2,8,Loyal Users
72125,167,54,380,3,5,5,13,Loyal Users
72133,120,5,12,4,1,1,6,Promising
72249,407,5,9,3,1,1,5,Casual Users
72448,9,133,612,5,5,5,15,Champions
72461,2536,9,15,1,2,1,4,Lost
72836,1708,12,39,1,3,3,7,Casual Users
72999,152,15,57,4,3,3,10,Loyal Users
73037,1693,6,34,1,1,3,5,Lost
73390,473,7,18,2,2,2,6,Lost
73439,426,32,157,3,4,5,12,Loyal Users
73669,3693,6,17,1,1,2,4,Lost
74039,4546,7,8,1,2,1,4,Lost
74087,710,5,10,2,1,1,4,Lost
74218,131,18,56,4,3,3,10,Loyal Users
74377,2,21,79,5,3,4,12,Loyal Users
74425,65,109,383,5,5,5,15,Champions
74563,1444,15,37,1,3,3,7,Casual Users
74911,3,81,153,5,5,5,15,Champions
75045,272,15,47,3,3,3,9,Loyal Users
75086,447,21,52,3,3,3,9,Loyal Users
75169,60,73,294,5,5,5,15,Champions
75566,297,36,52,3,4,3,10,Loyal Users
75642,1287,16,35,1,3,3,7,Casual Users
75821,111,9,49,4,2,3,9,Promising
76062,5299,6,14,1,1,1,3,Lost
76160,140,9,31,4,2,2,8,Promising
76352,972,17,31,2,3,2,7,Casual Users
76998,7,163,619,5,5,5,15,Champions
77090,423,7,34,3,2,3,8,Casual Users
77489,76,26,72,4,4,4,12,Champions
77559,1506,17,27,1,3,2,6,Casual Users
77727,25,67,197,5,5,5,15,Champions
77742,264,5,20,3,1,2,6,Casual Users
77831,383,6,9,3,1,1,5,Casual Users
78069,213,11,24,3,2,2,7,Casual Users
78176,522,27,96,2,4,4,10,At Risk
65598,4,88,288,5,5,5,15,Champions
65788,1113,12,138,2,3,4,9,Casual Users
65857,3649,28,198,1,4,5,10,At Risk
66079,1903,9,10,1,2,1,4,Lost
66603,304,8,11,3,2,1,6,Casual Users
66686,250,5,12,3,1,1,5,Casual Users
67188,3265,9,29,1,2,2,5,Lost
67404,106,65,134,4,5,4,13,Champions
67476,1817,25,44,1,4,3,8,At Risk
67764,182,33,110,3,4,4,11,Loyal Users
67920,5430,7,7,1,2,1,4,Lost
68150,95,48,199,4,5,5,14,Champions
68231,1422,13,22,1,3,2,6,Casual Users
68491,5294,8,22,1,2,2,5,Lost
68645,424,10,27,3,2,2,7,Casual Users
68821,3885,5,5,1,1,1,3,Lost
68872,35,58,87,5,5,4,14,Champions
69051,382,25,225,3,4,5,12,Loyal Users
69067,149,24,96,4,4,4,12,Champions
69088,838,8,28,2,2,2,6,Lost
69412,180,67,323,3,5,5,13,Loyal Users
69416,44,16,35,5,3,3,11,Loyal Users
69611,533,19,72,2,3,4,9,Casual Users
69631,427,28,66,3,4,4,11,Loyal Users
69725,521,73,257,2,5,5,12,At Risk
69749,524,25,43,2,4,3,9,At Risk
69759,101,7,15,4,2,1,7,Promising
69998,2474,5,18,1,1,2,4,Lost
70138,1382,6,13,1,1,1,3,Lost
70435,419,36,227,3,4,5,12,Loyal Users
70733,152,13,65,4,3,4,11,Loyal Users
70860,1248,20,127,2,3,4,9,Casual Users
70893,88,10,35,4,2,3,9,Promising
71423,4842,9,9,1,2,1,4,Lost
71618,2,42,105,5,4,4,13,Champions
71662,133,15,27,4,3,2,9,Loyal Users
71739,147,9,11,4,2,1,7,Promising
71869,26,24,46,5,4,3,12,Loyal Users
72035,3,79,245,5,5,5,15,Champions
72902,266,18,60,3,3,3,9,Loyal Users
73033,6107,5,31,1,1,2,4,Lost
73362,2549,5,18,1,1,2,4,Lost
73556,57,125,830,5,5,5,15,Champions
73783,3603,7,31,1,2,2,5,Lost
74220,96,110,222,4,5,5,14,Champions
74290,125,38,63,4,4,4,12,Champions
74458,106,76,315,4,5,5,14,Champions
74838,7,26,87,5,4,4,13,Champions
74865,102,74,366,4,5,5,14,Champions
74884,430,6,9,3,1,1,5,Casual Users
75113,4273,6,66,1,1,4,6,Lost
75168,4658,9,9,1,2,1,4,Lost
75426,6,45,168,5,4,5,14,Champions
75660,2513,11,18,1,2,2,5,Lost
75813,1854,6,16,1,1,2,4,Lost
75992,395,14,16,3,3,2,8,Loyal Users
76031,1307,10,27,1,2,2,5,Lost
76034,131,5,9,4,1,1,6,Promising
76196,140,65,179,4,5,5,14,Champions
76579,444,8,36,3,2,3,8,Casual Users
76619,6,155,595,5,5,5,15,Champions
77194,79,15,29,4,3,2,9,Loyal Users
77292,233,11,30,3,2,2,7,Casual Users
77537,422,8,9,3,2,1,6,Casual Users
77827,128,76,142,4,5,4,13,Champions
78018,22,45,173,5,4,5,14,Champions
78025,93,42,230,4,4,5,13,Champions
78038,113,11,56,4,2,3,9,Promising
78098,3,67,527,5,5,5,15,Champions
78182,172,30,52,3,4,3,10,Loyal Users
78195,3,26,45,5,4,3,12,Loyal Users
78227,149,7,74,4,2,4,10,Promising
78240,1861,6,18,1,1,2,4,Lost
65505,1407,11,116,1,2,4,7,Lost
65562,92,21,88,4,3,4,11,Loyal Users
65595,29,13,25,5,3,2,10,Loyal Users
65851,1,83,549,5,5,5,15,Champions
65880,429,13,18,3,3,2,8,Loyal Users
65942,889,6,9,2,1,1,4,Lost
65962,279,13,63,3,3,4,10,Loyal Users
66208,408,6,43,3,1,3,7,Casual Users
66307,412,78,118,3,5,4,12,Loyal Users
66342,86,136,508,4,5,5,14,Champions
66580,1354,10,34,1,2,3,6,Lost
66725,2297,5,27,1,1,2,4,Lost
67300,269,32,121,3,4,4,11,Loyal Users
67326,3181,5,21,1,1,2,4,Lost
67371,147,7,8,4,2,1,7,Promising
67387,360,45,119,3,4,4,11,Loyal Users
67393,1272,5,27,1,1,2,4,Lost
67788,2432,17,29,1,3,2,6,Casual Users
67880,403,5,6,3,1,1,5,Casual Users
68293,127,45,127,4,4,4,12,Champions
68370,132,24,77,4,4,4,12,Champions
68556,306,32,279,3,4,5,12,Loyal Users
68920,540,14,27,2,3,2,7,Casual Users
69081,14,102,309,5,5,5,15,Champions
69125,2340,12,17,1,3,2,6,Casual Users
69143,419,12,13,3,3,1,7,Loyal Users
69485,7,48,390,5,5,5,15,Champions
69500,42,149,407,5,5,5,15,Champions
69727,500,14,75,2,3,4,9,Casual Users
70007,131,24,45,4,4,3,11,Loyal Users
70579,712,34,66,2,4,4,10,At Risk
71161,137,39,70,4,4,4,12,Champions
71463,489,14,27,2,3,2,7,Casual Users
71717,111,75,173,4,5,5,14,Champions
71742,527,24,143,2,4,4,10,At Risk
72021,16,39,107,5,4,4,13,Champions
72112,96,14,43,4,3,3,10,Loyal Users
72244,402,25,67,3,4,4,11,Loyal Users
72342,582,5,11,2,1,1,4,Lost
72502,602,6,7,2,1,1,4,Lost
72863,966,17,36,2,3,3,8,Casual Users
72874,532,18,33,2,3,3,8,Casual Users
72895,235,7,27,3,2,2,7,Casual Users
73759,28,6,6,5,1,1,7,Promising
73782,2975,128,276,1,5,5,11,At Risk
73867,1542,11,22,1,2,2,5,Lost
74041,172,34,87,3,4,4,11,Loyal Users
74111,670,17,63,2,3,4,9,Casual Users
74314,150,34,178,4,4,5,13,Champions
74470,2549,7,12,1,2,1,4,Lost
74557,32,48,86,5,5,4,14,Champions
74598,1931,8,13,1,2,1,4,Lost
74687,130,37,68,4,4,4,12,Champions
74758,11,6,73,5,1,4,10,Promising
75239,873,11,15,2,2,1,5,Lost
75273,2128,6,44,1,1,3,5,Lost
75549,226,19,39,3,3,3,9,Loyal Users
75570,93,167,835,4,5,5,14,Champions
75691,221,12,174,3,3,5,11,Loyal Users
75983,438,32,95,3,4,4,11,Loyal Users
76006,118,41,69,4,4,4,12,Champions
76395,626,5,18,2,1,2,5,Lost
76420,382,5,51,3,1,3,7,Casual Users
76422,1443,15,45,1,3,3,7,Casual Users
76645,104,76,424,4,5,5,14,Champions
77386,116,20,151,4,3,5,12,Loyal Users
77403,2575,16,25,1,3,2,6,Casual Users
77898,167,32,73,3,4,4,11,Loyal Users
77923,409,6,10,3,1,1,5,Casual Users
78258,65,12,85,5,3,4,12,Loyal Users
65775,3374,5,37,1,1,3,5,Lost
65853,126,35,108,4,4,4,12,Champions
65885,114,22,74,4,4,4,12,Champions
65915,3413,5,8,1,1,1,3,Lost
65919,1554,28,46,1,4,3,8,At Risk
66118,1315,8,13,1,2,1,4,Lost
66387,851,19,46,2,3,3,8,Casual Users
66820,12,51,146,5,5,4,14,Champions
67211,1761,49,162,1,5,5,11,At Risk
67519,1083,25,117,2,4,4,10,At Risk
67554,25,71,143,5,5,4,14,Champions
67747,1181,9,16,2,2,2,6,Lost
67979,101,55,287,4,5,5,14,Champions
68217,814,29,80,2,4,4,10,At Risk
68608,548,13,18,2,3,2,7,Casual Users
68831,4579,9,12,1,2,1,4,Lost
68844,1104,15,24,2,3,2,7,Casual Users
68845,545,20,90,2,3,4,9,Casual Users
68858,724,12,27,2,3,2,7,Casual Users
68945,245,70,365,3,5,5,13,Loyal Users
69679,425,13,16,3,3,2,8,Loyal Users
69901,38,14,62,5,3,3,11,Loyal Users
70257,19,88,222,5,5,5,15,Champions
70263,2012,5,15,1,1,1,3,Lost
70514,285,6,15,3,1,1,5,Casual Users
70911,3,126,504,5,5,5,15,Champions
71143,182,70,159,3,5,5,13,Loyal Users
71275,540,5,10,2,1,1,4,Lost
71379,88,105,192,4,5,5,14,Champions
71414,1003,5,10,2,1,1,4,Lost
71435,129,5,12,4,1,1,6,Promising
71482,125,45,178,4,4,5,13,Champions
71683,134,9,19,4,2,2,8,Promising
71793,124,18,64,4,3,4,11,Loyal Users
71917,1627,7,16,1,2,2,5,Lost
71983,378,7,17,3,2,2,7,Casual Users
72042,6,107,228,5,5,5,15,Champions
73125,1724,41,118,1,4,4,9,At Risk
73324,1110,5,11,2,1,1,4,Lost
73404,1359,9,14,1,2,1,4,Lost
73636,155,11,66,4,2,4,10,Promising
74206,2900,5,15,1,1,1,3,Lost
74523,108,9,33,4,2,3,9,Promising
74653,134,11,52,4,2,3,9,Promising
74669,82,44,90,4,4,4,12,Champions
74702,26,40,47,5,4,3,12,Loyal Users
74754,587,12,26,2,3,2,7,Casual Users
74864,101,44,52,4,4,3,11,Loyal Users
74887,0,12,36,5,3,3,11,Loyal Users
75119,459,39,116,3,4,4,11,Loyal Users
75861,2004,23,38,1,4,3,8,At Risk
76064,27,32,138,5,4,4,13,Champions
76072,58,73,264,5,5,5,15,Champions
76229,2407,19,56,1,3,3,7,Casual Users
76300,115,28,56,4,4,3,11,Loyal Users
76381,15,19,38,5,3,3,11,Loyal Users
76447,2404,9,58,1,2,3,6,Lost
76478,223,31,66,3,4,4,11,Loyal Users
76514,126,65,119,4,5,4,13,Champions
76520,427,7,11,3,2,1,6,Casual Users
76595,20,70,139,5,5,4,14,Champions
76886,1078,13,19,2,3,2,7,Casual Users
77335,1,29,114,5,4,4,13,Champions
77451,2842,10,18,1,2,2,5,Lost
77519,433,57,152,3,5,5,13,Loyal Users
77577,12,66,171,5,5,5,15,Champions
77852,240,48,171,3,5,5,13,Loyal Users
77964,1710,11,18,1,2,2,5,Lost
78013,1444,8,32,1,2,3,6,Lost
78228,110,65,158,4,5,5,14,Champions
65488,546,11,17,2,2,2,6,Lost
65581,396,25,51,3,4,3,10,Loyal Users
65643,390,58,163,3,5,5,13,Loyal Users
65685,1178,16,16,2,3,2,7,Casual Users
66134,1522,5,20,1,1,2,4,Lost
66231,929,17,28,2,3,2,7,Casual Users
66405,882,19,62,2,3,3,8,Casual Users
66648,583,10,25,2,2,2,6,Lost
66906,19,12,33,5,3,3,11,Loyal Users
66963,455,14,24,3,3,2,8,Loyal Users
67155,279,5,14,3,1,1,5,Casual Users
67339,292,6,20,3,1,2,6,Casual Users
67513,2564,9,14,1,2,1,4,Lost
67801,376,26,38,3,4,3,10,Loyal Users
67977,40,7,23,5,2,2,9,Promising
68079,8,8,55,5,2,3,10,Promising
68315,182,7,19,3,2,2,7,Casual Users
68657,310,7,7,3,2,1,6,Casual Users
68683,775,32,34,2,4,3,9,At Risk
68734,1801,78,186,1,5,5,11,At Risk
68753,1395,8,9,1,2,1,4,Lost
68818,621,13,25,2,3,2,7,Casual Users
69014,867,7,26,2,2,2,6,Lost
69287,0,27,81,5,4,4,13,Champions
69307,418,6,66,3,1,4,8,Casual Users
69540,27,91,130,5,5,4,14,Champions
69693,136,27,45,4,4,3,11,Loyal Users
69958,1,145,542,5,5,5,15,Champions
70039,345,16,25,3,3,2,8,Loyal Users
70581,503,7,13,2,2,1,5,Lost
71026,173,7,9,3,2,1,6,Casual Users
71123,575,7,7,2,2,1,5,Lost
71225,114,191,427,4,5,5,14,Champions
71246,79,131,591,4,5,5,14,Champions
71419,2953,7,110,1,2,4,7,Lost
71857,26,16,39,5,3,3,11,Loyal Users
71977,819,7,17,2,2,2,6,Lost
72038,265,39,188,3,4,5,12,Loyal Users
72386,2414,5,6,1,1,1,3,Lost
72815,1120,14,45,2,3,3,8,Casual Users
72989,570,6,7,2,1,1,4,Lost
73858,110,145,468,4,5,5,14,Champions
73953,166,13,42,3,3,3,9,Loyal Users
74199,2870,20,32,1,3,3,7,Casual Users
74217,7,43,66,5,4,4,13,Champions
74230,3864,6,16,1,1,2,4,Lost
74591,1168,20,25,2,3,2,7,Casual Users
74869,5029,8,8,1,2,1,4,Lost
74906,981,7,12,2,2,1,5,Lost
74915,124,76,91,4,5,4,13,Champions
75395,1567,7,35,1,2,3,6,Lost
75648,306,12,39,3,3,3,9,Loyal Users
75737,303,16,102,3,3,4,10,Loyal Users
75810,92,11,23,4,2,2,8,Promising
75944,81,67,304,4,5,5,14,Champions
76355,132,32,159,4,4,5,13,Champions
76402,1352,7,20,1,2,2,5,Lost
76582,1089,16,34,2,3,3,8,Casual Users
77421,108,10,16,4,2,2,8,Promising
77437,2733,5,11,1,1,1,3,Lost
77571,249,56,316,3,5,5,13,Loyal Users
77686,1001,5,7,2,1,1,4,Lost
65627,11,145,612,5,5,5,15,Champions
66085,398,15,34,3,3,3,9,Loyal Users
66519,1753,10,33,1,2,3,6,Lost
66912,268,40,67,3,4,4,11,Loyal Users
67322,57,40,328,5,4,5,14,Champions
67795,1423,43,97,1,4,4,9,At Risk
67866,2135,10,18,1,2,2,5,Lost
68088,140,14,108,4,3,4,11,Loyal Users
68503,4125,7,26,1,2,2,5,Lost
68793,153,25,50,4,4,3,11,Loyal Users
68924,121,52,70,4,5,4,13,Champions
69034,1,20,22,5,3,2,10,Loyal Users
69365,245,7,30,3,2,2,7,Casual Users
69645,456,17,31,3,3,2,8,Loyal Users
69862,0,7,12,5,2,1,8,Promising
70286,58,55,226,5,5,5,15,Champions
70411,111,38,199,4,4,5,13,Champions
70507,3424,7,14,1,2,1,4,Lost
70904,30,20,63,5,3,4,12,Loyal Users
71162,10,25,50,5,4,3,12,Loyal Users
71292,419,7,13,3,2,1,6,Casual Users
71542,4473,20,53,1,3,3,7,Casual Users
71743,120,14,17,4,3,2,9,Loyal Users
71922,2519,6,36,1,1,3,5,Lost
71975,79,22,58,4,4,3,11,Loyal Users
72023,3700,11,19,1,2,2,5,Lost
72322,13,70,186,5,5,5,15,Champions
72535,1079,12,17,2,3,2,7,Casual Users
72952,16,31,61,5,4,3,12,Loyal Users
73541,3767,7,19,1,2,2,5,Lost
73897,531,15,45,2,3,3,8,Casual Users
73948,56,10,62,5,2,3,10,Promising
74037,239,6,17,3,1,2,6,Casual Users
74137,54,81,194,5,5,5,15,Champions
74350,79,65,307,4,5,5,14,Champions
74654,77,53,142,4,5,4,13,Champions
74704,296,93,135,3,5,4,12,Loyal Users
75129,2411,5,13,1,1,1,3,Lost
75291,17,93,659,5,5,5,15,Champions
75598,1474,19,62,1,3,3,7,Casual Users
75616,1838,5,8,1,1,1,3,Lost
75683,160,86,419,4,5,5,14,Champions
75946,288,8,21,3,2,2,7,Casual Users
75993,125,56,123,4,5,4,13,Champions
76014,92,22,95,4,4,4,12,Champions
77001,1061,18,28,2,3,2,7,Casual Users
77021,8,20,46,5,3,3,11,Loyal Users
77031,401,13,25,3,3,2,8,Loyal Users
77628,1123,10,11,2,2,1,5,Lost
77869,300,18,42,3,3,3,9,Loyal Users
78186,3037,7,7,1,2,1,4,Lost
78221,4,14,34,5,3,3,11,Loyal Users
78237,735,6,42,2,1,3,6,Lost
65887,20,73,325,5,5,5,15,Champions
65981,186,17,124,3,3,4,10,Loyal Users
67124,7,23,44,5,4,3,12,Loyal Users
67180,399,7,12,3,2,1,6,Casual Users
67768,37,46,287,5,5,5,15,Champions
67995,129,68,182,4,5,5,14,Champions
68023,270,28,70,3,4,4,11,Loyal Users
68250,81,18,29,4,3,2,9,Loyal Users
69434,72,7,44,4,2,3,9,Promising
69436,389,20,56,3,3,3,9,Loyal Users
69597,340,18,26,3,3,2,8,Loyal Users
69908,218,20,35,3,3,3,9,Loyal Users
69933,451,8,41,3,2,3,8,Casual Users
70307,6,17,175,5,3,5,13,Loyal Users
70313,625,11,102,2,2,4,8,Lost
70487,5,194,478,5,5,5,15,Champions
70617,440,19,51,3,3,3,9,Loyal Users
71022,1684,5,36,1,1,3,5,Lost
71213,429,8,44,3,2,3,8,Casual Users
71238,3569,8,26,1,2,2,5,Lost
71261,146,9,20,4,2,2,8,Promising
71308,270,7,22,3,2,2,7,Casual Users
71635,102,25,41,4,4,3,11,Loyal Users
71718,446,13,55,3,3,3,9,Loyal Users
72031,132,23,50,4,4,3,11,Loyal Users
72951,265,40,80,3,4,4,11,Loyal Users
72964,994,18,20,2,3,2,7,Casual Users
73055,88,88,138,4,5,4,13,Champions
73078,54,14,60,5,3,3,11,Loyal Users
73092,79,57,165,4,5,5,14,Champions
73147,323,11,78,3,2,4,9,Casual Users
73216,38,10,20,5,2,2,9,Promising
73321,229,48,123,3,5,4,12,Loyal Users
73691,964,18,97,2,3,4,9,Casual Users
73717,2268,5,32,1,1,3,5,Lost
73753,708,12,23,2,3,2,7,Casual Users
73949,2025,8,9,1,2,1,4,Lost
74193,97,23,86,4,4,4,12,Champions
74480,133,12,53,4,3,3,10,Loyal Users
74996,582,23,78,2,4,4,10,At Risk
75022,143,17,97,4,3,4,11,Loyal Users
75255,3320,6,11,1,1,1,3,Lost
75272,568,7,12,2,2,1,5,Lost
75319,3273,34,45,1,4,3,8,At Risk
75330,1997,18,20,1,3,2,6,Casual Users
75366,405,5,7,3,1,1,5,Casual Users
75450,1050,18,42,2,3,3,8,Casual Users
75538,3130,7,22,1,2,2,5,Lost
75615,6,27,87,5,4,4,13,Champions
75747,444,18,45,3,3,3,9,Loyal Users
75758,118,9,10,4,2,1,7,Promising
76081,83,10,15,4,2,1,7,Promising
76257,4,39,260,5,4,5,14,Champions
76583,4727,28,176,1,4,5,10,At Risk
76600,1754,45,93,1,4,4,9,At Risk
77018,178,95,163,3,5,5,13,Loyal Users
77203,464,15,40,3,3,3,9,Loyal Users
77246,109,18,75,4,3,4,11,Loyal Users
77295,27,65,99,5,5,4,14,Champions
77484,3254,14,21,1,3,2,6,Casual Users
77516,36,27,42,5,4,3,12,Loyal Users
77676,125,25,96,4,4,4,12,Champions
77879,5,26,99,5,4,4,13,Champions
78122,222,27,74,3,4,4,11,Loyal Users
65626,18,212,672,5,5,5,15,Champions
65692,3400,5,10,1,1,1,3,Lost
65871,1287,10,32,1,2,3,6,Lost
66054,273,65,569,3,5,5,13,Loyal Users
66074,406,101,131,3,5,4,12,Loyal Users
66190,1287,5,5,1,1,1,3,Lost
66659,49,64,283,5,5,5,15,Champions
66924,110,21,52,4,3,3,10,Loyal Users
67053,72,31,158,4,4,5,13,Champions
67083,157,12,46,4,3,3,10,Loyal Users
67241,428,31,54,3,4,3,10,Loyal Users
67708,698,9,13,2,2,1,5,Lost
67901,51,65,146,5,5,4,14,Champions
67940,1112,40,76,2,4,4,10,At Risk
68254,420,13,111,3,3,4,10,Loyal Users
68622,94,76,106,4,5,4,13,Champions
68896,3896,7,9,1,2,1,4,Lost
69200,90,10,25,4,2,2,8,Promising
69229,334,6,13,3,1,1,5,Casual Users
69672,606,7,11,2,2,1,5,Lost
69885,459,9,28,3,2,2,7,Casual Users
69939,139,20,22,4,3,2,9,Loyal Users
70079,127,6,41,4,1,3,8,Promising
70740,4,156,381,5,5,5,15,Champions
70940,0,69,122,5,5,4,14,Champions
71303,2,14,62,5,3,3,11,Loyal Users
71456,0,19,31,5,3,2,10,Loyal Users
71647,111,13,77,4,3,4,11,Loyal Users
71788,2796,10,23,1,2,2,5,Lost
72020,1415,28,184,1,4,5,10,At Risk
72463,170,145,219,3,5,5,13,Loyal Users
72554,275,82,569,3,5,5,13,Loyal Users
72617,592,14,21,2,3,2,7,Casual Users
72757,405,15,119,3,3,4,10,Loyal Users
72798,3470,8,25,1,2,2,5,Lost
72801,396,5,7,3,1,1,5,Casual Users
72900,845,11,81,2,2,4,8,Lost
72965,846,8,32,2,2,3,7,Lost
73447,1382,10,59,1,2,3,6,Lost
73515,126,8,36,4,2,3,9,Promising
73628,1710,9,44,1,2,3,6,Lost
73764,1120,7,24,2,2,2,6,Lost
73774,3740,5,5,1,1,1,3,Lost
73775,4091,10,17,1,2,2,5,Lost
73925,4475,5,6,1,1,1,3,Lost
73938,120,12,33,4,3,3,10,Loyal Users
74236,574,13,33,2,3,3,8,Casual Users
74356,140,84,431,4,5,5,14,Champions
74832,354,42,79,3,4,4,11,Loyal Users
75094,841,9,13,2,2,1,5,Lost
75098,159,15,16,4,3,2,9,Loyal Users
75671,20,28,122,5,4,4,13,Champions
75711,103,91,156,4,5,5,14,Champions
75764,1118,49,319,2,5,5,12,At Risk
76025,2673,6,25,1,1,2,4,Lost
76166,1861,16,28,1,3,2,6,Casual Users
76612,1691,6,14,1,1,1,3,Lost
76877,1287,8,38,1,2,3,6,Lost
77054,3880,5,7,1,1,1,3,Lost
77134,33,36,54,5,4,3,12,Loyal Users
77190,1257,30,181,2,4,5,11,At Risk
77326,1971,17,62,1,3,3,7,Casual Users
77381,822,15,22,2,3,2,7,Casual Users
77415,794,9,50,2,2,3,7,Lost
77625,964,5,23,2,1,2,5,Lost
77799,127,14,110,4,3,4,11,Loyal Users
78075,2556,16,58,1,3,3,7,Casual Users
78133,232,39,198,3,4,5,12,Loyal Users
65579,294,135,262,3,5,5,13,Loyal Users
66006,273,26,85,3,4,4,11,Loyal Users
66158,566,7,13,2,2,1,5,Lost
66379,1082,5,25,2,1,2,5,Lost
66666,419,9,46,3,2,3,8,Casual Users
66694,446,11,24,3,2,2,7,Casual Users
67186,291,59,79,3,5,4,12,Loyal Users
67442,1083,9,13,2,2,1,5,Lost
67449,26,15,47,5,3,3,11,Loyal Users
67541,5,13,49,5,3,3,11,Loyal Users
68148,52,6,9,5,1,1,7,Promising
68352,181,24,112,3,4,4,11,Loyal Users
68373,531,10,18,2,2,2,6,Lost
68767,418,52,258,3,5,5,13,Loyal Users
68880,121,7,8,4,2,1,7,Promising
69324,943,13,25,2,3,2,7,Casual Users
69487,46,25,96,5,4,4,13,Champions
69799,0,47,113,5,5,4,14,Champions
69950,7,14,25,5,3,2,10,Loyal Users
69967,305,17,29,3,3,2,8,Loyal Users
70035,1432,48,113,1,5,4,10,At Risk
70068,227,65,273,3,5,5,13,Loyal Users
70142,204,92,204,3,5,5,13,Loyal Users
70174,147,96,175,4,5,5,14,Champions
70329,406,15,140,3,3,4,10,Loyal Users
70461,235,21,68,3,3,4,10,Loyal Users
70481,133,36,173,4,4,5,13,Champions
70699,522,20,33,2,3,3,8,Casual Users
70701,159,23,39,4,4,3,11,Loyal Users
70761,327,28,169,3,4,5,12,Loyal Users
71889,1643,13,62,1,3,3,7,Casual Users
71958,16,7,17,5,2,2,9,Promising
72048,279,9,17,3,2,2,7,Casual Users
72447,109,29,80,4,4,4,12,Champions
72479,803,6,13,2,1,1,4,Lost
73323,289,152,348,3,5,5,13,Loyal Users
73331,5576,14,26,1,3,2,6,Casual Users
73430,1421,10,44,1,2,3,6,Lost
73526,5,52,94,5,5,4,14,Champions
73607,165,59,214,4,5,5,14,Champions
73632,2004,6,24,1,1,2,4,Lost
73697,163,22,39,4,4,3,11,Loyal Users
73843,4619,8,29,1,2,2,5,Lost
73912,1867,6,7,1,1,1,3,Lost
74055,8,40,51,5,4,3,12,Loyal Users
74360,184,23,104,3,4,4,11,Loyal Users
74463,3,83,391,5,5,5,15,Champions
74794,3706,10,37,1,2,3,6,Lost
74888,544,5,18,2,1,2,5,Lost
75048,73,48,237,4,5,5,14,Champions
75116,23,66,139,5,5,4,14,Champions
75293,38,57,85,5,5,4,14,Champions
75374,357,59,243,3,5,5,13,Loyal Users
75440,386,6,11,3,1,1,5,Casual Users
75634,137,32,101,4,4,4,12,Champions
75921,198,22,46,3,4,3,10,Loyal Users
76801,11,45,88,5,4,4,13,Champions
76865,382,28,55,3,4,3,10,Loyal Users
77146,191,25,118,3,4,4,11,Loyal Users
77174,27,175,878,5,5,5,15,Champions
77213,153,43,70,4,4,4,12,Champions
77464,3440,8,27,1,2,2,5,Lost
77762,18,11,26,5,2,2,9,Promising
77807,148,6,8,4,1,1,6,Promising
77840,159,38,143,4,4,4,12,Champions
77948,20,13,25,5,3,2,10,Loyal Users
78247,151,29,105,4,4,4,12,Champions
65536,101,21,92,4,3,4,11,Loyal Users
65752,1522,22,96,1,4,4,9,At Risk
65776,1592,5,22,1,1,2,4,Lost
65927,642,9,12,2,2,1,5,Lost
66212,395,6,9,3,1,1,5,Casual Users
66313,127,164,233,4,5,5,14,Champions
66365,2968,6,26,1,1,2,4,Lost
66635,544,22,166,2,4,5,11,At Risk
66916,90,9,41,4,2,3,9,Promising
66918,107,127,849,4,5,5,14,Champions
66935,1644,12,21,1,3,2,6,Casual Users
67077,52,12,17,5,3,2,10,Loyal Users
67099,424,11,18,3,2,2,7,Casual Users
67174,306,5,7,3,1,1,5,Casual Users
67218,1434,17,31,1,3,2,6,Casual Users
67233,332,28,47,3,4,3,10,Loyal Users
67364,840,13,34,2,3,3,8,Casual Users
67434,24,103,527,5,5,5,15,Champions
67772,1550,19,27,1,3,2,6,Casual Users
67780,1016,13,22,2,3,2,7,Casual Users
68035,1543,21,39,1,3,3,7,Casual Users
68275,126,9,32,4,2,3,9,Promising
68389,2,37,109,5,4,4,13,Champions
68478,116,32,61,4,4,3,11,Loyal Users
68522,7,16,30,5,3,2,10,Loyal Users
68549,584,11,22,2,2,2,6,Lost
68673,44,92,142,5,5,4,14,Champions
68681,104,24,77,4,4,4,12,Champions
68713,96,22,111,4,4,4,12,Champions
68937,1448,5,7,1,1,1,3,Lost
68950,4621,6,8,1,1,1,3,Lost
69008,130,74,346,4,5,5,14,Champions
69118,572,7,7,2,2,1,5,Lost
69507,442,18,23,3,3,2,8,Loyal Users
69613,443,13,47,3,3,3,9,Loyal Users
69767,4552,6,8,1,1,1,3,Lost
70187,1425,6,10,1,1,1,3,Lost
70261,1715,35,49,1,4,3,8,At Risk
70454,2400,5,6,1,1,1,3,Lost
70599,466,26,91,3,4,4,11,Loyal Users
70683,282,32,108,3,4,4,11,Loyal Users
70994,1059,10,23,2,2,2,6,Lost
71005,4355,25,77,1,4,4,9,At Risk
71008,126,59,115,4,5,4,13,Champions
71088,84,136,610,4,5,5,14,Champions
71378,240,65,234,3,5,5,13,Loyal Users
71634,2,96,406,5,5,5,15,Champions
71712,973,36,215,2,4,5,11,At Risk
71833,231,7,11,3,2,1,6,Casual Users
72685,2932,33,185,1,4,5,10,At Risk
72699,20,127,371,5,5,5,15,Champions
73039,840,40,188,2,4,5,11,At Risk
73223,1138,5,20,2,1,2,5,Lost
73381,130,6,10,4,1,1,6,Promising
73402,31,41,91,5,4,4,13,Champions
73493,89,71,185,4,5,5,14,Champions
73536,208,12,33,3,3,3,9,Loyal Users
73673,131,27,124,4,4,4,12,Champions
74104,406,11,22,3,2,2,7,Casual Users
74229,1744,5,15,1,1,1,3,Lost
74286,79,15,42,4,3,3,10,Loyal Users
74373,4416,5,11,1,1,1,3,Lost
74433,511,17,35,2,3,3,8,Casual Users
74734,27,56,123,5,5,4,14,Champions
74781,261,9,18,3,2,2,7,Casual Users
74893,84,134,281,4,5,5,14,Champions
74914,3728,7,12,1,2,1,4,Lost
75147,294,19,144,3,3,4,10,Loyal Users
75248,159,13,24,4,3,2,9,Loyal Users
75522,231,7,59,3,2,3,8,Casual Users
75631,500,13,20,2,3,2,7,Casual Users
75646,188,29,58,3,4,3,10,Loyal Users
75681,0,48,313,5,5,5,15,Champions
75851,51,24,41,5,4,3,12,Loyal Users
76098,289,6,12,3,1,1,5,Casual Users
76303,3728,6,8,1,1,1,3,Lost
76413,4412,5,9,1,1,1,3,Lost
76698,1230,9,57,2,2,3,7,Lost
76769,2278,5,7,1,1,1,3,Lost
77061,4,87,177,5,5,5,15,Champions
77126,136,14,31,4,3,2,9,Loyal Users
77154,651,7,21,2,2,2,6,Lost
77243,2987,5,9,1,1,1,3,Lost
77442,293,29,40,3,4,3,10,Loyal Users
77480,82,9,14,4,2,1,7,Promising
77621,426,5,6,3,1,1,5,Casual Users
77863,144,171,802,4,5,5,14,Champions
77902,679,13,27,2,3,2,7,Casual Users
77974,31,30,132,5,4,4,13,Champions
78162,160,101,482,4,5,5,14,Champions
78270,1077,35,55,2,4,3,9,At Risk
65636,624,65,111,2,5,4,11,At Risk
65777,425,41,246,3,4,5,12,Loyal Users
65778,2350,10,14,1,2,1,4,Lost
66250,209,69,259,3,5,5,13,Loyal Users
66421,6,11,15,5,2,1,8,Promising
66901,2371,5,10,1,1,1,3,Lost
67028,406,11,19,3,2,2,7,Casual Users
67146,368,7,33,3,2,3,8,Casual Users
67304,2877,9,12,1,2,1,4,Lost
67313,245,22,49,3,4,3,10,Loyal Users
67515,239,33,75,3,4,4,11,Loyal Users
67575,16,9,47,5,2,3,10,Promising
67765,1796,7,40,1,2,3,6,Lost
68314,284,26,33,3,4,3,10,Loyal Users
68419,65,51,116,5,5,4,14,Champions
68557,736,6,36,2,1,3,6,Lost
68633,121,26,49,4,4,3,11,Loyal Users
68909,0,26,84,5,4,4,13,Champions
68912,109,8,18,4,2,2,8,Promising
69183,43,68,392,5,5,5,15,Champions
69211,1091,17,27,2,3,2,7,Casual Users
69250,665,12,29,2,3,2,7,Casual Users
69336,735,14,72,2,3,4,9,Casual Users
69379,159,73,171,4,5,5,14,Champions
69753,713,11,24,2,2,2,6,Lost
69839,1460,11,36,1,2,3,6,Lost
70001,164,43,120,4,4,4,12,Champions
70988,153,23,51,4,4,3,11,Loyal Users
71052,874,12,16,2,3,2,7,Casual Users
71082,842,14,18,2,3,2,7,Casual Users
71251,1829,8,15,1,2,1,4,Lost
71679,830,11,46,2,2,3,7,Lost
72061,1976,6,9,1,1,1,3,Lost
72367,78,9,12,4,2,1,7,Promising
72518,344,17,22,3,3,2,8,Loyal Users
72534,1649,39,129,1,4,4,9,At Risk
72710,98,12,22,4,3,2,9,Loyal Users
72799,2998,5,9,1,1,1,3,Lost
73369,4873,6,10,1,1,1,3,Lost
73542,2089,37,82,1,4,4,9,At Risk
73586,1719,5,14,1,1,1,3,Lost
73666,5,90,626,5,5,5,15,Champions
73763,93,5,5,4,1,1,6,Promising
73769,1673,5,9,1,1,1,3,Lost
73824,3265,5,19,1,1,2,4,Lost
73835,2550,9,17,1,2,2,5,Lost
73853,12,52,61,5,5,3,13,Loyal Users
73875,4881,16,20,1,3,2,6,Casual Users
73909,2133,10,13,1,2,1,4,Lost
74004,1290,6,9,1,1,1,3,Lost
74019,164,25,99,4,4,4,12,Champions
74197,1998,9,59,1,2,3,6,Lost
74728,3251,27,45,1,4,3,8,At Risk
74905,759,17,36,2,3,3,8,Casual Users
75306,4098,8,23,1,2,2,5,Lost
75418,1410,12,71,1,3,4,8,Casual Users
75534,140,26,62,4,4,3,11,Loyal Users
75720,108,25,56,4,4,3,11,Loyal Users
76046,95,34,56,4,4,3,11,Loyal Users
76065,98,82,420,4,5,5,14,Champions
76201,987,9,10,2,2,1,5,Lost
76324,6,67,347,5,5,5,15,Champions
76382,395,30,42,3,4,3,10,Loyal Users
76533,121,37,59,4,4,3,11,Loyal Users
76705,7,16,138,5,3,4,12,Loyal Users
76876,1439,15,44,1,3,3,7,Casual Users
76906,347,5,24,3,1,2,6,Casual Users
76994,15,17,25,5,3,2,10,Loyal Users
77082,796,9,40,2,2,3,7,Lost
77111,270,6,61,3,1,3,7,Casual Users
77216,2693,22,45,1,4,3,8,At Risk
77303,2104,5,30,1,1,2,4,Lost
77372,230,47,65,3,5,4,12,Loyal Users
77505,460,43,62,3,4,3,10,Loyal Users
77542,3153,5,8,1,1,1,3,Lost
77854,207,35,50,3,4,3,10,Loyal Users
78148,224,171,288,3,5,5,13,Loyal Users
78177,66,37,109,5,4,4,13,Champions
78214,2462,34,125,1,4,4,9,At Risk
78273,149,27,57,4,4,3,11,Loyal Users
65797,1057,7,9,2,2,1,5,Lost
65810,3132,22,54,1,4,3,8,At Risk
65848,1625,10,18,1,2,2,5,Lost
65957,139,39,140,4,4,4,12,Champions
66291,45,12,33,5,3,3,11,Loyal Users
66434,108,88,218,4,5,5,14,Champions
66552,2947,6,9,1,1,1,3,Lost
66646,566,11,17,2,2,2,6,Lost
66747,4840,7,9,1,2,1,4,Lost
66944,153,63,79,4,5,4,13,Champions
67219,1537,6,7,1,1,1,3,Lost
67722,253,6,23,3,1,2,6,Casual Users
68049,1023,19,24,2,3,2,7,Casual Users
68239,821,21,24,2,3,2,7,Casual Users
68591,79,12,48,4,3,3,10,Loyal Users
68706,32,52,98,5,5,4,14,Champions
68842,86,12,17,4,3,2,9,Loyal Users
69041,2291,13,43,1,3,3,7,Casual Users
69045,357,30,100,3,4,4,11,Loyal Users
69091,1424,9,20,1,2,2,5,Lost
69224,25,5,14,5,1,1,7,Promising
69369,232,49,105,3,5,4,12,Loyal Users
69803,1257,11,41,2,2,3,7,Lost
70130,408,9,51,3,2,3,8,Casual Users
70661,162,6,6,4,1,1,6,Promising
70925,30,94,274,5,5,5,15,Champions
71470,4203,7,42,1,2,3,6,Lost
71805,10,37,96,5,4,4,13,Champions
72005,121,47,175,4,5,5,14,Champions
72992,415,43,96,3,4,4,11,Loyal Users
73455,818,20,38,2,3,3,8,Casual Users
73639,323,12,41,3,3,3,9,Loyal Users
73988,19,25,67,5,4,4,13,Champions
74050,191,13,107,3,3,4,10,Loyal Users
74053,17,106,222,5,5,5,15,Champions
74129,46,169,375,5,5,5,15,Champions
74851,434,10,108,3,2,4,9,Casual Users
75011,972,12,19,2,3,2,7,Casual Users
75167,2873,6,12,1,1,1,3,Lost
75204,138,30,111,4,4,4,12,Champions
75260,3489,5,5,1,1,1,3,Lost
75638,2043,13,22,1,3,2,6,Casual Users
75697,688,8,16,2,2,2,6,Lost
75866,18,15,43,5,3,3,11,Loyal Users
76354,1142,8,37,2,2,3,7,Lost
76790,1573,12,102,1,3,4,8,Casual Users
77188,736,14,30,2,3,2,7,Casual Users
77312,12,13,29,5,3,2,10,Loyal Users
77629,1003,71,163,2,5,5,12,At Risk
78251,127,12,18,4,3,2,9,Loyal Users
65476,79,7,19,4,2,2,8,Promising
66012,5861,6,13,1,1,1,3,Lost
66096,20,6,40,5,1,3,9,Promising
66105,55,30,137,5,4,4,13,Champions
66181,32,104,304,5,5,5,15,Champions
66292,17,156,199,5,5,5,15,Champions
66422,1857,6,26,1,1,2,4,Lost
66425,168,25,69,3,4,4,11,Loyal Users
66520,107,102,570,4,5,5,14,Champions
66674,834,7,28,2,2,2,6,Lost
67399,967,6,11,2,1,1,4,Lost
67760,794,14,48,2,3,3,8,Casual Users
67916,873,17,27,2,3,2,7,Casual Users
67917,31,27,42,5,4,3,12,Loyal Users
68051,219,28,45,3,4,3,10,Loyal Users
68121,3776,5,33,1,1,3,5,Lost
68321,5,154,586,5,5,5,15,Champions
68342,111,32,49,4,4,3,11,Loyal Users
68350,97,162,273,4,5,5,14,Champions
68535,139,20,22,4,3,2,9,Loyal Users
68621,118,26,93,4,4,4,12,Champions
68685,84,75,602,4,5,5,14,Champions
68755,142,12,41,4,3,3,10,Loyal Users
68967,158,46,196,4,5,5,14,Champions
69002,91,8,34,4,2,3,9,Promising
69028,1575,24,49,1,4,3,8,At Risk
69104,633,22,33,2,4,3,9,At Risk
69989,89,12,58,4,3,3,10,Loyal Users
70334,268,26,45,3,4,3,10,Loyal Users
70413,32,13,22,5,3,2,10,Loyal Users
71112,1413,5,56,1,1,3,5,Lost
71160,541,70,281,2,5,5,12,At Risk
71319,227,8,30,3,2,2,7,Casual Users
71406,645,25,47,2,4,3,9,At Risk
71897,814,8,17,2,2,2,6,Lost
72128,51,95,869,5,5,5,15,Champions
72375,23,19,33,5,3,3,11,Loyal Users
72572,713,23,73,2,4,4,10,At Risk
72691,11,5,5,5,1,1,7,Promising
72832,148,38,80,4,4,4,12,Champions
72835,379,10,31,3,2,2,7,Casual Users
73348,75,79,380,4,5,5,14,Champions
73355,3,115,349,5,5,5,15,Champions
73552,929,13,38,2,3,3,8,Casual Users
74204,1770,15,85,1,3,4,8,Casual Users
74842,2444,8,12,1,2,1,4,Lost
74902,417,8,10,3,2,1,6,Casual Users
75193,131,12,71,4,3,4,11,Loyal Users
75325,286,8,12,3,2,1,6,Casual Users
75658,687,34,127,2,4,4,10,At Risk
76449,1127,5,12,2,1,1,4,Lost
76523,510,24,76,2,4,4,10,At Risk
76649,67,81,292,5,5,5,15,Champions
76931,256,8,8,3,2,1,6,Casual Users
76947,91,47,100,4,5,4,13,Champions
77287,11,18,64,5,3,4,12,Loyal Users
77836,372,31,70,3,4,4,11,Loyal Users
77908,106,128,297,4,5,5,14,Champions
77938,2975,5,10,1,1,1,3,Lost
77946,2,65,126,5,5,4,14,Champions
65442,3427,6,24,1,1,2,4,Lost
65745,96,98,223,4,5,5,14,Champions
66163,96,73,230,4,5,5,14,Champions
66191,383,7,35,3,2,3,8,Casual Users
66447,372,8,12,3,2,1,6,Casual Users
66516,3140,5,5,1,1,1,3,Lost
66815,122,8,11,4,2,1,7,Promising
66817,460,6,48,3,1,3,7,Casual Users
67164,687,32,131,2,4,4,10,At Risk
67649,291,13,41,3,3,3,9,Loyal Users
67824,101,7,58,4,2,3,9,Promising
67853,110,26,51,4,4,3,11,Loyal Users
68040,0,29,81,5,4,4,13,Champions
68237,832,5,18,2,1,2,5,Lost
68324,1576,5,8,1,1,1,3,Lost
68423,1432,5,27,1,1,2,4,Lost
68498,413,19,85,3,3,4,10,Loyal Users
68555,4529,5,17,1,1,2,4,Lost
68732,34,56,85,5,5,4,14,Champions
68779,69,68,265,5,5,5,15,Champions
68823,3447,14,16,1,3,2,6,Casual Users
68828,16,21,127,5,3,4,12,Loyal Users
68839,199,10,19,3,2,2,7,Casual Users
69136,69,50,340,5,5,5,15,Champions
69476,148,75,273,4,5,5,14,Champions
69488,43,7,11,5,2,1,8,Promising
69669,3299,7,30,1,2,2,5,Lost
69711,1877,8,8,1,2,1,4,Lost
69742,623,14,54,2,3,3,8,Casual Users
69830,822,6,31,2,1,2,5,Lost
69872,596,67,185,2,5,5,12,At Risk
69927,105,39,136,4,4,4,12,Champions
69931,115,29,63,4,4,4,12,Champions
70016,422,13,16,3,3,2,8,Loyal Users
70215,1514,11,32,1,2,3,6,Lost
71048,224,15,64,3,3,4,10,Loyal Users
71128,161,84,185,4,5,5,14,Champions
71241,691,10,14,2,2,1,5,Lost
71767,1,93,495,5,5,5,15,Champions
71809,59,73,248,5,5,5,15,Champions
71817,1,123,488,5,5,5,15,Champions
72202,3436,58,161,1,5,5,11,At Risk
72887,88,28,32,4,4,3,11,Loyal Users
73150,935,20,31,2,3,2,7,Casual Users
73159,484,27,70,2,4,4,10,At Risk
73368,2185,7,29,1,2,2,5,Lost
73567,908,13,46,2,3,3,8,Casual Users
73573,142,52,375,4,5,5,14,Champions
73615,584,9,26,2,2,2,6,Lost
73863,59,10,22,5,2,2,9,Promising
73873,15,14,113,5,3,4,12,Loyal Users
74798,688,22,90,2,4,4,10,At Risk
74897,619,5,6,2,1,1,4,Lost
75117,23,29,116,5,4,4,13,Champions
75225,10,116,367,5,5,5,15,Champions
75232,277,6,7,3,1,1,5,Casual Users
76439,9,25,164,5,4,5,14,Champions
76545,2059,13,18,1,3,2,6,Casual Users
76961,465,28,143,3,4,4,11,Loyal Users
77025,3547,8,13,1,2,1,4,Lost
77094,326,44,265,3,4,5,12,Loyal Users
77149,375,9,9,3,2,1,6,Casual Users
77340,13,106,674,5,5,5,15,Champions
77617,616,94,192,2,5,5,12,At Risk
77657,139,40,45,4,4,3,11,Loyal Users
77959,72,7,24,4,2,2,8,Promising
77965,136,66,151,4,5,5,14,Champions
78169,121,94,140,4,5,4,13,Champions
66750,2736,9,12,1,2,1,4,Lost
67022,102,121,173,4,5,5,14,Champions
67144,165,20,36,4,3,3,10,Loyal Users
67265,133,13,28,4,3,2,9,Loyal Users
67312,651,9,9,2,2,1,5,Lost
67329,12,69,214,5,5,5,15,Champions
67875,104,68,314,4,5,5,14,Champions
68028,843,13,57,2,3,3,8,Casual Users
68282,270,13,47,3,3,3,9,Loyal Users
68292,1392,5,22,1,1,2,4,Lost
68709,3427,5,5,1,1,1,3,Lost
69789,73,145,259,4,5,5,14,Champions
69860,3,13,20,5,3,2,10,Loyal Users
70012,1851,7,9,1,2,1,4,Lost
70103,188,5,5,3,1,1,5,Casual Users
70643,1312,19,83,1,3,4,8,Casual Users
70782,2970,10,19,1,2,2,5,Lost
70817,71,45,295,4,4,5,13,Champions
70832,1143,15,32,2,3,3,8,Casual Users
70886,190,9,13,3,2,1,6,Casual Users
71155,1526,6,28,1,1,2,4,Lost
71252,5,54,76,5,5,4,14,Champions
71730,2527,12,58,1,3,3,7,Casual Users
71836,514,6,10,2,1,1,4,Lost
72192,137,78,202,4,5,5,14,Champions
72259,106,21,109,4,3,4,11,Loyal Users
72300,126,21,32,4,3,3,10,Loyal Users
72890,57,11,37,5,2,3,10,Promising
73664,22,115,198,5,5,5,15,Champions
73730,110,115,214,4,5,5,14,Champions
73855,181,17,21,3,3,2,8,Loyal Users
74299,741,5,5,2,1,1,4,Lost
74379,419,28,54,3,4,3,10,Loyal Users
74445,834,14,53,2,3,3,8,Casual Users
74503,81,17,72,4,3,4,11,Loyal Users
74583,276,23,45,3,4,3,10,Loyal Users
74748,405,15,146,3,3,4,10,Loyal Users
74834,42,90,445,5,5,5,15,Champions
75200,17,18,43,5,3,3,11,Loyal Users
75371,3334,7,12,1,2,1,4,Lost
75379,311,5,23,3,1,2,6,Casual Users
75445,793,5,20,2,1,2,5,Lost
75558,1328,30,150,1,4,5,10,At Risk
75625,290,11,16,3,2,2,7,Casual Users
75653,33,11,16,5,2,2,9,Promising
76135,92,10,22,4,2,2,8,Promising
76289,1125,11,15,2,2,1,5,Lost
76644,1561,6,9,1,1,1,3,Lost
76909,282,30,46,3,4,3,10,Loyal Users
77083,280,9,34,3,2,3,8,Casual Users
77162,102,100,444,4,5,5,14,Champions
77332,129,48,68,4,5,4,13,Champions
77769,266,10,23,3,2,2,7,Casual Users
65571,590,12,23,2,3,2,7,Casual Users
66323,0,12,22,5,3,2,10,Loyal Users
66333,0,56,230,5,5,5,15,Champions
66713,23,26,231,5,4,5,14,Champions
66882,3707,5,31,1,1,2,4,Lost
66971,3093,26,66,1,4,4,9,At Risk
66986,158,7,14,4,2,1,7,Promising
67227,128,247,386,4,5,5,14,Champions
67251,437,7,14,3,2,1,6,Casual Users
67274,2128,6,7,1,1,1,3,Lost
67503,94,47,89,4,5,4,13,Champions
67699,44,84,215,5,5,5,15,Champions
67732,1007,28,95,2,4,4,10,At Risk
67744,2273,12,69,1,3,4,8,Casual Users
67868,74,8,16,4,2,2,8,Promising
68171,151,26,50,4,4,3,11,Loyal Users
68871,270,40,63,3,4,4,11,Loyal Users
69142,2299,5,27,1,1,2,4,Lost
69294,64,65,254,5,5,5,15,Champions
69310,810,26,30,2,4,2,8,At Risk
69718,26,29,100,5,4,4,13,Champions
69757,1842,6,9,1,1,1,3,Lost
69978,34,31,50,5,4,3,12,Loyal Users
70085,691,8,10,2,2,1,5,Lost
70547,1725,14,23,1,3,2,6,Casual Users
70692,112,21,35,4,3,3,10,Loyal Users
70697,546,9,24,2,2,2,6,Lost
71116,4773,6,6,1,1,1,3,Lost
71197,275,23,47,3,4,3,10,Loyal Users
71254,137,59,315,4,5,5,14,Champions
71290,860,8,23,2,2,2,6,Lost
71590,801,5,28,2,1,2,5,Lost
71643,212,9,34,3,2,3,8,Casual Users
71678,1563,11,13,1,2,1,4,Lost
71734,129,134,367,4,5,5,14,Champions
71903,222,65,107,3,5,4,12,Loyal Users
72022,3059,7,30,1,2,2,5,Lost
72472,358,5,28,3,1,2,6,Casual Users
72504,266,11,13,3,2,1,6,Casual Users
72717,1536,8,21,1,2,2,5,Lost
72781,15,14,59,5,3,3,11,Loyal Users
73046,4,47,130,5,5,4,14,Champions
73233,1125,7,93,2,2,4,8,Lost
73539,6,45,468,5,4,5,14,Champions
73657,180,39,90,3,4,4,11,Loyal Users
73723,101,15,23,4,3,2,9,Loyal Users
73864,137,16,27,4,3,2,9,Loyal Users
73888,282,97,244,3,5,5,13,Loyal Users
74813,3159,15,109,1,3,4,8,Casual Users
75647,58,45,214,5,4,5,14,Champions
75726,126,5,9,4,1,1,6,Promising
75914,85,70,140,4,5,4,13,Champions
75965,119,34,102,4,4,4,12,Champions
76071,3713,5,15,1,1,1,3,Lost
76252,17,68,113,5,5,4,14,Champions
76254,78,73,508,4,5,5,14,Champions
76299,425,12,88,3,3,4,10,Loyal Users
76350,167,22,57,3,4,3,10,Loyal Users
76386,143,11,57,4,2,3,9,Promising
76847,30,57,260,5,5,5,15,Champions
76854,2552,5,8,1,1,1,3,Lost
77024,9,102,295,5,5,5,15,Champions
77027,216,69,510,3,5,5,13,Loyal Users
77366,2396,25,25,1,4,2,7,At Risk
77584,420,31,121,3,4,4,11,Loyal Users
77736,1732,8,45,1,2,3,6,Lost
77774,170,31,217,3,4,5,12,Loyal Users
77890,1122,81,155,2,5,5,12,At Risk
78119,1692,9,12,1,2,1,4,Lost
78179,46,129,200,5,5,5,15,Champions
65790,52,25,41,5,4,3,12,Loyal Users
66028,68,139,527,5,5,5,15,Champions
66035,2494,9,10,1,2,1,4,Lost
66148,133,44,60,4,4,3,11,Loyal Users
66316,9,82,176,5,5,5,15,Champions
66619,81,165,524,4,5,5,14,Champions
66943,128,18,70,4,3,4,11,Loyal Users
66984,822,75,150,2,5,5,12,At Risk
67323,959,21,31,2,3,2,7,Casual Users
67807,33,10,25,5,2,2,9,Promising
67876,412,13,22,3,3,2,8,Loyal Users
68053,317,16,86,3,3,4,10,Loyal Users
68144,48,52,259,5,5,5,15,Champions
68211,897,8,8,2,2,1,5,Lost
68484,30,9,35,5,2,3,10,Promising
68601,418,9,39,3,2,3,8,Casual Users
69075,671,8,14,2,2,1,5,Lost
69127,4751,6,8,1,1,1,3,Lost
69161,109,62,182,4,5,5,14,Champions
69350,2947,11,34,1,2,3,6,Lost
69497,3,32,159,5,4,5,14,Champions
69943,7,70,260,5,5,5,15,Champions
69954,3147,13,19,1,3,2,6,Casual Users
69972,1253,17,50,2,3,3,8,Casual Users
70192,105,44,93,4,4,4,12,Champions
70373,132,60,131,4,5,4,13,Champions
70383,273,10,50,3,2,3,8,Casual Users
70656,381,22,66,3,4,4,11,Loyal Users
70981,2696,7,34,1,2,3,6,Lost
71087,4,41,190,5,4,5,14,Champions
71296,1828,19,93,1,3,4,8,Casual Users
71421,11,26,124,5,4,4,13,Champions
71493,824,15,29,2,3,2,7,Casual Users
71568,542,6,8,2,1,1,4,Lost
71611,1414,5,10,1,1,1,3,Lost
71622,52,52,78,5,5,4,14,Champions
71877,439,33,64,3,4,4,11,Loyal Users
72041,399,7,25,3,2,2,7,Casual Users
72294,2078,8,32,1,2,3,6,Lost
72413,559,54,177,2,5,5,12,At Risk
72666,299,6,38,3,1,3,7,Casual Users
72979,859,7,13,2,2,1,5,Lost
73549,3076,10,63,1,2,4,7,Lost
74215,1258,8,61,1,2,3,6,Lost
74564,880,16,65,2,3,4,9,Casual Users
75041,380,8,27,3,2,2,7,Casual Users
75338,133,8,28,4,2,2,8,Promising
75706,272,29,76,3,4,4,11,Loyal Users
75801,151,15,141,4,3,4,11,Loyal Users
75953,76,21,94,4,3,4,11,Loyal Users
76220,140,125,298,4,5,5,14,Champions
76511,4591,11,70,1,2,4,7,Lost
76666,15,88,208,5,5,5,15,Champions
76780,388,31,56,3,4,3,10,Loyal Users
77138,1425,10,15,1,2,1,4,Lost
77148,4957,12,59,1,3,3,7,Casual Users
77482,2424,7,12,1,2,1,4,Lost
77525,12,149,524,5,5,5,15,Champions
77635,2802,7,8,1,2,1,4,Lost
77800,129,150,507,4,5,5,14,Champions
77921,85,77,371,4,5,5,14,Champions
77957,5021,20,50,1,3,3,7,Casual Users
78050,143,14,51,4,3,3,10,Loyal Users
78059,440,13,31,3,3,2,8,Loyal Users
65556,3525,6,20,1,1,2,4,Lost
65923,1574,34,60,1,4,3,8,At Risk
66284,146,115,341,4,5,5,14,Champions
66311,36,106,631,5,5,5,15,Champions
66406,193,40,86,3,4,4,11,Loyal Users
67013,245,40,146,3,4,4,11,Loyal Users
68076,109,34,74,4,4,4,12,Champions
68102,1113,18,85,2,3,4,9,Casual Users
68116,27,38,106,5,4,4,13,Champions
68158,155,22,41,4,4,3,11,Loyal Users
68227,134,62,131,4,5,4,13,Champions
68235,320,15,26,3,3,2,8,Loyal Users
68659,420,5,13,3,1,1,5,Casual Users
69005,20,125,226,5,5,5,15,Champions
69129,1575,5,9,1,1,1,3,Lost
69155,397,8,63,3,2,4,9,Casual Users
69233,709,12,20,2,3,2,7,Casual Users
69301,414,6,8,3,1,1,5,Casual Users
69465,120,37,162,4,4,5,13,Champions
69469,6131,8,8,1,2,1,4,Lost
69506,863,25,36,2,4,3,9,At Risk
69594,42,143,561,5,5,5,15,Champions
69620,109,45,106,4,4,4,12,Champions
69653,852,10,40,2,2,3,7,Lost
69715,1665,6,12,1,1,1,3,Lost
69724,1034,5,8,2,1,1,4,Lost
69822,272,15,107,3,3,4,10,Loyal Users
69855,367,5,14,3,1,1,5,Casual Users
69974,3216,5,5,1,1,1,3,Lost
70077,3850,5,5,1,1,1,3,Lost
70272,401,6,9,3,1,1,5,Casual Users
70282,413,11,26,3,2,2,7,Casual Users
70303,2267,8,10,1,2,1,4,Lost
70538,162,19,22,4,3,2,9,Loyal Users
70545,175,5,17,3,1,2,6,Casual Users
70553,18,57,129,5,5,4,14,Champions
70648,111,7,27,4,2,2,8,Promising
70717,45,51,170,5,5,5,15,Champions
71028,1,107,376,5,5,5,15,Champions
71036,575,15,22,2,3,2,7,Casual Users
71328,2316,7,12,1,2,1,4,Lost
71352,0,124,295,5,5,5,15,Champions
71354,400,8,11,3,2,1,6,Casual Users
71587,49,10,26,5,2,2,9,Promising
71721,3696,5,10,1,1,1,3,Lost
72008,6,72,159,5,5,5,15,Champions
72150,581,6,6,2,1,1,4,Lost
72339,176,16,67,3,3,4,10,Loyal Users
73221,2287,7,9,1,2,1,4,Lost
73229,229,28,127,3,4,4,11,Loyal Users
73732,12,71,179,5,5,5,15,Champions
73793,4,8,9,5,2,1,8,Promising
74796,9,33,75,5,4,4,13,Champions
74891,694,5,5,2,1,1,4,Lost
75323,2,5,8,5,1,1,7,Promising
75399,1510,5,5,1,1,1,3,Lost
75459,69,9,24,5,2,2,9,Promising
75891,1878,5,6,1,1,1,3,Lost
76458,49,32,95,5,4,4,13,Champions
76669,72,149,750,4,5,5,14,Champions
76959,65,29,101,5,4,4,13,Champions
77007,110,5,10,4,1,1,6,Promising
77114,311,5,8,3,1,1,5,Casual Users
77140,16,22,49,5,4,3,12,Loyal Users
77411,1691,5,8,1,1,1,3,Lost
65869,289,71,127,3,5,4,12,Loyal Users
66211,91,94,155,4,5,5,14,Champions
66268,138,35,73,4,4,4,12,Champions
66638,240,9,47,3,2,3,8,Casual Users
66706,205,7,16,3,2,2,7,Casual Users
67185,193,25,38,3,4,3,10,Loyal Users
67209,151,39,75,4,4,4,12,Champions
67366,106,76,95,4,5,4,13,Champions
67444,23,57,122,5,5,4,14,Champions
67457,2566,12,37,1,3,3,7,Casual Users
67459,123,15,20,4,3,2,9,Loyal Users
67681,3672,142,285,1,5,5,11,At Risk
67844,68,32,44,5,4,3,12,Loyal Users
67860,994,16,19,2,3,2,7,Casual Users
68348,0,36,293,5,4,5,14,Champions
68704,10,15,99,5,3,4,12,Loyal Users
68966,2133,9,25,1,2,2,5,Lost
68981,1080,11,62,2,2,3,7,Lost
69100,18,64,164,5,5,5,15,Champions
69368,975,33,157,2,4,5,11,At Risk
69581,7,81,526,5,5,5,15,Champions
69703,2300,7,7,1,2,1,4,Lost
69874,2688,6,18,1,1,2,4,Lost
70124,425,17,41,3,3,3,9,Loyal Users
70739,3641,6,12,1,1,1,3,Lost
70871,213,37,40,3,4,3,10,Loyal Users
70883,102,65,200,4,5,5,14,Champions
71016,2389,12,67,1,3,4,8,Casual Users
71093,1937,8,27,1,2,2,5,Lost
71269,32,5,6,5,1,1,7,Promising
71270,2861,6,8,1,1,1,3,Lost
71321,0,232,509,5,5,5,15,Champions
71376,246,17,49,3,3,3,9,Loyal Users
71534,1128,12,17,2,3,2,7,Casual Users
71630,1397,6,13,1,1,1,3,Lost
71669,130,11,35,4,2,3,9,Promising
71992,1555,5,11,1,1,1,3,Lost
71996,114,5,9,4,1,1,6,Promising
72272,1975,5,9,1,1,1,3,Lost
72293,7,142,336,5,5,5,15,Champions
72498,105,125,176,4,5,5,14,Champions
72526,1429,7,19,1,2,2,5,Lost
72582,75,32,105,4,4,4,12,Champions
72695,596,29,65,2,4,4,10,At Risk
72946,1954,12,29,1,3,2,6,Casual Users
73000,514,12,22,2,3,2,7,Casual Users
73014,109,150,300,4,5,5,14,Champions
73133,618,21,42,2,3,3,8,Casual Users
73178,2863,5,8,1,1,1,3,Lost
73179,24,130,611,5,5,5,15,Champions
73801,422,12,24,3,3,2,8,Loyal Users
73920,731,15,48,2,3,3,8,Casual Users
73935,5,36,77,5,4,4,13,Champions
74065,147,6,30,4,1,2,7,Promising
74066,1750,8,13,1,2,1,4,Lost
74253,11,6,9,5,1,1,7,Promising
74345,301,17,27,3,3,2,8,Loyal Users
74507,495,26,46,2,4,3,9,At Risk
74572,21,100,151,5,5,5,15,Champions
74946,247,53,96,3,5,4,12,Loyal Users
75161,49,18,159,5,3,5,13,Loyal Users
75178,802,9,13,2,2,1,5,Lost
75186,6,32,87,5,4,4,13,Champions
75307,740,6,8,2,1,1,4,Lost
75925,1098,10,74,2,2,4,8,Lost
76319,142,13,47,4,3,3,10,Loyal Users
76441,2,39,140,5,4,4,13,Champions
77080,92,7,10,4,2,1,7,Promising
77301,6,24,34,5,4,3,12,Loyal Users
77344,127,38,77,4,4,4,12,Champions
77802,408,8,40,3,2,3,8,Casual Users
77847,2365,6,8,1,1,1,3,Lost
78161,5893,12,40,1,3,3,7,Casual Users
65722,280,19,25,3,3,2,8,Loyal Users
66251,719,13,49,2,3,3,8,Casual Users
66537,539,48,60,2,5,3,10,At Risk
66697,3461,17,31,1,3,2,6,Casual Users
67199,411,76,125,3,5,4,12,Loyal Users
68017,12,57,216,5,5,5,15,Champions
68100,2123,7,17,1,2,2,5,Lost
68140,6,124,387,5,5,5,15,Champions
68571,2000,9,26,1,2,2,5,Lost
69117,5,9,52,5,2,3,10,Promising
69461,48,31,176,5,4,5,14,Champions
69520,420,11,28,3,2,2,7,Casual Users
69570,3593,9,9,1,2,1,4,Lost
69584,9,108,509,5,5,5,15,Champions
69681,277,123,325,3,5,5,13,Loyal Users
69834,163,23,144,4,4,4,12,Champions
70026,12,36,58,5,4,3,12,Loyal Users
70146,452,6,12,3,1,1,5,Casual Users
70158,140,41,69,4,4,4,12,Champions
70202,0,127,539,5,5,5,15,Champions
70285,101,47,268,4,5,5,14,Champions
70511,587,23,66,2,4,4,10,At Risk
70765,130,8,16,4,2,2,8,Promising
70788,1127,7,26,2,2,2,6,Lost
70823,3,18,56,5,3,3,11,Loyal Users
71062,126,7,15,4,2,1,7,Promising
71772,919,10,36,2,2,3,7,Lost
72102,123,14,17,4,3,2,9,Loyal Users
72444,576,37,223,2,4,5,11,At Risk
72519,1439,6,13,1,1,1,3,Lost
72735,42,38,94,5,4,4,13,Champions
72748,949,6,22,2,1,2,5,Lost
73132,713,12,41,2,3,3,8,Casual Users
73242,1021,16,43,2,3,3,8,Casual Users
73244,16,50,93,5,5,4,14,Champions
73915,1275,6,19,1,1,2,4,Lost
73954,850,8,16,2,2,2,6,Lost
74108,669,6,22,2,1,2,5,Lost
74205,199,8,17,3,2,2,7,Casual Users
74337,18,21,39,5,3,3,11,Loyal Users
74603,45,138,498,5,5,5,15,Champions
74616,550,16,30,2,3,2,7,Casual Users
74689,10,17,20,5,3,2,10,Loyal Users
74926,566,18,33,2,3,3,8,Casual Users
75015,1108,8,12,2,2,1,5,Lost
75151,1662,5,8,1,1,1,3,Lost
75811,2735,16,63,1,3,4,8,Casual Users
75829,3093,13,26,1,3,2,6,Casual Users
75922,303,13,23,3,3,2,8,Loyal Users
75958,270,57,183,3,5,5,13,Loyal Users
75985,596,18,30,2,3,2,7,Casual Users
76243,392,10,15,3,2,1,6,Casual Users
76630,10,68,221,5,5,5,15,Champions
77163,1269,13,29,1,3,2,6,Casual Users
77186,289,10,17,3,2,2,7,Casual Users
77626,132,54,206,4,5,5,14,Champions
77816,1435,15,26,1,3,2,6,Casual Users
77982,722,11,16,2,2,2,6,Lost
78234,148,28,57,4,4,3,11,Loyal Users
78263,216,7,8,3,2,1,6,Casual Users
65465,267,6,9,3,1,1,5,Casual Users
65535,16,29,64,5,4,4,13,Champions
65563,140,105,457,4,5,5,14,Champions
66142,12,16,78,5,3,4,12,Loyal Users
66287,36,79,439,5,5,5,15,Champions
66563,98,37,112,4,4,4,12,Champions
66601,887,14,84,2,3,4,9,Casual Users
66714,1415,7,27,1,2,2,5,Lost
66956,30,120,273,5,5,5,15,Champions
67210,4261,5,19,1,1,2,4,Lost
67701,1068,23,143,2,4,4,10,At Risk
68032,3250,8,33,1,2,3,6,Lost
68516,35,22,42,5,4,3,12,Loyal Users
68641,1493,71,170,1,5,5,11,At Risk
68913,384,46,220,3,5,5,13,Loyal Users
69039,10,142,655,5,5,5,15,Champions
69251,995,8,13,2,2,1,5,Lost
69255,441,22,32,3,4,3,10,Loyal Users
69316,31,185,392,5,5,5,15,Champions
69380,11,151,291,5,5,5,15,Champions
69575,149,19,71,4,3,4,11,Loyal Users
69654,83,125,366,4,5,5,14,Champions
70059,13,115,470,5,5,5,15,Champions
70098,65,79,219,5,5,5,15,Champions
70441,30,55,278,5,5,5,15,Champions
70450,16,50,208,5,5,5,15,Champions
70457,3522,13,73,1,3,4,8,Casual Users
70585,466,13,37,3,3,3,9,Loyal Users
71109,263,10,16,3,2,2,7,Casual Users
71248,104,47,249,4,5,5,14,Champions
71536,1407,7,9,1,2,1,4,Lost
72016,223,6,6,3,1,1,5,Casual Users
72224,135,33,106,4,4,4,12,Champions
72330,27,40,115,5,4,4,13,Champions
72515,246,19,26,3,3,2,8,Loyal Users
72540,4,97,220,5,5,5,15,Champions
72544,1162,5,9,2,1,1,4,Lost
72678,747,5,7,2,1,1,4,Lost
72786,494,34,77,2,4,4,10,At Risk
72850,32,13,79,5,3,4,12,Loyal Users
73264,718,90,222,2,5,5,12,At Risk
73325,4205,19,37,1,3,3,7,Casual Users
73740,437,8,48,3,2,3,8,Casual Users
73762,128,79,186,4,5,5,14,Champions
73908,468,23,47,3,4,3,10,Loyal Users
74248,286,6,35,3,1,3,7,Casual Users
74293,784,25,52,2,4,3,9,At Risk
74427,6,16,46,5,3,3,11,Loyal Users
74482,198,8,18,3,2,2,7,Casual Users
75385,157,7,20,4,2,2,8,Promising
75793,2753,5,8,1,1,1,3,Lost
75818,539,7,11,2,2,1,5,Lost
76056,699,27,138,2,4,4,10,At Risk
76162,674,35,47,2,4,3,9,At Risk
76309,208,6,7,3,1,1,5,Casual Users
76671,260,10,55,3,2,3,8,Casual Users
76853,515,7,7,2,2,1,5,Lost
77118,3526,16,23,1,3,2,6,Casual Users
77169,428,33,113,3,4,4,11,Loyal Users
77379,0,37,75,5,4,4,13,Champions
77522,3,15,15,5,3,1,9,Loyal Users
77986,84,7,25,4,2,2,8,Promising
77989,1097,6,9,2,1,1,4,Lost
78055,43,38,133,5,4,4,13,Champions
78078,886,7,8,2,2,1,5,Lost
78245,1273,24,90,1,4,4,9,At Risk
66027,101,158,299,4,5,5,14,Champions
66201,477,5,25,2,1,2,5,Lost
66204,1371,10,50,1,2,3,6,Lost
66314,574,34,167,2,4,5,11,At Risk
66377,260,15,43,3,3,3,9,Loyal Users
66600,120,16,34,4,3,3,10,Loyal Users
66753,137,18,38,4,3,3,10,Loyal Users
66757,113,11,12,4,2,1,7,Promising
66898,96,90,289,4,5,5,14,Champions
66921,30,155,214,5,5,5,15,Champions
67026,130,6,14,4,1,1,6,Promising
67269,649,6,18,2,1,2,5,Lost
67437,52,37,156,5,4,5,14,Champions
67498,4,87,209,5,5,5,15,Champions
67593,103,29,74,4,4,4,12,Champions
67610,2,109,314,5,5,5,15,Champions
67991,2042,6,9,1,1,1,3,Lost
68204,1431,12,24,1,3,2,6,Casual Users
68296,693,11,28,2,2,2,6,Lost
68517,1109,17,21,2,3,2,7,Casual Users
68540,252,7,11,3,2,1,6,Casual Users
68782,1008,20,31,2,3,2,7,Casual Users
68889,92,109,699,4,5,5,14,Champions
69539,124,10,28,4,2,2,8,Promising
69766,1047,13,22,2,3,2,7,Casual Users
69916,86,24,100,4,4,4,12,Champions
70154,1296,7,16,1,2,2,5,Lost
70434,321,6,7,3,1,1,5,Casual Users
70753,2847,5,9,1,1,1,3,Lost
70870,1158,55,206,2,5,5,12,At Risk
71186,254,20,34,3,3,3,9,Loyal Users
71333,934,24,81,2,4,4,10,At Risk
71358,21,22,79,5,4,4,13,Champions
71393,1117,5,8,2,1,1,4,Lost
71431,684,5,5,2,1,1,4,Lost
71695,1008,51,86,2,5,4,11,At Risk
72027,968,8,19,2,2,2,6,Lost
72193,828,16,48,2,3,3,8,Casual Users
72402,19,249,400,5,5,5,15,Champions
72429,1655,24,29,1,4,2,7,At Risk
72556,371,33,49,3,4,3,10,Loyal Users
72910,436,11,42,3,2,3,8,Casual Users
72959,156,54,116,4,5,4,13,Champions
73161,52,15,28,5,3,2,10,Loyal Users
73371,296,12,33,3,3,3,9,Loyal Users
73659,3996,7,14,1,2,1,4,Lost
73736,18,14,363,5,3,5,13,Loyal Users
73804,0,96,573,5,5,5,15,Champions
73923,721,11,40,2,2,3,7,Lost
73939,2601,5,9,1,1,1,3,Lost
74049,176,17,53,3,3,3,9,Loyal Users
74167,281,27,35,3,4,3,10,Loyal Users
74245,16,36,91,5,4,4,13,Champions
75183,81,9,9,4,2,1,7,Promising
75283,670,27,102,2,4,4,10,At Risk
75350,239,25,84,3,4,4,11,Loyal Users
75431,0,74,96,5,5,4,14,Champions
75910,121,30,41,4,4,3,11,Loyal Users
76112,2579,7,7,1,2,1,4,Lost
76125,569,17,45,2,3,3,8,Casual Users
76674,4,76,157,5,5,5,15,Champions
76757,698,18,40,2,3,3,8,Casual Users
77105,22,6,18,5,1,2,8,Promising
77196,799,6,50,2,1,3,6,Lost
77610,91,10,22,4,2,2,8,Promising
77624,405,12,22,3,3,2,8,Loyal Users
77689,506,46,78,2,5,4,11,At Risk
77749,91,56,166,4,5,5,14,Champions
78035,114,14,66,4,3,4,11,Loyal Users
78086,4395,13,43,1,3,3,7,Casual Users
78268,220,54,231,3,5,5,13,Loyal Users
65545,303,103,155,3,5,5,13,Loyal Users
65938,236,79,134,3,5,4,12,Loyal Users
66198,146,5,14,4,1,1,6,Promising
66424,1300,11,20,1,2,2,5,Lost
66691,964,13,23,2,3,2,7,Casual Users
67100,438,23,23,3,4,2,9,Loyal Users
67136,9,197,336,5,5,5,15,Champions
67415,27,50,169,5,5,5,15,Champions
67544,419,26,53,3,4,3,10,Loyal Users
67904,579,9,35,2,2,3,7,Lost
68300,1135,5,5,2,1,1,4,Lost
68333,148,38,239,4,4,5,13,Champions
68416,840,6,7,2,1,1,4,Lost
68586,131,22,56,4,4,3,11,Loyal Users
68983,552,20,149,2,3,5,10,Casual Users
69024,985,7,16,2,2,2,6,Lost
69163,1172,10,23,2,2,2,6,Lost
69527,10,63,539,5,5,5,15,Champions
69587,22,54,188,5,5,5,15,Champions
69606,413,10,22,3,2,2,7,Casual Users
69632,5458,14,14,1,3,1,5,Casual Users
69917,365,28,127,3,4,4,11,Loyal Users
70064,1280,9,12,1,2,1,4,Lost
70451,1032,26,84,2,4,4,10,At Risk
70833,2,108,820,5,5,5,15,Champions
71257,72,99,212,4,5,5,14,Champions
71258,261,27,48,3,4,3,10,Loyal Users
71579,305,5,13,3,1,1,5,Casual Users
71696,294,6,7,3,1,1,5,Casual Users
71705,3799,10,38,1,2,3,6,Lost
71803,2,161,336,5,5,5,15,Champions
72032,135,41,125,4,4,4,12,Champions
72086,890,20,63,2,3,4,9,Casual Users
72310,272,17,72,3,3,4,10,Loyal Users
72590,101,17,64,4,3,4,11,Loyal Users
72722,697,7,10,2,2,1,5,Lost
72763,22,14,43,5,3,3,11,Loyal Users
72855,216,58,222,3,5,5,13,Loyal Users
72935,1976,9,9,1,2,1,4,Lost
73199,2218,6,8,1,1,1,3,Lost
73772,425,23,28,3,4,2,9,Loyal Users
73790,2412,9,15,1,2,1,4,Lost
74000,1384,6,11,1,1,1,3,Lost
74069,0,98,445,5,5,5,15,Champions
74232,2106,7,12,1,2,1,4,Lost
74446,697,6,21,2,1,2,5,Lost
74647,2366,10,10,1,2,1,4,Lost
74782,23,66,110,5,5,4,14,Champions
75062,500,18,44,2,3,3,8,Casual Users
75746,2581,8,10,1,2,1,4,Lost
75759,57,65,101,5,5,4,14,Champions
75915,27,98,394,5,5,5,15,Champions
76007,133,103,474,4,5,5,14,Champions
76157,1944,20,83,1,3,4,8,Casual Users
76364,264,63,479,3,5,5,13,Loyal Users
76536,326,11,22,3,2,2,7,Casual Users
76652,739,7,10,2,2,1,5,Lost
76722,3,19,64,5,3,4,12,Loyal Users
77035,87,5,27,4,1,2,7,Promising
77273,401,22,35,3,4,3,10,Loyal Users
77590,276,6,10,3,1,1,5,Casual Users
77862,91,7,37,4,2,3,9,Promising
78200,583,7,42,2,2,3,7,Lost
65494,156,36,71,4,4,4,12,Champions
65907,115,32,61,4,4,3,11,Loyal Users
66068,29,8,44,5,2,3,10,Promising
66232,571,6,13,2,1,1,4,Lost
66245,500,13,31,2,3,2,7,Casual Users
66276,5151,15,18,1,3,2,6,Casual Users
66491,20,38,92,5,4,4,13,Champions
66644,730,5,47,2,1,3,6,Lost
66827,683,13,39,2,3,3,8,Casual Users
67010,70,71,136,4,5,4,13,Champions
67129,3223,6,18,1,1,2,4,Lost
67159,1154,9,15,2,2,1,5,Lost
67196,2582,6,8,1,1,1,3,Lost
67352,92,66,215,4,5,5,14,Champions
68189,694,16,66,2,3,4,9,Casual Users
68454,1037,16,66,2,3,4,9,Casual Users
69049,667,33,300,2,4,5,11,At Risk
69071,844,12,140,2,3,4,9,Casual Users
69234,4522,5,6,1,1,1,3,Lost
69261,1012,10,37,2,2,3,7,Lost
70008,559,69,261,2,5,5,12,At Risk
70037,286,21,118,3,3,4,10,Loyal Users
70099,264,12,132,3,3,4,10,Loyal Users
70150,246,43,113,3,4,4,11,Loyal Users
71074,1768,12,54,1,3,3,7,Casual Users
71870,148,21,158,4,3,5,12,Loyal Users
71969,3266,10,16,1,2,2,5,Lost
72058,5,19,52,5,3,3,11,Loyal Users
72060,2121,10,13,1,2,1,4,Lost
72221,108,16,90,4,3,4,11,Loyal Users
72380,273,11,43,3,2,3,8,Casual Users
72410,108,22,99,4,4,4,12,Champions
72559,1666,7,13,1,2,1,4,Lost
72673,2943,9,12,1,2,1,4,Lost
72843,3999,15,47,1,3,3,7,Casual Users
73234,1383,9,13,1,2,1,4,Lost
73351,1904,23,209,1,4,5,10,At Risk
73471,263,10,17,3,2,2,7,Casual Users
73593,4,18,34,5,3,3,11,Loyal Users
73630,1747,5,29,1,1,2,4,Lost
73820,3,56,448,5,5,5,15,Champions
74029,1396,10,16,1,2,2,5,Lost
74343,68,7,10,5,2,1,8,Promising
74562,954,18,74,2,3,4,9,Casual Users
74710,419,24,32,3,4,3,10,Loyal Users
74847,49,30,147,5,4,5,14,Champions
75109,139,154,364,4,5,5,14,Champions
75285,15,77,301,5,5,5,15,Champions
75428,364,6,22,3,1,2,6,Casual Users
75547,1543,17,92,1,3,4,8,Casual Users
75603,2549,7,23,1,2,2,5,Lost
75976,22,55,72,5,5,4,14,Champions
76059,66,50,204,5,5,5,15,Champions
76151,199,25,32,3,4,3,10,Loyal Users
76175,138,36,137,4,4,4,12,Champions
76179,128,32,47,4,4,3,11,Loyal Users
76349,56,54,114,5,5,4,14,Champions
76351,1291,8,13,1,2,1,4,Lost
76724,1701,21,35,1,3,3,7,Casual Users
76829,4264,40,138,1,4,4,9,At Risk
76919,1007,30,166,2,4,5,11,At Risk
77376,18,14,17,5,3,2,10,Loyal Users
77466,1576,12,31,1,3,2,6,Casual Users
77702,79,43,138,4,4,4,12,Champions
77704,3924,12,31,1,3,2,6,Casual Users
65463,265,57,338,3,5,5,13,Loyal Users
65845,423,45,117,3,4,4,11,Loyal Users
65977,28,58,81,5,5,4,14,Champions
66146,5411,6,12,1,1,1,3,Lost
66236,1023,14,27,2,3,2,7,Casual Users
66459,1155,5,5,2,1,1,4,Lost
66468,78,13,22,4,3,2,9,Loyal Users
67154,911,10,15,2,2,1,5,Lost
67195,6,81,180,5,5,5,15,Champions
67258,236,17,40,3,3,3,9,Loyal Users
67447,127,17,33,4,3,3,10,Loyal Users
67506,978,6,19,2,1,2,5,Lost
67682,58,21,101,5,3,4,12,Loyal Users
68108,128,5,21,4,1,2,7,Promising
68487,4,141,196,5,5,5,15,Champions
68668,3756,6,6,1,1,1,3,Lost
68848,93,8,12,4,2,1,7,Promising
69085,6,77,315,5,5,5,15,Champions
69187,2452,18,58,1,3,3,7,Casual Users
69746,614,23,24,2,4,2,8,At Risk
69951,109,21,148,4,3,5,12,Loyal Users
70041,295,52,150,3,5,5,13,Loyal Users
70048,391,8,11,3,2,1,6,Casual Users
70693,1697,13,29,1,3,2,6,Casual Users
70738,110,6,22,4,1,2,7,Promising
70866,432,35,394,3,4,5,12,Loyal Users
70882,127,91,259,4,5,5,14,Champions
70998,8,148,331,5,5,5,15,Champions
71219,1261,6,11,1,1,1,3,Lost
71638,385,66,254,3,5,5,13,Loyal Users
71697,65,37,78,5,4,4,13,Champions
71724,272,32,60,3,4,3,10,Loyal Users
71879,291,19,66,3,3,4,10,Loyal Users
71919,23,49,155,5,5,5,15,Champions
71928,261,27,42,3,4,3,10,Loyal Users
72434,116,140,388,4,5,5,14,Champions
72450,2135,10,35,1,2,3,6,Lost
72493,5127,12,61,1,3,3,7,Casual Users
72834,82,110,228,4,5,5,14,Champions
73058,267,6,31,3,1,2,6,Casual Users
73085,531,5,19,2,1,2,5,Lost
73416,148,17,55,4,3,3,10,Loyal Users
73654,16,80,158,5,5,5,15,Champions
73744,2540,5,13,1,1,1,3,Lost
74016,121,106,172,4,5,5,14,Champions
74369,3,110,145,5,5,4,14,Champions
74732,3462,8,8,1,2,1,4,Lost
74770,454,24,128,3,4,4,11,Loyal Users
74924,425,37,104,3,4,4,11,Loyal Users
74976,546,36,95,2,4,4,10,At Risk
75513,8,8,12,5,2,1,8,Promising
75627,379,50,222,3,5,5,13,Loyal Users
75787,182,52,229,3,5,5,13,Loyal Users
75846,561,18,61,2,3,3,8,Casual Users
75924,433,7,28,3,2,2,7,Casual Users
75943,299,39,196,3,4,5,12,Loyal Users
76370,971,16,45,2,3,3,8,Casual Users
76501,6027,11,11,1,2,1,4,Lost
76506,416,8,46,3,2,3,8,Casual Users
76849,0,34,331,5,4,5,14,Champions
76856,60,48,62,5,5,3,13,Loyal Users
76902,778,9,20,2,2,2,6,Lost
76944,532,14,17,2,3,2,7,Casual Users
77176,133,30,53,4,4,3,11,Loyal Users
77491,29,63,398,5,5,5,15,Champions
77538,124,15,22,4,3,2,9,Loyal Users
77585,33,66,216,5,5,5,15,Champions
78022,3301,12,23,1,3,2,6,Casual Users
65431,243,77,387,3,5,5,13,Loyal Users
65503,860,6,8,2,1,1,4,Lost
65655,11,59,229,5,5,5,15,Champions
65678,315,8,37,3,2,3,8,Casual Users
65819,234,5,17,3,1,2,6,Casual Users
65860,31,113,480,5,5,5,15,Champions
66094,2467,6,7,1,1,1,3,Lost
66870,46,59,247,5,5,5,15,Champions
66919,4215,5,5,1,1,1,3,Lost
66948,574,9,21,2,2,2,6,Lost
67162,13,63,273,5,5,5,15,Champions
68096,568,9,15,2,2,1,5,Lost
68467,695,16,103,2,3,4,9,Casual Users
69288,3121,14,20,1,3,2,6,Casual Users
69295,1174,5,7,2,1,1,4,Lost
69717,41,5,11,5,1,1,7,Promising
69889,424,47,215,3,5,5,13,Loyal Users
70184,4637,10,12,1,2,1,4,Lost
70452,42,14,62,5,3,3,11,Loyal Users
70486,239,11,43,3,2,3,8,Casual Users
71444,1189,8,8,2,2,1,5,Lost
71726,123,74,453,4,5,5,14,Champions
72261,267,6,10,3,1,1,5,Casual Users
72390,0,22,68,5,4,4,13,Champions
72566,2633,5,10,1,1,1,3,Lost
72580,1,26,72,5,4,4,13,Champions
72724,216,74,137,3,5,4,12,Loyal Users
72745,738,16,51,2,3,3,8,Casual Users
72769,849,11,22,2,2,2,6,Lost
72839,422,7,12,3,2,1,6,Casual Users
73459,299,11,90,3,2,4,9,Casual Users
73500,490,5,10,2,1,1,4,Lost
73521,1123,33,95,2,4,4,10,At Risk
74030,279,25,96,3,4,4,11,Loyal Users
74679,2,98,574,5,5,5,15,Champions
74762,125,29,159,4,4,5,13,Champions
75233,17,47,201,5,5,5,15,Champions
75336,3299,9,15,1,2,1,4,Lost
75370,864,5,7,2,1,1,4,Lost
75855,1708,6,22,1,1,2,4,Lost
76015,2440,78,494,1,5,5,11,At Risk
76149,26,131,449,5,5,5,15,Champions
76834,2546,5,11,1,1,1,3,Lost
77229,643,17,223,2,3,5,10,Casual Users
77336,791,23,50,2,4,3,9,At Risk
77391,1545,14,50,1,3,3,7,Casual Users
77531,298,41,168,3,4,5,12,Loyal Users
77962,7,20,27,5,3,2,10,Loyal Users
78057,1309,16,22,1,3,2,6,Casual Users
78192,263,12,15,3,3,1,7,Loyal Users
78207,160,60,210,4,5,5,14,Champions
65531,16,90,234,5,5,5,15,Champions
65662,4014,11,12,1,2,1,4,Lost
65989,308,11,26,3,2,2,7,Casual Users
66106,2816,5,11,1,1,1,3,Lost
66579,417,25,68,3,4,4,11,Loyal Users
66639,1300,7,22,1,2,2,5,Lost
66990,10,21,65,5,3,4,12,Loyal Users
67360,738,9,11,2,2,1,5,Lost
67427,4130,8,42,1,2,3,6,Lost
67651,114,63,409,4,5,5,14,Champions
67790,3374,78,281,1,5,5,11,At Risk
67847,93,36,136,4,4,4,12,Champions
67909,1863,14,33,1,3,3,7,Casual Users
68092,399,52,136,3,5,4,12,Loyal Users
68117,451,18,90,3,3,4,10,Loyal Users
68155,7,55,152,5,5,5,15,Champions
68180,547,5,25,2,1,2,5,Lost
68236,1287,5,5,1,1,1,3,Lost
68532,3883,11,25,1,2,2,5,Lost
68773,811,6,9,2,1,1,4,Lost
68805,772,42,228,2,4,5,11,At Risk
68936,41,7,20,5,2,2,9,Promising
69237,11,59,140,5,5,4,14,Champions
69254,3039,10,23,1,2,2,5,Lost
69300,188,11,16,3,2,2,7,Casual Users
69357,253,46,105,3,5,4,12,Loyal Users
69615,2,106,191,5,5,5,15,Champions
69658,1,81,105,5,5,4,14,Champions
69808,4448,12,22,1,3,2,6,Casual Users
69892,153,17,32,4,3,3,10,Loyal Users
69898,244,19,64,3,3,4,10,Loyal Users
70242,251,43,67,3,4,4,11,Loyal Users
70424,1211,8,26,2,2,2,6,Lost
70875,643,15,21,2,3,2,7,Casual Users
70922,2850,20,122,1,3,4,8,Casual Users
71153,708,9,27,2,2,2,6,Lost
71243,86,94,365,4,5,5,14,Champions
71313,111,55,96,4,5,4,13,Champions
71554,1001,10,11,2,2,1,5,Lost
71758,146,82,149,4,5,5,14,Champions
71885,695,5,31,2,1,2,5,Lost
71949,137,86,324,4,5,5,14,Champions
71951,6,54,265,5,5,5,15,Champions
72443,243,9,56,3,2,3,8,Casual Users
72525,747,11,18,2,2,2,6,Lost
72726,27,86,301,5,5,5,15,Champions
72751,246,56,101,3,5,4,12,Loyal Users
73107,889,48,77,2,5,4,11,At Risk
73197,374,41,89,3,4,4,11,Loyal Users
73344,282,24,56,3,4,3,10,Loyal Users
73724,587,10,19,2,2,2,6,Lost
73761,467,5,5,3,1,1,5,Casual Users
73850,297,22,118,3,4,4,11,Loyal Users
73894,35,21,50,5,3,3,11,Loyal Users
74414,136,20,152,4,3,5,12,Loyal Users
74549,63,76,115,5,5,4,14,Champions
74899,21,8,18,5,2,2,9,Promising
75302,1008,12,78,2,3,4,9,Casual Users
75362,534,10,24,2,2,2,6,Lost
76042,107,90,462,4,5,5,14,Champions
76235,428,5,22,3,1,2,6,Casual Users
76621,649,6,6,2,1,1,4,Lost
76981,2274,10,25,1,2,2,5,Lost
77101,348,50,85,3,5,4,12,Loyal Users
77187,414,6,11,3,1,1,5,Casual Users
77668,67,28,80,5,4,4,13,Champions
77835,18,21,47,5,3,3,11,Loyal Users
78072,2578,115,222,1,5,5,11,At Risk
65574,416,31,63,3,4,4,11,Loyal Users
65903,149,42,153,4,4,5,13,Champions
66023,1265,12,36,1,3,3,7,Casual Users
66327,1122,14,21,2,3,2,7,Casual Users
66481,146,21,32,4,3,3,10,Loyal Users
66597,72,99,398,4,5,5,14,Champions
66705,1596,14,66,1,3,4,8,Casual Users
66784,106,128,298,4,5,5,14,Champions
66868,3712,5,5,1,1,1,3,Lost
66942,1143,10,23,2,2,2,6,Lost
67510,1509,9,20,1,2,2,5,Lost
68030,141,16,27,4,3,2,9,Loyal Users
68073,232,20,157,3,3,5,11,Loyal Users
68361,30,11,48,5,2,3,10,Promising
68744,202,75,85,3,5,4,12,Loyal Users
68927,121,53,215,4,5,5,14,Champions
69023,2001,9,43,1,2,3,6,Lost
69083,621,5,12,2,1,1,4,Lost
69107,3109,16,37,1,3,3,7,Casual Users
69194,1828,7,17,1,2,2,5,Lost
69297,36,111,210,5,5,5,15,Champions
69373,119,109,322,4,5,5,14,Champions
70510,17,11,36,5,2,3,10,Promising
70570,45,92,301,5,5,5,15,Champions
70664,483,8,14,2,2,1,5,Lost
70816,87,65,220,4,5,5,14,Champions
71500,3902,16,40,1,3,3,7,Casual Users
71749,8,6,9,5,1,1,7,Promising
71781,409,34,111,3,4,4,11,Loyal Users
71841,437,7,17,3,2,2,7,Casual Users
72024,11,17,40,5,3,3,11,Loyal Users
72370,416,5,52,3,1,3,7,Casual Users
72442,1876,5,35,1,1,3,5,Lost
72968,721,16,62,2,3,3,8,Casual Users
73079,213,51,192,3,5,5,13,Loyal Users
73420,1118,10,28,2,2,2,6,Lost
73617,37,19,50,5,3,3,11,Loyal Users
73684,222,7,19,3,2,2,7,Casual Users
74045,120,68,281,4,5,5,14,Champions
74856,135,24,43,4,4,3,11,Loyal Users
74883,24,119,521,5,5,5,15,Champions
74954,335,33,143,3,4,4,11,Loyal Users
75372,117,8,10,4,2,1,7,Promising
75543,1798,20,69,1,3,4,8,Casual Users
76213,1424,18,19,1,3,2,6,Casual Users
76329,2587,5,31,1,1,2,4,Lost
76456,276,10,19,3,2,2,7,Casual Users
76508,5462,7,7,1,2,1,4,Lost
76746,4,21,27,5,3,2,10,Loyal Users
76953,282,32,51,3,4,3,10,Loyal Users
77223,879,9,53,2,2,3,7,Lost
77249,177,15,62,3,3,3,9,Loyal Users
77450,86,10,36,4,2,3,9,Promising
77730,3375,5,5,1,1,1,3,Lost
77753,29,85,158,5,5,5,15,Champions
77914,105,118,358,4,5,5,14,Champions
78223,30,80,363,5,5,5,15,Champions
65687,66,80,228,5,5,5,15,Champions
65716,16,29,106,5,4,4,13,Champions
65741,1531,5,10,1,1,1,3,Lost
65918,21,109,155,5,5,5,15,Champions
66615,65,49,267,5,5,5,15,Champions
67073,842,37,48,2,4,3,9,At Risk
67075,1552,6,13,1,1,1,3,Lost
67113,5,111,344,5,5,5,15,Champions
67126,272,14,68,3,3,4,10,Loyal Users
67297,102,110,474,4,5,5,14,Champions
67514,549,12,33,2,3,3,8,Casual Users
67665,4190,6,10,1,1,1,3,Lost
67830,4,28,40,5,4,3,12,Loyal Users
67951,137,8,9,4,2,1,7,Promising
68015,226,32,168,3,4,5,12,Loyal Users
68057,506,7,11,2,2,1,5,Lost
68173,54,37,242,5,4,5,14,Champions
68307,140,12,64,4,3,4,11,Loyal Users
68378,440,21,65,3,3,4,10,Loyal Users
68589,114,69,462,4,5,5,14,Champions
68847,220,46,72,3,5,4,12,Loyal Users
68849,690,10,12,2,2,1,5,Lost
69124,7,28,68,5,4,4,13,Champions
69217,573,5,11,2,1,1,4,Lost
69425,270,20,36,3,3,3,9,Loyal Users
69505,163,66,409,4,5,5,14,Champions
69837,67,108,572,5,5,5,15,Champions
70036,2244,5,14,1,1,1,3,Lost
70104,613,14,62,2,3,3,8,Casual Users
70387,8,19,50,5,3,3,11,Loyal Users
70698,325,6,28,3,1,2,6,Casual Users
71060,4782,25,32,1,4,3,8,At Risk
71768,968,21,205,2,3,5,10,Casual Users
71820,1433,15,57,1,3,3,7,Casual Users
71838,85,33,46,4,4,3,11,Loyal Users
71876,1099,19,19,2,3,2,7,Casual Users
72440,831,18,54,2,3,3,8,Casual Users
72478,17,137,362,5,5,5,15,Champions
72497,955,7,23,2,2,2,6,Lost
72577,13,36,64,5,4,4,13,Champions
72584,211,32,82,3,4,4,11,Loyal Users
72740,94,8,51,4,2,3,9,Promising
72764,1434,9,12,1,2,1,4,Lost
72987,8,45,72,5,4,4,13,Champions
73012,729,11,39,2,2,3,7,Lost
73114,647,7,8,2,2,1,5,Lost
73293,95,14,26,4,3,2,9,Loyal Users
73345,50,38,46,5,4,3,12,Loyal Users
73728,110,196,402,4,5,5,14,Champions
73792,137,93,415,4,5,5,14,Champions
73798,437,32,78,3,4,4,11,Loyal Users
73871,781,22,29,2,4,2,8,At Risk
73975,67,74,297,5,5,5,15,Champions
73996,291,68,125,3,5,4,12,Loyal Users
74056,1091,5,5,2,1,1,4,Lost
74870,2882,6,7,1,1,1,3,Lost
74953,425,24,31,3,4,2,9,Loyal Users
75292,736,27,176,2,4,5,11,At Risk
75352,570,11,22,2,2,2,6,Lost
75477,136,37,115,4,4,4,12,Champions
75487,1787,25,62,1,4,3,8,At Risk
75545,3577,6,17,1,1,2,4,Lost
75927,962,12,46,2,3,3,8,Casual Users
76335,71,8,60,4,2,3,9,Promising
76818,2246,21,26,1,3,2,6,Casual Users
76888,91,119,548,4,5,5,14,Champions
76905,2201,6,14,1,1,1,3,Lost
77252,2687,11,13,1,2,1,4,Lost
77475,313,74,229,3,5,5,13,Loyal Users
77596,72,52,268,4,5,5,14,Champions
77739,28,8,14,5,2,1,8,Promising
78009,633,16,28,2,3,2,7,Casual Users
78039,102,7,8,4,2,1,7,Promising
65539,4459,32,53,1,4,3,8,At Risk
65663,428,16,74,3,3,4,10,Loyal Users
66025,2436,9,25,1,2,2,5,Lost
66069,541,6,39,2,1,3,6,Lost
66149,222,10,136,3,2,4,9,Casual Users
66444,270,8,8,3,2,1,6,Casual Users
66467,39,106,482,5,5,5,15,Champions
66499,531,9,18,2,2,2,6,Lost
66793,115,35,133,4,4,4,12,Champions
66850,11,8,25,5,2,2,9,Promising
66899,358,68,336,3,5,5,13,Loyal Users
67127,3400,12,40,1,3,3,7,Casual Users
67243,142,94,440,4,5,5,14,Champions
67522,3254,6,6,1,1,1,3,Lost
68162,1637,5,5,1,1,1,3,Lost
68354,580,8,23,2,2,2,6,Lost
68476,138,49,343,4,5,5,14,Champions
68843,228,16,155,3,3,5,11,Loyal Users
68934,167,46,94,3,5,4,12,Loyal Users
69097,132,18,24,4,3,2,9,Loyal Users
69298,1746,13,13,1,3,1,5,Casual Users
69643,322,32,120,3,4,4,11,Loyal Users
69852,34,62,427,5,5,5,15,Champions
69899,1379,7,17,1,2,2,5,Lost
70444,2013,35,176,1,4,5,10,At Risk
70685,2743,6,12,1,1,1,3,Lost
71395,123,12,19,4,3,2,9,Loyal Users
71710,294,9,9,3,2,1,6,Casual Users
72054,1,172,699,5,5,5,15,Champions
72069,215,16,79,3,3,4,10,Loyal Users
72201,73,107,262,4,5,5,14,Champions
72223,2,43,151,5,4,5,14,Champions
72392,18,110,478,5,5,5,15,Champions
73379,118,47,100,4,5,4,13,Champions
74125,283,32,89,3,4,4,11,Loyal Users
74429,410,5,34,3,1,3,7,Casual Users
74506,1732,6,7,1,1,1,3,Lost
74543,86,58,213,4,5,5,14,Champions
74691,109,70,179,4,5,5,14,Champions
75342,270,40,64,3,4,4,11,Loyal Users
75602,69,25,94,5,4,4,13,Champions
75860,477,52,421,2,5,5,12,At Risk
75901,5090,11,20,1,2,2,5,Lost
75931,1362,7,18,1,2,2,5,Lost
76028,669,12,31,2,3,2,7,Casual Users
76089,701,14,33,2,3,3,8,Casual Users
76106,3000,6,49,1,1,3,5,Lost
76199,112,124,358,4,5,5,14,Champions
76496,1673,5,18,1,1,2,4,Lost
76601,108,26,81,4,4,4,12,Champions
76949,141,40,160,4,4,5,13,Champions
77418,706,15,34,2,3,3,8,Casual Users
77672,2614,11,15,1,2,1,4,Lost
78088,5736,12,16,1,3,2,6,Casual Users
65455,4,39,85,5,4,4,13,Champions
65773,137,44,285,4,4,5,13,Champions
66060,1087,95,286,2,5,5,12,At Risk
66063,292,5,7,3,1,1,5,Casual Users
66343,27,26,37,5,4,3,12,Loyal Users
66515,19,13,24,5,3,2,10,Loyal Users
66624,5484,9,20,1,2,2,5,Lost
67094,120,21,53,4,3,3,10,Loyal Users
68091,441,5,14,3,1,1,5,Casual Users
68430,85,47,86,4,5,4,13,Champions
68525,385,17,22,3,3,2,8,Loyal Users
68711,3878,6,10,1,1,1,3,Lost
68922,101,92,140,4,5,4,13,Champions
69366,1161,25,88,2,4,4,10,At Risk
69495,197,8,12,3,2,1,6,Casual Users
69577,104,16,32,4,3,3,10,Loyal Users
69955,39,13,14,5,3,1,9,Loyal Users
70210,438,5,24,3,1,2,6,Casual Users
70437,210,13,53,3,3,3,9,Loyal Users
70963,40,39,324,5,4,5,14,Champions
71152,97,15,58,4,3,3,10,Loyal Users
71207,827,11,11,2,2,1,5,Lost
71412,68,72,132,5,5,4,14,Champions
71637,66,10,174,5,2,5,12,Promising
72007,294,5,17,3,1,2,6,Casual Users
72046,162,59,219,4,5,5,14,Champions
72103,25,8,13,5,2,1,8,Promising
72670,4708,9,25,1,2,2,5,Lost
72682,415,7,17,3,2,2,7,Casual Users
72756,425,9,57,3,2,3,8,Casual Users
72876,100,77,102,4,5,4,13,Champions
73010,6,31,57,5,4,3,12,Loyal Users
73284,3827,12,23,1,3,2,6,Casual Users
73460,75,83,255,4,5,5,14,Champions
73503,135,46,96,4,5,4,13,Champions
73725,3175,5,6,1,1,1,3,Lost
73883,1035,6,50,2,1,3,6,Lost
73992,289,19,152,3,3,5,11,Loyal Users
74211,23,122,415,5,5,5,15,Champions
74297,848,7,26,2,2,2,6,Lost
74501,26,12,36,5,3,3,11,Loyal Users
74576,90,56,260,4,5,5,14,Champions
74815,408,5,19,3,1,2,6,Casual Users
74837,216,17,51,3,3,3,9,Loyal Users
75218,412,15,73,3,3,4,10,Loyal Users
75224,110,49,65,4,5,4,13,Champions
75435,28,96,328,5,5,5,15,Champions
75473,114,104,359,4,5,5,14,Champions
75709,1431,9,20,1,2,2,5,Lost
76208,399,16,31,3,3,2,8,Loyal Users
76280,157,5,13,4,1,1,6,Promising
76491,131,6,8,4,1,1,6,Promising
76682,397,86,598,3,5,5,13,Loyal Users
76709,1867,10,12,1,2,1,4,Lost
77116,88,10,79,4,2,4,10,Promising
77180,441,10,21,3,2,2,7,Casual Users
77290,16,38,161,5,4,5,14,Champions
77958,875,31,55,2,4,3,9,At Risk
78006,3123,6,13,1,1,1,3,Lost
65642,221,76,330,3,5,5,13,Loyal Users
65786,243,16,207,3,3,5,11,Loyal Users
65862,609,11,73,2,2,4,8,Lost
65931,3775,8,14,1,2,1,4,Lost
66130,523,12,119,2,3,4,9,Casual Users
66335,259,29,43,3,4,3,10,Loyal Users
66376,1424,14,27,1,3,2,6,Casual Users
66389,1364,23,66,1,4,4,9,At Risk
66637,843,195,591,2,5,5,12,At Risk
67123,321,86,112,3,5,4,12,Loyal Users
67392,660,43,129,2,4,4,10,At Risk
67412,164,19,35,4,3,3,10,Loyal Users
67633,195,22,56,3,4,3,10,Loyal Users
67840,3552,8,20,1,2,2,5,Lost
67890,2,100,520,5,5,5,15,Champions
67996,270,33,75,3,4,4,11,Loyal Users
68042,402,46,99,3,5,4,12,Loyal Users
68161,1,206,867,5,5,5,15,Champions
68933,126,28,48,4,4,3,11,Loyal Users
69278,2114,6,27,1,1,2,4,Lost
69299,1647,6,63,1,1,4,6,Lost
69494,23,92,229,5,5,5,15,Champions
69586,2422,11,30,1,2,2,5,Lost
70516,56,11,107,5,2,4,11,Promising
70905,488,14,34,2,3,3,8,Casual Users
70955,8,75,453,5,5,5,15,Champions
70960,16,22,61,5,4,3,12,Loyal Users
71240,12,12,14,5,3,1,9,Loyal Users
71501,278,53,321,3,5,5,13,Loyal Users
71848,122,54,118,4,5,4,13,Champions
71941,2260,18,60,1,3,3,7,Casual Users
72203,2,105,181,5,5,5,15,Champions
72235,45,69,209,5,5,5,15,Champions
72995,82,63,266,4,5,5,14,Champions
73129,10,81,171,5,5,5,15,Champions
73604,222,74,232,3,5,5,13,Loyal Users
73726,2406,6,16,1,1,2,4,Lost
73852,42,8,29,5,2,2,9,Promising
73911,110,8,11,4,2,1,7,Promising
73982,385,97,300,3,5,5,13,Loyal Users
74044,41,39,133,5,4,4,13,Champions
74570,38,13,23,5,3,2,10,Loyal Users
74700,62,66,362,5,5,5,15,Champions
74844,15,13,95,5,3,4,12,Loyal Users
75229,2518,6,23,1,1,2,4,Lost
75436,14,48,78,5,5,4,14,Champions
75662,176,9,67,3,2,4,9,Casual Users
76537,111,40,66,4,4,4,12,Champions
77185,389,18,53,3,3,3,9,Loyal Users
77463,144,6,8,4,1,1,6,Promising
77581,4345,7,14,1,2,1,4,Lost
77601,15,47,119,5,5,4,14,Champions
77708,1565,9,11,1,2,1,4,Lost
78037,256,88,472,3,5,5,13,Loyal Users
78250,844,5,9,2,1,1,4,Lost
65607,559,12,15,2,3,1,6,Casual Users
65621,1924,7,11,1,2,1,4,Lost
65702,571,13,26,2,3,2,7,Casual Users
66294,27,5,50,5,1,3,9,Promising
66373,1398,14,21,1,3,2,6,Casual Users
66758,389,21,33,3,3,3,9,Loyal Users
66847,807,9,34,2,2,3,7,Lost
66865,1859,40,63,1,4,4,9,At Risk
66922,1579,5,50,1,1,3,5,Lost
67170,49,22,70,5,4,4,13,Champions
67246,13,13,19,5,3,2,10,Loyal Users
67389,90,56,242,4,5,5,14,Champions
67416,155,14,41,4,3,3,10,Loyal Users
67803,96,119,515,4,5,5,14,Champions
68123,422,23,122,3,4,4,11,Loyal Users
68447,125,27,69,4,4,4,12,Champions
68697,258,5,15,3,1,1,5,Casual Users
68717,44,65,148,5,5,5,15,Champions
68855,1433,8,26,1,2,2,5,Lost
68951,1368,16,33,1,3,3,7,Casual Users
68971,427,24,50,3,4,3,10,Loyal Users
69103,4854,11,17,1,2,2,5,Lost
69256,2143,8,35,1,2,3,6,Lost
69457,181,50,390,3,5,5,13,Loyal Users
69628,939,16,18,2,3,2,7,Casual Users
70023,0,54,115,5,5,4,14,Champions
70246,421,23,67,3,4,4,11,Loyal Users
70778,141,8,11,4,2,1,7,Promising
71081,45,45,94,5,4,4,13,Champions
71267,334,18,71,3,3,4,10,Loyal Users
71277,128,13,99,4,3,4,11,Loyal Users
71532,17,9,10,5,2,1,8,Promising
72480,873,6,11,2,1,1,4,Lost
72570,946,82,159,2,5,5,12,At Risk
72822,271,7,28,3,2,2,7,Casual Users
72988,101,15,129,4,3,4,11,Loyal Users
73066,1441,82,306,1,5,5,11,At Risk
73385,997,12,39,2,3,3,8,Casual Users
73680,101,67,96,4,5,4,13,Champions
73997,574,15,51,2,3,3,8,Casual Users
74102,76,12,48,4,3,3,10,Loyal Users
74393,485,39,208,2,4,5,11,At Risk
74489,708,29,55,2,4,3,9,At Risk
75013,388,15,26,3,3,2,8,Loyal Users
75536,201,9,17,3,2,2,7,Casual Users
75710,0,36,74,5,4,4,13,Champions
75819,521,15,36,2,3,3,8,Casual Users
75836,1562,9,110,1,2,4,7,Lost
75930,62,9,118,5,2,4,11,Promising
75974,738,201,560,2,5,5,12,At Risk
76242,9,33,87,5,4,4,13,Champions
76258,116,11,127,4,2,4,10,Promising
76278,1452,6,8,1,1,1,3,Lost
76494,1407,11,71,1,2,4,7,Lost
76546,110,32,55,4,4,3,11,Loyal Users
76882,266,26,46,3,4,3,10,Loyal Users
76893,1438,10,14,1,2,1,4,Lost
77081,3111,7,64,1,2,4,7,Lost
77171,122,6,6,4,1,1,6,Promising
77236,0,144,313,5,5,5,15,Champions
77494,144,9,14,4,2,1,7,Promising
77497,25,5,6,5,1,1,7,Promising
77498,285,58,368,3,5,5,13,Loyal Users
77850,165,33,86,4,4,4,12,Champions
77871,151,25,46,4,4,3,11,Loyal Users
77886,29,20,103,5,3,4,12,Loyal Users
78140,194,14,33,3,3,3,9,Loyal Users
78400,101,30,115,4,4,4,12,Champions
78440,1603,12,18,1,3,2,6,Casual Users
78478,27,16,34,5,3,3,11,Loyal Users
79220,144,52,139,4,5,4,13,Champions
79361,5,5,8,5,1,1,7,Promising
80006,1,54,174,5,5,5,15,Champions
80033,135,52,134,4,5,4,13,Champions
80332,262,129,306,3,5,5,13,Loyal Users
80451,552,41,62,2,4,3,9,At Risk
80579,131,74,470,4,5,5,14,Champions
81349,2254,6,7,1,1,1,3,Lost
81410,37,15,18,5,3,2,10,Loyal Users
81501,98,11,29,4,2,2,8,Promising
81734,57,66,228,5,5,5,15,Champions
81900,722,7,18,2,2,2,6,Lost
82529,284,44,75,3,4,4,11,Loyal Users
82582,128,23,46,4,4,3,11,Loyal Users
82672,12,42,108,5,4,4,13,Champions
82730,137,6,10,4,1,1,6,Promising
82794,146,32,185,4,4,5,13,Champions
83242,1145,10,50,2,2,3,7,Lost
83250,100,16,95,4,3,4,11,Loyal Users
83693,50,14,27,5,3,2,10,Loyal Users
83861,0,27,55,5,4,3,12,Loyal Users
84018,64,59,453,5,5,5,15,Champions
84812,115,89,284,4,5,5,14,Champions
85100,12,90,264,5,5,5,15,Champions
85253,1403,5,9,1,1,1,3,Lost
85321,856,14,43,2,3,3,8,Casual Users
85332,1135,11,12,2,2,1,5,Lost
85349,471,11,24,2,2,2,6,Lost
85749,1351,5,16,1,1,2,4,Lost
86082,149,6,20,4,1,2,7,Promising
86927,115,32,42,4,4,3,11,Loyal Users
87120,405,17,55,3,3,3,9,Loyal Users
87338,163,59,315,4,5,5,14,Champions
87462,829,45,168,2,4,5,11,At Risk
87616,1070,11,24,2,2,2,6,Lost
87656,839,42,70,2,4,4,10,At Risk
87724,715,5,11,2,1,1,4,Lost
87905,50,70,230,5,5,5,15,Champions
88599,1585,11,172,1,2,5,8,Lost
88666,961,8,26,2,2,2,6,Lost
88674,1976,5,28,1,1,2,4,Lost
89056,57,39,103,5,4,4,13,Champions
89385,185,41,132,3,4,4,11,Loyal Users
89476,28,56,120,5,5,4,14,Champions
89537,320,6,24,3,1,2,6,Casual Users
89574,36,55,241,5,5,5,15,Champions
89844,2346,19,73,1,3,4,8,Casual Users
89863,1068,5,7,2,1,1,4,Lost
89874,263,72,159,3,5,5,13,Loyal Users
89878,905,8,13,2,2,1,5,Lost
90019,4848,8,11,1,2,1,4,Lost
90228,9,40,76,5,4,4,13,Champions
90461,930,11,37,2,2,3,7,Lost
90550,232,18,75,3,3,4,10,Loyal Users
90817,60,5,7,5,1,1,7,Promising
78494,3414,5,5,1,1,1,3,Lost
78700,1269,15,20,1,3,2,6,Casual Users
78766,334,9,12,3,2,1,6,Casual Users
78805,101,146,643,4,5,5,14,Champions
78905,125,9,26,4,2,2,8,Promising
79564,221,10,44,3,2,3,8,Casual Users
79641,878,15,18,2,3,2,7,Casual Users
79647,433,17,52,3,3,3,9,Loyal Users
79758,128,166,852,4,5,5,14,Champions
80152,127,5,7,4,1,1,6,Promising
80170,1840,7,35,1,2,3,6,Lost
80424,26,40,44,5,4,3,12,Loyal Users
80898,3464,34,79,1,4,4,9,At Risk
80943,34,14,19,5,3,2,10,Loyal Users
81273,371,5,23,3,1,2,6,Casual Users
81284,2240,8,14,1,2,1,4,Lost
81312,719,8,14,2,2,1,5,Lost
81496,694,14,46,2,3,3,8,Casual Users
81935,777,5,28,2,1,2,5,Lost
82140,106,76,301,4,5,5,14,Champions
82164,187,11,27,3,2,2,7,Casual Users
82385,1007,20,51,2,3,3,8,Casual Users
82733,0,63,317,5,5,5,15,Champions
82872,341,26,60,3,4,3,10,Loyal Users
82965,408,14,37,3,3,3,9,Loyal Users
82966,4,55,152,5,5,5,15,Champions
83033,137,6,20,4,1,2,7,Promising
83427,40,26,267,5,4,5,14,Champions
83702,1943,8,12,1,2,1,4,Lost
83769,1994,5,16,1,1,2,4,Lost
83947,626,8,9,2,2,1,5,Lost
84542,1977,6,71,1,1,4,6,Lost
84654,158,10,80,4,2,4,10,Promising
84704,353,14,25,3,3,2,8,Loyal Users
85000,416,13,57,3,3,3,9,Loyal Users
85052,405,17,71,3,3,4,10,Loyal Users
85119,165,67,382,4,5,5,14,Champions
85363,2461,6,33,1,1,3,5,Lost
85858,29,92,250,5,5,5,15,Champions
86074,229,106,500,3,5,5,13,Loyal Users
86078,438,5,13,3,1,1,5,Casual Users
86181,439,11,18,3,2,2,7,Casual Users
86400,124,49,80,4,5,4,13,Champions
86409,623,11,92,2,2,4,8,Lost
86672,4,25,82,5,4,4,13,Champions
87253,2077,7,11,1,2,1,4,Lost
87560,11,28,136,5,4,4,13,Champions
87759,360,50,133,3,5,4,12,Loyal Users
87982,724,7,15,2,2,1,5,Lost
88156,108,64,173,4,5,5,14,Champions
89379,2235,20,28,1,3,2,6,Casual Users
89506,2395,8,8,1,2,1,4,Lost
90107,128,35,55,4,4,3,11,Loyal Users
90493,106,40,84,4,4,4,12,Champions
90818,500,33,101,2,4,4,10,At Risk
78334,833,8,28,2,2,2,6,Lost
78561,3224,33,51,1,4,3,8,At Risk
78709,62,51,382,5,5,5,15,Champions
78925,11,89,243,5,5,5,15,Champions
79130,2273,38,53,1,4,3,8,At Risk
79760,96,36,171,4,4,5,13,Champions
79791,3354,24,133,1,4,4,9,At Risk
80315,166,14,190,3,3,5,11,Loyal Users
80644,193,9,28,3,2,2,7,Casual Users
80805,24,178,625,5,5,5,15,Champions
80906,187,5,12,3,1,1,5,Casual Users
81050,338,16,382,3,3,5,11,Loyal Users
81137,101,17,129,4,3,4,11,Loyal Users
81326,1541,12,25,1,3,2,6,Casual Users
81465,368,45,265,3,4,5,12,Loyal Users
81475,1809,10,69,1,2,4,7,Lost
81527,616,13,126,2,3,4,9,Casual Users
82432,262,90,343,3,5,5,13,Loyal Users
82459,2303,17,73,1,3,4,8,Casual Users
82498,865,12,26,2,3,2,7,Casual Users
82516,1662,7,13,1,2,1,4,Lost
82886,333,25,170,3,4,5,12,Loyal Users
82963,444,19,92,3,3,4,10,Loyal Users
83291,967,16,17,2,3,2,7,Casual Users
83307,122,22,29,4,4,2,10,Loyal Users
83654,122,26,79,4,4,4,12,Champions
83684,1483,14,14,1,3,1,5,Casual Users
84247,108,18,39,4,3,3,10,Loyal Users
84275,859,23,37,2,4,3,9,At Risk
84314,281,8,11,3,2,1,6,Casual Users
84445,288,34,81,3,4,4,11,Loyal Users
84720,3667,5,5,1,1,1,3,Lost
84739,420,9,11,3,2,1,6,Casual Users
84774,4613,6,12,1,1,1,3,Lost
84936,9,11,27,5,2,2,9,Promising
85268,209,10,31,3,2,2,7,Casual Users
85351,1946,6,28,1,1,2,4,Lost
85579,314,5,6,3,1,1,5,Casual Users
85748,513,17,210,2,3,5,10,Casual Users
86206,2792,6,28,1,1,2,4,Lost
86256,386,16,23,3,3,2,8,Loyal Users
86337,271,8,84,3,2,4,9,Casual Users
86406,1446,49,148,1,5,5,11,At Risk
86411,978,9,18,2,2,2,6,Lost
86443,113,18,192,4,3,5,12,Loyal Users
87023,120,40,299,4,4,5,13,Champions
87028,1384,11,31,1,2,2,5,Lost
87295,26,52,87,5,5,4,14,Champions
87339,126,6,44,4,1,3,8,Promising
87675,44,120,243,5,5,5,15,Champions
88211,6,17,88,5,3,4,12,Loyal Users
88508,1109,16,109,2,3,4,9,Casual Users
88871,866,5,19,2,1,2,5,Lost
88999,5229,6,6,1,1,1,3,Lost
89044,3,25,47,5,4,3,12,Loyal Users
89165,17,114,561,5,5,5,15,Champions
89166,111,12,48,4,3,3,10,Loyal Users
89194,1654,6,9,1,1,1,3,Lost
89428,3456,13,32,1,3,3,7,Casual Users
89461,26,127,810,5,5,5,15,Champions
89882,1729,15,25,1,3,2,6,Casual Users
90446,817,19,38,2,3,3,8,Casual Users
90450,105,69,337,4,5,5,14,Champions
90457,216,13,58,3,3,3,9,Loyal Users
90674,16,43,73,5,4,4,13,Champions
90692,430,9,50,3,2,3,8,Casual Users
90804,351,14,50,3,3,3,9,Loyal Users
90891,722,5,5,2,1,1,4,Lost
78383,577,18,45,2,3,3,8,Casual Users
78539,851,11,56,2,2,3,7,Lost
78603,153,108,170,4,5,5,14,Champions
78645,297,23,28,3,4,2,9,Loyal Users
78776,1570,7,8,1,2,1,4,Lost
79163,193,50,74,3,5,4,12,Loyal Users
79207,683,14,86,2,3,4,9,Casual Users
80535,272,90,210,3,5,5,13,Loyal Users
80561,209,43,93,3,4,4,11,Loyal Users
80669,920,11,62,2,2,3,7,Lost
80685,362,19,30,3,3,2,8,Loyal Users
80815,6,33,59,5,4,3,12,Loyal Users
80999,699,20,61,2,3,3,8,Casual Users
81703,890,11,18,2,2,2,6,Lost
81832,322,8,34,3,2,3,8,Casual Users
81968,505,7,12,2,2,1,5,Lost
82049,1419,16,18,1,3,2,6,Casual Users
82115,197,21,69,3,3,4,10,Loyal Users
82124,279,37,72,3,4,4,11,Loyal Users
82233,0,15,27,5,3,2,10,Loyal Users
82375,3222,10,26,1,2,2,5,Lost
82409,1234,8,9,2,2,1,5,Lost
82465,132,8,28,4,2,2,8,Promising
82835,420,6,21,3,1,2,6,Casual Users
82901,1779,6,9,1,1,1,3,Lost
83325,80,100,363,4,5,5,14,Champions
83421,72,17,27,4,3,2,9,Loyal Users
83536,6114,5,5,1,1,1,3,Lost
83613,3111,6,13,1,1,1,3,Lost
83663,2019,11,13,1,2,1,4,Lost
83746,3972,10,44,1,2,3,6,Lost
84288,300,25,84,3,4,4,11,Loyal Users
84479,124,29,95,4,4,4,12,Champions
84533,586,6,19,2,1,2,5,Lost
84602,2602,18,52,1,3,3,7,Casual Users
84706,297,26,31,3,4,2,9,Loyal Users
85193,592,64,217,2,5,5,12,At Risk
85456,1206,10,47,2,2,3,7,Lost
85820,553,22,33,2,4,3,9,At Risk
85840,5992,6,8,1,1,1,3,Lost
85873,511,71,108,2,5,4,11,At Risk
85900,361,6,25,3,1,2,6,Casual Users
85946,106,9,18,4,2,2,8,Promising
86480,0,76,153,5,5,5,15,Champions
86627,22,12,20,5,3,2,10,Loyal Users
86771,23,40,159,5,4,5,14,Champions
86775,181,38,46,3,4,3,10,Loyal Users
87035,18,84,228,5,5,5,15,Champions
87066,9,73,93,5,5,4,14,Champions
87219,75,12,29,4,3,2,9,Loyal Users
87224,233,24,48,3,4,3,10,Loyal Users
87349,1991,33,70,1,4,4,9,At Risk
87482,7,59,230,5,5,5,15,Champions
87742,72,65,276,4,5,5,14,Champions
87849,272,23,49,3,4,3,10,Loyal Users
88726,306,6,12,3,1,1,5,Casual Users
89221,1,9,18,5,2,2,9,Promising
89781,135,5,10,4,1,1,6,Promising
89900,370,29,52,3,4,3,10,Loyal Users
90388,470,37,114,3,4,4,11,Loyal Users
90567,656,19,69,2,3,4,9,Casual Users
90586,275,68,110,3,5,4,12,Loyal Users
90873,61,9,23,5,2,2,9,Promising
78336,272,10,107,3,2,4,9,Casual Users
78622,33,28,40,5,4,3,12,Loyal Users
78671,2340,10,11,1,2,1,4,Lost
78752,64,64,326,5,5,5,15,Champions
79049,149,19,63,4,3,4,11,Loyal Users
79248,3013,9,16,1,2,2,5,Lost
79309,534,7,34,2,2,3,7,Lost
79378,566,14,33,2,3,3,8,Casual Users
79589,49,59,569,5,5,5,15,Champions
79830,183,6,10,3,1,1,5,Casual Users
79878,2391,17,80,1,3,4,8,Casual Users
79988,2840,15,26,1,3,2,6,Casual Users
80122,393,22,33,3,4,3,10,Loyal Users
80361,147,8,12,4,2,1,7,Promising
80718,1277,37,134,1,4,4,9,At Risk
80984,41,75,222,5,5,5,15,Champions
81035,13,24,126,5,4,4,13,Champions
81132,37,40,263,5,4,5,14,Champions
81480,3,101,461,5,5,5,15,Champions
81513,1522,12,20,1,3,2,6,Casual Users
82147,172,21,70,3,3,4,10,Loyal Users
82151,145,144,269,4,5,5,14,Champions
82681,3000,6,11,1,1,1,3,Lost
82753,577,20,107,2,3,4,9,Casual Users
82889,894,38,97,2,4,4,10,At Risk
83169,14,13,30,5,3,2,10,Loyal Users
83186,889,8,13,2,2,1,5,Lost
83346,123,68,237,4,5,5,14,Champions
83391,69,79,321,5,5,5,15,Champions
83526,15,36,71,5,4,4,13,Champions
83842,74,19,180,4,3,5,12,Loyal Users
83855,418,7,12,3,2,1,6,Casual Users
83864,85,8,8,4,2,1,7,Promising
84056,881,9,20,2,2,2,6,Lost
84123,1991,10,39,1,2,3,6,Lost
84177,23,47,84,5,5,4,14,Champions
84190,582,17,66,2,3,4,9,Casual Users
84281,0,115,330,5,5,5,15,Champions
85112,490,28,143,2,4,4,10,At Risk
85237,601,28,55,2,4,3,9,At Risk
85384,97,8,12,4,2,1,7,Promising
85408,219,32,80,3,4,4,11,Loyal Users
85475,1,14,21,5,3,2,10,Loyal Users
85784,127,7,38,4,2,3,9,Promising
86251,188,38,116,3,4,4,11,Loyal Users
86338,103,56,235,4,5,5,14,Champions
86729,1741,6,8,1,1,1,3,Lost
86732,405,18,33,3,3,3,9,Loyal Users
86973,402,6,7,3,1,1,5,Casual Users
87168,1083,5,13,2,1,1,4,Lost
87301,88,65,141,4,5,4,13,Champions
87573,83,51,130,4,5,4,13,Champions
87632,972,5,17,2,1,2,5,Lost
87796,303,22,28,3,4,2,9,Loyal Users
87814,387,33,64,3,4,4,11,Loyal Users
88146,689,63,130,2,5,4,11,At Risk
88287,2400,7,7,1,2,1,4,Lost
88389,326,50,141,3,5,4,12,Loyal Users
88463,2,44,142,5,4,4,13,Champions
88527,138,190,464,4,5,5,14,Champions
88597,97,5,7,4,1,1,6,Promising
88890,606,33,95,2,4,4,10,At Risk
88908,998,22,81,2,4,4,10,At Risk
89112,77,10,23,4,2,2,8,Promising
89233,854,9,15,2,2,1,5,Lost
89296,279,5,6,3,1,1,5,Casual Users
89345,182,71,108,3,5,4,12,Loyal Users
89349,412,26,33,3,4,3,10,Loyal Users
89563,43,6,21,5,1,2,8,Promising
89710,879,5,7,2,1,1,4,Lost
89868,314,7,20,3,2,2,7,Casual Users
90130,453,5,13,3,1,1,5,Casual Users
90136,58,111,127,5,5,4,14,Champions
90296,125,45,144,4,4,4,12,Champions
90487,15,44,64,5,4,4,13,Champions
90571,1310,6,47,1,1,3,5,Lost
78677,941,46,100,2,5,4,11,At Risk
78931,269,11,59,3,2,3,8,Casual Users
79002,717,8,28,2,2,2,6,Lost
79229,807,14,61,2,3,3,8,Casual Users
79308,137,19,73,4,3,4,11,Loyal Users
79332,73,33,94,4,4,4,12,Champions
79402,297,20,48,3,3,3,9,Loyal Users
79575,428,25,72,3,4,4,11,Loyal Users
79763,155,104,351,4,5,5,14,Champions
80587,285,10,11,3,2,1,6,Casual Users
80876,261,28,48,3,4,3,10,Loyal Users
80981,1263,9,13,1,2,1,4,Lost
81425,99,46,98,4,5,4,13,Champions
81761,28,97,636,5,5,5,15,Champions
81835,5548,5,5,1,1,1,3,Lost
81872,175,42,196,3,4,5,12,Loyal Users
81888,233,70,226,3,5,5,13,Loyal Users
82039,169,22,38,3,4,3,10,Loyal Users
82500,143,9,21,4,2,2,8,Promising
82922,24,28,152,5,4,5,14,Champions
82935,101,9,104,4,2,4,10,Promising
83221,574,12,31,2,3,2,7,Casual Users
83516,71,8,9,4,2,1,7,Promising
83554,121,56,86,4,5,4,13,Champions
83843,2828,5,7,1,1,1,3,Lost
84331,39,25,196,5,4,5,14,Champions
84346,17,56,78,5,5,4,14,Champions
84420,935,33,50,2,4,3,9,At Risk
84471,33,123,497,5,5,5,15,Champions
84610,1985,10,11,1,2,1,4,Lost
84882,18,53,160,5,5,5,15,Champions
84925,673,18,37,2,3,3,8,Casual Users
85598,1102,15,39,2,3,3,8,Casual Users
85631,2026,5,5,1,1,1,3,Lost
85848,2122,8,8,1,2,1,4,Lost
85918,1115,17,67,2,3,4,9,Casual Users
86169,95,26,103,4,4,4,12,Champions
86239,421,44,88,3,4,4,11,Loyal Users
86454,404,15,65,3,3,4,10,Loyal Users
86544,122,70,260,4,5,5,14,Champions
86574,461,12,26,3,3,2,8,Loyal Users
86652,1967,5,6,1,1,1,3,Lost
86785,11,11,25,5,2,2,9,Promising
87133,153,6,7,4,1,1,6,Promising
87281,694,29,131,2,4,4,10,At Risk
88025,2104,5,5,1,1,1,3,Lost
88064,8,8,12,5,2,1,8,Promising
88162,213,64,123,3,5,4,12,Loyal Users
88264,417,8,15,3,2,1,6,Casual Users
88457,608,23,46,2,4,3,9,At Risk
88470,1684,9,9,1,2,1,4,Lost
88684,5809,9,9,1,2,1,4,Lost
88826,653,8,8,2,2,1,5,Lost
88862,60,19,74,5,3,4,12,Loyal Users
89596,979,17,66,2,3,4,9,Casual Users
89754,492,20,36,2,3,3,8,Casual Users
89929,370,39,165,3,4,5,12,Loyal Users
90048,2298,12,43,1,3,3,7,Casual Users
90073,186,20,34,3,3,3,9,Loyal Users
90180,150,40,56,4,4,3,11,Loyal Users
90691,146,36,65,4,4,4,12,Champions
78329,4298,13,75,1,3,4,8,Casual Users
78338,566,16,117,2,3,4,9,Casual Users
78425,1787,26,186,1,4,5,10,At Risk
78464,1829,21,34,1,3,3,7,Casual Users
79397,145,23,79,4,4,4,12,Champions
79417,0,73,154,5,5,5,15,Champions
79643,17,68,87,5,5,4,14,Champions
79956,132,19,64,4,3,4,11,Loyal Users
80018,139,12,36,4,3,3,10,Loyal Users
80266,649,15,49,2,3,3,8,Casual Users
80378,973,32,149,2,4,5,11,At Risk
80522,1021,7,10,2,2,1,5,Lost
80923,1950,17,41,1,3,3,7,Casual Users
81023,844,5,15,2,1,1,4,Lost
81042,139,18,59,4,3,3,10,Loyal Users
81524,413,11,23,3,2,2,7,Casual Users
81608,191,5,15,3,1,1,5,Casual Users
81936,3383,5,11,1,1,1,3,Lost
82883,3582,13,25,1,3,2,6,Casual Users
82907,1976,9,31,1,2,2,5,Lost
82920,4,107,535,5,5,5,15,Champions
83192,545,30,71,2,4,4,10,At Risk
83229,1942,10,18,1,2,2,5,Lost
83731,130,11,95,4,2,4,10,Promising
84307,148,12,16,4,3,2,9,Loyal Users
84506,37,13,20,5,3,2,10,Loyal Users
84731,156,53,99,4,5,4,13,Champions
84773,2495,12,21,1,3,2,6,Casual Users
84833,157,152,336,4,5,5,14,Champions
84867,14,11,140,5,2,4,11,Promising
85038,103,46,326,4,5,5,14,Champions
85439,4671,18,55,1,3,3,7,Casual Users
85528,51,78,253,5,5,5,15,Champions
85531,399,54,162,3,5,5,13,Loyal Users
86023,1198,73,413,2,5,5,12,At Risk
86360,761,6,25,2,1,2,5,Lost
86368,282,27,149,3,4,5,12,Loyal Users
86681,3,64,238,5,5,5,15,Champions
86694,2634,6,88,1,1,4,6,Lost
86997,178,27,67,3,4,4,11,Loyal Users
87172,280,13,29,3,3,2,8,Loyal Users
87199,1721,5,5,1,1,1,3,Lost
87210,2702,11,42,1,2,3,6,Lost
87766,10,77,217,5,5,5,15,Champions
87827,8,70,263,5,5,5,15,Champions
88027,1347,6,119,1,1,4,6,Lost
88076,2288,11,25,1,2,2,5,Lost
88150,3973,7,33,1,2,3,6,Lost
88161,158,19,68,4,3,4,11,Loyal Users
88236,2138,43,127,1,4,4,9,At Risk
88401,303,12,126,3,3,4,10,Loyal Users
88638,2029,71,181,1,5,5,11,At Risk
89109,426,5,13,3,1,1,5,Casual Users
89133,13,119,142,5,5,4,14,Champions
89196,399,15,50,3,3,3,9,Loyal Users
89295,778,12,17,2,3,2,7,Casual Users
89373,3594,5,7,1,1,1,3,Lost
89539,313,17,25,3,3,2,8,Loyal Users
89765,547,6,7,2,1,1,4,Lost
90069,104,37,133,4,4,4,12,Champions
90218,132,20,54,4,3,3,10,Loyal Users
90278,2173,6,13,1,1,1,3,Lost
90328,230,7,13,3,2,1,6,Casual Users
90393,116,34,55,4,4,3,11,Loyal Users
90555,417,33,87,3,4,4,11,Loyal Users
90712,123,100,237,4,5,5,14,Champions
90859,20,68,188,5,5,5,15,Champions
78538,1013,9,29,2,2,2,6,Lost
78689,376,62,201,3,5,5,13,Loyal Users
79222,736,27,75,2,4,4,10,At Risk
79358,7,37,103,5,4,4,13,Champions
79419,23,30,154,5,4,5,14,Champions
79700,34,22,53,5,4,3,12,Loyal Users
79889,110,50,68,4,5,4,13,Champions
79915,127,28,62,4,4,3,11,Loyal Users
80198,49,63,390,5,5,5,15,Champions
80335,717,5,6,2,1,1,4,Lost
80799,107,16,23,4,3,2,9,Loyal Users
80947,1517,7,29,1,2,2,5,Lost
80977,118,29,48,4,4,3,11,Loyal Users
81215,880,7,44,2,2,3,7,Lost
81532,695,9,35,2,2,3,7,Lost
81579,416,8,13,3,2,1,6,Casual Users
81887,144,18,26,4,3,2,9,Loyal Users
82388,1791,39,109,1,4,4,9,At Risk
83020,255,28,52,3,4,3,10,Loyal Users
83150,114,11,17,4,2,2,8,Promising
83255,548,24,68,2,4,4,10,At Risk
83715,374,100,366,3,5,5,13,Loyal Users
84110,186,27,43,3,4,3,10,Loyal Users
84685,766,13,22,2,3,2,7,Casual Users
84975,4,45,144,5,4,4,13,Champions
85185,582,20,29,2,3,2,7,Casual Users
85273,4170,10,15,1,2,1,4,Lost
85521,74,47,172,4,5,5,14,Champions
86377,28,126,315,5,5,5,15,Champions
86517,214,25,43,3,4,3,10,Loyal Users
86956,5,36,92,5,4,4,13,Champions
86984,741,5,13,2,1,1,4,Lost
87034,227,39,77,3,4,4,11,Loyal Users
87610,36,94,300,5,5,5,15,Champions
88479,990,5,5,2,1,1,4,Lost
88598,87,8,25,4,2,2,8,Promising
88956,408,5,7,3,1,1,5,Casual Users
89484,2419,5,25,1,1,2,4,Lost
89540,1229,5,14,2,1,1,4,Lost
89578,3981,6,20,1,1,2,4,Lost
89595,408,26,85,3,4,4,11,Loyal Users
89753,472,8,8,2,2,1,5,Lost
89772,2164,7,14,1,2,1,4,Lost
89817,62,23,44,5,4,3,12,Loyal Users
90039,1017,5,5,2,1,1,4,Lost
90085,399,54,169,3,5,5,13,Loyal Users
90094,8,134,387,5,5,5,15,Champions
90105,70,5,9,4,1,1,6,Promising
90319,108,7,26,4,2,2,8,Promising
90485,419,5,5,3,1,1,5,Casual Users
91000,212,23,40,3,4,3,10,Loyal Users
78301,426,6,63,3,1,4,8,Casual Users
78633,131,5,11,4,1,1,6,Promising
78742,16,38,152,5,4,5,14,Champions
78850,3,8,24,5,2,2,9,Promising
78906,423,37,55,3,4,3,10,Loyal Users
78919,327,69,116,3,5,4,12,Loyal Users
79398,1078,11,16,2,2,2,6,Lost
79483,492,8,92,2,2,4,8,Lost
79578,398,6,17,3,1,2,6,Casual Users
80241,3,5,24,5,1,2,8,Promising
80355,780,6,13,2,1,1,4,Lost
80738,2549,5,19,1,1,2,4,Lost
80832,106,68,122,4,5,4,13,Champions
81639,13,29,86,5,4,4,13,Champions
81641,978,10,10,2,2,1,5,Lost
81721,2914,5,7,1,1,1,3,Lost
81915,4440,17,45,1,3,3,7,Casual Users
82122,2020,40,99,1,4,4,9,At Risk
82228,94,11,23,4,2,2,8,Promising
82551,833,58,96,2,5,4,11,At Risk
82652,3159,6,38,1,1,3,5,Lost
82790,2137,8,28,1,2,2,5,Lost
82804,108,96,247,4,5,5,14,Champions
82925,2686,9,9,1,2,1,4,Lost
82969,2917,14,41,1,3,3,7,Casual Users
83090,837,6,7,2,1,1,4,Lost
83209,43,72,383,5,5,5,15,Champions
83487,1003,123,208,2,5,5,12,At Risk
83492,116,47,132,4,5,4,13,Champions
83546,107,5,10,4,1,1,6,Promising
83698,847,24,38,2,4,3,9,At Risk
83793,2104,7,19,1,2,2,5,Lost
84272,247,26,42,3,4,3,10,Loyal Users
84273,444,23,36,3,4,3,10,Loyal Users
84745,281,11,83,3,2,4,9,Casual Users
85250,304,53,120,3,5,4,12,Loyal Users
85419,261,10,18,3,2,2,7,Casual Users
85835,97,59,84,4,5,4,13,Champions
85877,326,20,35,3,3,3,9,Loyal Users
85910,387,13,41,3,3,3,9,Loyal Users
85953,810,12,20,2,3,2,7,Casual Users
86385,532,25,76,2,4,4,10,At Risk
86665,1645,6,12,1,1,1,3,Lost
87373,25,17,129,5,3,4,12,Loyal Users
87411,22,22,51,5,4,3,12,Loyal Users
87705,569,21,43,2,3,3,8,Casual Users
87788,117,28,79,4,4,4,12,Champions
88044,6,166,290,5,5,5,15,Champions
88227,43,6,35,5,1,3,9,Promising
88243,164,10,53,4,2,3,9,Promising
88396,85,66,107,4,5,4,13,Champions
88590,1331,8,8,1,2,1,4,Lost
88679,934,5,9,2,1,1,4,Lost
88719,326,29,100,3,4,4,11,Loyal Users
88787,6,10,25,5,2,2,9,Promising
89037,95,59,390,4,5,5,14,Champions
89047,1,66,505,5,5,5,15,Champions
89517,39,23,32,5,4,3,12,Loyal Users
89606,1,43,233,5,4,5,14,Champions
89739,129,7,13,4,2,1,7,Promising
90042,30,92,302,5,5,5,15,Champions
90059,111,42,166,4,4,5,13,Champions
90109,5,51,62,5,5,3,13,Loyal Users
90414,248,10,33,3,2,3,8,Casual Users
90611,149,30,51,4,4,3,11,Loyal Users
90636,125,16,20,4,3,2,9,Loyal Users
90777,290,20,53,3,3,3,9,Loyal Users
90968,2478,7,17,1,2,2,5,Lost
90992,1198,8,21,2,2,2,6,Lost
91004,104,39,111,4,4,4,12,Champions
91017,223,25,36,3,4,3,10,Loyal Users
91023,441,9,22,3,2,2,7,Casual Users
78485,4180,5,7,1,1,1,3,Lost
78735,5,99,225,5,5,5,15,Champions
78748,0,44,85,5,4,4,13,Champions
78993,4581,10,19,1,2,2,5,Lost
79350,778,9,20,2,2,2,6,Lost
79531,351,10,37,3,2,3,8,Casual Users
79577,43,106,202,5,5,5,15,Champions
79730,129,18,44,4,3,3,10,Loyal Users
79843,2076,22,45,1,4,3,8,At Risk
80099,271,16,29,3,3,2,8,Loyal Users
80130,39,36,70,5,4,4,13,Champions
80133,120,20,78,4,3,4,11,Loyal Users
80150,291,10,43,3,2,3,8,Casual Users
81019,1507,39,89,1,4,4,9,At Risk
81218,9,67,303,5,5,5,15,Champions
81450,39,17,24,5,3,2,10,Loyal Users
81462,127,32,72,4,4,4,12,Champions
81511,64,117,563,5,5,5,15,Champions
81589,396,11,84,3,2,4,9,Casual Users
81664,290,30,49,3,4,3,10,Loyal Users
81979,127,24,107,4,4,4,12,Champions
82114,35,53,169,5,5,5,15,Champions
82220,32,81,132,5,5,4,14,Champions
82248,130,10,16,4,2,2,8,Promising
82341,54,7,8,5,2,1,8,Promising
82351,2,7,10,5,2,1,8,Promising
82454,515,22,75,2,4,4,10,At Risk
82793,93,57,331,4,5,5,14,Champions
82799,3159,5,13,1,1,1,3,Lost
83009,3867,7,11,1,2,1,4,Lost
83082,3,102,441,5,5,5,15,Champions
83104,240,9,29,3,2,2,7,Casual Users
83298,132,33,98,4,4,4,12,Champions
83472,183,71,353,3,5,5,13,Loyal Users
83479,75,21,83,4,3,4,11,Loyal Users
83761,1833,13,54,1,3,3,7,Casual Users
83799,46,39,40,5,4,3,12,Loyal Users
84352,1988,27,99,1,4,4,9,At Risk
84396,590,118,651,2,5,5,12,At Risk
84514,1301,5,9,1,1,1,3,Lost
84828,271,77,193,3,5,5,13,Loyal Users
84956,468,31,39,3,4,3,10,Loyal Users
85104,56,11,49,5,2,3,10,Promising
85651,9,73,256,5,5,5,15,Champions
85728,232,15,30,3,3,2,8,Loyal Users
85888,1235,7,20,2,2,2,6,Lost
85908,100,26,41,4,4,3,11,Loyal Users
85922,944,7,28,2,2,2,6,Lost
86095,86,6,13,4,1,1,6,Promising
86163,32,15,43,5,3,3,11,Loyal Users
86317,127,34,51,4,4,3,11,Loyal Users
86505,392,12,23,3,3,2,8,Loyal Users
86674,704,19,44,2,3,3,8,Casual Users
86769,379,6,17,3,1,2,6,Casual Users
86845,3,31,193,5,4,5,14,Champions
87251,3171,5,6,1,1,1,3,Lost
87531,36,19,102,5,3,4,12,Loyal Users
87824,414,8,26,3,2,2,7,Casual Users
88342,289,27,43,3,4,3,10,Loyal Users
88393,416,21,31,3,3,2,8,Loyal Users
88588,542,16,18,2,3,2,7,Casual Users
88613,38,104,257,5,5,5,15,Champions
88743,66,106,378,5,5,5,15,Champions
89059,524,12,101,2,3,4,9,Casual Users
89544,1950,65,221,1,5,5,11,At Risk
89695,1248,10,13,2,2,1,5,Lost
89717,766,8,14,2,2,1,5,Lost
89891,9,142,834,5,5,5,15,Champions
89958,372,14,33,3,3,3,9,Loyal Users
90745,101,12,25,4,3,2,9,Loyal Users
91020,309,67,201,3,5,5,13,Loyal Users
78327,8,46,148,5,5,5,15,Champions
78532,4020,22,37,1,4,3,8,At Risk
78615,963,8,15,2,2,1,5,Lost
78824,682,5,20,2,1,2,5,Lost
78924,594,13,40,2,3,3,8,Casual Users
79061,11,47,122,5,5,4,14,Champions
79379,151,6,20,4,1,2,7,Promising
79387,91,10,14,4,2,1,7,Promising
79662,2863,14,47,1,3,3,7,Casual Users
79776,18,15,30,5,3,2,10,Loyal Users
79900,913,12,35,2,3,3,8,Casual Users
80078,2420,6,9,1,1,1,3,Lost
80114,725,16,72,2,3,4,9,Casual Users
80179,1199,24,162,2,4,5,11,At Risk
80294,536,7,13,2,2,1,5,Lost
80446,518,26,82,2,4,4,10,At Risk
80867,1817,8,44,1,2,3,6,Lost
81041,78,79,264,4,5,5,14,Champions
81199,950,28,44,2,4,3,9,At Risk
81443,1146,12,32,2,3,3,8,Casual Users
81971,424,10,10,3,2,1,6,Casual Users
82371,355,64,288,3,5,5,13,Loyal Users
82430,54,11,28,5,2,2,9,Promising
82800,585,33,50,2,4,3,9,At Risk
82860,95,82,611,4,5,5,14,Champions
82980,1005,16,24,2,3,2,7,Casual Users
83135,146,7,12,4,2,1,7,Promising
83423,2867,7,14,1,2,1,4,Lost
83533,10,12,18,5,3,2,10,Loyal Users
83997,429,7,15,3,2,1,6,Casual Users
84004,56,28,105,5,4,4,13,Champions
84096,296,54,65,3,5,4,12,Loyal Users
84403,89,6,14,4,1,1,6,Promising
84456,82,66,216,4,5,5,14,Champions
84491,964,15,21,2,3,2,7,Casual Users
84572,813,6,28,2,1,2,5,Lost
84616,242,69,256,3,5,5,13,Loyal Users
85078,20,64,104,5,5,4,14,Champions
85226,130,47,189,4,5,5,14,Champions
85241,260,6,20,3,1,2,6,Casual Users
85623,5112,18,35,1,3,3,7,Casual Users
85709,123,12,22,4,3,2,9,Loyal Users
85914,3,31,60,5,4,3,12,Loyal Users
86022,4440,6,8,1,1,1,3,Lost
86117,46,94,158,5,5,5,15,Champions
86310,787,7,11,2,2,1,5,Lost
86348,745,62,94,2,5,4,11,At Risk
86511,832,7,28,2,2,2,6,Lost
87111,795,5,12,2,1,1,4,Lost
87156,961,16,21,2,3,2,7,Casual Users
87313,11,22,55,5,4,3,12,Loyal Users
87439,43,15,35,5,3,3,11,Loyal Users
87511,1695,11,12,1,2,1,4,Lost
87512,4848,6,23,1,1,2,4,Lost
87801,2864,6,7,1,1,1,3,Lost
87960,616,11,98,2,2,4,8,Lost
87962,114,71,148,4,5,5,14,Champions
88073,271,6,38,3,1,3,7,Casual Users
88149,847,14,21,2,3,2,7,Casual Users
88224,297,5,36,3,1,3,7,Casual Users
88265,44,20,61,5,3,3,11,Loyal Users
88860,170,46,106,3,5,4,12,Loyal Users
88938,629,19,29,2,3,2,7,Casual Users
88941,14,61,111,5,5,4,14,Champions
89048,18,172,708,5,5,5,15,Champions
89161,276,94,136,3,5,4,12,Loyal Users
89278,1532,7,8,1,2,1,4,Lost
89309,493,13,19,2,3,2,7,Casual Users
89432,3120,5,7,1,1,1,3,Lost
89507,300,8,8,3,2,1,6,Casual Users
90175,147,219,526,4,5,5,14,Champions
90267,12,35,88,5,4,4,13,Champions
90362,699,35,89,2,4,4,10,At Risk
90430,20,54,99,5,5,4,14,Champions
90703,88,101,162,4,5,5,14,Champions
90822,65,36,153,5,4,5,14,Champions
90875,1253,6,16,2,1,2,5,Lost
91042,144,33,71,4,4,4,12,Champions
78364,34,31,70,5,4,4,13,Champions
78559,1864,12,15,1,3,1,5,Casual Users
78786,140,34,41,4,4,3,11,Loyal Users
78968,1418,6,8,1,1,1,3,Lost
79223,532,42,173,2,4,5,11,At Risk
79257,434,10,14,3,2,1,6,Casual Users
79266,51,27,58,5,4,3,12,Loyal Users
79550,1708,8,31,1,2,2,5,Lost
79798,154,21,43,4,3,3,10,Loyal Users
79952,1597,16,64,1,3,4,8,Casual Users
79990,1986,10,65,1,2,4,7,Lost
80002,937,10,112,2,2,4,8,Lost
80197,39,64,87,5,5,4,14,Champions
80570,408,27,32,3,4,3,10,Loyal Users
80884,661,11,77,2,2,4,8,Lost
81013,37,49,84,5,5,4,14,Champions
81505,55,97,152,5,5,5,15,Champions
81672,73,133,328,4,5,5,14,Champions
81846,32,33,93,5,4,4,13,Champions
82026,781,6,12,2,1,1,4,Lost
82276,35,40,171,5,4,5,14,Champions
82408,257,36,57,3,4,3,10,Loyal Users
83272,127,17,57,4,3,3,10,Loyal Users
83414,76,21,39,4,3,3,10,Loyal Users
83417,688,8,11,2,2,1,5,Lost
83519,419,11,17,3,2,2,7,Casual Users
83858,9,149,341,5,5,5,15,Champions
83948,436,11,25,3,2,2,7,Casual Users
84230,100,63,335,4,5,5,14,Champions
84436,71,19,23,4,3,2,9,Loyal Users
84483,1862,14,33,1,3,3,7,Casual Users
84519,791,8,8,2,2,1,5,Lost
84682,53,115,513,5,5,5,15,Champions
84708,108,39,228,4,4,5,13,Champions
84785,737,8,25,2,2,2,6,Lost
84858,668,28,181,2,4,5,11,At Risk
85068,3992,10,35,1,2,3,6,Lost
85258,429,49,98,3,5,4,12,Loyal Users
85633,525,12,86,2,3,4,9,Casual Users
85726,2018,13,21,1,3,2,6,Casual Users
85798,316,41,111,3,4,4,11,Loyal Users
86016,285,36,65,3,4,4,11,Loyal Users
86319,236,16,28,3,3,2,8,Loyal Users
86536,147,9,18,4,2,2,8,Promising
87260,115,16,32,4,3,3,10,Loyal Users
87309,355,25,41,3,4,3,10,Loyal Users
87540,182,67,311,3,5,5,13,Loyal Users
87634,0,60,189,5,5,5,15,Champions
88099,272,29,54,3,4,3,10,Loyal Users
88412,135,82,298,4,5,5,14,Champions
88524,1711,7,16,1,2,2,5,Lost
88541,1,20,52,5,3,3,11,Loyal Users
88619,0,77,339,5,5,5,15,Champions
88766,149,11,42,4,2,3,9,Promising
88814,256,63,271,3,5,5,13,Loyal Users
89386,394,12,21,3,3,2,8,Loyal Users
89609,146,10,63,4,2,4,10,Promising
89641,2444,5,9,1,1,1,3,Lost
89663,547,6,8,2,1,1,4,Lost
89789,246,50,100,3,5,4,12,Loyal Users
89877,5282,17,50,1,3,3,7,Casual Users
90234,1415,11,11,1,2,1,4,Lost
90385,0,29,76,5,4,4,13,Champions
90552,5608,24,27,1,4,2,7,At Risk
90563,1392,27,63,1,4,4,9,At Risk
91063,112,14,53,4,3,3,10,Loyal Users
78293,1196,19,48,2,3,3,8,Casual Users
78305,1840,7,14,1,2,1,4,Lost
78319,428,11,31,3,2,2,7,Casual Users
78408,266,20,34,3,3,3,9,Loyal Users
78492,588,74,190,2,5,5,12,At Risk
78579,1988,11,29,1,2,2,5,Lost
78604,84,38,202,4,4,5,13,Champions
78659,391,18,38,3,3,3,9,Loyal Users
78904,10,104,194,5,5,5,15,Champions
79067,1,39,92,5,4,4,13,Champions
79188,16,5,33,5,1,3,9,Promising
79231,219,43,206,3,4,5,12,Loyal Users
79457,1414,10,72,1,2,4,7,Lost
79734,1844,11,18,1,2,2,5,Lost
79832,300,29,74,3,4,4,11,Loyal Users
79850,29,44,88,5,4,4,13,Champions
79918,107,96,140,4,5,4,13,Champions
80094,133,170,320,4,5,5,14,Champions
80390,2286,8,42,1,2,3,6,Lost
80715,142,48,55,4,5,3,12,Loyal Users
81587,1203,18,74,2,3,4,9,Casual Users
81795,3131,6,10,1,1,1,3,Lost
81999,691,14,46,2,3,3,8,Casual Users
82116,594,27,52,2,4,3,9,At Risk
82141,132,72,278,4,5,5,14,Champions
82463,194,22,172,3,4,5,12,Loyal Users
83037,1709,20,92,1,3,4,8,Casual Users
83079,95,12,28,4,3,2,9,Loyal Users
83097,851,6,8,2,1,1,4,Lost
83361,4472,12,28,1,3,2,6,Casual Users
83586,52,13,24,5,3,2,10,Loyal Users
83918,273,5,9,3,1,1,5,Casual Users
83973,2991,5,12,1,1,1,3,Lost
84425,167,35,53,3,4,3,10,Loyal Users
84559,795,9,111,2,2,4,8,Lost
84576,907,7,14,2,2,1,5,Lost
84604,123,15,169,4,3,5,12,Loyal Users
85017,65,32,94,5,4,4,13,Champions
85171,1844,6,14,1,1,1,3,Lost
85205,2959,5,25,1,1,2,4,Lost
85245,5230,11,13,1,2,1,4,Lost
85689,293,5,33,3,1,3,7,Casual Users
85734,23,152,436,5,5,5,15,Champions
85986,412,13,24,3,3,2,8,Loyal Users
86014,2866,10,21,1,2,2,5,Lost
86070,9,7,11,5,2,1,8,Promising
86301,23,20,31,5,3,2,10,Loyal Users
86590,111,10,40,4,2,3,9,Promising
86660,195,37,107,3,4,4,11,Loyal Users
86809,694,11,21,2,2,2,6,Lost
87008,17,146,291,5,5,5,15,Champions
87017,5,56,121,5,5,4,14,Champions
87135,4314,15,38,1,3,3,7,Casual Users
87774,56,49,200,5,5,5,15,Champions
88846,1088,34,200,2,4,5,11,At Risk
89442,330,119,344,3,5,5,13,Loyal Users
89672,156,15,24,4,3,2,9,Loyal Users
89792,5717,10,13,1,2,1,4,Lost
90025,127,35,48,4,4,3,11,Loyal Users
90189,1822,8,9,1,2,1,4,Lost
90220,123,15,26,4,3,2,9,Loyal Users
90367,359,23,29,3,4,2,9,Loyal Users
78298,191,24,36,3,4,3,10,Loyal Users
78628,3,66,164,5,5,5,15,Champions
78706,253,6,7,3,1,1,5,Casual Users
78730,1548,10,13,1,2,1,4,Lost
78753,32,19,46,5,3,3,11,Loyal Users
78764,513,17,32,2,3,3,8,Casual Users
78820,75,30,41,4,4,3,11,Loyal Users
78829,453,5,9,3,1,1,5,Casual Users
79022,1742,9,27,1,2,2,5,Lost
79212,260,8,18,3,2,2,7,Casual Users
79259,102,10,33,4,2,3,9,Promising
79689,2700,17,48,1,3,3,7,Casual Users
80172,20,112,145,5,5,4,14,Champions
80382,4932,5,11,1,1,1,3,Lost
80493,130,96,261,4,5,5,14,Champions
80538,15,101,247,5,5,5,15,Champions
80616,278,23,54,3,4,3,10,Loyal Users
80677,1877,26,184,1,4,5,10,At Risk
80747,121,17,35,4,3,3,10,Loyal Users
80753,961,14,49,2,3,3,8,Casual Users
80778,1736,6,34,1,1,3,5,Lost
80843,176,22,34,3,4,3,10,Loyal Users
80965,5832,6,11,1,1,1,3,Lost
81303,47,11,17,5,2,2,9,Promising
81357,480,82,281,2,5,5,12,At Risk
81535,280,7,22,3,2,2,7,Casual Users
81716,27,35,87,5,4,4,13,Champions
81794,1696,18,68,1,3,4,8,Casual Users
82177,272,22,111,3,4,4,11,Loyal Users
82251,701,5,57,2,1,3,6,Lost
82749,27,5,19,5,1,2,8,Promising
82750,993,37,59,2,4,3,9,At Risk
82933,18,109,147,5,5,5,15,Champions
83197,125,10,15,4,2,1,7,Promising
83853,1283,9,13,1,2,1,4,Lost
84477,193,39,114,3,4,4,11,Loyal Users
84486,245,7,14,3,2,1,6,Casual Users
84619,1887,13,30,1,3,2,6,Casual Users
84620,992,11,30,2,2,2,6,Lost
84800,310,20,21,3,3,2,8,Loyal Users
84878,711,26,68,2,4,4,10,At Risk
85357,1371,12,22,1,3,2,6,Casual Users
85362,1469,9,9,1,2,1,4,Lost
85383,15,8,40,5,2,3,10,Promising
85468,128,40,267,4,4,5,13,Champions
85719,1145,10,16,2,2,2,6,Lost
85962,54,93,251,5,5,5,15,Champions
86084,627,8,23,2,2,2,6,Lost
86191,1193,26,136,2,4,4,10,At Risk
86520,42,19,65,5,3,4,12,Loyal Users
86532,1693,9,172,1,2,5,8,Lost
86671,8,72,220,5,5,5,15,Champions
86755,132,13,53,4,3,3,10,Loyal Users
86833,2521,8,41,1,2,3,6,Lost
86841,24,76,446,5,5,5,15,Champions
87098,2509,10,24,1,2,2,5,Lost
87451,981,6,12,2,1,1,4,Lost
87932,23,25,132,5,4,4,13,Champions
88048,64,187,312,5,5,5,15,Champions
88139,1116,6,16,2,1,2,5,Lost
88608,6,154,545,5,5,5,15,Champions
89607,80,18,96,4,3,4,11,Loyal Users
89804,3,98,355,5,5,5,15,Champions
89905,1205,11,39,2,2,3,7,Lost
90416,385,14,42,3,3,3,9,Loyal Users
90501,1151,7,9,2,2,1,5,Lost
90609,512,10,11,2,2,1,5,Lost
90794,831,7,16,2,2,2,6,Lost
78552,834,9,61,2,2,3,7,Lost
78686,36,159,262,5,5,5,15,Champions
79081,2961,15,68,1,3,4,8,Casual Users
79205,3607,38,59,1,4,3,8,At Risk
79206,34,79,474,5,5,5,15,Champions
79319,177,47,62,3,5,3,11,Loyal Users
79609,269,22,83,3,4,4,11,Loyal Users
79863,693,5,7,2,1,1,4,Lost
80097,127,43,151,4,4,5,13,Champions
80135,589,5,5,2,1,1,4,Lost
80166,1840,25,48,1,4,3,8,At Risk
80731,273,202,499,3,5,5,13,Loyal Users
80881,315,11,31,3,2,2,7,Casual Users
81248,40,7,29,5,2,2,9,Promising
81259,837,5,75,2,1,4,7,Lost
81269,3545,5,29,1,1,2,4,Lost
81270,430,15,40,3,3,3,9,Loyal Users
81696,111,9,12,4,2,1,7,Promising
81711,127,5,6,4,1,1,6,Promising
81763,16,9,31,5,2,2,9,Promising
82076,9,28,34,5,4,3,12,Loyal Users
82209,282,36,62,3,4,3,10,Loyal Users
82303,965,12,13,2,3,1,6,Casual Users
82392,20,30,78,5,4,4,13,Champions
82398,161,98,212,4,5,5,14,Champions
82945,837,20,35,2,3,3,8,Casual Users
83084,5578,8,8,1,2,1,4,Lost
83289,146,54,277,4,5,5,14,Champions
83385,1774,29,53,1,4,3,8,At Risk
83498,236,12,106,3,3,4,10,Loyal Users
83727,2830,74,95,1,5,4,10,At Risk
83732,0,81,202,5,5,5,15,Champions
83939,294,27,99,3,4,4,11,Loyal Users
84135,380,26,103,3,4,4,11,Loyal Users
84196,123,60,131,4,5,4,13,Champions
84460,2539,7,7,1,2,1,4,Lost
84540,7,21,28,5,3,2,10,Loyal Users
84629,743,11,22,2,2,2,6,Lost
85079,268,5,14,3,1,1,5,Casual Users
85450,1346,8,9,1,2,1,4,Lost
85469,21,43,78,5,4,4,13,Champions
85568,0,130,715,5,5,5,15,Champions
85582,334,22,71,3,4,4,11,Loyal Users
85955,1530,8,82,1,2,4,7,Lost
86343,101,15,74,4,3,4,11,Loyal Users
86531,1832,8,52,1,2,3,6,Lost
86970,106,23,82,4,4,4,12,Champions
86999,158,47,136,4,5,4,13,Champions
87059,22,89,226,5,5,5,15,Champions
87073,157,21,38,4,3,3,10,Loyal Users
87782,1521,6,9,1,1,1,3,Lost
87987,545,5,11,2,1,1,4,Lost
88088,18,54,278,5,5,5,15,Champions
88250,351,8,13,3,2,1,6,Casual Users
88522,2812,11,35,1,2,3,6,Lost
88554,95,61,277,4,5,5,14,Champions
88612,439,19,70,3,3,4,10,Loyal Users
88704,136,35,168,4,4,5,13,Champions
88939,1564,7,12,1,2,1,4,Lost
89009,0,143,627,5,5,5,15,Champions
89310,134,20,50,4,3,3,10,Loyal Users
89497,2,25,32,5,4,3,12,Loyal Users
89550,680,8,9,2,2,1,5,Lost
89581,181,9,11,3,2,1,6,Casual Users
89632,111,16,55,4,3,3,10,Loyal Users
89706,65,45,86,5,4,4,13,Champions
89837,4625,5,5,1,1,1,3,Lost
90030,1003,6,6,2,1,1,4,Lost
90304,52,53,104,5,5,4,14,Champions
90482,1358,10,22,1,2,2,5,Lost
90709,725,6,9,2,1,1,4,Lost
78403,380,16,64,3,3,4,10,Loyal Users
78555,845,14,31,2,3,2,7,Casual Users
78750,384,21,23,3,3,2,8,Loyal Users
78954,0,133,202,5,5,5,15,Champions
78986,20,42,108,5,4,4,13,Champions
79108,757,21,70,2,3,4,9,Casual Users
79111,137,35,106,4,4,4,12,Champions
79203,69,26,75,5,4,4,13,Champions
79389,790,8,27,2,2,2,6,Lost
79995,92,17,27,4,3,2,9,Loyal Users
80042,85,7,43,4,2,3,9,Promising
80157,21,44,92,5,4,4,13,Champions
80447,793,13,38,2,3,3,8,Casual Users
80623,3191,11,33,1,2,3,6,Lost
80957,260,15,42,3,3,3,9,Loyal Users
81370,146,47,96,4,5,4,13,Champions
81630,372,18,63,3,3,4,10,Loyal Users
81768,1,73,102,5,5,4,14,Champions
81967,390,28,169,3,4,5,12,Loyal Users
81976,180,21,33,3,3,3,9,Loyal Users
82216,18,30,214,5,4,5,14,Champions
82628,897,31,92,2,4,4,10,At Risk
82731,264,25,58,3,4,3,10,Loyal Users
83656,439,9,53,3,2,3,8,Casual Users
83854,213,47,130,3,5,4,12,Loyal Users
83895,348,28,106,3,4,4,11,Loyal Users
83923,985,8,20,2,2,2,6,Lost
83979,329,67,200,3,5,5,13,Loyal Users
84013,1282,23,50,1,4,3,8,At Risk
84203,3141,9,26,1,2,2,5,Lost
84271,1989,8,14,1,2,1,4,Lost
84472,2477,8,17,1,2,2,5,Lost
84631,3138,9,41,1,2,3,6,Lost
84650,90,25,33,4,4,3,11,Loyal Users
84765,1123,24,36,2,4,3,9,At Risk
84819,405,60,150,3,5,5,13,Loyal Users
85061,66,42,151,5,4,5,14,Champions
85088,1463,8,42,1,2,3,6,Lost
85210,173,27,149,3,4,5,12,Loyal Users
85485,691,8,26,2,2,2,6,Lost
85643,1658,23,40,1,4,3,8,At Risk
85665,3740,24,105,1,4,4,9,At Risk
85743,105,30,120,4,4,4,12,Champions
86130,423,11,16,3,2,2,7,Casual Users
86649,8,8,72,5,2,4,11,Promising
87383,279,58,148,3,5,5,13,Loyal Users
87413,9,53,224,5,5,5,15,Champions
87663,19,61,408,5,5,5,15,Champions
87714,537,98,410,2,5,5,12,At Risk
88124,81,8,8,4,2,1,7,Promising
88385,20,34,46,5,4,3,12,Loyal Users
88409,1874,12,17,1,3,2,6,Casual Users
88640,16,96,293,5,5,5,15,Champions
88712,246,96,192,3,5,5,13,Loyal Users
88813,1133,15,29,2,3,2,7,Casual Users
88879,132,5,29,4,1,2,7,Promising
89560,30,5,10,5,1,1,7,Promising
89561,1718,9,11,1,2,1,4,Lost
89615,466,6,8,3,1,1,5,Casual Users
89719,262,5,7,3,1,1,5,Casual Users
89931,472,5,6,2,1,1,4,Lost
89951,699,17,44,2,3,3,8,Casual Users
90072,495,16,37,2,3,3,8,Casual Users
90254,1119,6,15,2,1,1,4,Lost
90272,487,49,102,2,5,4,11,At Risk
90280,70,24,35,4,4,3,11,Loyal Users
90454,88,9,11,4,2,1,7,Promising
90490,4231,15,48,1,3,3,7,Casual Users
90573,1116,7,17,2,2,2,6,Lost
90659,439,8,23,3,2,2,7,Casual Users
90769,1705,5,23,1,1,2,4,Lost
78664,1210,7,50,2,2,3,7,Lost
78899,158,54,127,4,5,4,13,Champions
78983,11,53,94,5,5,4,14,Champions
79003,105,63,111,4,5,4,13,Champions
79025,78,30,84,4,4,4,12,Champions
79047,1820,6,15,1,1,1,3,Lost
79059,1382,11,21,1,2,2,5,Lost
79065,408,13,66,3,3,4,10,Loyal Users
79072,23,40,129,5,4,4,13,Champions
79301,38,23,31,5,4,2,11,Loyal Users
79600,278,14,71,3,3,4,10,Loyal Users
79711,669,7,22,2,2,2,6,Lost
79910,259,56,109,3,5,4,12,Loyal Users
79994,473,5,6,2,1,1,4,Lost
80168,1654,6,13,1,1,1,3,Lost
80189,272,14,30,3,3,2,8,Loyal Users
80308,2139,5,28,1,1,2,4,Lost
80434,11,88,665,5,5,5,15,Champions
80556,1586,13,22,1,3,2,6,Casual Users
80657,3817,5,24,1,1,2,4,Lost
80804,338,12,139,3,3,4,10,Loyal Users
80979,26,123,544,5,5,5,15,Champions
81007,4,73,232,5,5,5,15,Champions
81175,23,13,14,5,3,1,9,Loyal Users
81521,640,15,43,2,3,3,8,Casual Users
81755,1513,7,10,1,2,1,4,Lost
82055,135,103,313,4,5,5,14,Champions
82424,121,31,87,4,4,4,12,Champions
82629,142,59,280,4,5,5,14,Champions
83473,653,8,36,2,2,3,7,Lost
83569,1293,21,115,1,3,4,8,Casual Users
83789,304,13,44,3,3,3,9,Loyal Users
83975,117,13,65,4,3,4,11,Loyal Users
84173,283,12,96,3,3,4,10,Loyal Users
84215,17,25,27,5,4,2,11,Loyal Users
84290,45,39,93,5,4,4,13,Champions
84563,890,25,34,2,4,3,9,At Risk
84969,0,93,118,5,5,4,14,Champions
84992,1174,10,34,2,2,3,7,Lost
85138,101,116,510,4,5,5,14,Champions
85317,69,92,119,5,5,4,14,Champions
85427,425,22,188,3,4,5,12,Loyal Users
85452,424,5,16,3,1,2,6,Casual Users
85467,180,100,308,3,5,5,13,Loyal Users
86017,699,5,13,2,1,1,4,Lost
86083,840,30,60,2,4,3,9,At Risk
86268,74,47,205,4,5,5,14,Champions
86390,113,31,47,4,4,3,11,Loyal Users
86434,1817,5,24,1,1,2,4,Lost
86547,30,37,262,5,4,5,14,Champions
86582,974,16,27,2,3,2,7,Casual Users
86658,278,8,14,3,2,1,6,Casual Users
86818,318,6,8,3,1,1,5,Casual Users
87379,278,5,5,3,1,1,5,Casual Users
87647,613,7,22,2,2,2,6,Lost
87861,700,5,9,2,1,1,4,Lost
88053,17,21,28,5,3,2,10,Loyal Users
88919,96,7,82,4,2,4,10,Promising
88990,411,34,83,3,4,4,11,Loyal Users
88991,165,8,25,4,2,2,8,Promising
89268,4592,10,10,1,2,1,4,Lost
89509,79,13,25,4,3,2,9,Loyal Users
89809,69,12,13,5,3,1,9,Loyal Users
89881,1711,9,10,1,2,1,4,Lost
90311,115,32,86,4,4,4,12,Champions
90541,2026,8,25,1,2,2,5,Lost
90557,101,56,159,4,5,5,14,Champions
90646,35,29,38,5,4,3,12,Loyal Users
90965,120,84,709,4,5,5,14,Champions
78289,147,10,10,4,2,1,7,Promising
78556,4417,5,9,1,1,1,3,Lost
78817,1418,6,7,1,1,1,3,Lost
78858,4403,6,13,1,1,1,3,Lost
78959,135,28,67,4,4,4,12,Champions
79117,425,12,28,3,3,2,8,Loyal Users
79271,134,35,93,4,4,4,12,Champions
79286,121,14,48,4,3,3,10,Loyal Users
79902,138,133,559,4,5,5,14,Champions
80630,1206,31,79,2,4,4,10,At Risk
80652,1117,12,40,2,3,3,8,Casual Users
80817,686,25,60,2,4,3,9,At Risk
80840,60,51,241,5,5,5,15,Champions
81444,130,68,144,4,5,4,13,Champions
81563,1529,5,9,1,1,1,3,Lost
81695,2980,16,59,1,3,3,7,Casual Users
81830,60,16,24,5,3,2,10,Loyal Users
82206,84,83,283,4,5,5,14,Champions
82256,106,8,51,4,2,3,9,Promising
82324,30,22,110,5,4,4,13,Champions
82491,818,27,101,2,4,4,10,At Risk
82519,148,12,25,4,3,2,9,Loyal Users
82543,595,19,22,2,3,2,7,Casual Users
82765,0,5,15,5,1,1,7,Promising
82766,1437,11,20,1,2,2,5,Lost
83199,1885,7,14,1,2,1,4,Lost
83402,2727,5,13,1,1,1,3,Lost
83528,961,6,8,2,1,1,4,Lost
83593,303,48,198,3,5,5,13,Loyal Users
83742,130,10,10,4,2,1,7,Promising
84567,282,6,30,3,1,2,6,Casual Users
84590,722,11,51,2,2,3,7,Lost
84599,19,13,33,5,3,3,11,Loyal Users
84818,317,15,129,3,3,4,10,Loyal Users
84859,401,43,82,3,4,4,11,Loyal Users
85211,68,7,24,5,2,2,9,Promising
85347,32,166,392,5,5,5,15,Champions
85510,669,29,46,2,4,3,9,At Risk
85792,14,150,294,5,5,5,15,Champions
85917,95,6,25,4,1,2,7,Promising
86656,138,29,65,4,4,4,12,Champions
87014,123,26,266,4,4,5,13,Champions
87064,1566,8,34,1,2,3,6,Lost
87130,3114,18,73,1,3,4,8,Casual Users
87420,1122,6,12,2,1,1,4,Lost
87468,3938,6,27,1,1,2,4,Lost
87539,442,12,36,3,3,3,9,Loyal Users
87595,35,89,312,5,5,5,15,Champions
87730,1163,5,9,2,1,1,4,Lost
88037,6,15,109,5,3,4,12,Loyal Users
88386,147,54,100,4,5,4,13,Champions
89320,0,35,171,5,4,5,14,Champions
89334,576,5,12,2,1,1,4,Lost
89649,424,7,10,3,2,1,6,Casual Users
89937,46,59,533,5,5,5,15,Champions
90147,51,194,302,5,5,5,15,Champions
90358,768,9,43,2,2,3,7,Lost
90379,1264,36,110,1,4,4,9,At Risk
90528,82,90,501,4,5,5,14,Champions
90780,3685,5,13,1,1,1,3,Lost
90854,11,19,69,5,3,4,12,Loyal Users
90897,306,21,76,3,3,4,10,Loyal Users
91021,1006,6,16,2,1,2,5,Lost
78378,1103,20,35,2,3,3,8,Casual Users
78675,252,5,7,3,1,1,5,Casual Users
78912,1101,7,23,2,2,2,6,Lost
79090,946,13,15,2,3,1,6,Casual Users
79299,918,6,33,2,1,3,6,Lost
79574,125,34,74,4,4,4,12,Champions
79634,9,36,150,5,4,5,14,Champions
79966,5030,11,17,1,2,2,5,Lost
79967,992,7,22,2,2,2,6,Lost
80161,225,51,245,3,5,5,13,Loyal Users
80393,190,109,288,3,5,5,13,Loyal Users
80534,275,8,43,3,2,3,8,Casual Users
80722,299,120,625,3,5,5,13,Loyal Users
80836,232,29,208,3,4,5,12,Loyal Users
81299,82,12,44,4,3,3,10,Loyal Users
81449,4830,6,17,1,1,2,4,Lost
81491,3,17,74,5,3,4,12,Loyal Users
81576,92,8,14,4,2,1,7,Promising
81972,195,68,416,3,5,5,13,Loyal Users
82572,167,95,367,3,5,5,13,Loyal Users
82575,1118,14,70,2,3,4,9,Casual Users
82631,747,8,15,2,2,1,5,Lost
83223,826,13,15,2,3,1,6,Casual Users
83354,1385,6,9,1,1,1,3,Lost
83571,1160,29,241,2,4,5,11,At Risk
83754,204,14,18,3,3,2,8,Loyal Users
83901,122,14,20,4,3,2,9,Loyal Users
84107,537,9,14,2,2,1,5,Lost
84132,559,8,11,2,2,1,5,Lost
84217,542,24,35,2,4,3,9,At Risk
84923,154,25,36,4,4,3,11,Loyal Users
85666,1291,12,15,1,3,1,5,Casual Users
86328,963,11,21,2,2,2,6,Lost
86546,28,11,16,5,2,2,9,Promising
86597,71,34,83,4,4,4,12,Champions
86796,412,15,36,3,3,3,9,Loyal Users
86968,1587,5,9,1,1,1,3,Lost
87225,413,5,12,3,1,1,5,Casual Users
87354,1107,5,5,2,1,1,4,Lost
87412,2968,5,39,1,1,3,5,Lost
87885,166,52,120,3,5,4,12,Loyal Users
88107,1159,35,78,2,4,4,10,At Risk
88373,124,135,188,4,5,5,14,Champions
88819,4595,11,20,1,2,2,5,Lost
89011,83,105,154,4,5,5,14,Champions
89271,502,6,17,2,1,2,5,Lost
89816,441,6,22,3,1,2,6,Casual Users
90243,10,121,253,5,5,5,15,Champions
90680,448,49,245,3,5,5,13,Loyal Users
90923,272,22,35,3,4,3,10,Loyal Users
78357,33,26,160,5,4,5,14,Champions
78466,124,11,31,4,2,2,8,Promising
78853,853,8,17,2,2,2,6,Lost
79198,1508,18,63,1,3,4,8,Casual Users
79285,102,39,55,4,4,3,11,Loyal Users
79595,0,52,353,5,5,5,15,Champions
79911,1868,5,25,1,1,2,4,Lost
80107,833,64,88,2,5,4,11,At Risk
80199,954,7,12,2,2,1,5,Lost
80246,12,43,76,5,4,4,13,Champions
80465,5091,6,6,1,1,1,3,Lost
80672,671,7,11,2,2,1,5,Lost
80856,12,131,463,5,5,5,15,Champions
81140,1002,6,34,2,1,3,6,Lost
81169,69,28,82,5,4,4,13,Champions
81174,1308,8,65,1,2,4,7,Lost
81254,123,20,79,4,3,4,11,Loyal Users
81293,1,61,482,5,5,5,15,Champions
81400,683,5,15,2,1,1,4,Lost
81486,567,46,171,2,5,5,12,At Risk
81834,32,39,136,5,4,4,13,Champions
81839,578,8,119,2,2,4,8,Lost
81952,938,12,29,2,3,2,7,Casual Users
82138,2848,5,89,1,1,4,6,Lost
82436,1366,11,42,1,2,3,6,Lost
83225,123,31,114,4,4,4,12,Champions
83669,540,15,40,2,3,3,8,Casual Users
83695,688,34,56,2,4,3,9,At Risk
84515,319,6,10,3,1,1,5,Casual Users
84673,277,22,56,3,4,3,10,Loyal Users
84751,858,5,7,2,1,1,4,Lost
84791,91,7,19,4,2,2,8,Promising
85370,320,6,30,3,1,2,6,Casual Users
85583,93,105,345,4,5,5,14,Champions
85857,433,11,29,3,2,2,7,Casual Users
86090,171,7,18,3,2,2,7,Casual Users
86221,280,17,145,3,3,4,10,Loyal Users
86399,77,9,9,4,2,1,7,Promising
86420,130,40,59,4,4,3,11,Loyal Users
86472,211,80,140,3,5,4,12,Loyal Users
86498,358,16,57,3,3,3,9,Loyal Users
86673,37,57,106,5,5,4,14,Champions
86781,2792,6,8,1,1,1,3,Lost
86983,2777,5,10,1,1,1,3,Lost
86995,139,30,59,4,4,3,11,Loyal Users
87075,80,5,6,4,1,1,6,Promising
87087,871,33,54,2,4,3,9,At Risk
87147,55,23,62,5,4,3,12,Loyal Users
87222,54,34,45,5,4,3,12,Loyal Users
87303,56,76,131,5,5,4,14,Champions
87385,129,13,24,4,3,2,9,Loyal Users
87396,10,69,293,5,5,5,15,Champions
87925,2089,14,77,1,3,4,8,Casual Users
88414,1211,33,164,2,4,5,11,At Risk
88611,750,10,28,2,2,2,6,Lost
88694,998,8,13,2,2,1,5,Lost
88843,77,172,315,4,5,5,14,Champions
88920,317,117,420,3,5,5,13,Loyal Users
89332,0,220,739,5,5,5,15,Champions
89381,26,19,51,5,3,3,11,Loyal Users
89523,437,59,169,3,5,5,13,Loyal Users
89628,120,31,47,4,4,3,11,Loyal Users
90476,280,72,640,3,5,5,13,Loyal Users
90642,9,11,13,5,2,1,8,Promising
90836,648,12,24,2,3,2,7,Casual Users
91067,10,83,142,5,5,4,14,Champions
78443,1522,14,26,1,3,2,6,Casual Users
78470,147,11,26,4,2,2,8,Promising
78567,150,18,23,4,3,2,9,Loyal Users
78847,428,22,33,3,4,3,10,Loyal Users
78876,280,36,84,3,4,4,11,Loyal Users
79121,124,7,12,4,2,1,7,Promising
79300,14,75,340,5,5,5,15,Champions
79362,110,63,458,4,5,5,14,Champions
79630,481,6,10,2,1,1,4,Lost
79785,408,55,183,3,5,5,13,Loyal Users
79836,533,10,18,2,2,2,6,Lost
80011,691,9,21,2,2,2,6,Lost
80085,1117,116,211,2,5,5,12,At Risk
80394,1250,16,41,2,3,3,8,Casual Users
80639,3248,138,186,1,5,5,11,At Risk
80688,121,78,157,4,5,5,14,Champions
80695,4161,7,7,1,2,1,4,Lost
80703,853,14,17,2,3,2,7,Casual Users
80883,1007,6,23,2,1,2,5,Lost
81011,62,58,147,5,5,5,15,Champions
81118,429,6,16,3,1,2,6,Casual Users
81177,425,21,52,3,3,3,9,Loyal Users
81708,1285,29,163,1,4,5,10,At Risk
81754,0,50,168,5,5,5,15,Champions
81780,123,115,487,4,5,5,14,Champions
82058,159,12,25,4,3,2,9,Loyal Users
82290,299,51,145,3,5,4,12,Loyal Users
82325,1481,18,62,1,3,3,7,Casual Users
82453,5,12,19,5,3,2,10,Loyal Users
82865,1011,5,6,2,1,1,4,Lost
82977,1704,5,5,1,1,1,3,Lost
83012,1992,7,31,1,2,2,5,Lost
84357,23,70,156,5,5,5,15,Champions
85058,1820,5,12,1,1,1,3,Lost
85093,544,5,9,2,1,1,4,Lost
85303,42,14,153,5,3,5,13,Loyal Users
85705,33,24,39,5,4,3,12,Loyal Users
86045,153,55,321,4,5,5,14,Champions
86064,251,8,83,3,2,4,9,Casual Users
86750,2106,9,22,1,2,2,5,Lost
86761,183,30,78,3,4,4,11,Loyal Users
86808,4530,5,5,1,1,1,3,Lost
86872,444,13,63,3,3,4,10,Loyal Users
86874,6,44,90,5,4,4,13,Champions
87108,71,73,181,4,5,5,14,Champions
88316,1156,9,43,2,2,3,7,Lost
88355,484,36,96,2,4,4,10,At Risk
89175,99,10,12,4,2,1,7,Promising
89313,2246,10,16,1,2,2,5,Lost
89372,228,12,91,3,3,4,10,Loyal Users
89552,64,86,578,5,5,5,15,Champions
89718,1222,23,27,2,4,2,8,At Risk
90046,66,105,287,5,5,5,15,Champions
90210,839,15,33,2,3,3,8,Casual Users
90372,113,29,109,4,4,4,12,Champions
90757,554,24,36,2,4,3,9,At Risk
90776,118,10,24,4,2,2,8,Promising
90799,14,207,762,5,5,5,15,Champions
90922,940,25,145,2,4,4,10,At Risk
78417,19,49,95,5,5,4,14,Champions
78450,32,33,183,5,4,5,14,Champions
78469,91,12,52,4,3,3,10,Loyal Users
78972,179,81,169,3,5,5,13,Loyal Users
79262,1,103,821,5,5,5,15,Champions
79338,1357,6,11,1,1,1,3,Lost
79687,489,19,50,2,3,3,8,Casual Users
80052,28,20,30,5,3,2,10,Loyal Users
80746,153,53,105,4,5,4,13,Champions
81021,2463,21,67,1,3,4,8,Casual Users
81197,2526,5,10,1,1,1,3,Lost
81287,1305,19,28,1,3,2,6,Casual Users
81492,27,36,94,5,4,4,13,Champions
81518,47,6,40,5,1,3,9,Promising
81945,144,73,91,4,5,4,13,Champions
82161,0,23,39,5,4,3,12,Loyal Users
82467,1022,5,13,2,1,1,4,Lost
82732,83,172,485,4,5,5,14,Champions
83514,127,5,16,4,1,2,7,Promising
83878,2553,5,8,1,1,1,3,Lost
83886,291,13,28,3,3,2,8,Loyal Users
83928,696,14,21,2,3,2,7,Casual Users
84094,2709,6,10,1,1,1,3,Lost
84118,492,26,81,2,4,4,10,At Risk
84207,2116,5,18,1,1,2,4,Lost
84381,4385,10,15,1,2,1,4,Lost
84846,252,30,51,3,4,3,10,Loyal Users
84886,4297,6,54,1,1,3,5,Lost
84929,1304,5,28,1,1,2,4,Lost
85260,844,11,22,2,2,2,6,Lost
85271,16,35,115,5,4,4,13,Champions
85729,130,17,40,4,3,3,10,Loyal Users
85927,92,8,25,4,2,2,8,Promising
85950,282,15,15,3,3,1,7,Loyal Users
86210,301,12,111,3,3,4,10,Loyal Users
86933,75,77,213,4,5,5,14,Champions
87345,145,113,408,4,5,5,14,Champions
87508,451,5,22,3,1,2,6,Casual Users
87543,2,45,98,5,4,4,13,Champions
87769,141,49,69,4,5,4,13,Champions
88046,605,11,15,2,2,1,5,Lost
88160,9,21,52,5,3,3,11,Loyal Users
88285,79,62,141,4,5,4,13,Champions
88299,454,12,28,3,3,2,8,Loyal Users
88488,282,6,35,3,1,3,7,Casual Users
88703,54,40,131,5,4,4,13,Champions
88775,100,22,35,4,4,3,11,Loyal Users
89234,67,26,227,5,4,5,14,Champions
89241,3342,6,9,1,1,1,3,Lost
89292,533,5,23,2,1,2,5,Lost
89350,805,25,62,2,4,3,9,At Risk
89489,1079,7,13,2,2,1,5,Lost
89771,925,27,61,2,4,3,9,At Risk
89788,39,76,168,5,5,5,15,Champions
90360,744,7,10,2,2,1,5,Lost
90524,839,5,20,2,1,2,5,Lost
78315,50,42,57,5,4,3,12,Loyal Users
78609,133,49,347,4,5,5,14,Champions
78877,156,9,37,4,2,3,9,Promising
78909,668,5,8,2,1,1,4,Lost
79035,403,36,87,3,4,4,11,Loyal Users
79077,1879,5,19,1,1,2,4,Lost
79195,861,8,20,2,2,2,6,Lost
79265,4655,11,29,1,2,2,5,Lost
79882,442,10,41,3,2,3,8,Casual Users
79897,167,34,45,3,4,3,10,Loyal Users
79944,3605,7,10,1,2,1,4,Lost
80222,43,19,120,5,3,4,12,Loyal Users
80625,282,18,53,3,3,3,9,Loyal Users
80773,892,9,11,2,2,1,5,Lost
80795,1420,5,16,1,1,2,4,Lost
80848,42,116,343,5,5,5,15,Champions
80987,3541,92,287,1,5,5,11,At Risk
81080,1072,7,10,2,2,1,5,Lost
81082,2746,5,11,1,1,1,3,Lost
81662,1206,5,11,2,1,1,4,Lost
81757,138,17,25,4,3,2,9,Loyal Users
81951,551,5,10,2,1,1,4,Lost
82160,823,5,6,2,1,1,4,Lost
82347,124,10,21,4,2,2,8,Promising
82349,252,5,10,3,1,1,5,Casual Users
82671,1434,6,10,1,1,1,3,Lost
82704,347,18,56,3,3,3,9,Loyal Users
82784,25,41,191,5,4,5,14,Champions
83309,449,29,100,3,4,4,11,Loyal Users
83425,57,80,199,5,5,5,15,Champions
83781,0,27,133,5,4,4,13,Champions
83867,1182,10,29,2,2,2,6,Lost
84009,78,8,11,4,2,1,7,Promising
84027,70,15,81,4,3,4,11,Loyal Users
84562,695,5,7,2,1,1,4,Lost
84628,112,21,51,4,3,3,10,Loyal Users
85558,4551,9,47,1,2,3,6,Lost
85992,102,65,267,4,5,5,14,Champions
86279,999,5,11,2,1,1,4,Lost
86482,57,119,312,5,5,5,15,Champions
86774,822,5,36,2,1,3,6,Lost
86860,18,55,101,5,5,4,14,Champions
86901,110,5,6,4,1,1,6,Promising
87078,3658,10,12,1,2,1,4,Lost
87177,150,8,19,4,2,2,8,Promising
87250,151,21,76,4,3,4,11,Loyal Users
87502,419,43,83,3,4,4,11,Loyal Users
87633,566,11,22,2,2,2,6,Lost
87912,6,8,54,5,2,3,10,Promising
88750,429,28,117,3,4,4,11,Loyal Users
89189,126,17,26,4,3,2,9,Loyal Users
89727,569,10,14,2,2,1,5,Lost
89886,5312,11,66,1,2,4,7,Lost
90612,1912,16,56,1,3,3,7,Casual Users
78501,3609,9,9,1,2,1,4,Lost
78727,90,9,80,4,2,4,10,Promising
78902,499,23,83,2,4,4,10,At Risk
78955,399,57,106,3,5,4,12,Loyal Users
79239,0,5,23,5,1,2,8,Promising
79253,292,6,9,3,1,1,5,Casual Users
79258,0,100,367,5,5,5,15,Champions
79505,77,80,293,4,5,5,14,Champions
79532,5274,5,5,1,1,1,3,Lost
79557,536,13,34,2,3,3,8,Casual Users
79847,129,12,46,4,3,3,10,Loyal Users
80228,424,8,61,3,2,3,8,Casual Users
80354,93,94,641,4,5,5,14,Champions
80622,1110,9,25,2,2,2,6,Lost
80681,4345,9,47,1,2,3,6,Lost
81018,3174,7,14,1,2,1,4,Lost
81036,697,8,13,2,2,1,5,Lost
81037,276,44,93,3,4,4,11,Loyal Users
81038,119,110,287,4,5,5,14,Champions
81099,104,54,104,4,5,4,13,Champions
81161,138,48,89,4,5,4,13,Champions
81252,414,6,16,3,1,2,6,Casual Users
81487,12,81,276,5,5,5,15,Champions
81602,154,26,128,4,4,4,12,Champions
81653,42,75,363,5,5,5,15,Champions
82086,129,16,32,4,3,3,10,Loyal Users
82415,3,30,78,5,4,4,13,Champions
82583,872,9,18,2,2,2,6,Lost
82618,4702,5,6,1,1,1,3,Lost
82707,689,18,24,2,3,2,7,Casual Users
83049,113,10,19,4,2,2,8,Promising
83141,137,31,61,4,4,3,11,Loyal Users
83604,2311,5,10,1,1,1,3,Lost
83612,598,11,20,2,2,2,6,Lost
83620,253,6,11,3,1,1,5,Casual Users
83825,19,52,68,5,5,4,14,Champions
83904,306,18,78,3,3,4,10,Loyal Users
83951,432,9,38,3,2,3,8,Casual Users
83995,62,77,224,5,5,5,15,Champions
84278,7,53,83,5,5,4,14,Champions
84354,45,71,418,5,5,5,15,Champions
84634,2,10,38,5,2,3,10,Promising
84728,3365,24,49,1,4,3,8,At Risk
85145,3215,7,11,1,2,1,4,Lost
85244,81,80,213,4,5,5,14,Champions
85372,650,9,38,2,2,3,7,Lost
85621,338,24,251,3,4,5,12,Loyal Users
85960,248,125,238,3,5,5,13,Loyal Users
86287,89,71,238,4,5,5,14,Champions
86497,852,6,7,2,1,1,4,Lost
86499,2236,50,183,1,5,5,11,At Risk
86587,423,25,60,3,4,3,10,Loyal Users
86707,24,83,187,5,5,5,15,Champions
86892,206,25,72,3,4,4,11,Loyal Users
87027,118,67,423,4,5,5,14,Champions
87221,16,54,84,5,5,4,14,Champions
87361,263,5,15,3,1,1,5,Casual Users
87503,262,38,68,3,4,4,11,Loyal Users
87626,313,50,108,3,5,4,12,Loyal Users
87664,566,11,18,2,2,2,6,Lost
87810,656,23,70,2,4,4,10,At Risk
87844,700,25,37,2,4,3,9,At Risk
87974,733,10,49,2,2,3,7,Lost
88021,129,26,58,4,4,3,11,Loyal Users
88166,10,13,25,5,3,2,10,Loyal Users
88407,131,11,35,4,2,3,9,Promising
88593,109,23,55,4,4,3,11,Loyal Users
88717,835,17,38,2,3,3,8,Casual Users
88840,2438,7,11,1,2,1,4,Lost
89036,150,7,8,4,2,1,7,Promising
89067,2543,14,43,1,3,3,7,Casual Users
89080,572,11,32,2,2,3,7,Lost
89252,0,50,97,5,5,4,14,Champions
89389,875,11,15,2,2,1,5,Lost
89467,6,49,124,5,5,4,14,Champions
89998,433,43,54,3,4,3,10,Loyal Users
90053,1990,6,14,1,1,1,3,Lost
90135,1418,10,17,1,2,2,5,Lost
90559,2710,10,63,1,2,4,7,Lost
90568,257,10,19,3,2,2,7,Casual Users
90884,3413,6,8,1,1,1,3,Lost
78394,787,5,7,2,1,1,4,Lost
78428,22,29,125,5,4,4,13,Champions
78608,43,165,540,5,5,5,15,Champions
78616,455,6,47,3,1,3,7,Casual Users
78719,697,5,12,2,1,1,4,Lost
78891,520,12,30,2,3,2,7,Casual Users
78937,175,42,126,3,4,4,11,Loyal Users
79133,290,48,71,3,5,4,12,Loyal Users
79346,106,40,75,4,4,4,12,Champions
79415,122,9,31,4,2,2,8,Promising
79775,994,5,5,2,1,1,4,Lost
80320,259,29,140,3,4,4,11,Loyal Users
80590,2228,12,16,1,3,2,6,Casual Users
80632,82,156,484,4,5,5,14,Champions
80970,37,135,340,5,5,5,15,Champions
81247,107,107,252,4,5,5,14,Champions
81288,887,18,70,2,3,4,9,Casual Users
81384,5540,17,33,1,3,3,7,Casual Users
81774,418,8,21,3,2,2,7,Casual Users
81937,242,38,99,3,4,4,11,Loyal Users
81977,282,22,57,3,4,3,10,Loyal Users
82162,84,115,368,4,5,5,14,Champions
82255,429,19,46,3,3,3,9,Loyal Users
82260,0,35,106,5,4,4,13,Champions
82476,1079,5,25,2,1,2,5,Lost
82592,816,8,8,2,2,1,5,Lost
82599,143,25,87,4,4,4,12,Champions
82612,661,5,6,2,1,1,4,Lost
82670,110,60,303,4,5,5,14,Champions
82838,122,14,39,4,3,3,10,Loyal Users
82974,86,38,88,4,4,4,12,Champions
83127,588,9,68,2,2,4,8,Lost
83224,2166,8,26,1,2,2,5,Lost
83230,699,8,20,2,2,2,6,Lost
83445,639,12,51,2,3,3,8,Casual Users
83481,1018,11,14,2,2,1,5,Lost
83549,31,18,33,5,3,3,11,Loyal Users
83827,88,5,5,4,1,1,6,Promising
84080,1030,5,12,2,1,1,4,Lost
85028,2076,23,63,1,4,4,9,At Risk
85041,420,9,29,3,2,2,7,Casual Users
85126,933,7,11,2,2,1,5,Lost
85773,5624,12,12,1,3,1,5,Casual Users
85915,27,22,57,5,4,3,12,Loyal Users
86087,226,23,45,3,4,3,10,Loyal Users
86093,22,170,348,5,5,5,15,Champions
86106,66,6,41,5,1,3,9,Promising
86282,423,11,34,3,2,3,8,Casual Users
86651,792,17,76,2,3,4,9,Casual Users
86913,6,117,394,5,5,5,15,Champions
87056,676,30,107,2,4,4,10,At Risk
87274,1544,33,97,1,4,4,9,At Risk
87432,287,11,26,3,2,2,7,Casual Users
87815,195,36,115,3,4,4,11,Loyal Users
88312,272,34,46,3,4,3,10,Loyal Users
88585,429,8,10,3,2,1,6,Casual Users
88709,1838,6,9,1,1,1,3,Lost
89134,403,38,129,3,4,4,11,Loyal Users
89277,151,20,75,4,3,4,11,Loyal Users
89354,84,10,12,4,2,1,7,Promising
89570,471,75,144,2,5,4,11,At Risk
89660,75,33,49,4,4,3,11,Loyal Users
89989,158,90,274,4,5,5,14,Champions
90211,568,5,11,2,1,1,4,Lost
90415,284,28,90,3,4,4,11,Loyal Users
90431,683,10,18,2,2,2,6,Lost
90661,2145,28,38,1,4,3,8,At Risk
90664,118,32,75,4,4,4,12,Champions
90771,676,8,9,2,2,1,5,Lost
78386,180,45,260,3,4,5,12,Loyal Users
78939,111,43,189,4,4,5,13,Champions
79200,19,139,951,5,5,5,15,Champions
79327,1927,7,8,1,2,1,4,Lost
79376,91,41,317,4,4,5,13,Champions
79530,46,83,333,5,5,5,15,Champions
79579,415,12,33,3,3,3,9,Loyal Users
79697,1285,16,34,1,3,3,7,Casual Users
79851,126,18,44,4,3,3,10,Loyal Users
79965,819,33,172,2,4,5,11,At Risk
80083,211,35,158,3,4,5,12,Loyal Users
80090,38,19,163,5,3,5,13,Loyal Users
80091,0,101,318,5,5,5,15,Champions
80117,2494,9,19,1,2,2,5,Lost
80279,1531,10,51,1,2,3,6,Lost
80420,75,21,29,4,3,2,9,Loyal Users
80491,69,11,84,5,2,4,11,Promising
80692,965,9,10,2,2,1,5,Lost
81107,16,8,9,5,2,1,8,Promising
81195,29,76,119,5,5,4,14,Champions
81534,1177,39,106,2,4,4,10,At Risk
81559,126,7,29,4,2,2,8,Promising
81621,374,9,18,3,2,2,7,Casual Users
81726,391,8,16,3,2,2,7,Casual Users
82104,174,23,73,3,4,4,11,Loyal Users
82123,481,5,12,2,1,1,4,Lost
82373,270,22,104,3,4,4,11,Loyal Users
82596,2095,5,7,1,1,1,3,Lost
82943,130,31,95,4,4,4,12,Champions
82957,47,61,231,5,5,5,15,Champions
83626,98,11,15,4,2,1,7,Promising
83648,172,45,125,3,4,4,11,Loyal Users
83665,1551,5,5,1,1,1,3,Lost
84298,16,29,323,5,4,5,14,Champions
84306,123,13,17,4,3,2,9,Loyal Users
84677,4676,33,151,1,4,5,10,At Risk
84752,90,8,23,4,2,2,8,Promising
84900,1188,11,20,2,2,2,6,Lost
84949,121,18,28,4,3,2,9,Loyal Users
84959,442,11,13,3,2,1,6,Casual Users
85008,313,11,20,3,2,2,7,Casual Users
86156,592,8,17,2,2,2,6,Lost
86313,3726,5,13,1,1,1,3,Lost
86426,432,29,68,3,4,4,11,Loyal Users
86946,407,6,33,3,1,3,7,Casual Users
87157,1698,5,9,1,1,1,3,Lost
87293,1013,20,30,2,3,2,7,Casual Users
87369,191,21,50,3,3,3,9,Loyal Users
87800,30,31,66,5,4,4,13,Champions
88282,432,17,38,3,3,3,9,Loyal Users
88440,16,7,22,5,2,2,9,Promising
88632,533,15,22,2,3,2,7,Casual Users
88692,48,30,149,5,4,5,14,Champions
88926,1585,6,13,1,1,1,3,Lost
89057,104,56,129,4,5,4,13,Champions
89438,0,42,254,5,4,5,14,Champions
89534,13,93,111,5,5,4,14,Champions
89776,1350,5,5,1,1,1,3,Lost
90003,428,15,16,3,3,2,8,Loyal Users
90097,1511,9,23,1,2,2,5,Lost
90122,278,9,20,3,2,2,7,Casual Users
90297,317,41,174,3,4,5,12,Loyal Users
90549,3648,12,25,1,3,2,6,Casual Users
90587,1688,11,56,1,2,3,6,Lost
90803,40,174,605,5,5,5,15,Champions
90815,261,17,109,3,3,4,10,Loyal Users
90870,2506,11,19,1,2,2,5,Lost
90890,39,12,41,5,3,3,11,Loyal Users
90974,1375,8,14,1,2,1,4,Lost
78421,153,72,252,4,5,5,14,Champions
79011,4015,6,9,1,1,1,3,Lost
79337,1382,26,36,1,4,3,8,At Risk
79407,290,20,33,3,3,3,9,Loyal Users
79456,275,17,108,3,3,4,10,Loyal Users
79654,412,23,25,3,4,2,9,Loyal Users
79655,243,45,106,3,4,4,11,Loyal Users
79669,249,218,901,3,5,5,13,Loyal Users
79752,379,41,98,3,4,4,11,Loyal Users
79764,36,32,39,5,4,3,12,Loyal Users
79938,165,46,54,4,5,3,12,Loyal Users
80191,4716,5,11,1,1,1,3,Lost
80801,45,12,29,5,3,2,10,Loyal Users
80878,53,28,49,5,4,3,12,Loyal Users
81031,139,18,83,4,3,4,11,Loyal Users
81166,303,26,43,3,4,3,10,Loyal Users
81260,67,57,180,5,5,5,15,Champions
81445,148,9,22,4,2,2,8,Promising
81577,107,26,67,4,4,4,12,Champions
81597,1407,6,17,1,1,2,4,Lost
81837,514,10,79,2,2,4,8,Lost
81913,566,42,74,2,4,4,10,At Risk
81992,46,24,29,5,4,2,11,Loyal Users
82191,98,67,188,4,5,5,14,Champions
82338,5264,13,14,1,3,1,5,Casual Users
82439,4097,66,144,1,5,4,10,At Risk
82665,2471,5,13,1,1,1,3,Lost
82864,1,57,131,5,5,4,14,Champions
83283,17,22,58,5,4,3,12,Loyal Users
83801,522,85,277,2,5,5,12,At Risk
84121,131,77,189,4,5,5,14,Champions
84512,36,52,122,5,5,4,14,Champions
84666,45,14,59,5,3,3,11,Loyal Users
84937,497,30,84,2,4,4,10,At Risk
84980,3781,11,14,1,2,1,4,Lost
85044,822,5,9,2,1,1,4,Lost
85286,145,42,60,4,4,3,11,Loyal Users
85634,85,10,14,4,2,1,7,Promising
85706,515,6,9,2,1,1,4,Lost
85720,64,73,312,5,5,5,15,Champions
85844,3303,14,65,1,3,4,8,Casual Users
85974,4039,6,17,1,1,2,4,Lost
86007,538,7,9,2,2,1,5,Lost
86503,24,73,202,5,5,5,15,Champions
86739,874,7,17,2,2,2,6,Lost
86741,15,149,718,5,5,5,15,Champions
86763,90,6,63,4,1,4,9,Promising
87232,105,14,59,4,3,3,10,Loyal Users
87469,124,5,8,4,1,1,6,Promising
87833,3540,5,8,1,1,1,3,Lost
87969,9,97,150,5,5,5,15,Champions
88148,119,79,160,4,5,5,14,Champions
88358,337,7,33,3,2,3,8,Casual Users
88438,2580,9,24,1,2,2,5,Lost
88791,1099,8,9,2,2,1,5,Lost
89072,5703,15,30,1,3,2,6,Casual Users
89100,107,21,32,4,3,3,10,Loyal Users
89201,110,69,220,4,5,5,14,Champions
89235,24,33,101,5,4,4,13,Champions
89322,405,60,190,3,5,5,13,Loyal Users
89452,439,7,15,3,2,1,6,Casual Users
89617,1841,8,34,1,2,3,6,Lost
90168,11,162,317,5,5,5,15,Champions
90214,16,44,123,5,4,4,13,Champions
90352,777,32,126,2,4,4,10,At Risk
90564,71,6,15,4,1,1,6,Promising
90616,817,13,23,2,3,2,7,Casual Users
90812,71,13,44,4,3,3,10,Loyal Users
90906,498,10,24,2,2,2,6,Lost
91036,117,10,32,4,2,3,9,Promising
91052,5329,7,7,1,2,1,4,Lost
78294,581,14,54,2,3,3,8,Casual Users
78743,826,5,32,2,1,3,6,Lost
78834,275,39,54,3,4,3,10,Loyal Users
79254,1747,15,46,1,3,3,7,Casual Users
79865,2544,11,12,1,2,1,4,Lost
79885,379,13,81,3,3,4,10,Loyal Users
80181,2210,10,20,1,2,2,5,Lost
80356,86,25,112,4,4,4,12,Champions
80776,559,6,15,2,1,1,4,Lost
80888,11,68,186,5,5,5,15,Champions
81109,996,17,55,2,3,3,8,Casual Users
81119,2592,5,11,1,1,1,3,Lost
81155,1399,12,14,1,3,1,5,Casual Users
81176,477,11,19,2,2,2,6,Lost
81395,167,72,162,3,5,5,13,Loyal Users
81715,1913,12,48,1,3,3,7,Casual Users
82036,116,36,120,4,4,4,12,Champions
82343,4657,14,27,1,3,2,6,Casual Users
83168,1233,6,39,2,1,3,6,Lost
83246,486,11,35,2,2,3,7,Lost
83477,545,17,37,2,3,3,8,Casual Users
83723,331,11,51,3,2,3,8,Casual Users
83752,101,124,707,4,5,5,14,Champions
83903,789,5,9,2,1,1,4,Lost
83993,299,6,7,3,1,1,5,Casual Users
84040,545,8,12,2,2,1,5,Lost
84238,1142,5,7,2,1,1,4,Lost
84240,361,17,74,3,3,4,10,Loyal Users
84494,1256,24,41,2,4,3,9,At Risk
84744,2,28,74,5,4,4,13,Champions
84794,4748,8,8,1,2,1,4,Lost
84880,394,18,34,3,3,3,9,Loyal Users
85051,80,53,415,4,5,5,14,Champions
85453,93,7,7,4,2,1,7,Promising
85656,118,35,95,4,4,4,12,Champions
86099,907,16,33,2,3,3,8,Casual Users
86371,3344,5,6,1,1,1,3,Lost
86429,543,23,48,2,4,3,9,At Risk
86486,1617,10,41,1,2,3,6,Lost
86570,3259,10,33,1,2,3,6,Lost
86623,2449,5,5,1,1,1,3,Lost
86908,1097,15,50,2,3,3,8,Casual Users
86960,1164,27,129,2,4,4,10,At Risk
87229,1425,10,26,1,2,2,5,Lost
87243,34,29,144,5,4,4,13,Champions
87368,91,79,156,4,5,5,14,Champions
87528,986,18,125,2,3,4,9,Casual Users
87568,404,40,87,3,4,4,11,Loyal Users
87845,2488,6,48,1,1,3,5,Lost
87959,106,21,28,4,3,2,9,Loyal Users
87998,731,9,35,2,2,3,7,Lost
88059,83,66,125,4,5,4,13,Champions
88081,1799,5,44,1,1,3,5,Lost
88189,319,18,29,3,3,2,8,Loyal Users
88248,1498,8,45,1,2,3,6,Lost
88374,126,5,27,4,1,2,7,Promising
89083,1948,17,22,1,3,2,6,Casual Users
89087,738,33,58,2,4,3,9,At Risk
89265,839,27,52,2,4,3,9,At Risk
89541,268,87,410,3,5,5,13,Loyal Users
90124,688,26,40,2,4,3,9,At Risk
90433,25,59,418,5,5,5,15,Champions
90737,90,11,30,4,2,2,8,Promising
78377,418,15,103,3,3,4,10,Loyal Users
78948,5,110,464,5,5,5,15,Champions
79045,90,9,9,4,2,1,7,Promising
79064,4279,8,13,1,2,1,4,Lost
79102,3552,6,42,1,1,3,5,Lost
79411,416,14,61,3,3,3,9,Loyal Users
79466,3931,13,37,1,3,3,7,Casual Users
79581,2988,7,11,1,2,1,4,Lost
79691,25,174,570,5,5,5,15,Champions
79812,756,223,688,2,5,5,12,At Risk
79979,2690,13,24,1,3,2,6,Casual Users
80046,841,24,162,2,4,5,11,At Risk
80093,662,28,161,2,4,5,11,At Risk
80196,87,176,425,4,5,5,14,Champions
80253,282,76,160,3,5,5,13,Loyal Users
80307,263,80,200,3,5,5,13,Loyal Users
80496,3556,5,26,1,1,2,4,Lost
80608,866,16,19,2,3,2,7,Casual Users
81219,14,114,195,5,5,5,15,Champions
81528,359,61,231,3,5,5,13,Loyal Users
81854,81,84,253,4,5,5,14,Champions
82304,826,113,405,2,5,5,12,At Risk
82513,120,72,194,4,5,5,14,Champions
83286,1140,18,23,2,3,2,7,Casual Users
83389,2680,7,11,1,2,1,4,Lost
83987,1240,35,67,2,4,4,10,At Risk
84171,113,17,21,4,3,2,9,Loyal Users
84877,469,22,57,3,4,3,10,Loyal Users
84999,3477,6,13,1,1,1,3,Lost
85007,47,97,562,5,5,5,15,Champions
85153,103,133,219,4,5,5,14,Champions
85297,475,29,106,2,4,4,10,At Risk
85595,308,11,47,3,2,3,8,Casual Users
85625,2690,5,23,1,1,2,4,Lost
85717,4,84,158,5,5,5,15,Champions
86171,313,11,17,3,2,2,7,Casual Users
86342,1585,9,34,1,2,3,6,Lost
86533,34,18,235,5,3,5,13,Loyal Users
86553,1273,5,5,1,1,1,3,Lost
86575,545,37,47,2,4,3,9,At Risk
86939,921,8,20,2,2,2,6,Lost
86994,127,94,552,4,5,5,14,Champions
87061,90,22,55,4,4,3,11,Loyal Users
87070,1906,36,140,1,4,4,9,At Risk
87331,146,9,13,4,2,1,7,Promising
87479,567,36,142,2,4,4,10,At Risk
87645,84,41,56,4,4,3,11,Loyal Users
87906,50,19,48,5,3,3,11,Loyal Users
87914,133,12,166,4,3,5,12,Loyal Users
88555,288,25,96,3,4,4,11,Loyal Users
88747,3707,9,26,1,2,2,5,Lost
89088,214,37,110,3,4,4,11,Loyal Users
89122,1097,10,22,2,2,2,6,Lost
89404,23,56,317,5,5,5,15,Champions
89567,375,36,45,3,4,3,10,Loyal Users
90049,0,25,168,5,4,5,14,Champions
90790,423,55,59,3,5,3,11,Loyal Users
90954,23,17,99,5,3,4,12,Loyal Users
78343,206,24,101,3,4,4,11,Loyal Users
78484,28,92,310,5,5,5,15,Champions
78531,3007,22,101,1,4,4,9,At Risk
78560,1700,14,29,1,3,2,6,Casual Users
78597,263,30,78,3,4,4,11,Loyal Users
78670,2419,6,105,1,1,4,6,Lost
78732,217,7,47,3,2,3,8,Casual Users
78857,140,20,30,4,3,2,9,Loyal Users
78875,1759,5,6,1,1,1,3,Lost
78885,1571,7,32,1,2,3,6,Lost
79690,587,14,62,2,3,3,8,Casual Users
79720,1979,7,7,1,2,1,4,Lost
79789,1823,8,21,1,2,2,5,Lost
80280,1688,15,141,1,3,4,8,Casual Users
80693,100,9,19,4,2,2,8,Promising
80697,215,9,20,3,2,2,7,Casual Users
80727,1,35,89,5,4,4,13,Champions
80781,1094,6,8,2,1,1,4,Lost
80894,165,36,174,4,4,5,13,Champions
81138,140,40,214,4,4,5,13,Champions
81236,405,12,102,3,3,4,10,Loyal Users
81382,135,11,45,4,2,3,9,Promising
81448,104,7,41,4,2,3,9,Promising
81843,107,99,404,4,5,5,14,Champions
82006,1569,5,7,1,1,1,3,Lost
82091,606,10,102,2,2,4,8,Lost
82112,76,31,118,4,4,4,12,Champions
82200,1179,18,31,2,3,2,7,Casual Users
82301,111,51,296,4,5,5,14,Champions
82322,5632,9,30,1,2,2,5,Lost
82374,0,149,723,5,5,5,15,Champions
82421,2449,52,92,1,5,4,10,At Risk
82602,477,5,8,2,1,1,4,Lost
82621,28,33,209,5,4,5,14,Champions
82651,272,5,7,3,1,1,5,Casual Users
82754,2860,5,11,1,1,1,3,Lost
82839,1573,7,9,1,2,1,4,Lost
82842,160,83,408,4,5,5,14,Champions
82950,4376,5,13,1,1,1,3,Lost
83039,2719,5,5,1,1,1,3,Lost
83218,140,67,161,4,5,5,14,Champions
83372,183,12,21,3,3,2,8,Loyal Users
83553,1602,7,15,1,2,1,4,Lost
83798,3652,5,14,1,1,1,3,Lost
83819,570,8,15,2,2,1,5,Lost
83849,116,40,54,4,4,3,11,Loyal Users
84141,195,30,168,3,4,5,12,Loyal Users
84299,952,9,28,2,2,2,6,Lost
84300,2688,10,30,1,2,2,5,Lost
84348,1283,10,92,1,2,4,7,Lost
84508,424,8,30,3,2,2,7,Casual Users
84663,386,5,16,3,1,2,6,Casual Users
85207,99,7,16,4,2,2,8,Promising
85254,2049,8,10,1,2,1,4,Lost
85573,136,15,42,4,3,3,10,Loyal Users
85641,392,5,29,3,1,2,6,Casual Users
85687,947,7,10,2,2,1,5,Lost
85944,1763,16,33,1,3,3,7,Casual Users
86197,1643,13,19,1,3,2,6,Casual Users
86274,32,99,376,5,5,5,15,Champions
86539,142,15,51,4,3,3,10,Loyal Users
86600,2464,9,11,1,2,1,4,Lost
86839,19,58,277,5,5,5,15,Champions
86878,487,6,14,2,1,1,4,Lost
86926,2,18,169,5,3,5,13,Loyal Users
86941,2230,5,27,1,1,2,4,Lost
87167,333,28,104,3,4,4,11,Loyal Users
87341,1039,83,157,2,5,5,12,At Risk
87440,4728,20,34,1,3,3,7,Casual Users
87501,853,20,187,2,3,5,10,Casual Users
87578,113,51,394,4,5,5,14,Champions
87629,128,46,175,4,5,5,14,Champions
87854,80,35,247,4,4,5,13,Champions
88119,5,42,141,5,4,4,13,Champions
88163,3003,5,7,1,1,1,3,Lost
88253,125,45,161,4,4,5,13,Champions
88445,713,42,118,2,4,4,10,At Risk
88460,710,9,86,2,2,4,8,Lost
88509,484,30,52,2,4,3,9,At Risk
88710,26,21,97,5,3,4,12,Loyal Users
88851,5520,8,8,1,2,1,4,Lost
89094,84,19,49,4,3,3,10,Loyal Users
89401,5811,11,21,1,2,2,5,Lost
89690,653,7,11,2,2,1,5,Lost
89760,1532,5,6,1,1,1,3,Lost
89915,175,13,18,3,3,2,8,Loyal Users
90579,31,8,9,5,2,1,8,Promising
90657,442,18,39,3,3,3,9,Loyal Users
90727,133,69,282,4,5,5,14,Champions
90918,164,10,14,4,2,1,7,Promising
91037,1422,11,47,1,2,3,6,Lost
78683,1440,34,75,1,4,4,9,At Risk
79174,1286,5,15,1,1,1,3,Lost
80439,2850,9,18,1,2,2,5,Lost
81157,397,14,49,3,3,3,9,Loyal Users
81433,1279,24,93,1,4,4,9,At Risk
81779,624,15,71,2,3,4,9,Casual Users
81828,122,26,150,4,4,5,13,Champions
82013,41,56,100,5,5,4,14,Champions
82192,900,10,52,2,2,3,7,Lost
82222,840,7,38,2,2,3,7,Lost
82486,299,19,29,3,3,2,8,Loyal Users
82539,595,27,84,2,4,4,10,At Risk
82657,949,8,26,2,2,2,6,Lost
82693,115,20,29,4,3,2,9,Loyal Users
82741,835,29,47,2,4,3,9,At Risk
82822,4965,7,13,1,2,1,4,Lost
83158,45,52,201,5,5,5,15,Champions
84469,112,64,239,4,5,5,14,Champions
84967,5428,14,59,1,3,3,7,Casual Users
85072,3829,54,155,1,5,5,11,At Risk
85371,402,22,32,3,4,3,10,Loyal Users
85381,118,46,148,4,5,5,14,Champions
85513,96,38,204,4,4,5,13,Champions
85572,66,103,253,5,5,5,15,Champions
85620,4534,24,105,1,4,4,9,At Risk
86011,133,34,119,4,4,4,12,Champions
86220,4542,25,39,1,4,3,8,At Risk
86306,128,84,770,4,5,5,14,Champions
86444,26,101,501,5,5,5,15,Champions
86631,1,86,326,5,5,5,15,Champions
86640,107,21,26,4,3,2,9,Loyal Users
86712,1858,9,15,1,2,1,4,Lost
86757,1119,6,7,2,1,1,4,Lost
86935,91,90,496,4,5,5,14,Champions
87158,407,20,82,3,3,4,10,Loyal Users
87235,2,28,83,5,4,4,13,Champions
87557,840,31,54,2,4,3,9,At Risk
87596,154,102,603,4,5,5,14,Champions
87614,23,78,241,5,5,5,15,Champions
88014,250,60,305,3,5,5,13,Loyal Users
88368,59,179,795,5,5,5,15,Champions
88695,0,70,387,5,5,5,15,Champions
88811,269,50,77,3,5,4,12,Loyal Users
88894,4542,23,76,1,4,4,9,At Risk
88923,151,20,87,4,3,4,11,Loyal Users
88940,1564,7,11,1,2,1,4,Lost
89465,1189,7,15,2,2,1,5,Lost
89777,22,134,836,5,5,5,15,Champions
89920,708,27,60,2,4,3,9,At Risk
89927,17,6,15,5,1,1,7,Promising
90057,697,35,54,2,4,3,9,At Risk
90763,413,10,11,3,2,1,6,Casual Users
90865,288,13,70,3,3,4,10,Loyal Users
91056,162,45,158,4,4,5,13,Champions
78350,172,8,24,3,2,2,7,Casual Users
78369,332,80,203,3,5,5,13,Loyal Users
78639,132,43,68,4,4,4,12,Champions
78665,861,20,53,2,3,3,8,Casual Users
79624,151,15,46,4,3,3,10,Loyal Users
79829,1041,10,43,2,2,3,7,Lost
79890,19,89,136,5,5,4,14,Champions
79917,408,17,48,3,3,3,9,Loyal Users
80053,16,116,461,5,5,5,15,Champions
80066,331,21,41,3,3,3,9,Loyal Users
80082,1509,51,272,1,5,5,11,At Risk
80217,107,16,24,4,3,2,9,Loyal Users
80271,49,95,287,5,5,5,15,Champions
80862,71,22,46,4,4,3,11,Loyal Users
80871,19,10,13,5,2,1,8,Promising
81277,3,90,202,5,5,5,15,Champions
81300,1518,12,22,1,3,2,6,Casual Users
81313,79,47,147,4,5,5,14,Champions
81740,281,6,41,3,1,3,7,Casual Users
81750,1,15,20,5,3,2,10,Loyal Users
81791,901,6,57,2,1,3,6,Lost
81898,1006,44,95,2,4,4,10,At Risk
81921,17,22,46,5,4,3,12,Loyal Users
82425,143,5,6,4,1,1,6,Promising
82601,1567,21,64,1,3,4,8,Casual Users
82641,114,117,396,4,5,5,14,Champions
82722,5105,8,49,1,2,3,6,Lost
82924,3528,15,52,1,3,3,7,Casual Users
83092,430,5,15,3,1,1,5,Casual Users
83393,426,23,119,3,4,4,11,Loyal Users
83488,30,44,137,5,4,4,13,Champions
83818,2229,6,35,1,1,3,5,Lost
83856,44,6,14,5,1,1,7,Promising
83860,2374,6,10,1,1,1,3,Lost
84122,48,8,26,5,2,2,9,Promising
84489,132,5,5,4,1,1,6,Promising
84710,175,61,101,3,5,4,12,Loyal Users
84780,441,27,42,3,4,3,10,Loyal Users
84945,563,81,102,2,5,4,11,At Risk
85077,2013,6,11,1,1,1,3,Lost
85353,36,56,191,5,5,5,15,Champions
85586,118,23,44,4,4,3,11,Loyal Users
85985,2226,5,5,1,1,1,3,Lost
86039,115,67,152,4,5,5,14,Champions
86110,166,30,157,3,4,5,12,Loyal Users
86228,30,37,104,5,4,4,13,Champions
86335,0,7,19,5,2,2,9,Promising
86605,463,20,105,3,3,4,10,Loyal Users
86857,87,23,49,4,4,3,11,Loyal Users
87637,1700,5,9,1,1,1,3,Lost
87654,9,12,49,5,3,3,11,Loyal Users
88103,284,14,22,3,3,2,8,Loyal Users
88290,405,26,49,3,4,3,10,Loyal Users
88370,139,15,56,4,3,3,10,Loyal Users
88542,2601,11,35,1,2,3,6,Lost
88546,3,50,115,5,5,4,14,Champions
88827,141,5,12,4,1,1,6,Promising
89256,5,20,28,5,3,2,10,Loyal Users
89459,223,15,29,3,3,2,8,Loyal Users
90200,2193,11,34,1,2,3,6,Lost
90209,5,35,89,5,4,4,13,Champions
90232,543,28,75,2,4,4,10,At Risk
90663,245,113,190,3,5,5,13,Loyal Users
78680,1266,9,43,1,2,3,6,Lost
78908,7,17,45,5,3,3,11,Loyal Users
79057,669,14,15,2,3,1,6,Casual Users
79357,519,7,72,2,2,4,8,Lost
79464,300,24,60,3,4,3,10,Loyal Users
79470,1805,24,53,1,4,3,8,At Risk
79476,482,24,83,2,4,4,10,At Risk
79544,234,112,130,3,5,4,12,Loyal Users
79665,893,7,7,2,2,1,5,Lost
79770,133,51,243,4,5,5,14,Champions
79814,276,11,38,3,2,3,8,Casual Users
79833,80,41,70,4,4,4,12,Champions
79955,1164,11,17,2,2,2,6,Lost
80124,887,79,165,2,5,5,12,At Risk
80433,1710,6,8,1,1,1,3,Lost
80513,24,48,165,5,5,5,15,Champions
80523,5,176,366,5,5,5,15,Champions
80544,688,22,66,2,4,4,10,At Risk
80592,1286,14,25,1,3,2,6,Casual Users
80679,1967,7,7,1,2,1,4,Lost
81599,3685,5,12,1,1,1,3,Lost
81949,413,30,48,3,4,3,10,Loyal Users
82344,340,10,21,3,2,2,7,Casual Users
82437,36,6,9,5,1,1,7,Promising
82634,539,97,451,2,5,5,12,At Risk
82825,801,8,21,2,2,2,6,Lost
82854,86,59,116,4,5,4,13,Champions
83026,1805,5,8,1,1,1,3,Lost
83206,1300,18,21,1,3,2,6,Casual Users
83395,97,28,76,4,4,4,12,Champions
83438,5109,6,17,1,1,2,4,Lost
83440,284,27,128,3,4,4,11,Loyal Users
83543,414,26,151,3,4,5,12,Loyal Users
83614,3112,8,52,1,2,3,6,Lost
83675,149,24,60,4,4,3,11,Loyal Users
83774,968,7,62,2,2,3,7,Lost
83808,1405,10,14,1,2,1,4,Lost
84050,402,8,21,3,2,2,7,Casual Users
84068,11,65,76,5,5,4,14,Champions
84264,431,17,37,3,3,3,9,Loyal Users
84565,231,127,490,3,5,5,13,Loyal Users
84571,720,6,15,2,1,1,4,Lost
85163,9,116,368,5,5,5,15,Champions
85377,96,57,89,4,5,4,13,Champions
85424,171,17,95,3,3,4,10,Loyal Users
85426,98,7,30,4,2,2,8,Promising
85542,50,53,78,5,5,4,14,Champions
85653,97,46,173,4,5,5,14,Champions
86278,1797,5,22,1,1,2,4,Lost
86609,1741,9,11,1,2,1,4,Lost
86993,3177,5,33,1,1,3,5,Lost
87254,688,31,44,2,4,3,9,At Risk
87421,681,11,26,2,2,2,6,Lost
87887,55,83,190,5,5,5,15,Champions
87915,1117,9,11,2,2,1,5,Lost
88028,236,23,25,3,4,2,9,Loyal Users
88087,13,17,174,5,3,5,13,Loyal Users
88399,86,141,385,4,5,5,14,Champions
88435,4166,5,9,1,1,1,3,Lost
88476,415,11,14,3,2,1,6,Casual Users
88514,24,87,142,5,5,4,14,Champions
88681,386,27,99,3,4,4,11,Loyal Users
88883,34,52,186,5,5,5,15,Champions
89219,669,5,5,2,1,1,4,Lost
89225,116,19,55,4,3,3,10,Loyal Users
89469,69,9,29,5,2,2,9,Promising
89625,119,11,76,4,2,4,10,Promising
89653,4225,12,22,1,3,2,6,Casual Users
90190,3456,5,5,1,1,1,3,Lost
90235,2995,10,17,1,2,2,5,Lost
90481,67,47,355,5,5,5,15,Champions
90558,18,29,67,5,4,4,13,Champions
90644,613,5,6,2,1,1,4,Lost
78312,170,35,158,3,4,5,12,Loyal Users
78737,718,61,370,2,5,5,12,At Risk
78787,124,13,56,4,3,3,10,Loyal Users
78962,23,27,67,5,4,4,13,Champions
79442,1880,12,27,1,3,2,6,Casual Users
79558,412,15,69,3,3,4,10,Loyal Users
79608,2828,10,43,1,2,3,6,Lost
79631,18,45,101,5,4,4,13,Champions
80056,5969,5,5,1,1,1,3,Lost
80136,3299,5,14,1,1,1,3,Lost
80419,2386,5,6,1,1,1,3,Lost
80788,1647,7,43,1,2,3,6,Lost
81225,1227,21,100,2,3,4,9,Casual Users
82166,513,22,73,2,4,4,10,At Risk
82528,975,12,28,2,3,2,7,Casual Users
82968,1708,8,19,1,2,2,5,Lost
83534,64,28,101,5,4,4,13,Champions
83607,244,12,44,3,3,3,9,Loyal Users
84145,8,26,38,5,4,3,12,Loyal Users
84182,229,73,543,3,5,5,13,Loyal Users
84270,837,10,14,2,2,1,5,Lost
84596,272,11,33,3,2,3,8,Casual Users
84683,2489,7,13,1,2,1,4,Lost
85487,3883,16,39,1,3,3,7,Casual Users
85511,1695,5,32,1,1,3,5,Lost
85547,2119,7,17,1,2,2,5,Lost
85703,265,16,28,3,3,2,8,Loyal Users
86367,64,107,700,5,5,5,15,Champions
86427,2586,15,28,1,3,2,6,Casual Users
86433,88,17,142,4,3,4,11,Loyal Users
86459,410,9,32,3,2,3,8,Casual Users
87072,4638,6,12,1,1,1,3,Lost
87187,68,16,23,5,3,2,10,Loyal Users
87259,81,11,66,4,2,4,10,Promising
87286,163,15,47,4,3,3,10,Loyal Users
87882,2041,10,97,1,2,4,7,Lost
88016,405,7,19,3,2,2,7,Casual Users
88595,21,16,52,5,3,3,11,Loyal Users
88707,0,15,32,5,3,3,11,Loyal Users
88778,3570,7,25,1,2,2,5,Lost
89154,133,48,67,4,5,4,13,Champions
89229,415,7,30,3,2,2,7,Casual Users
89251,1150,10,21,2,2,2,6,Lost
89686,1134,5,8,2,1,1,4,Lost
89873,398,5,10,3,1,1,5,Casual Users
90177,4967,7,19,1,2,2,5,Lost
90321,1527,9,25,1,2,2,5,Lost
90333,2001,15,37,1,3,3,7,Casual Users
90361,785,8,12,2,2,1,5,Lost
90624,835,8,18,2,2,2,6,Lost
90667,2614,7,8,1,2,1,4,Lost
90813,411,47,74,3,5,4,12,Loyal Users
90858,508,5,98,2,1,4,7,Lost
90864,499,53,89,2,5,4,11,At Risk
90927,1013,19,29,2,3,2,7,Casual Users
78414,4,23,46,5,4,3,12,Loyal Users
78989,35,51,102,5,5,4,14,Champions
79080,115,13,52,4,3,3,10,Loyal Users
79307,822,15,59,2,3,3,8,Casual Users
79562,391,33,85,3,4,4,11,Loyal Users
80086,5068,16,28,1,3,2,6,Casual Users
80483,2452,6,6,1,1,1,3,Lost
80580,231,10,61,3,2,3,8,Casual Users
80627,6,155,273,5,5,5,15,Champions
80658,1955,10,24,1,2,2,5,Lost
80663,23,9,22,5,2,2,9,Promising
80827,1217,8,13,2,2,1,5,Lost
80960,966,7,9,2,2,1,5,Lost
81804,270,17,129,3,3,4,10,Loyal Users
81827,93,17,42,4,3,3,10,Loyal Users
82000,245,22,54,3,4,3,10,Loyal Users
82229,931,7,9,2,2,1,5,Lost
82391,612,9,16,2,2,2,6,Lost
82542,123,14,46,4,3,3,10,Loyal Users
82549,1665,8,24,1,2,2,5,Lost
82745,454,7,9,3,2,1,6,Casual Users
82762,163,89,549,4,5,5,14,Champions
82871,15,23,35,5,4,3,12,Loyal Users
83040,168,6,63,3,1,4,8,Casual Users
83247,115,17,71,4,3,4,11,Loyal Users
83284,245,61,99,3,5,4,12,Loyal Users
83394,566,17,96,2,3,4,9,Casual Users
83784,670,10,17,2,2,2,6,Lost
83919,4043,8,9,1,2,1,4,Lost
84554,1120,7,51,2,2,3,7,Lost
84598,187,12,40,3,3,3,9,Loyal Users
84661,2804,6,8,1,1,1,3,Lost
84767,322,6,7,3,1,1,5,Casual Users
85087,1863,21,32,1,3,3,7,Casual Users
85309,118,50,131,4,5,4,13,Champions
85444,3697,5,8,1,1,1,3,Lost
85600,84,63,217,4,5,5,14,Champions
86018,107,140,257,4,5,5,14,Champions
86336,165,41,190,4,4,5,13,Champions
86357,25,188,569,5,5,5,15,Champions
86494,486,8,8,2,2,1,5,Lost
86937,4108,7,31,1,2,2,5,Lost
87074,110,16,104,4,3,4,11,Loyal Users
87159,167,19,21,3,3,2,8,Loyal Users
87239,130,110,205,4,5,5,14,Champions
87372,572,26,52,2,4,3,9,At Risk
87541,272,59,93,3,5,4,12,Loyal Users
87883,117,101,633,4,5,5,14,Champions
87936,667,6,8,2,1,1,4,Lost
88263,854,9,14,2,2,1,5,Lost
88621,1536,14,16,1,3,2,6,Casual Users
88790,2529,9,22,1,2,2,5,Lost
88869,105,109,943,4,5,5,14,Champions
88962,105,112,359,4,5,5,14,Champions
89142,2420,8,19,1,2,2,5,Lost
89174,379,11,15,3,2,1,6,Casual Users
89188,248,9,12,3,2,1,6,Casual Users
89269,2278,10,20,1,2,2,5,Lost
89392,568,14,20,2,3,2,7,Casual Users
89571,3,64,230,5,5,5,15,Champions
89922,114,7,15,4,2,1,7,Promising
90205,77,145,259,4,5,5,14,Champions
90570,31,41,89,5,4,4,13,Champions
90589,1000,5,8,2,1,1,4,Lost
90990,71,12,47,4,3,3,10,Loyal Users
78957,3111,5,23,1,1,2,4,Lost
79029,442,17,123,3,3,4,10,Loyal Users
79056,1229,5,9,2,1,1,4,Lost
79186,129,18,53,4,3,3,10,Loyal Users
79237,572,12,19,2,3,2,7,Casual Users
79287,1111,5,16,2,1,2,5,Lost
79293,7,74,196,5,5,5,15,Champions
79312,4417,9,37,1,2,3,6,Lost
79563,6,7,18,5,2,2,9,Promising
79576,2256,8,26,1,2,2,5,Lost
79986,100,18,41,4,3,3,10,Loyal Users
80037,4140,15,16,1,3,2,6,Casual Users
80055,1558,8,27,1,2,2,5,Lost
80123,428,19,187,3,3,5,11,Loyal Users
80214,4,48,185,5,5,5,15,Champions
80226,12,106,209,5,5,5,15,Champions
80249,727,16,54,2,3,3,8,Casual Users
80259,252,5,5,3,1,1,5,Casual Users
80527,122,41,187,4,4,5,13,Champions
80680,135,62,106,4,5,4,13,Champions
81061,129,60,365,4,5,5,14,Champions
81089,257,16,78,3,3,4,10,Loyal Users
81674,274,6,7,3,1,1,5,Casual Users
82496,13,73,340,5,5,5,15,Champions
82818,67,49,226,5,5,5,15,Champions
82970,96,29,45,4,4,3,11,Loyal Users
83030,123,27,97,4,4,4,12,Champions
83106,3405,6,10,1,1,1,3,Lost
83176,4584,5,6,1,1,1,3,Lost
83214,534,19,51,2,3,3,8,Casual Users
83258,148,47,112,4,5,4,13,Champions
83304,37,73,554,5,5,5,15,Champions
83336,117,40,162,4,4,5,13,Champions
83510,504,19,41,2,3,3,8,Casual Users
83910,427,14,19,3,3,2,8,Loyal Users
84797,18,67,227,5,5,5,15,Champions
84904,5806,6,6,1,1,1,3,Lost
84952,386,33,225,3,4,5,12,Loyal Users
85025,9,130,343,5,5,5,15,Champions
85386,4,6,6,5,1,1,7,Promising
85501,10,106,313,5,5,5,15,Champions
85544,2652,65,273,1,5,5,11,At Risk
85995,249,43,133,3,4,4,11,Loyal Users
86323,84,53,72,4,5,4,13,Champions
86465,268,10,45,3,2,3,8,Casual Users
86578,2162,12,19,1,3,2,6,Casual Users
86762,386,16,40,3,3,3,9,Loyal Users
86954,1670,12,67,1,3,4,8,Casual Users
88077,107,16,47,4,3,3,10,Loyal Users
88420,3099,5,25,1,1,2,4,Lost
88600,8,39,52,5,4,3,12,Loyal Users
88728,321,69,166,3,5,5,13,Loyal Users
88800,2985,13,22,1,3,2,6,Casual Users
88881,5683,20,149,1,3,5,9,Casual Users
88965,30,62,427,5,5,5,15,Champions
89184,124,67,372,4,5,5,14,Champions
89222,169,27,59,3,4,3,10,Loyal Users
89283,2538,7,12,1,2,1,4,Lost
89315,158,110,354,4,5,5,14,Champions
89331,67,58,629,5,5,5,15,Champions
89623,74,8,13,4,2,1,7,Promising
89768,2104,7,15,1,2,1,4,Lost
89994,2000,6,67,1,1,4,6,Lost
90186,115,10,16,4,2,2,8,Promising
90227,1416,5,12,1,1,1,3,Lost
90456,691,38,49,2,4,3,9,At Risk
90824,119,8,23,4,2,2,8,Promising
78358,984,15,49,2,3,3,8,Casual Users
78460,996,6,22,2,1,2,5,Lost
78495,256,15,21,3,3,2,8,Loyal Users
78637,38,39,69,5,4,4,13,Champions
78746,2,43,81,5,4,4,13,Champions
78936,686,13,74,2,3,4,9,Casual Users
79060,290,11,25,3,2,2,7,Casual Users
79083,29,44,135,5,4,4,13,Champions
79525,204,5,7,3,1,1,5,Casual Users
79527,96,50,159,4,5,5,14,Champions
79867,84,14,43,4,3,3,10,Loyal Users
80092,833,5,10,2,1,1,4,Lost
80211,65,146,290,5,5,5,15,Champions
80351,2699,7,15,1,2,1,4,Lost
80475,1224,7,14,2,2,1,5,Lost
80877,508,7,14,2,2,1,5,Lost
81307,971,11,31,2,2,2,6,Lost
81592,1526,5,57,1,1,3,5,Lost
81693,4261,5,18,1,1,2,4,Lost
81697,113,10,12,4,2,1,7,Promising
81855,241,45,145,3,4,4,11,Loyal Users
82084,272,15,69,3,3,4,10,Loyal Users
82242,422,7,11,3,2,1,6,Casual Users
82333,594,7,15,2,2,1,5,Lost
83239,2274,14,67,1,3,4,8,Casual Users
83694,679,12,26,2,3,2,7,Casual Users
83804,152,11,75,4,2,4,10,Promising
84084,4025,13,25,1,3,2,6,Casual Users
84115,618,28,97,2,4,4,10,At Risk
84187,1848,9,12,1,2,1,4,Lost
84244,73,23,64,4,4,4,12,Champions
84319,1720,7,13,1,2,1,4,Lost
84723,140,7,10,4,2,1,7,Promising
84996,829,6,46,2,1,3,6,Lost
85430,329,18,76,3,3,4,10,Loyal Users
85474,429,5,24,3,1,2,6,Casual Users
85578,206,86,189,3,5,5,13,Loyal Users
85636,1581,5,7,1,1,1,3,Lost
85662,2079,13,65,1,3,4,8,Casual Users
86024,120,12,24,4,3,2,9,Loyal Users
86073,828,5,21,2,1,2,5,Lost
86194,79,79,267,4,5,5,14,Champions
86573,4468,12,18,1,3,2,6,Casual Users
87450,1566,7,10,1,2,1,4,Lost
87686,32,22,84,5,4,4,13,Champions
87720,12,29,86,5,4,4,13,Champions
88039,595,6,6,2,1,1,4,Lost
88074,135,6,28,4,1,2,7,Promising
88090,237,64,170,3,5,5,13,Loyal Users
88226,4,47,172,5,5,5,15,Champions
88664,128,26,75,4,4,4,12,Champions
88737,238,24,41,3,4,3,10,Loyal Users
89145,959,21,105,2,3,4,9,Casual Users
89314,59,30,84,5,4,4,13,Champions
89926,63,10,38,5,2,3,10,Promising
90120,50,87,472,5,5,5,15,Champions
90276,28,45,137,5,4,4,13,Champions
90585,15,14,27,5,3,2,10,Loyal Users
90595,236,21,42,3,3,3,9,Loyal Users
90932,27,55,189,5,5,5,15,Champions
78956,260,52,347,3,5,5,13,Loyal Users
79559,180,23,66,3,4,4,11,Loyal Users
79598,629,23,188,2,4,5,11,At Risk
79637,452,7,15,3,2,1,6,Casual Users
79991,345,8,164,3,2,5,10,Casual Users
80247,609,37,82,2,4,4,10,At Risk
80255,3512,7,24,1,2,2,5,Lost
80437,634,15,46,2,3,3,8,Casual Users
81048,291,22,67,3,4,4,11,Loyal Users
81315,1892,31,52,1,4,3,8,At Risk
81333,70,97,277,4,5,5,14,Champions
82030,65,24,66,5,4,4,13,Champions
82032,710,10,22,2,2,2,6,Lost
82520,709,11,26,2,2,2,6,Lost
82609,2730,7,12,1,2,1,4,Lost
82644,124,53,156,4,5,5,14,Champions
82696,2304,10,12,1,2,1,4,Lost
82755,1426,20,31,1,3,2,6,Casual Users
82758,822,6,19,2,1,2,5,Lost
82897,322,12,105,3,3,4,10,Loyal Users
83019,62,233,418,5,5,5,15,Champions
83067,1130,15,55,2,3,3,8,Casual Users
83114,638,14,43,2,3,3,8,Casual Users
83680,53,104,411,5,5,5,15,Champions
83719,115,56,215,4,5,5,14,Champions
84033,74,27,91,4,4,4,12,Champions
84204,1698,7,8,1,2,1,4,Lost
84912,67,31,118,5,4,4,13,Champions
85206,2302,8,14,1,2,1,4,Lost
85217,1324,6,33,1,1,3,5,Lost
85387,286,9,45,3,2,3,8,Casual Users
85454,38,46,91,5,5,4,14,Champions
85680,669,5,8,2,1,1,4,Lost
85742,2963,5,19,1,1,2,4,Lost
85973,215,58,176,3,5,5,13,Loyal Users
86051,21,77,130,5,5,4,14,Champions
86143,1525,6,11,1,1,1,3,Lost
86349,76,13,43,4,3,3,10,Loyal Users
86384,473,11,23,2,2,2,6,Lost
86527,265,10,43,3,2,3,8,Casual Users
86670,866,15,36,2,3,3,8,Casual Users
87325,299,46,88,3,5,4,12,Loyal Users
87627,128,38,156,4,4,5,13,Champions
87684,407,27,39,3,4,3,10,Loyal Users
87902,86,6,65,4,1,4,9,Promising
88201,133,15,32,4,3,3,10,Loyal Users
88213,7,31,65,5,4,4,13,Champions
88861,81,19,29,4,3,2,9,Loyal Users
89030,88,29,42,4,4,3,11,Loyal Users
89212,88,11,67,4,2,4,10,Promising
89369,69,16,93,5,3,4,12,Loyal Users
89377,423,30,50,3,4,3,10,Loyal Users
89696,3265,5,9,1,1,1,3,Lost
89748,351,6,10,3,1,1,5,Casual Users
90058,166,34,109,3,4,4,11,Loyal Users
90082,4423,6,8,1,1,1,3,Lost
90574,466,9,20,3,2,2,7,Casual Users
90721,492,8,36,2,2,3,7,Lost
90739,2527,5,14,1,1,1,3,Lost
90773,2549,5,8,1,1,1,3,Lost
90900,227,47,301,3,5,5,13,Loyal Users
78681,1104,7,10,2,2,1,5,Lost
79032,704,5,13,2,1,1,4,Lost
79234,1599,7,9,1,2,1,4,Lost
79388,261,20,97,3,3,4,10,Loyal Users
79515,3995,5,9,1,1,1,3,Lost
79588,1389,32,63,1,4,4,9,At Risk
79652,118,32,34,4,4,3,11,Loyal Users
79876,1877,6,8,1,1,1,3,Lost
80023,1601,14,37,1,3,3,7,Casual Users
80274,706,7,11,2,2,1,5,Lost
80284,422,5,20,3,1,2,6,Casual Users
80728,642,9,22,2,2,2,6,Lost
80830,109,105,515,4,5,5,14,Champions
80904,1161,5,14,2,1,1,4,Lost
80915,504,22,37,2,4,3,9,At Risk
81542,1326,5,9,1,1,1,3,Lost
81616,147,117,719,4,5,5,14,Champions
82239,136,17,36,4,3,3,10,Loyal Users
82856,33,44,84,5,4,4,13,Champions
82923,299,17,98,3,3,4,10,Loyal Users
82964,170,17,38,3,3,3,9,Loyal Users
83384,240,7,11,3,2,1,6,Casual Users
83433,119,51,294,4,5,5,14,Champions
83449,50,25,51,5,4,3,12,Loyal Users
83502,15,10,25,5,2,2,9,Promising
83797,960,8,18,2,2,2,6,Lost
84684,33,94,792,5,5,5,15,Champions
84970,526,25,72,2,4,4,10,At Risk
85307,128,47,142,4,5,4,13,Champions
85405,3576,5,7,1,1,1,3,Lost
85459,45,5,5,5,1,1,7,Promising
85763,282,30,124,3,4,4,11,Loyal Users
86003,123,13,17,4,3,2,9,Loyal Users
86237,1054,6,30,2,1,2,5,Lost
86298,34,43,169,5,4,5,14,Champions
86782,90,44,195,4,4,5,13,Champions
87011,140,29,60,4,4,3,11,Loyal Users
87089,4118,5,7,1,1,1,3,Lost
87121,425,6,11,3,1,1,5,Casual Users
87422,123,26,57,4,4,3,11,Loyal Users
87693,21,91,585,5,5,5,15,Champions
87900,75,43,61,4,4,3,11,Loyal Users
87958,2405,6,31,1,1,2,4,Lost
88152,111,32,92,4,4,4,12,Champions
88207,185,54,183,3,5,5,13,Loyal Users
88251,1,21,44,5,3,3,11,Loyal Users
88394,2,99,352,5,5,5,15,Champions
88544,2500,8,8,1,2,1,4,Lost
88571,4225,5,12,1,1,1,3,Lost
88643,131,35,311,4,4,5,13,Champions
88739,239,14,25,3,3,2,8,Loyal Users
89054,1870,6,11,1,1,1,3,Lost
89231,63,101,261,5,5,5,15,Champions
89311,860,11,25,2,2,2,6,Lost
89495,2726,14,15,1,3,1,5,Casual Users
89612,154,64,262,4,5,5,14,Champions
89918,1255,9,9,2,2,1,5,Lost
90406,103,39,182,4,4,5,13,Champions
90668,1305,13,37,1,3,3,7,Casual Users
90862,276,6,9,3,1,1,5,Casual Users
91055,106,39,90,4,4,4,12,Champions
78512,11,214,433,5,5,5,15,Champions
78658,125,140,399,4,5,5,14,Champions
78662,256,16,48,3,3,3,9,Loyal Users
78674,426,9,20,3,2,2,7,Casual Users
78818,587,14,35,2,3,3,8,Casual Users
78881,268,18,98,3,3,4,10,Loyal Users
78941,81,13,86,4,3,4,11,Loyal Users
79156,126,5,7,4,1,1,6,Promising
79168,1785,9,23,1,2,2,5,Lost
79197,419,9,12,3,2,1,6,Casual Users
79382,1111,9,10,2,2,1,5,Lost
79467,1857,6,8,1,1,1,3,Lost
79538,1675,13,18,1,3,2,6,Casual Users
79879,680,11,22,2,2,2,6,Lost
80116,36,95,321,5,5,5,15,Champions
80227,19,68,423,5,5,5,15,Champions
80252,2095,13,15,1,3,1,5,Casual Users
80381,281,6,11,3,1,1,5,Casual Users
80461,111,87,282,4,5,5,14,Champions
80974,2440,5,10,1,1,1,3,Lost
81034,1566,11,36,1,2,3,6,Lost
81274,1326,6,6,1,1,1,3,Lost
81319,103,15,31,4,3,2,9,Loyal Users
81562,134,11,33,4,2,3,9,Promising
81667,836,26,46,2,4,3,9,At Risk
81962,892,28,84,2,4,4,10,At Risk
82094,403,12,23,3,3,2,8,Loyal Users
82190,425,49,66,3,5,4,12,Loyal Users
82673,1145,7,9,2,2,1,5,Lost
82706,274,29,46,3,4,3,10,Loyal Users
82961,83,20,21,4,3,2,9,Loyal Users
83273,3,97,379,5,5,5,15,Champions
83331,83,57,87,4,5,4,13,Champions
83378,794,15,23,2,3,2,7,Casual Users
83464,279,27,80,3,4,4,11,Loyal Users
83469,2105,8,32,1,2,3,6,Lost
83868,171,5,23,3,1,2,6,Casual Users
83900,1872,9,16,1,2,2,5,Lost
83986,90,33,79,4,4,4,12,Champions
84074,2565,5,9,1,1,1,3,Lost
84134,43,41,115,5,4,4,13,Champions
84392,790,9,52,2,2,3,7,Lost
84635,231,14,60,3,3,3,9,Loyal Users
84895,4463,5,8,1,1,1,3,Lost
85491,1081,5,8,2,1,1,4,Lost
85794,309,8,22,3,2,2,7,Casual Users
86166,264,7,10,3,2,1,6,Casual Users
86489,582,10,34,2,2,3,7,Lost
87038,465,33,125,3,4,4,11,Loyal Users
87409,461,61,163,3,5,5,13,Loyal Users
87818,128,47,72,4,5,4,13,Champions
88000,48,45,224,5,4,5,14,Champions
88062,164,11,37,4,2,3,9,Promising
88176,1866,43,66,1,4,4,9,At Risk
88369,544,15,21,2,3,2,7,Casual Users
88489,263,6,14,3,1,1,5,Casual Users
88648,67,7,9,5,2,1,8,Promising
88892,2251,9,14,1,2,1,4,Lost
89139,1161,5,17,2,1,2,5,Lost
89147,1782,6,8,1,1,1,3,Lost
89348,107,9,11,4,2,1,7,Promising
89514,2,35,122,5,4,4,13,Champions
89584,30,17,33,5,3,3,11,Loyal Users
89629,5521,8,15,1,2,1,4,Lost
89644,384,9,21,3,2,2,7,Casual Users
89670,318,5,12,3,1,1,5,Casual Users
89705,93,72,675,4,5,5,14,Champions
89982,755,8,8,2,2,1,5,Lost
89993,88,74,216,4,5,5,14,Champions
90012,3133,7,16,1,2,2,5,Lost
90543,566,9,15,2,2,1,5,Lost
78285,143,9,23,4,2,2,8,Promising
78355,115,65,369,4,5,5,14,Champions
78397,126,87,294,4,5,5,14,Champions
78549,5000,13,16,1,3,2,6,Casual Users
78794,93,15,86,4,3,4,11,Loyal Users
78841,6,42,97,5,4,4,13,Champions
79267,1941,10,21,1,2,2,5,Lost
79453,983,6,16,2,1,2,5,Lost
79489,3,165,484,5,5,5,15,Champions
79553,126,11,23,4,2,2,8,Promising
80110,17,50,76,5,5,4,14,Champions
80365,289,8,12,3,2,1,6,Casual Users
80574,566,8,12,2,2,1,5,Lost
80593,122,101,381,4,5,5,14,Champions
80659,1231,15,56,2,3,3,8,Casual Users
80689,115,15,39,4,3,3,10,Loyal Users
80694,3328,6,25,1,1,2,4,Lost
80824,70,40,115,4,4,4,12,Champions
81077,3244,6,7,1,1,1,3,Lost
81405,215,11,28,3,2,2,7,Casual Users
81642,1359,6,11,1,1,1,3,Lost
81823,113,11,29,4,2,2,8,Promising
82017,27,84,235,5,5,5,15,Champions
82034,156,9,24,4,2,2,8,Promising
82077,175,92,301,3,5,5,13,Loyal Users
82508,2499,5,14,1,1,1,3,Lost
82690,112,40,200,4,4,5,13,Champions
83015,162,22,71,4,4,4,12,Champions
83034,116,145,393,4,5,5,14,Champions
83132,405,15,46,3,3,3,9,Loyal Users
83288,3485,7,23,1,2,2,5,Lost
83408,3552,12,20,1,3,2,6,Casual Users
83711,97,27,92,4,4,4,12,Champions
83865,427,6,6,3,1,1,5,Casual Users
84302,19,39,121,5,4,4,13,Champions
84600,1377,11,14,1,2,1,4,Lost
84709,271,8,34,3,2,3,8,Casual Users
85013,21,63,278,5,5,5,15,Champions
85477,63,65,208,5,5,5,15,Champions
85506,21,11,35,5,2,3,10,Promising
85575,872,22,63,2,4,4,10,At Risk
86508,27,31,118,5,4,4,13,Champions
86727,1131,6,8,2,1,1,4,Lost
86894,137,13,33,4,3,3,10,Loyal Users
86962,81,33,58,4,4,3,11,Loyal Users
87198,1110,9,23,2,2,2,6,Lost
87228,7,82,421,5,5,5,15,Champions
87268,28,74,281,5,5,5,15,Champions
87435,1002,6,13,2,1,1,4,Lost
87478,108,8,52,4,2,3,9,Promising
87876,541,33,125,2,4,4,10,At Risk
87961,120,45,117,4,4,4,12,Champions
87976,1758,8,18,1,2,2,5,Lost
88444,4833,6,27,1,1,2,4,Lost
88513,5020,16,29,1,3,2,6,Casual Users
88568,707,51,138,2,5,4,11,At Risk
88943,2548,11,14,1,2,1,4,Lost
88960,49,16,22,5,3,2,10,Loyal Users
89565,227,19,75,3,3,4,10,Loyal Users
89682,135,127,212,4,5,5,14,Champions
89970,981,6,8,2,1,1,4,Lost
90293,249,18,87,3,3,4,10,Loyal Users
90437,389,10,12,3,2,1,6,Casual Users
90658,414,21,54,3,3,3,9,Loyal Users
90969,14,12,15,5,3,1,9,Loyal Users
78345,787,30,56,2,4,3,9,At Risk
78672,666,12,12,2,3,1,6,Casual Users
78775,3665,6,7,1,1,1,3,Lost
79107,142,24,72,4,4,4,12,Champions
79463,1300,7,18,1,2,2,5,Lost
79715,270,35,67,3,4,4,11,Loyal Users
79735,11,40,208,5,4,5,14,Champions
79894,166,6,6,3,1,1,5,Casual Users
79962,1089,9,20,2,2,2,6,Lost
80260,59,64,187,5,5,5,15,Champions
80584,23,117,945,5,5,5,15,Champions
80635,7,20,45,5,3,3,11,Loyal Users
80968,4102,18,19,1,3,2,6,Casual Users
81060,599,6,25,2,1,2,5,Lost
81205,568,12,25,2,3,2,7,Casual Users
81482,2805,5,30,1,1,2,4,Lost
81610,226,9,75,3,2,4,9,Casual Users
81694,666,7,61,2,2,3,7,Lost
81783,1983,10,36,1,2,3,6,Lost
82018,116,137,972,4,5,5,14,Champions
82131,7,73,230,5,5,5,15,Champions
82187,549,14,27,2,3,2,7,Casual Users
82517,1090,5,37,2,1,3,6,Lost
82566,0,143,211,5,5,5,15,Champions
82577,2090,10,71,1,2,4,7,Lost
82676,850,5,5,2,1,1,4,Lost
82746,434,10,42,3,2,3,8,Casual Users
82773,929,5,5,2,1,1,4,Lost
83048,165,7,8,4,2,1,7,Promising
83219,1240,26,102,2,4,4,10,At Risk
83357,1927,5,9,1,1,1,3,Lost
83833,405,8,66,3,2,4,9,Casual Users
84066,314,29,185,3,4,5,12,Loyal Users
84359,1922,5,15,1,1,1,3,Lost
84743,165,18,76,4,3,4,11,Loyal Users
84831,1,42,176,5,4,5,14,Champions
84903,577,16,21,2,3,2,7,Casual Users
85004,609,8,14,2,2,1,5,Lost
85431,84,137,217,4,5,5,14,Champions
85505,1875,5,19,1,1,2,4,Lost
85614,128,32,180,4,4,5,13,Champions
85752,867,7,47,2,2,3,7,Lost
85871,84,111,177,4,5,5,14,Champions
85886,96,38,74,4,4,4,12,Champions
86650,2628,6,16,1,1,2,4,Lost
86683,93,114,234,4,5,5,14,Champions
86700,1318,14,28,1,3,2,6,Casual Users
86724,307,28,105,3,4,4,11,Loyal Users
86873,141,76,93,4,5,4,13,Champions
86910,128,73,219,4,5,5,14,Champions
86966,227,11,22,3,2,2,7,Casual Users
87039,137,45,68,4,4,4,12,Champions
87441,2474,5,9,1,1,1,3,Lost
87507,277,10,55,3,2,3,8,Casual Users
87517,106,33,225,4,4,5,13,Champions
87648,139,6,11,4,1,1,6,Promising
88070,3357,7,7,1,2,1,4,Lost
88193,348,15,22,3,3,2,8,Loyal Users
88212,12,141,279,5,5,5,15,Champions
88308,691,10,18,2,2,2,6,Lost
88410,269,77,146,3,5,4,12,Loyal Users
88649,521,34,326,2,4,5,11,At Risk
88893,4973,15,41,1,3,3,7,Casual Users
89529,114,10,20,4,2,2,8,Promising
89730,422,8,65,3,2,4,9,Casual Users
90029,83,43,87,4,4,4,12,Champions
90095,98,145,608,4,5,5,14,Champions
90119,1,38,77,5,4,4,13,Champions
90123,274,37,109,3,4,4,11,Loyal Users
90261,66,17,21,5,3,2,10,Loyal Users
90483,489,28,63,2,4,4,10,At Risk
90592,9,69,155,5,5,5,15,Champions
78481,2110,9,27,1,2,2,5,Lost
78499,2369,12,23,1,3,2,6,Casual Users
78591,5955,5,5,1,1,1,3,Lost
78985,143,18,199,4,3,5,12,Loyal Users
79033,1734,5,7,1,1,1,3,Lost
79317,111,42,99,4,4,4,12,Champions
79477,813,79,214,2,5,5,12,At Risk
79614,150,18,35,4,3,3,10,Loyal Users
79891,40,15,53,5,3,3,11,Loyal Users
80156,122,59,246,4,5,5,14,Champions
80321,379,20,96,3,3,4,10,Loyal Users
80340,51,54,76,5,5,4,14,Champions
80704,118,44,375,4,4,5,13,Champions
80714,102,72,577,4,5,5,14,Champions
81010,103,25,80,4,4,4,12,Champions
81609,118,51,279,4,5,5,14,Champions
81668,4294,5,9,1,1,1,3,Lost
81712,66,151,236,5,5,5,15,Champions
81745,2689,12,21,1,3,2,6,Casual Users
81882,23,65,150,5,5,5,15,Champions
82144,1013,14,32,2,3,3,8,Casual Users
82321,2,63,150,5,5,5,15,Champions
82689,455,22,30,3,4,2,9,Loyal Users
82714,1,12,37,5,3,3,11,Loyal Users
82894,142,16,25,4,3,2,9,Loyal Users
82930,406,14,39,3,3,3,9,Loyal Users
83047,1610,20,49,1,3,3,7,Casual Users
83241,491,65,110,2,5,4,11,At Risk
83254,67,99,199,5,5,5,15,Champions
83710,699,6,19,2,1,2,5,Lost
83737,144,12,26,4,3,2,9,Loyal Users
83753,321,15,43,3,3,3,9,Loyal Users
84309,311,27,51,3,4,3,10,Loyal Users
84389,567,8,12,2,2,1,5,Lost
85082,12,107,841,5,5,5,15,Champions
85650,142,42,49,4,4,3,11,Loyal Users
85823,506,7,12,2,2,1,5,Lost
86154,441,59,148,3,5,5,13,Loyal Users
86255,25,38,187,5,4,5,14,Champions
86344,134,69,270,4,5,5,14,Champions
86422,2979,6,6,1,1,1,3,Lost
86460,696,7,10,2,2,1,5,Lost
87123,93,74,129,4,5,4,13,Champions
87163,108,12,13,4,3,1,8,Loyal Users
87739,832,20,26,2,3,2,7,Casual Users
87761,979,7,67,2,2,4,8,Lost
88006,3,66,279,5,5,5,15,Champions
88469,139,11,21,4,2,2,8,Promising
88745,368,9,12,3,2,1,6,Casual Users
88752,728,19,114,2,3,4,9,Casual Users
88788,123,19,122,4,3,4,11,Loyal Users
88972,694,18,30,2,3,2,7,Casual Users
89515,1378,10,13,1,2,1,4,Lost
89651,1737,12,28,1,3,2,6,Casual Users
89661,3279,5,5,1,1,1,3,Lost
89697,227,10,28,3,2,2,7,Casual Users
89732,542,16,78,2,3,4,9,Casual Users
90011,1029,15,59,2,3,3,8,Casual Users
90044,401,39,86,3,4,4,11,Loyal Users
90236,171,100,132,3,5,4,12,Loyal Users
90459,151,34,96,4,4,4,12,Champions
90540,429,68,140,3,5,4,12,Loyal Users
90681,39,175,287,5,5,5,15,Champions
90738,1957,19,49,1,3,3,7,Casual Users
90883,121,60,92,4,5,4,13,Champions
91029,939,10,12,2,2,1,5,Lost
91047,22,12,64,5,3,4,12,Loyal Users
78535,539,22,58,2,4,3,9,At Risk
78626,11,136,273,5,5,5,15,Champions
78769,587,14,46,2,3,3,8,Casual Users
78770,2261,6,10,1,1,1,3,Lost
79089,852,13,24,2,3,2,7,Casual Users
79126,1557,13,19,1,3,2,6,Casual Users
79377,917,21,40,2,3,3,8,Casual Users
79625,11,27,189,5,4,5,14,Champions
79948,671,8,15,2,2,1,5,Lost
80041,2,6,19,5,1,2,8,Promising
80375,1455,5,5,1,1,1,3,Lost
80571,1,9,31,5,2,2,9,Promising
80790,959,16,52,2,3,3,8,Casual Users
80992,93,6,43,4,1,3,8,Promising
81054,4,29,284,5,4,5,14,Champions
81148,131,88,194,4,5,5,14,Champions
81149,93,88,237,4,5,5,14,Champions
81446,3724,16,27,1,3,2,6,Casual Users
81617,81,27,42,4,4,3,11,Loyal Users
81654,2997,6,17,1,1,2,4,Lost
81756,810,16,19,2,3,2,7,Casual Users
81836,17,46,259,5,5,5,15,Champions
82001,246,40,198,3,4,5,12,Loyal Users
82098,570,11,16,2,2,2,6,Lost
82136,3252,10,14,1,2,1,4,Lost
82218,5034,7,12,1,2,1,4,Lost
82320,723,5,6,2,1,1,4,Lost
82446,410,13,90,3,3,4,10,Loyal Users
82771,36,84,411,5,5,5,15,Champions
83112,2207,13,25,1,3,2,6,Casual Users
83508,25,57,247,5,5,5,15,Champions
83517,121,32,199,4,4,5,13,Champions
83565,912,9,19,2,2,2,6,Lost
83902,172,62,329,3,5,5,13,Loyal Users
84032,138,53,143,4,5,4,13,Champions
84041,5118,5,5,1,1,1,3,Lost
84282,2051,9,11,1,2,1,4,Lost
84370,154,9,19,4,2,2,8,Promising
84504,105,11,21,4,2,2,8,Promising
84511,3596,7,14,1,2,1,4,Lost
84939,10,43,213,5,4,5,14,Champions
85334,166,43,299,3,4,5,12,Loyal Users
85432,283,78,472,3,5,5,13,Loyal Users
85546,658,7,10,2,2,1,5,Lost
85654,1696,12,25,1,3,2,6,Casual Users
85761,79,68,186,4,5,5,14,Champions
85980,4,78,114,5,5,4,14,Champions
86026,563,6,9,2,1,1,4,Lost
86096,147,56,131,4,5,4,13,Champions
86115,1489,7,13,1,2,1,4,Lost
86273,2405,36,117,1,4,4,9,At Risk
86358,23,9,21,5,2,2,9,Promising
86397,1415,11,13,1,2,1,4,Lost
86487,21,32,195,5,4,5,14,Champions
86555,822,98,448,2,5,5,12,At Risk
86753,82,46,131,4,5,4,13,Champions
87404,2283,14,15,1,3,1,5,Casual Users
87870,21,14,45,5,3,3,11,Loyal Users
88496,1117,5,5,2,1,1,4,Lost
88841,2428,9,14,1,2,1,4,Lost
88958,2490,14,21,1,3,2,6,Casual Users
89035,1100,7,59,2,2,3,7,Lost
89052,39,212,952,5,5,5,15,Champions
89153,230,78,150,3,5,5,13,Loyal Users
89185,369,58,159,3,5,5,13,Loyal Users
89210,4,43,73,5,4,4,13,Champions
89242,30,13,128,5,3,4,12,Loyal Users
89281,84,33,248,4,4,5,13,Champions
89421,545,9,12,2,2,1,5,Lost
89463,0,23,46,5,4,3,12,Loyal Users
90290,3,50,122,5,5,4,14,Champions
90380,6,105,502,5,5,5,15,Champions
90515,213,8,71,3,2,4,9,Casual Users
78843,5866,12,12,1,3,1,5,Casual Users
79394,428,16,26,3,3,2,8,Loyal Users
79508,544,5,18,2,1,2,5,Lost
79784,555,6,26,2,1,2,5,Lost
79877,13,19,92,5,3,4,12,Loyal Users
79895,2211,37,96,1,4,4,9,At Risk
80038,524,30,73,2,4,4,10,At Risk
80059,131,8,16,4,2,2,8,Promising
80165,74,17,78,4,3,4,11,Loyal Users
80337,2257,9,14,1,2,1,4,Lost
80613,593,12,12,2,3,1,6,Casual Users
80800,123,14,47,4,3,3,10,Loyal Users
81083,719,6,16,2,1,2,5,Lost
81246,185,32,51,3,4,3,10,Loyal Users
81265,174,29,59,3,4,3,10,Loyal Users
81343,142,18,102,4,3,4,11,Loyal Users
81488,8,76,451,5,5,5,15,Champions
81539,3195,10,77,1,2,4,7,Lost
81606,531,6,14,2,1,1,4,Lost
81801,520,6,12,2,1,1,4,Lost
81982,447,16,24,3,3,2,8,Loyal Users
82175,1314,17,25,1,3,2,6,Casual Users
82230,434,17,39,3,3,3,9,Loyal Users
82695,510,12,21,2,3,2,7,Casual Users
83172,165,5,57,4,1,3,8,Promising
83374,1035,5,8,2,1,1,4,Lost
83682,4152,8,26,1,2,2,5,Lost
83826,622,17,111,2,3,4,9,Casual Users
83844,3114,17,77,1,3,4,8,Casual Users
83845,91,27,141,4,4,4,12,Champions
83847,334,39,96,3,4,4,11,Loyal Users
84138,1318,18,34,1,3,3,7,Casual Users
84147,3410,9,61,1,2,3,6,Lost
84172,856,17,102,2,3,4,9,Casual Users
85091,3289,6,13,1,1,1,3,Lost
85364,1824,7,40,1,2,3,6,Lost
85663,2097,67,359,1,5,5,11,At Risk
85963,1546,5,11,1,1,1,3,Lost
86410,159,11,14,4,2,1,7,Promising
86415,845,7,11,2,2,1,5,Lost
86540,155,8,32,4,2,3,9,Promising
86891,705,21,52,2,3,3,8,Casual Users
86918,1281,5,11,1,1,1,3,Lost
87036,108,31,62,4,4,3,11,Loyal Users
87333,119,104,298,4,5,5,14,Champions
87377,545,55,106,2,5,4,11,At Risk
87661,195,30,84,3,4,4,11,Loyal Users
87731,439,20,61,3,3,3,9,Loyal Users
88173,1121,11,15,2,2,1,5,Lost
88361,537,17,25,2,3,2,7,Casual Users
88553,701,12,34,2,3,3,8,Casual Users
88655,116,152,284,4,5,5,14,Champions
88699,116,5,19,4,1,2,7,Promising
88863,1,13,27,5,3,2,10,Loyal Users
89213,247,6,7,3,1,1,5,Casual Users
89262,140,21,83,4,3,4,11,Loyal Users
89783,16,30,67,5,4,4,13,Champions
89854,1080,9,21,2,2,2,6,Lost
90008,169,54,218,3,5,5,13,Loyal Users
90162,5527,17,97,1,3,4,8,Casual Users
90213,840,25,29,2,4,2,8,At Risk
90443,338,9,152,3,2,5,10,Casual Users
90517,406,17,26,3,3,2,8,Loyal Users
90687,114,38,105,4,4,4,12,Champions
90950,5426,6,13,1,1,1,3,Lost
78321,840,9,14,2,2,1,5,Lost
78331,2261,5,6,1,1,1,3,Lost
78497,169,21,168,3,3,5,11,Loyal Users
78945,507,7,7,2,2,1,5,Lost
79316,0,85,153,5,5,5,15,Champions
79590,1568,17,29,1,3,2,6,Casual Users
79939,64,7,61,5,2,3,10,Promising
80142,76,6,15,4,1,1,6,Promising
80372,128,15,28,4,3,2,9,Loyal Users
80542,668,39,51,2,4,3,9,At Risk
80550,697,19,48,2,3,3,8,Casual Users
81045,19,7,16,5,2,2,9,Promising
81051,162,16,40,4,3,3,10,Loyal Users
81116,128,42,94,4,4,4,12,Champions
81286,198,40,101,3,4,4,11,Loyal Users
81409,1091,7,20,2,2,2,6,Lost
81702,83,67,143,4,5,4,13,Champions
81824,494,16,57,2,3,3,8,Casual Users
81860,1700,5,17,1,1,2,4,Lost
81926,6,84,216,5,5,5,15,Champions
81957,88,65,285,4,5,5,14,Champions
82079,391,48,173,3,5,5,13,Loyal Users
82210,58,89,222,5,5,5,15,Champions
82470,475,18,31,2,3,2,7,Casual Users
82638,11,44,176,5,4,5,14,Champions
82878,416,50,168,3,5,5,13,Loyal Users
83146,0,27,69,5,4,4,13,Champions
83610,148,39,141,4,4,4,12,Champions
83785,860,20,129,2,3,4,9,Casual Users
84046,1576,11,14,1,2,1,4,Lost
84154,22,25,118,5,4,4,13,Champions
84521,979,11,39,2,2,3,7,Lost
84597,4075,8,31,1,2,2,5,Lost
85149,114,15,42,4,3,3,10,Loyal Users
85385,121,10,85,4,2,4,10,Promising
85677,1935,32,63,1,4,4,9,At Risk
86037,498,44,272,2,4,5,11,At Risk
86152,114,102,440,4,5,5,14,Champions
86292,527,24,57,2,4,3,9,At Risk
86391,322,127,387,3,5,5,13,Loyal Users
86432,13,10,14,5,2,1,8,Promising
86637,69,76,237,5,5,5,15,Champions
87266,208,16,73,3,3,4,10,Loyal Users
87360,272,5,10,3,1,1,5,Casual Users
87650,624,7,10,2,2,1,5,Lost
87840,10,83,143,5,5,4,14,Champions
87893,232,10,22,3,2,2,7,Casual Users
87955,3945,6,6,1,1,1,3,Lost
88020,342,112,172,3,5,5,13,Loyal Users
88494,139,107,203,4,5,5,14,Champions
88574,15,57,80,5,5,4,14,Champions
88741,41,165,633,5,5,5,15,Champions
88758,286,18,27,3,3,2,8,Loyal Users
88855,264,27,123,3,4,4,11,Loyal Users
88961,1127,12,29,2,3,2,7,Casual Users
89107,70,82,213,4,5,5,14,Champions
89129,2955,7,40,1,2,3,6,Lost
89176,1417,16,26,1,3,2,6,Casual Users
89589,1151,14,37,2,3,3,8,Casual Users
90368,2,11,20,5,2,2,9,Promising
90404,350,19,45,3,3,3,9,Loyal Users
90523,5607,9,15,1,2,1,4,Lost
90947,74,83,374,4,5,5,14,Champions
90951,383,8,14,3,2,1,6,Casual Users
90978,700,39,180,2,4,5,11,At Risk
91051,73,46,113,4,5,4,13,Champions
78517,41,16,25,5,3,2,10,Loyal Users
78761,382,16,22,3,3,2,8,Loyal Users
79284,1425,6,8,1,1,1,3,Lost
79352,13,50,116,5,5,4,14,Champions
79363,235,13,48,3,3,3,9,Loyal Users
79473,2,47,119,5,5,4,14,Champions
79675,1021,5,7,2,1,1,4,Lost
79718,1454,6,6,1,1,1,3,Lost
79739,1683,12,29,1,3,2,6,Casual Users
80004,1269,14,21,1,3,2,6,Casual Users
80129,549,9,17,2,2,2,6,Lost
80283,1050,6,14,2,1,1,4,Lost
80399,3,26,84,5,4,4,13,Champions
80480,60,13,38,5,3,3,11,Loyal Users
81271,66,38,312,5,4,5,14,Champions
81361,441,13,23,3,3,2,8,Loyal Users
81517,12,162,484,5,5,5,15,Champions
82265,37,17,201,5,3,5,13,Loyal Users
82568,412,16,18,3,3,2,8,Loyal Users
83072,1097,6,57,2,1,3,6,Lost
83426,1343,29,115,1,4,4,9,At Risk
83840,15,34,157,5,4,5,14,Champions
84075,21,40,55,5,4,3,12,Loyal Users
84260,85,31,121,4,4,4,12,Champions
84419,2406,8,8,1,2,1,4,Lost
84583,534,10,11,2,2,1,5,Lost
84608,555,12,22,2,3,2,7,Casual Users
85318,428,52,71,3,5,4,12,Loyal Users
85632,285,27,68,3,4,4,11,Loyal Users
85948,125,98,303,4,5,5,14,Champions
86056,288,7,8,3,2,1,6,Casual Users
86296,384,24,40,3,4,3,10,Loyal Users
86307,97,89,110,4,5,4,13,Champions
86325,1261,5,9,1,1,1,3,Lost
86327,2988,8,9,1,2,1,4,Lost
86340,2024,6,10,1,1,1,3,Lost
86613,415,26,73,3,4,4,11,Loyal Users
86644,1817,17,26,1,3,2,6,Casual Users
86958,131,24,118,4,4,4,12,Champions
87020,1543,7,13,1,2,1,4,Lost
87320,119,12,50,4,3,3,10,Loyal Users
87752,100,106,323,4,5,5,14,Champions
88024,34,11,12,5,2,1,8,Promising
89020,301,12,17,3,3,2,8,Loyal Users
89138,56,89,145,5,5,4,14,Champions
89279,4,24,37,5,4,3,12,Loyal Users
89304,628,7,44,2,2,3,7,Lost
89342,185,43,365,3,4,5,12,Loyal Users
89362,32,34,238,5,4,5,14,Champions
89673,708,11,45,2,2,3,7,Lost
89743,418,5,21,3,1,2,6,Casual Users
89976,3,15,21,5,3,2,10,Loyal Users
90569,70,58,244,4,5,5,14,Champions
90806,85,30,143,4,4,4,12,Champions
90916,385,49,168,3,5,5,13,Loyal Users
78546,4278,8,14,1,2,1,4,Lost
78935,130,71,144,4,5,4,13,Champions
79141,411,6,7,3,1,1,5,Casual Users
79380,95,69,94,4,5,4,13,Champions
79430,270,35,68,3,4,4,11,Loyal Users
79502,3039,9,19,1,2,2,5,Lost
79680,701,51,160,2,5,5,12,At Risk
79976,194,29,82,3,4,4,11,Loyal Users
80256,1440,16,25,1,3,2,6,Casual Users
80309,16,57,211,5,5,5,15,Champions
80400,707,5,30,2,1,2,5,Lost
80413,287,63,137,3,5,4,12,Loyal Users
80713,10,20,28,5,3,2,10,Loyal Users
81032,6,17,59,5,3,3,11,Loyal Users
81091,270,50,136,3,5,4,12,Loyal Users
81189,1,65,190,5,5,5,15,Champions
81377,4018,6,33,1,1,3,5,Lost
81650,547,25,144,2,4,4,10,At Risk
81728,277,35,57,3,4,3,10,Loyal Users
82133,2479,9,27,1,2,2,5,Lost
82269,144,18,38,4,3,3,10,Loyal Users
82329,1003,20,36,2,3,3,8,Casual Users
82380,419,46,61,3,5,3,11,Loyal Users
82493,46,53,116,5,5,4,14,Champions
82649,860,5,6,2,1,1,4,Lost
82740,16,159,438,5,5,5,15,Champions
83074,110,46,213,4,5,5,14,Champions
83281,1513,5,35,1,1,3,5,Lost
83380,3392,10,17,1,2,2,5,Lost
83574,2027,5,6,1,1,1,3,Lost
83592,7,49,129,5,5,4,14,Champions
83673,2,5,5,5,1,1,7,Promising
83802,3349,6,6,1,1,1,3,Lost
84072,234,53,188,3,5,5,13,Loyal Users
84518,3,52,109,5,5,4,14,Champions
84537,7,6,10,5,1,1,7,Promising
84667,0,5,15,5,1,1,7,Promising
84700,77,68,447,4,5,5,14,Champions
84894,3276,5,23,1,1,2,4,Lost
85124,861,5,11,2,1,1,4,Lost
85221,22,100,155,5,5,5,15,Champions
85428,79,21,63,4,3,4,11,Loyal Users
85866,90,22,131,4,4,4,12,Champions
85920,411,9,64,3,2,4,9,Casual Users
86041,88,14,122,4,3,4,11,Loyal Users
86464,8,28,53,5,4,3,12,Loyal Users
86549,31,5,23,5,1,2,8,Promising
86593,280,8,18,3,2,2,7,Casual Users
86679,9,51,160,5,5,5,15,Champions
86680,825,5,6,2,1,1,4,Lost
87179,345,9,15,3,2,1,6,Casual Users
87207,277,23,29,3,4,2,9,Loyal Users
87522,57,37,124,5,4,4,13,Champions
87996,194,24,52,3,4,3,10,Loyal Users
88026,4661,9,24,1,2,2,5,Lost
88493,33,40,47,5,4,3,12,Loyal Users
88736,295,36,150,3,4,5,12,Loyal Users
89016,1423,7,11,1,2,1,4,Lost
89070,1918,5,5,1,1,1,3,Lost
89079,284,83,280,3,5,5,13,Loyal Users
89155,560,42,261,2,4,5,11,At Risk
89604,558,27,73,2,4,4,10,At Risk
90111,2824,18,47,1,3,3,7,Casual Users
90187,151,6,19,4,1,2,7,Promising
90473,726,8,20,2,2,2,6,Lost
90676,290,61,147,3,5,5,13,Loyal Users
90762,99,5,10,4,1,1,6,Promising
90797,819,12,16,2,3,2,7,Casual Users
90808,27,159,184,5,5,5,15,Champions
78326,134,48,155,4,5,5,14,Champions
78629,3623,7,14,1,2,1,4,Lost
78863,4263,7,11,1,2,1,4,Lost
79137,2006,13,24,1,3,2,6,Casual Users
79348,970,10,122,2,2,4,8,Lost
79509,1181,5,10,2,1,1,4,Lost
79619,427,26,38,3,4,3,10,Loyal Users
79702,141,43,333,4,4,5,13,Champions
80272,30,35,89,5,4,4,13,Champions
80277,2,33,112,5,4,4,13,Champions
80366,139,34,76,4,4,4,12,Champions
80368,24,39,114,5,4,4,13,Champions
80373,283,37,122,3,4,4,11,Loyal Users
80401,124,44,394,4,4,5,13,Champions
80547,1230,6,13,2,1,1,4,Lost
80564,272,18,37,3,3,3,9,Loyal Users
80907,1588,5,21,1,1,2,4,Lost
80971,120,22,54,4,4,3,11,Loyal Users
81476,84,94,245,4,5,5,14,Champions
82737,715,8,10,2,2,1,5,Lost
82997,547,12,12,2,3,1,6,Casual Users
83237,368,6,10,3,1,1,5,Casual Users
83562,1115,12,27,2,3,2,7,Casual Users
83712,454,25,93,3,4,4,11,Loyal Users
83786,119,20,143,4,3,4,11,Loyal Users
83949,364,11,70,3,2,4,9,Casual Users
84256,672,8,107,2,2,4,8,Lost
85539,1649,7,7,1,2,1,4,Lost
86496,2829,12,54,1,3,3,7,Casual Users
86528,828,13,53,2,3,3,8,Casual Users
86541,40,106,230,5,5,5,15,Champions
86736,2790,5,9,1,1,1,3,Lost
86831,320,5,21,3,1,2,6,Casual Users
87097,7,48,104,5,5,4,14,Champions
87171,431,9,12,3,2,1,6,Casual Users
87382,500,8,58,2,2,3,7,Lost
87571,142,19,28,4,3,2,9,Loyal Users
87619,17,33,58,5,4,3,12,Loyal Users
87879,1413,12,36,1,3,3,7,Casual Users
88092,1217,14,21,2,3,2,7,Casual Users
88343,132,16,39,4,3,3,10,Loyal Users
88591,2562,38,81,1,4,4,9,At Risk
88690,252,12,84,3,3,4,10,Loyal Users
89352,431,26,144,3,4,4,11,Loyal Users
89831,1405,12,54,1,3,3,7,Casual Users
89974,3873,6,7,1,1,1,3,Lost
90034,411,14,19,3,3,2,8,Loyal Users
90252,5796,10,20,1,2,2,5,Lost
90332,475,33,114,2,4,4,10,At Risk
90460,2424,5,5,1,1,1,3,Lost
90898,91,63,389,4,5,5,14,Champions
78772,12,62,100,5,5,4,14,Champions
79069,343,12,19,3,3,2,8,Loyal Users
79175,2299,7,36,1,2,3,6,Lost
79821,408,5,68,3,1,4,8,Casual Users
80102,108,35,134,4,4,4,12,Champions
80349,93,79,230,4,5,5,14,Champions
80443,11,7,29,5,2,2,9,Promising
80940,1859,13,62,1,3,3,7,Casual Users
81537,4984,11,11,1,2,1,4,Lost
81566,6,51,231,5,5,5,15,Champions
81713,4172,8,8,1,2,1,4,Lost
82008,149,36,63,4,4,4,12,Champions
82158,2093,6,10,1,1,1,3,Lost
82238,293,10,29,3,2,2,7,Casual Users
82272,173,42,95,3,4,4,11,Loyal Users
82291,822,6,6,2,1,1,4,Lost
82581,27,100,139,5,5,4,14,Champions
82779,158,96,671,4,5,5,14,Champions
83053,819,25,71,2,4,4,10,At Risk
83232,1509,20,99,1,3,4,8,Casual Users
83252,2474,23,80,1,4,4,9,At Risk
83292,886,16,48,2,3,3,8,Casual Users
83324,264,14,55,3,3,3,9,Loyal Users
83379,47,29,70,5,4,4,13,Champions
83409,69,21,194,5,3,5,13,Loyal Users
83636,106,6,40,4,1,3,8,Promising
84216,397,30,77,3,4,4,11,Loyal Users
84293,125,83,392,4,5,5,14,Champions
84578,691,6,7,2,1,1,4,Lost
84609,410,13,43,3,3,3,9,Loyal Users
84838,421,20,29,3,3,2,8,Loyal Users
84918,763,7,9,2,2,1,5,Lost
84944,123,8,10,4,2,1,7,Promising
85129,292,5,78,3,1,4,8,Casual Users
85801,530,5,43,2,1,3,6,Lost
85967,122,30,81,4,4,4,12,Champions
86042,428,16,20,3,3,2,8,Loyal Users
86207,94,5,28,4,1,2,7,Promising
86324,2462,22,32,1,4,3,8,At Risk
86387,295,6,12,3,1,1,5,Casual Users
86490,1532,13,50,1,3,3,7,Casual Users
86747,127,70,149,4,5,5,14,Champions
87297,24,82,268,5,5,5,15,Champions
87484,2866,5,5,1,1,1,3,Lost
87638,1841,10,52,1,2,3,6,Lost
87701,34,96,313,5,5,5,15,Champions
87771,880,31,105,2,4,4,10,At Risk
87972,148,9,21,4,2,2,8,Promising
87991,405,53,277,3,5,5,13,Loyal Users
88078,417,14,18,3,3,2,8,Loyal Users
88249,68,6,12,5,1,1,7,Promising
88436,403,22,62,3,4,3,10,Loyal Users
88875,20,136,622,5,5,5,15,Champions
89068,90,25,162,4,4,5,13,Champions
89872,23,110,510,5,5,5,15,Champions
90157,1996,5,7,1,1,1,3,Lost
90193,616,12,22,2,3,2,7,Casual Users
90405,695,13,27,2,3,2,7,Casual Users
90684,1430,7,13,1,2,1,4,Lost
90995,878,7,9,2,2,1,5,Lost
78477,333,13,85,3,3,4,10,Loyal Users
79273,4,119,131,5,5,4,14,Champions
79777,1439,8,70,1,2,4,7,Lost
79782,143,22,47,4,4,3,11,Loyal Users
79859,27,118,430,5,5,5,15,Champions
80328,414,7,36,3,2,3,8,Casual Users
80417,26,63,114,5,5,4,14,Champions
80745,19,159,438,5,5,5,15,Champions
81058,12,34,52,5,4,3,12,Loyal Users
81565,101,19,78,4,3,4,11,Loyal Users
81585,105,41,118,4,4,4,12,Champions
81600,1663,5,7,1,1,1,3,Lost
81627,144,51,265,4,5,5,14,Champions
81825,550,10,35,2,2,3,7,Lost
81958,531,29,61,2,4,3,9,At Risk
82046,737,35,50,2,4,3,9,At Risk
82667,411,20,56,3,3,3,9,Loyal Users
82698,820,42,75,2,4,4,10,At Risk
82890,5,109,213,5,5,5,15,Champions
83506,305,48,125,3,5,4,12,Loyal Users
83759,127,6,12,4,1,1,6,Promising
83872,2280,6,12,1,1,1,3,Lost
83940,241,39,59,3,4,3,10,Loyal Users
84058,756,7,9,2,2,1,5,Lost
84161,852,20,108,2,3,4,9,Casual Users
84162,129,7,30,4,2,2,8,Promising
84184,19,118,440,5,5,5,15,Champions
84517,1092,6,30,2,1,2,5,Lost
84587,403,22,42,3,4,3,10,Loyal Users
84653,23,33,64,5,4,4,13,Champions
85495,464,11,20,3,2,2,7,Casual Users
85608,1300,25,43,1,4,3,8,At Risk
85843,67,98,194,5,5,5,15,Champions
86098,116,57,357,4,5,5,14,Champions
86183,114,112,483,4,5,5,14,Champions
86184,1108,10,37,2,2,3,7,Lost
86308,2074,22,107,1,4,4,9,At Risk
86606,248,30,263,3,4,5,12,Loyal Users
86615,440,5,6,3,1,1,5,Casual Users
86780,465,18,66,3,3,4,10,Loyal Users
87151,1053,18,48,2,3,3,8,Casual Users
87236,262,17,25,3,3,2,8,Loyal Users
87249,1787,5,9,1,1,1,3,Lost
87388,29,33,77,5,4,4,13,Champions
87750,4616,5,12,1,1,1,3,Lost
87937,814,8,36,2,2,3,7,Lost
88032,409,57,72,3,5,4,12,Loyal Users
88453,132,68,201,4,5,5,14,Champions
88549,830,18,50,2,3,3,8,Casual Users
88603,1237,10,14,2,2,1,5,Lost
88764,66,12,80,5,3,4,12,Loyal Users
88902,151,162,238,4,5,5,14,Champions
88995,1407,17,104,1,3,4,8,Casual Users
89005,52,37,137,5,4,4,13,Champions
89156,1624,8,32,1,2,3,6,Lost
89167,403,7,10,3,2,1,6,Casual Users
89215,94,33,58,4,4,3,11,Loyal Users
89856,2127,8,26,1,2,2,5,Lost
90004,16,43,168,5,4,5,14,Champions
90215,213,41,205,3,4,5,12,Loyal Users
90354,58,9,34,5,2,3,10,Promising
90396,688,12,29,2,3,2,7,Casual Users
90484,735,5,17,2,1,2,5,Lost
90561,149,8,37,4,2,3,9,Promising
90761,67,39,195,5,4,5,14,Champions
90788,184,8,39,3,2,3,8,Casual Users
90911,827,18,60,2,3,3,8,Casual Users
91019,873,16,28,2,3,2,7,Casual Users
78521,143,18,42,4,3,3,10,Loyal Users
78610,27,5,11,5,1,1,7,Promising
78837,132,55,100,4,5,4,13,Champions
79042,116,118,488,4,5,5,14,Champions
79085,938,9,15,2,2,1,5,Lost
79370,234,94,418,3,5,5,13,Loyal Users
79603,170,61,179,3,5,5,13,Loyal Users
79801,427,7,10,3,2,1,6,Casual Users
79898,700,5,9,2,1,1,4,Lost
80163,2125,5,16,1,1,2,4,Lost
80802,2983,5,7,1,1,1,3,Lost
81000,215,25,67,3,4,4,11,Loyal Users
81122,130,18,47,4,3,3,10,Loyal Users
81156,1752,12,25,1,3,2,6,Casual Users
81582,16,105,557,5,5,5,15,Champions
81619,534,31,40,2,4,3,9,At Risk
81822,865,17,30,2,3,2,7,Casual Users
82099,25,24,154,5,4,5,14,Champions
82495,276,29,85,3,4,4,11,Loyal Users
82606,275,11,23,3,2,2,7,Casual Users
82699,40,91,450,5,5,5,15,Champions
82757,442,5,5,3,1,1,5,Casual Users
82891,2474,9,9,1,2,1,4,Lost
82944,1007,53,124,2,5,4,11,At Risk
83093,81,19,49,4,3,3,10,Loyal Users
83312,4433,9,9,1,2,1,4,Lost
83415,131,77,301,4,5,5,14,Champions
83788,32,27,86,5,4,4,13,Champions
84024,82,78,160,4,5,5,14,Champions
84367,10,185,491,5,5,5,15,Champions
84441,598,7,16,2,2,2,6,Lost
84662,258,98,219,3,5,5,13,Loyal Users
84724,427,10,30,3,2,2,7,Casual Users
85116,62,64,298,5,5,5,15,Champions
85181,135,16,38,4,3,3,10,Loyal Users
85197,93,94,462,4,5,5,14,Champions
85418,5807,7,11,1,2,1,4,Lost
85536,124,10,17,4,2,2,8,Promising
85972,227,26,51,3,4,3,10,Loyal Users
86013,53,91,491,5,5,5,15,Champions
86662,77,71,441,4,5,5,14,Champions
86797,2933,7,23,1,2,2,5,Lost
87553,41,109,577,5,5,5,15,Champions
87716,516,8,19,2,2,2,6,Lost
88209,48,27,59,5,4,3,12,Loyal Users
88382,528,29,93,2,4,4,10,At Risk
88499,2291,22,66,1,4,4,9,At Risk
88537,127,11,22,4,2,2,8,Promising
88771,5260,23,48,1,4,3,8,At Risk
89043,241,42,105,3,4,4,11,Loyal Users
89439,21,83,186,5,5,5,15,Champions
89518,29,41,100,5,4,4,13,Champions
90150,2494,5,13,1,1,1,3,Lost
90197,96,14,23,4,3,2,9,Loyal Users
90357,937,25,142,2,4,4,10,At Risk
90497,1407,12,19,1,3,2,6,Casual Users
90698,256,63,118,3,5,4,12,Loyal Users
90972,16,52,129,5,5,4,14,Champions
78316,111,57,352,4,5,5,14,Champions
78852,1976,12,28,1,3,2,6,Casual Users
78856,118,49,234,4,5,5,14,Champions
79055,162,20,82,4,3,4,11,Loyal Users
79427,139,95,356,4,5,5,14,Champions
79586,351,12,19,3,3,2,8,Loyal Users
79696,3240,16,63,1,3,4,8,Casual Users
79886,44,14,35,5,3,3,11,Loyal Users
79969,477,14,24,2,3,2,7,Casual Users
80486,103,122,333,4,5,5,14,Champions
80578,1241,12,16,2,3,2,7,Casual Users
80825,409,5,11,3,1,1,5,Casual Users
81027,718,13,21,2,3,2,7,Casual Users
81078,1101,25,38,2,4,3,9,At Risk
81154,110,42,82,4,4,4,12,Champions
81208,132,13,19,4,3,2,9,Loyal Users
81504,1519,9,20,1,2,2,5,Lost
81570,4847,8,15,1,2,1,4,Lost
81578,674,21,35,2,3,3,8,Casual Users
81916,19,67,114,5,5,4,14,Champions
82054,108,7,52,4,2,3,9,Promising
82245,131,26,40,4,4,3,11,Loyal Users
82428,31,43,202,5,4,5,14,Champions
82973,2404,8,103,1,2,4,7,Lost
83007,275,50,89,3,5,4,12,Loyal Users
83338,1470,6,12,1,1,1,3,Lost
83662,12,5,18,5,1,2,8,Promising
83863,1198,17,60,2,3,3,8,Casual Users
83871,33,165,447,5,5,5,15,Champions
83934,1,131,773,5,5,5,15,Champions
84014,4863,9,26,1,2,2,5,Lost
84453,76,13,17,4,3,2,9,Loyal Users
84644,1584,7,12,1,2,1,4,Lost
84822,1254,17,91,2,3,4,9,Casual Users
85016,92,17,97,4,3,4,11,Loyal Users
85033,2,119,196,5,5,5,15,Champions
85187,15,186,646,5,5,5,15,Champions
85352,688,147,452,2,5,5,12,At Risk
85710,41,52,246,5,5,5,15,Champions
85767,1134,12,19,2,3,2,7,Casual Users
85879,332,13,18,3,3,2,8,Loyal Users
86050,3,20,71,5,3,4,12,Loyal Users
86080,130,9,36,4,2,3,9,Promising
86249,2233,6,8,1,1,1,3,Lost
86295,127,18,35,4,3,3,10,Loyal Users
86378,87,43,115,4,4,4,12,Champions
86669,395,23,69,3,4,4,11,Loyal Users
86730,632,26,217,2,4,5,11,At Risk
86760,119,42,96,4,4,4,12,Champions
86905,487,6,6,2,1,1,4,Lost
86949,507,6,26,2,1,2,5,Lost
87835,407,10,60,3,2,3,8,Casual Users
87891,336,83,468,3,5,5,13,Loyal Users
88120,2025,10,25,1,2,2,5,Lost
88718,48,36,172,5,4,5,14,Champions
89123,135,43,75,4,4,4,12,Champions
89178,135,31,90,4,4,4,12,Champions
89326,1127,21,63,2,3,4,9,Casual Users
89477,270,7,16,3,2,2,7,Casual Users
89935,1,70,422,5,5,5,15,Champions
90056,74,107,311,4,5,5,14,Champions
90104,234,5,7,3,1,1,5,Casual Users
90181,120,9,29,4,2,2,8,Promising
90229,4170,5,6,1,1,1,3,Lost
90340,250,23,33,3,4,3,10,Loyal Users
90402,1404,5,7,1,1,1,3,Lost
90534,2951,7,10,1,2,1,4,Lost
90670,128,117,534,4,5,5,14,Champions
78465,0,38,171,5,4,5,14,Champions
78550,1227,8,13,2,2,1,5,Lost
79403,166,66,373,3,5,5,13,Loyal Users
79439,568,8,10,2,2,1,5,Lost
79522,1664,6,15,1,1,1,3,Lost
79732,95,38,119,4,4,4,12,Champions
79802,103,9,13,4,2,1,7,Promising
79828,500,9,20,2,2,2,6,Lost
80054,69,104,326,5,5,5,15,Champions
80362,79,7,8,4,2,1,7,Promising
80649,535,7,33,2,2,3,7,Lost
80662,755,14,49,2,3,3,8,Casual Users
81110,4088,18,38,1,3,3,7,Casual Users
81673,529,11,82,2,2,4,8,Lost
81810,101,33,273,4,4,5,13,Champions
81848,471,8,10,2,2,1,5,Lost
81852,28,66,97,5,5,4,14,Champions
81868,699,20,31,2,3,2,7,Casual Users
81994,1568,7,27,1,2,2,5,Lost
82057,408,25,49,3,4,3,10,Loyal Users
82384,97,31,84,4,4,4,12,Champions
82633,56,12,273,5,3,5,13,Loyal Users
83149,117,10,65,4,2,4,10,Promising
83722,109,38,115,4,4,4,12,Champions
83958,139,12,48,4,3,3,10,Loyal Users
84098,1,43,73,5,4,4,13,Champions
84102,544,7,12,2,2,1,5,Lost
84265,4299,5,12,1,1,1,3,Lost
84294,22,110,666,5,5,5,15,Champions
85402,151,5,7,4,1,1,6,Promising
85700,1621,15,35,1,3,3,7,Casual Users
85875,1792,10,71,1,2,4,7,Lost
86142,326,17,29,3,3,2,8,Loyal Users
86235,93,7,12,4,2,1,7,Promising
86401,1343,8,31,1,2,2,5,Lost
86783,38,9,22,5,2,2,9,Promising
86793,773,6,21,2,1,2,5,Lost
86856,3706,17,32,1,3,3,7,Casual Users
86951,81,57,173,4,5,5,14,Champions
87106,515,18,67,2,3,4,9,Casual Users
87230,1571,8,14,1,2,1,4,Lost
87874,125,20,53,4,3,3,10,Loyal Users
87910,14,24,46,5,4,3,12,Loyal Users
87931,130,121,301,4,5,5,14,Champions
88104,3,46,140,5,5,4,14,Champions
88157,534,5,11,2,1,1,4,Lost
88199,583,9,12,2,2,1,5,Lost
88310,1002,20,29,2,3,2,7,Casual Users
88353,292,8,16,3,2,2,7,Casual Users
88452,280,35,133,3,4,4,11,Loyal Users
88491,310,24,61,3,4,3,10,Loyal Users
88665,121,22,51,4,4,3,11,Loyal Users
88765,238,17,38,3,3,3,9,Loyal Users
88767,1454,18,29,1,3,2,6,Casual Users
88782,855,7,11,2,2,1,5,Lost
88973,162,88,145,4,5,4,13,Champions
89089,104,26,45,4,4,3,11,Loyal Users
89114,272,53,350,3,5,5,13,Loyal Users
89159,123,31,37,4,4,3,11,Loyal Users
89364,1398,16,46,1,3,3,7,Casual Users
89431,456,17,33,3,3,3,9,Loyal Users
89688,1752,6,64,1,1,4,6,Lost
89966,207,13,25,3,3,2,8,Loyal Users
90544,448,29,55,3,4,3,10,Loyal Users
90689,416,9,17,3,2,2,7,Casual Users
90784,1264,7,20,1,2,2,5,Lost
90843,119,16,37,4,3,3,10,Loyal Users
78346,412,11,34,3,2,3,8,Casual Users
78380,7,62,178,5,5,5,15,Champions
78715,3613,10,27,1,2,2,5,Lost
78720,456,11,13,3,2,1,6,Casual Users
78788,665,8,34,2,2,3,7,Lost
78795,275,36,58,3,4,3,10,Loyal Users
79001,90,9,108,4,2,4,10,Promising
79438,21,74,334,5,5,5,15,Champions
79542,1,22,38,5,4,3,12,Loyal Users
80120,114,42,152,4,4,5,13,Champions
80554,3516,8,8,1,2,1,4,Lost
80764,2513,7,31,1,2,2,5,Lost
80844,1987,8,36,1,2,3,6,Lost
81183,1016,9,11,2,2,1,5,Lost
81348,429,6,9,3,1,1,5,Casual Users
81403,1421,11,51,1,2,3,6,Lost
81648,148,18,29,4,3,2,9,Loyal Users
81817,143,24,134,4,4,4,12,Champions
81889,3953,5,5,1,1,1,3,Lost
82490,1717,38,49,1,4,3,8,At Risk
82521,1,90,208,5,5,5,15,Champions
82725,122,69,313,4,5,5,14,Champions
82829,248,69,186,3,5,5,13,Loyal Users
82882,327,15,106,3,3,4,10,Loyal Users
83073,114,14,19,4,3,2,9,Loyal Users
83151,17,101,240,5,5,5,15,Champions
83184,469,11,13,3,2,1,6,Casual Users
83529,1988,5,32,1,1,3,5,Lost
83687,4,10,10,5,2,1,8,Promising
83770,2010,14,18,1,3,2,6,Casual Users
83912,87,53,345,4,5,5,14,Champions
83994,1637,9,23,1,2,2,5,Lost
84091,95,27,88,4,4,4,12,Champions
84259,296,7,21,3,2,2,7,Casual Users
84523,1137,15,29,2,3,2,7,Casual Users
84672,706,12,15,2,3,1,6,Casual Users
84909,1134,5,6,2,1,1,4,Lost
85055,394,6,8,3,1,1,5,Casual Users
85766,4000,5,14,1,1,1,3,Lost
86147,975,6,12,2,1,1,4,Lost
86230,538,8,12,2,2,1,5,Lost
86333,1450,8,21,1,2,2,5,Lost
86425,113,37,91,4,4,4,12,Champions
86563,4241,12,76,1,3,4,8,Casual Users
86663,581,19,86,2,3,4,9,Casual Users
86716,11,15,18,5,3,2,10,Loyal Users
87024,196,32,73,3,4,4,11,Loyal Users
87494,249,33,58,3,4,3,10,Loyal Users
87916,16,100,240,5,5,5,15,Champions
88130,274,37,49,3,4,3,10,Loyal Users
88136,115,65,134,4,5,4,13,Champions
88327,1157,8,64,2,2,4,8,Lost
88870,18,25,92,5,4,4,13,Champions
88966,2509,5,7,1,1,1,3,Lost
89343,161,94,495,4,5,5,14,Champions
89359,3627,8,13,1,2,1,4,Lost
90023,2402,8,18,1,2,2,5,Lost
90172,472,5,13,2,1,1,4,Lost
90268,2,23,59,5,4,3,12,Loyal Users
90273,174,13,35,3,3,3,9,Loyal Users
90392,134,11,49,4,2,3,9,Promising
90572,633,6,14,2,1,1,4,Lost
90835,600,27,72,2,4,4,10,At Risk
90876,118,54,184,4,5,5,14,Champions
78367,98,27,150,4,4,5,13,Champions
78419,535,17,36,2,3,3,8,Casual Users
78506,374,17,67,3,3,4,10,Loyal Users
78796,1703,10,24,1,2,2,5,Lost
79021,5,39,118,5,4,4,13,Champions
79106,1263,8,13,1,2,1,4,Lost
79178,5707,6,8,1,1,1,3,Lost
79501,24,74,231,5,5,5,15,Champions
79528,418,16,61,3,3,3,9,Loyal Users
79587,594,8,8,2,2,1,5,Lost
79987,931,24,27,2,4,2,8,At Risk
80064,23,87,278,5,5,5,15,Champions
80139,4774,7,19,1,2,2,5,Lost
80530,431,6,13,3,1,1,5,Casual Users
80706,1966,19,25,1,3,2,6,Casual Users
81033,1104,6,12,2,1,1,4,Lost
81322,2716,27,67,1,4,4,9,At Risk
81494,296,41,75,3,4,4,11,Loyal Users
81629,363,6,45,3,1,3,7,Casual Users
81874,481,5,14,2,1,1,4,Lost
81920,1055,6,8,2,1,1,4,Lost
82477,90,56,324,4,5,5,14,Champions
82481,83,11,18,4,2,2,8,Promising
82812,6,42,54,5,4,3,12,Loyal Users
82917,144,45,63,4,4,4,12,Champions
82991,3,44,193,5,4,5,14,Champions
83227,118,17,32,4,3,3,10,Loyal Users
83386,6,91,278,5,5,5,15,Champions
83390,392,36,62,3,4,3,10,Loyal Users
83458,707,22,58,2,4,3,9,At Risk
83525,683,13,23,2,3,2,7,Casual Users
83594,903,5,6,2,1,1,4,Lost
83885,422,29,111,3,4,4,11,Loyal Users
83889,119,6,17,4,1,2,7,Promising
83991,1552,10,42,1,2,3,6,Lost
84108,22,160,502,5,5,5,15,Champions
85026,8,80,153,5,5,5,15,Champions
85635,97,45,255,4,4,5,13,Champions
85664,298,24,57,3,4,3,10,Loyal Users
85965,4709,8,16,1,2,2,5,Lost
86036,134,54,126,4,5,4,13,Champions
86046,1863,10,14,1,2,1,4,Lost
86144,104,5,10,4,1,1,6,Promising
86598,680,11,12,2,2,1,5,Lost
86924,101,101,311,4,5,5,14,Champions
87037,38,152,808,5,5,5,15,Champions
87128,592,7,33,2,2,3,7,Lost
87189,121,5,11,4,1,1,6,Promising
87709,4372,6,12,1,1,1,3,Lost
87719,421,7,8,3,2,1,6,Casual Users
87725,1288,12,23,1,3,2,6,Casual Users
88288,121,9,23,4,2,2,8,Promising
88464,25,55,160,5,5,5,15,Champions
88569,126,29,175,4,4,5,13,Champions
88626,566,5,10,2,1,1,4,Lost
88751,2704,5,20,1,1,2,4,Lost
89106,2,52,277,5,5,5,15,Champions
89319,5,103,178,5,5,5,15,Champions
89511,2,5,23,5,1,2,8,Promising
89733,1795,5,8,1,1,1,3,Lost
89987,34,11,17,5,2,2,9,Promising
90383,106,75,96,4,5,4,13,Champions
90395,131,11,19,4,2,2,8,Promising
78368,566,11,31,2,2,2,6,Lost
78513,112,23,78,4,4,4,12,Champions
78682,2710,5,32,1,1,3,5,Lost
78862,492,9,35,2,2,3,7,Lost
78975,2465,51,141,1,5,4,10,At Risk
79094,13,103,205,5,5,5,15,Champions
79129,120,12,55,4,3,3,10,Loyal Users
79165,1563,11,35,1,2,3,6,Lost
79238,173,11,80,3,2,4,9,Casual Users
79260,421,41,64,3,4,4,11,Loyal Users
79638,978,43,75,2,4,4,10,At Risk
79681,67,14,20,5,3,2,10,Loyal Users
79707,652,38,85,2,4,4,10,At Risk
79753,138,35,67,4,4,4,12,Champions
79820,4884,21,75,1,3,4,8,Casual Users
80024,1,148,788,5,5,5,15,Champions
80920,383,7,9,3,2,1,6,Casual Users
81335,96,54,298,4,5,5,14,Champions
81397,3830,5,15,1,1,1,3,Lost
81557,1129,8,22,2,2,2,6,Lost
81584,398,15,31,3,3,2,8,Loyal Users
81758,0,7,24,5,2,2,9,Promising
81894,2,80,509,5,5,5,15,Champions
82038,262,31,124,3,4,4,11,Loyal Users
82118,396,53,156,3,5,5,13,Loyal Users
82153,90,36,81,4,4,4,12,Champions
82249,2695,5,14,1,1,1,3,Lost
82552,984,5,14,2,1,1,4,Lost
82666,226,30,122,3,4,4,11,Loyal Users
82876,262,78,99,3,5,4,12,Loyal Users
83131,642,6,17,2,1,2,5,Lost
83758,966,18,120,2,3,4,9,Casual Users
84560,4,14,42,5,3,3,11,Loyal Users
84584,215,26,41,3,4,3,10,Loyal Users
84740,12,6,15,5,1,1,7,Promising
85014,2,133,236,5,5,5,15,Champions
85340,713,86,223,2,5,5,12,At Risk
85669,2650,20,40,1,3,3,7,Casual Users
86204,255,54,192,3,5,5,13,Loyal Users
86211,31,98,308,5,5,5,15,Champions
86253,715,14,21,2,3,2,7,Casual Users
86451,2,93,207,5,5,5,15,Champions
86568,1111,9,20,2,2,2,6,Lost
86596,2646,9,25,1,2,2,5,Lost
87302,30,134,238,5,5,5,15,Champions
87521,1419,19,35,1,3,3,7,Casual Users
87692,2877,13,24,1,3,2,6,Casual Users
87694,146,65,167,4,5,5,14,Champions
87802,102,23,199,4,4,5,13,Champions
88313,12,10,27,5,2,2,9,Promising
88375,14,21,82,5,3,4,12,Loyal Users
88475,406,26,141,3,4,4,11,Loyal Users
88662,143,5,8,4,1,1,6,Promising
88781,266,5,6,3,1,1,5,Casual Users
88932,138,62,282,4,5,5,14,Champions
89121,162,47,162,4,5,5,14,Champions
89668,3503,6,16,1,1,2,4,Lost
89707,922,80,149,2,5,5,12,At Risk
89798,113,11,20,4,2,2,8,Promising
89871,428,73,226,3,5,5,13,Loyal Users
90066,1373,17,65,1,3,4,8,Casual Users
90134,4132,6,7,1,1,1,3,Lost
90381,612,8,23,2,2,2,6,Lost
90389,109,15,114,4,3,4,11,Loyal Users
78300,1630,20,46,1,3,3,7,Casual Users
78314,414,21,92,3,3,4,10,Loyal Users
78463,398,20,31,3,3,2,8,Loyal Users
78661,61,105,205,5,5,5,15,Champions
78961,134,92,131,4,5,4,13,Champions
79142,710,5,13,2,1,1,4,Lost
79484,19,12,24,5,3,2,10,Loyal Users
79512,13,12,26,5,3,2,10,Loyal Users
79958,11,40,165,5,4,5,14,Champions
80238,2274,7,18,1,2,2,5,Lost
80243,846,5,5,2,1,1,4,Lost
80442,2111,5,46,1,1,3,5,Lost
80502,1495,7,13,1,2,1,4,Lost
81084,34,34,153,5,4,5,14,Champions
81240,400,10,17,3,2,2,7,Casual Users
81244,134,36,154,4,4,5,13,Champions
81453,341,19,49,3,3,3,9,Loyal Users
81571,138,82,461,4,5,5,14,Champions
81687,50,27,59,5,4,3,12,Loyal Users
81690,1932,7,17,1,2,2,5,Lost
82088,385,23,31,3,4,2,9,Loyal Users
82709,643,5,20,2,1,2,5,Lost
83058,14,80,144,5,5,4,14,Champions
83461,39,58,101,5,5,4,14,Champions
83489,589,13,53,2,3,3,8,Casual Users
83541,649,7,11,2,2,1,5,Lost
83813,211,31,129,3,4,4,11,Loyal Users
83908,57,82,413,5,5,5,15,Champions
84038,0,41,191,5,4,5,14,Champions
84128,78,35,166,4,4,5,13,Champions
84534,69,103,372,5,5,5,15,Champions
84741,157,7,13,4,2,1,7,Promising
84933,1514,24,79,1,4,4,9,At Risk
85105,294,20,28,3,3,2,8,Loyal Users
85270,446,47,195,3,5,5,13,Loyal Users
85566,233,14,136,3,3,4,10,Loyal Users
85735,80,72,214,4,5,5,14,Champions
86131,2217,13,16,1,3,2,6,Casual Users
86581,2587,7,14,1,2,1,4,Lost
86717,158,29,86,4,4,4,12,Champions
86955,150,50,124,4,5,4,13,Champions
86961,1540,11,45,1,2,3,6,Lost
87103,304,42,55,3,4,3,10,Loyal Users
87458,2,90,182,5,5,5,15,Champions
87670,347,15,20,3,3,2,8,Loyal Users
88108,1,87,460,5,5,5,15,Champions
88118,293,5,10,3,1,1,5,Casual Users
88169,700,19,64,2,3,4,9,Casual Users
88715,263,40,125,3,4,4,11,Loyal Users
88867,47,60,559,5,5,5,15,Champions
88924,258,16,101,3,3,4,10,Loyal Users
88942,1521,18,49,1,3,3,7,Casual Users
89150,32,74,394,5,5,5,15,Champions
89374,1128,11,34,2,2,3,7,Lost
89621,3519,6,6,1,1,1,3,Lost
89799,117,32,148,4,4,5,13,Champions
89805,2546,6,7,1,1,1,3,Lost
89865,764,8,14,2,2,1,5,Lost
90155,2561,5,8,1,1,1,3,Lost
90191,694,5,22,2,1,2,5,Lost
90299,1840,12,152,1,3,5,9,Casual Users
90625,4289,7,13,1,2,1,4,Lost
90853,367,12,14,3,3,1,7,Loyal Users
78349,38,120,464,5,5,5,15,Champions
78705,459,23,68,3,4,4,11,Loyal Users
78887,0,22,39,5,4,3,12,Loyal Users
79147,103,8,13,4,2,1,7,Promising
79278,2,8,27,5,2,2,9,Promising
79305,679,22,85,2,4,4,10,At Risk
79373,247,6,30,3,1,2,6,Casual Users
79420,5540,6,17,1,1,2,4,Lost
79591,829,29,81,2,4,4,10,At Risk
79658,425,14,21,3,3,2,8,Loyal Users
79736,163,108,178,4,5,5,14,Champions
79808,997,20,38,2,3,3,8,Casual Users
80040,4820,5,7,1,1,1,3,Lost
80300,1652,5,6,1,1,1,3,Lost
80716,388,13,23,3,3,2,8,Loyal Users
80886,745,5,5,2,1,1,4,Lost
80951,129,16,53,4,3,3,10,Loyal Users
81142,324,8,16,3,2,2,7,Casual Users
81159,13,51,178,5,5,5,15,Champions
81332,28,41,82,5,4,4,13,Champions
81509,126,23,45,4,4,3,11,Loyal Users
81554,1559,5,13,1,1,1,3,Lost
81620,2291,10,29,1,2,2,5,Lost
82223,1125,11,49,2,2,3,7,Lost
82431,121,77,178,4,5,5,14,Champions
82682,0,100,403,5,5,5,15,Champions
82869,3,16,49,5,3,3,11,Loyal Users
82952,4,14,16,5,3,2,10,Loyal Users
83188,0,6,14,5,1,1,7,Promising
83261,7,11,50,5,2,3,10,Promising
84043,71,20,120,4,3,4,11,Loyal Users
84144,2,69,339,5,5,5,15,Champions
84250,48,39,139,5,4,4,13,Champions
84313,266,57,103,3,5,4,12,Loyal Users
84380,101,11,110,4,2,4,10,Promising
84637,100,9,9,4,2,1,7,Promising
84777,17,11,14,5,2,1,8,Promising
85341,1569,40,69,1,4,4,9,At Risk
85987,27,128,618,5,5,5,15,Champions
86226,8,33,45,5,4,3,12,Loyal Users
86457,374,32,111,3,4,4,11,Loyal Users
86801,260,6,13,3,1,1,5,Casual Users
86931,2106,11,26,1,2,2,5,Lost
87003,203,32,80,3,4,4,11,Loyal Users
87311,697,13,25,2,3,2,7,Casual Users
87351,799,5,50,2,1,3,6,Lost
87495,8,46,112,5,5,4,14,Champions
87749,333,43,70,3,4,4,11,Loyal Users
87850,1551,5,15,1,1,1,3,Lost
87918,2971,5,26,1,1,2,4,Lost
88187,2311,6,7,1,1,1,3,Lost
88497,363,11,13,3,2,1,6,Casual Users
88558,637,30,89,2,4,4,10,At Risk
88582,2123,7,21,1,2,2,5,Lost
88964,408,5,13,3,1,1,5,Casual Users
89198,2106,8,32,1,2,3,6,Lost
89344,3151,6,11,1,1,1,3,Lost
89493,154,21,27,4,3,2,9,Loyal Users
89502,4711,6,12,1,1,1,3,Lost
89510,3578,6,7,1,1,1,3,Lost
89843,151,29,163,4,4,5,13,Champions
89858,106,36,80,4,4,4,12,Champions
90257,444,222,620,3,5,5,13,Loyal Users
90325,1091,5,9,2,1,1,4,Lost
90477,1270,29,91,1,4,4,9,At Risk
90744,650,18,43,2,3,3,8,Casual Users
90772,1125,80,206,2,5,5,12,At Risk
90999,289,8,16,3,2,2,7,Casual Users
78335,700,7,9,2,2,1,5,Lost
78353,2085,13,26,1,3,2,6,Casual Users
79594,40,28,51,5,4,3,12,Loyal Users
80028,140,11,26,4,2,2,8,Promising
80030,260,19,41,3,3,3,9,Loyal Users
80640,394,5,19,3,1,2,6,Casual Users
80777,78,37,180,4,4,5,13,Champions
80837,392,7,18,3,2,2,7,Casual Users
80997,699,9,24,2,2,2,6,Lost
81249,424,13,20,3,3,2,8,Loyal Users
81493,607,43,48,2,4,3,9,At Risk
81567,97,129,745,4,5,5,14,Champions
81850,971,5,6,2,1,1,4,Lost
82071,7,5,5,5,1,1,7,Promising
82395,118,11,18,4,2,2,8,Promising
82413,463,48,262,3,5,5,13,Loyal Users
82440,1700,5,12,1,1,1,3,Lost
82948,3,46,168,5,5,5,15,Champions
83341,32,33,150,5,4,5,14,Champions
83762,3657,13,13,1,3,1,5,Casual Users
83763,157,12,28,4,3,2,9,Loyal Users
83945,371,37,56,3,4,3,10,Loyal Users
83964,5,57,187,5,5,5,15,Champions
85003,10,211,291,5,5,5,15,Champions
85280,0,144,587,5,5,5,15,Champions
85401,118,6,9,4,1,1,6,Promising
85619,514,10,42,2,2,3,7,Lost
85771,54,18,51,5,3,3,11,Loyal Users
85880,843,25,45,2,4,3,9,At Risk
87032,422,11,32,3,2,3,8,Casual Users
87114,5474,10,50,1,2,3,6,Lost
87416,1119,8,37,2,2,3,7,Lost
87423,98,11,36,4,2,3,9,Promising
87496,4,65,232,5,5,5,15,Champions
87565,293,10,25,3,2,2,7,Casual Users
87757,6,21,116,5,3,4,12,Loyal Users
88291,411,11,41,3,2,3,8,Casual Users
88700,419,14,25,3,3,2,8,Loyal Users
88748,129,47,274,4,5,5,14,Champions
88804,248,8,10,3,2,1,6,Casual Users
88876,1532,19,58,1,3,3,7,Casual Users
88988,26,15,52,5,3,3,11,Loyal Users
89250,398,37,184,3,4,5,12,Loyal Users
89409,126,19,152,4,3,5,12,Loyal Users
89423,111,59,223,4,5,5,14,Champions
89464,539,14,79,2,3,4,9,Casual Users
89591,3,49,53,5,5,3,13,Loyal Users
89708,1368,17,61,1,3,3,7,Casual Users
89904,133,32,294,4,4,5,13,Champions
90729,650,29,92,2,4,4,10,At Risk
90882,2695,13,46,1,3,3,7,Casual Users
78643,1885,5,21,1,1,2,4,Lost
78987,427,10,35,3,2,3,8,Casual Users
79167,129,13,40,4,3,3,10,Loyal Users
79193,2817,43,69,1,4,4,9,At Risk
79221,544,42,232,2,4,5,11,At Risk
79228,122,9,9,4,2,1,7,Promising
79475,3131,7,13,1,2,1,4,Lost
79480,86,12,21,4,3,2,9,Loyal Users
80684,1480,9,26,1,2,2,5,Lost
81053,392,13,98,3,3,4,10,Loyal Users
81064,849,10,40,2,2,3,7,Lost
81072,342,5,12,3,1,1,5,Casual Users
81481,54,138,271,5,5,5,15,Champions
81624,25,10,23,5,2,2,9,Promising
81749,1532,6,6,1,1,1,3,Lost
82253,145,100,158,4,5,5,14,Champions
82326,9,61,105,5,5,4,14,Champions
82669,129,8,18,4,2,2,8,Promising
82809,1125,10,12,2,2,1,5,Lost
82979,1290,5,12,1,1,1,3,Lost
83674,11,106,248,5,5,5,15,Champions
83795,12,140,382,5,5,5,15,Champions
83998,1295,23,76,1,4,4,9,At Risk
84404,102,81,284,4,5,5,14,Champions
84505,908,8,27,2,2,2,6,Lost
84772,511,7,21,2,2,2,6,Lost
84810,975,25,90,2,4,4,10,At Risk
84902,1113,7,12,2,2,1,5,Lost
85018,440,8,12,3,2,1,6,Casual Users
85272,423,5,9,3,1,1,5,Casual Users
85516,37,32,136,5,4,4,13,Champions
85588,680,7,10,2,2,1,5,Lost
85977,5,8,48,5,2,3,10,Promising
86079,243,91,304,3,5,5,13,Loyal Users
86182,385,8,32,3,2,3,8,Casual Users
86248,675,19,189,2,3,5,10,Casual Users
86463,697,5,7,2,1,1,4,Lost
87346,85,59,110,4,5,4,13,Champions
87431,251,59,228,3,5,5,13,Loyal Users
87601,190,5,5,3,1,1,5,Casual Users
87823,3009,8,16,1,2,2,5,Lost
88049,101,48,111,4,5,4,13,Champions
88646,384,8,20,3,2,2,7,Casual Users
88686,163,32,288,4,4,5,13,Champions
88716,162,19,58,4,3,3,10,Loyal Users
89017,129,70,122,4,5,4,13,Champions
89323,990,10,27,2,2,2,6,Lost
89496,1562,8,18,1,2,2,5,Lost
89774,579,11,19,2,2,2,6,Lost
90010,464,11,25,3,2,2,7,Casual Users
90047,97,52,321,4,5,5,14,Champions
90376,213,13,26,3,3,2,8,Loyal Users
90603,1517,6,16,1,1,2,4,Lost
90655,1039,12,242,2,3,5,10,Casual Users
90723,7,14,26,5,3,2,10,Loyal Users
91028,23,17,54,5,3,3,11,Loyal Users
91049,125,6,10,4,1,1,6,Promising
78388,222,32,112,3,4,4,11,Loyal Users
78578,40,63,153,5,5,5,15,Champions
78703,87,11,21,4,2,2,8,Promising
78821,105,119,288,4,5,5,14,Champions
78940,286,27,37,3,4,3,10,Loyal Users
79280,10,71,126,5,5,4,14,Champions
79298,15,87,514,5,5,5,15,Champions
79514,2396,6,8,1,1,1,3,Lost
79660,96,10,26,4,2,2,8,Promising
80331,688,17,89,2,3,4,9,Casual Users
80919,274,6,20,3,1,2,6,Casual Users
80978,80,10,14,4,2,1,7,Promising
81043,111,9,33,4,2,3,9,Promising
81081,792,26,84,2,4,4,10,At Risk
81100,692,20,59,2,3,3,8,Casual Users
81104,0,15,26,5,3,2,10,Loyal Users
81164,147,13,59,4,3,3,10,Loyal Users
81626,298,20,101,3,3,4,10,Loyal Users
81938,304,33,93,3,4,4,11,Loyal Users
82012,2988,53,142,1,5,4,10,At Risk
82346,2850,35,119,1,4,4,9,At Risk
82524,481,6,8,2,1,1,4,Lost
82565,40,90,257,5,5,5,15,Champions
82828,41,16,41,5,3,3,11,Loyal Users
82937,135,36,133,4,4,4,12,Champions
83028,124,60,127,4,5,4,13,Champions
83070,4770,10,13,1,2,1,4,Lost
83317,2563,9,17,1,2,2,5,Lost
83430,547,7,21,2,2,2,6,Lost
83625,108,91,262,4,5,5,14,Champions
84127,3779,5,7,1,1,1,3,Lost
84234,3811,5,6,1,1,1,3,Lost
84675,3083,5,35,1,1,3,5,Lost
84803,277,26,61,3,4,3,10,Loyal Users
84915,225,55,309,3,5,5,13,Loyal Users
85060,35,137,290,5,5,5,15,Champions
85144,2122,6,22,1,1,2,4,Lost
85168,11,92,231,5,5,5,15,Champions
85191,228,74,155,3,5,5,13,Loyal Users
85203,65,97,301,5,5,5,15,Champions
85278,132,70,165,4,5,5,14,Champions
85350,260,54,186,3,5,5,13,Loyal Users
85395,304,23,115,3,4,4,11,Loyal Users
85736,25,149,575,5,5,5,15,Champions
86419,2030,14,26,1,3,2,6,Casual Users
86507,21,22,32,5,4,3,12,Loyal Users
87137,687,15,56,2,3,3,8,Casual Users
87374,424,10,93,3,2,4,9,Casual Users
87465,15,186,824,5,5,5,15,Champions
87697,101,6,12,4,1,1,6,Promising
88275,276,9,10,3,2,1,6,Casual Users
88498,451,51,120,3,5,4,12,Loyal Users
88853,25,61,229,5,5,5,15,Champions
89287,2535,7,8,1,2,1,4,Lost
89907,55,47,205,5,5,5,15,Champions
90447,1968,11,42,1,2,3,6,Lost
90863,1274,18,39,1,3,3,7,Casual Users
90955,71,37,86,4,4,4,12,Champions
78879,2145,17,30,1,3,2,6,Casual Users
79052,101,107,413,4,5,5,14,Champions
79815,70,24,164,4,4,5,13,Champions
80383,416,16,25,3,3,2,8,Loyal Users
80464,247,19,25,3,3,2,8,Loyal Users
80603,1834,18,66,1,3,4,8,Casual Users
80810,96,14,57,4,3,3,10,Loyal Users
81187,1418,5,5,1,1,1,3,Lost
81588,110,83,639,4,5,5,14,Champions
81651,3375,11,20,1,2,2,5,Lost
81684,418,13,18,3,3,2,8,Loyal Users
81821,1326,9,12,1,2,1,4,Lost
82083,23,21,99,5,3,4,12,Loyal Users
82661,1849,7,10,1,2,1,4,Lost
82778,3372,10,16,1,2,2,5,Lost
83006,1273,19,58,1,3,3,7,Casual Users
83008,109,20,34,4,3,3,10,Loyal Users
83383,396,11,47,3,2,3,8,Casual Users
83778,567,9,13,2,2,1,5,Lost
83990,63,139,989,5,5,5,15,Champions
84355,702,26,69,2,4,4,10,At Risk
84391,1420,5,6,1,1,1,3,Lost
84988,1063,10,33,2,2,3,7,Lost
85032,107,104,155,4,5,5,14,Champions
85323,105,58,215,4,5,5,14,Champions
85647,681,13,91,2,3,4,9,Casual Users
85806,135,5,6,4,1,1,6,Promising
86612,2190,5,13,1,1,1,3,Lost
86632,287,7,16,3,2,2,7,Casual Users
86934,37,15,145,5,3,4,12,Loyal Users
87294,36,38,591,5,4,5,14,Champions
87364,72,12,27,4,3,2,9,Loyal Users
87808,5794,5,23,1,1,2,4,Lost
87988,2741,39,115,1,4,4,9,At Risk
88168,23,125,629,5,5,5,15,Champions
88455,112,29,138,4,4,4,12,Champions
88486,125,60,97,4,5,4,13,Champions
89834,2419,5,7,1,1,1,3,Lost
89846,414,54,138,3,5,4,12,Loyal Users
90035,702,9,15,2,2,1,5,Lost
90324,294,29,41,3,4,3,10,Loyal Users
90348,544,15,27,2,3,2,7,Casual Users
90363,229,5,17,3,1,2,6,Casual Users
90365,642,7,41,2,2,3,7,Lost
90724,3258,16,38,1,3,3,7,Casual Users
91039,124,9,22,4,2,2,8,Promising
91046,228,27,67,3,4,4,11,Loyal Users
91065,4846,5,6,1,1,1,3,Lost
78527,1700,5,8,1,1,1,3,Lost
78807,250,114,217,3,5,5,13,Loyal Users
78920,129,7,29,4,2,2,8,Promising
78930,1759,7,10,1,2,1,4,Lost
79038,127,42,265,4,4,5,13,Champions
79105,1314,7,9,1,2,1,4,Lost
79132,3309,7,11,1,2,1,4,Lost
79303,283,23,44,3,4,3,10,Loyal Users
79409,98,19,32,4,3,3,10,Loyal Users
79452,1839,8,34,1,2,3,6,Lost
79548,42,74,254,5,5,5,15,Champions
79592,117,9,85,4,2,4,10,Promising
79767,3141,6,10,1,1,1,3,Lost
79903,408,7,11,3,2,1,6,Casual Users
80220,8,11,59,5,2,3,10,Promising
80254,997,18,58,2,3,3,8,Casual Users
80336,557,9,20,2,2,2,6,Lost
80364,141,6,6,4,1,1,6,Promising
80723,253,11,45,3,2,3,8,Casual Users
80829,286,18,72,3,3,4,10,Loyal Users
81025,5400,5,6,1,1,1,3,Lost
81094,818,19,93,2,3,4,9,Casual Users
81305,1147,11,50,2,2,3,7,Lost
81612,682,7,20,2,2,2,6,Lost
81683,272,85,556,3,5,5,13,Loyal Users
81829,442,5,9,3,1,1,5,Casual Users
82139,1948,16,21,1,3,2,6,Casual Users
82204,362,13,19,3,3,2,8,Loyal Users
82213,30,132,346,5,5,5,15,Champions
82313,83,69,372,4,5,5,14,Champions
82376,1129,18,27,2,3,2,7,Casual Users
82387,419,17,88,3,3,4,10,Loyal Users
82458,25,30,89,5,4,4,13,Champions
82484,3930,30,30,1,4,2,7,At Risk
82511,500,16,34,2,3,3,8,Casual Users
82541,139,38,111,4,4,4,12,Champions
82817,1852,7,26,1,2,2,5,Lost
82821,17,57,269,5,5,5,15,Champions
82993,2247,7,12,1,2,1,4,Lost
83205,418,5,11,3,1,1,5,Casual Users
83256,1081,5,5,2,1,1,4,Lost
83293,430,8,11,3,2,1,6,Casual Users
83370,156,55,100,4,5,4,13,Champions
83465,5860,11,35,1,2,3,6,Lost
83468,512,10,11,2,2,1,5,Lost
83499,6,55,253,5,5,5,15,Champions
83544,117,77,107,4,5,4,13,Champions
83581,707,13,22,2,3,2,7,Casual Users
83690,310,8,17,3,2,2,7,Casual Users
84149,24,51,508,5,5,5,15,Champions
84181,25,8,45,5,2,3,10,Promising
84430,387,34,109,3,4,4,11,Loyal Users
84475,369,34,366,3,4,5,12,Loyal Users
84569,6,5,6,5,1,1,7,Promising
84573,220,7,21,3,2,2,7,Casual Users
84642,1745,15,64,1,3,4,8,Casual Users
84748,15,24,43,5,4,3,12,Loyal Users
85063,660,10,58,2,2,3,7,Lost
85219,397,22,99,3,4,4,11,Loyal Users
85276,1213,5,17,2,1,2,5,Lost
85421,2390,9,18,1,2,2,5,Lost
85811,568,22,28,2,4,2,8,At Risk
86209,6,13,24,5,3,2,10,Loyal Users
86470,1543,9,35,1,2,3,6,Lost
86512,37,47,84,5,5,4,14,Champions
86704,250,11,56,3,2,3,8,Casual Users
86936,435,6,7,3,1,1,5,Casual Users
87018,384,7,24,3,2,2,7,Casual Users
87129,232,18,43,3,3,3,9,Loyal Users
87192,209,18,49,3,3,3,9,Loyal Users
87312,2304,12,16,1,3,2,6,Casual Users
87536,1824,8,28,1,2,2,5,Lost
87671,310,15,20,3,3,2,8,Loyal Users
87817,2625,16,45,1,3,3,7,Casual Users
88017,1849,19,96,1,3,4,8,Casual Users
88125,547,5,5,2,1,1,4,Lost
88293,444,16,27,3,3,2,8,Loyal Users
88356,271,16,27,3,3,2,8,Loyal Users
89280,1380,8,20,1,2,2,5,Lost
89393,806,16,43,2,3,3,8,Casual Users
89427,137,15,44,4,3,3,10,Loyal Users
89492,504,6,6,2,1,1,4,Lost
89527,0,148,303,5,5,5,15,Champions
89665,1918,6,7,1,1,1,3,Lost
89711,149,19,23,4,3,2,9,Loyal Users
89928,367,46,59,3,5,3,11,Loyal Users
90021,210,12,23,3,3,2,8,Loyal Users
90179,31,66,89,5,5,4,14,Champions
90638,127,16,148,4,3,5,12,Loyal Users
90758,801,19,105,2,3,4,9,Casual Users
90764,317,16,79,3,3,4,10,Loyal Users
78627,1001,50,72,2,5,4,11,At Risk
78784,4,95,174,5,5,5,15,Champions
78890,176,56,154,3,5,5,13,Loyal Users
78929,574,5,10,2,1,1,4,Lost
78992,675,16,28,2,3,2,7,Casual Users
79313,971,16,45,2,3,3,8,Casual Users
79371,162,39,94,4,4,4,12,Champions
79541,27,122,669,5,5,5,15,Champions
79679,742,34,126,2,4,4,10,At Risk
79709,405,11,26,3,2,2,7,Casual Users
79963,11,31,87,5,4,4,13,Champions
80034,1264,5,8,1,1,1,3,Lost
80761,424,18,34,3,3,3,9,Loyal Users
80807,697,22,49,2,4,3,9,At Risk
81304,131,42,253,4,4,5,13,Champions
81800,127,52,141,4,5,4,13,Champions
82271,2298,8,16,1,2,2,5,Lost
82512,3129,6,7,1,1,1,3,Lost
82830,120,38,95,4,4,4,12,Champions
82919,90,47,238,4,5,5,14,Champions
82954,261,63,161,3,5,5,13,Loyal Users
83016,4066,6,25,1,1,2,4,Lost
83275,120,8,20,4,2,2,8,Promising
83455,30,10,72,5,2,4,11,Promising
84496,379,48,93,3,5,4,12,Loyal Users
85564,1448,15,18,1,3,2,6,Casual Users
85796,85,60,133,4,5,4,13,Champions
85876,1427,27,100,1,4,4,9,At Risk
85952,643,9,83,2,2,4,8,Lost
86583,3250,6,7,1,1,1,3,Lost
86805,0,57,128,5,5,4,14,Champions
86967,696,12,17,2,3,2,7,Casual Users
86979,0,105,552,5,5,5,15,Champions
87119,120,26,116,4,4,4,12,Champions
87330,1367,10,20,1,2,2,5,Lost
87357,97,7,7,4,2,1,7,Promising
87436,579,9,10,2,2,1,5,Lost
87480,51,90,119,5,5,4,14,Champions
87576,3142,18,18,1,3,2,6,Casual Users
87847,25,106,229,5,5,5,15,Champions
88391,2739,11,17,1,2,2,5,Lost
88413,248,44,96,3,4,4,11,Loyal Users
88447,136,31,61,4,4,3,11,Loyal Users
88563,266,11,32,3,2,3,8,Casual Users
88602,220,78,155,3,5,5,13,Loyal Users
88792,589,6,10,2,1,1,4,Lost
89151,227,15,23,3,3,2,8,Loyal Users
89356,287,36,86,3,4,4,11,Loyal Users
89487,41,45,77,5,4,4,13,Champions
90398,6,16,42,5,3,3,11,Loyal Users
90740,723,10,15,2,2,1,5,Lost
90816,359,13,16,3,3,2,8,Loyal Users
90879,131,20,161,4,3,5,12,Loyal Users
90941,188,30,67,3,4,4,11,Loyal Users
91016,11,8,15,5,2,1,8,Promising
78287,2804,5,5,1,1,1,3,Lost
78566,239,29,134,3,4,4,11,Loyal Users
78582,96,23,149,4,4,5,13,Champions
78588,275,53,391,3,5,5,13,Loyal Users
78747,306,12,13,3,3,1,7,Loyal Users
79580,1039,29,134,2,4,4,10,At Risk
79639,4370,5,22,1,1,2,4,Lost
79673,13,8,9,5,2,1,8,Promising
80207,212,10,91,3,2,4,9,Casual Users
80458,795,7,20,2,2,2,6,Lost
80517,5561,5,9,1,1,1,3,Lost
80645,7,185,1217,5,5,5,15,Champions
81127,97,25,45,4,4,3,11,Loyal Users
81179,15,114,252,5,5,5,15,Champions
81368,2482,5,5,1,1,1,3,Lost
81884,238,31,115,3,4,4,11,Loyal Users
82128,790,5,31,2,1,2,5,Lost
82478,14,61,459,5,5,5,15,Champions
82483,127,88,415,4,5,5,14,Champions
82579,754,17,42,2,3,3,8,Casual Users
82680,64,149,767,5,5,5,15,Champions
82705,20,14,38,5,3,3,11,Loyal Users
82866,815,15,58,2,3,3,8,Casual Users
83203,2710,17,35,1,3,3,7,Casual Users
83233,1852,7,18,1,2,2,5,Lost
83435,955,21,36,2,3,3,8,Casual Users
83542,2393,5,7,1,1,1,3,Lost
83893,72,7,10,4,2,1,7,Promising
84200,75,32,57,4,4,3,11,Loyal Users
84206,249,15,24,3,3,2,8,Loyal Users
84464,3284,11,21,1,2,2,5,Lost
84718,3143,7,59,1,2,3,6,Lost
84964,971,7,33,2,2,3,7,Lost
85142,291,61,150,3,5,5,13,Loyal Users
85304,559,7,10,2,2,1,5,Lost
85440,2000,5,11,1,1,1,3,Lost
85594,2744,10,48,1,2,3,6,Lost
85701,1848,7,34,1,2,3,6,Lost
85865,4965,7,13,1,2,1,4,Lost
85954,107,5,14,4,1,1,6,Promising
86127,1670,18,28,1,3,2,6,Casual Users
86128,28,40,160,5,4,5,14,Champions
86725,496,43,62,2,4,3,9,At Risk
86903,717,5,7,2,1,1,4,Lost
86940,1059,7,11,2,2,1,5,Lost
87214,2229,15,45,1,3,3,7,Casual Users
87242,425,7,7,3,2,1,6,Casual Users
87525,1264,9,88,1,2,4,7,Lost
87657,856,18,168,2,3,5,10,Casual Users
87729,23,58,310,5,5,5,15,Champions
87777,1167,9,60,2,2,3,7,Lost
88540,2126,5,5,1,1,1,3,Lost
88670,304,12,17,3,3,2,8,Loyal Users
88688,2095,5,13,1,1,1,3,Lost
88714,116,134,427,4,5,5,14,Champions
88906,86,8,68,4,2,4,10,Promising
89013,3387,21,49,1,3,3,7,Casual Users
89074,366,41,127,3,4,4,11,Loyal Users
89206,72,41,196,4,4,5,13,Champions
89336,92,20,40,4,3,3,10,Loyal Users
89363,149,108,456,4,5,5,14,Champions
90184,222,5,7,3,1,1,5,Casual Users
90660,331,18,74,3,3,4,10,Loyal Users
90841,220,18,45,3,3,3,9,Loyal Users
78741,1614,6,96,1,1,4,6,Lost
78840,444,11,111,3,2,4,9,Casual Users
79213,4756,6,51,1,1,3,5,Lost
79341,558,6,12,2,1,1,4,Lost
79656,94,18,37,4,3,3,10,Loyal Users
79664,11,90,282,5,5,5,15,Champions
79721,255,5,17,3,1,2,6,Casual Users
79989,664,9,15,2,2,1,5,Lost
80084,1958,8,30,1,2,2,5,Lost
80212,423,25,169,3,4,5,12,Loyal Users
80641,2008,40,71,1,4,4,9,At Risk
80698,5412,5,5,1,1,1,3,Lost
80854,316,7,11,3,2,1,6,Casual Users
80887,30,96,247,5,5,5,15,Champions
81158,3580,7,51,1,2,3,6,Lost
81172,878,9,26,2,2,2,6,Lost
81437,2953,7,25,1,2,2,5,Lost
81568,94,38,99,4,4,4,12,Champions
81730,83,28,31,4,4,2,10,Loyal Users
82289,1984,46,121,1,5,4,10,At Risk
82396,4161,5,10,1,1,1,3,Lost
82451,271,20,58,3,3,3,9,Loyal Users
82452,668,7,19,2,2,2,6,Lost
82775,156,9,37,4,2,3,9,Promising
82797,279,19,114,3,3,4,10,Loyal Users
82849,2631,5,5,1,1,1,3,Lost
83011,266,88,189,3,5,5,13,Loyal Users
83419,138,21,51,4,3,3,10,Loyal Users
83460,987,14,35,2,3,3,8,Casual Users
83575,39,96,244,5,5,5,15,Champions
83585,76,86,166,4,5,5,14,Champions
83655,296,7,30,3,2,2,7,Casual Users
83667,415,24,67,3,4,4,11,Loyal Users
83709,706,5,15,2,1,1,4,Lost
83824,3,58,238,5,5,5,15,Champions
83982,180,19,48,3,3,3,9,Loyal Users
84093,2587,13,22,1,3,2,6,Casual Users
84213,116,5,14,4,1,1,6,Promising
84241,4742,6,7,1,1,1,3,Lost
84327,71,58,517,4,5,5,14,Champions
84531,18,52,100,5,5,4,14,Champions
84552,1382,7,13,1,2,1,4,Lost
84615,1458,6,9,1,1,1,3,Lost
84883,125,28,64,4,4,4,12,Champions
84908,1108,7,10,2,2,1,5,Lost
84994,70,6,8,4,1,1,6,Promising
85021,1150,11,20,2,2,2,6,Lost
85073,1460,14,82,1,3,4,8,Casual Users
85263,489,23,76,2,4,4,10,At Risk
85295,252,55,83,3,5,4,12,Loyal Users
85355,1601,5,25,1,1,2,4,Lost
85515,89,19,92,4,3,4,11,Loyal Users
85975,3,67,442,5,5,5,15,Champions
86028,433,31,47,3,4,3,10,Loyal Users
86109,151,118,300,4,5,5,14,Champions
86300,473,7,10,2,2,1,5,Lost
86366,719,8,25,2,2,2,6,Lost
86969,299,31,96,3,4,4,11,Loyal Users
87193,1176,11,30,2,2,2,6,Lost
87604,2183,6,39,1,1,3,5,Lost
87621,146,14,65,4,3,4,11,Loyal Users
87653,877,9,17,2,2,2,6,Lost
87736,1001,12,123,2,3,4,9,Casual Users
87762,976,15,19,2,3,2,7,Casual Users
87776,1732,12,30,1,3,2,6,Casual Users
87816,3575,5,7,1,1,1,3,Lost
87846,254,5,24,3,1,2,6,Casual Users
88096,1810,8,34,1,2,3,6,Lost
88105,18,21,86,5,3,4,12,Loyal Users
88138,3906,5,8,1,1,1,3,Lost
88142,1002,8,12,2,2,1,5,Lost
88424,578,29,41,2,4,3,9,At Risk
88785,1873,6,11,1,1,1,3,Lost
88809,294,175,522,3,5,5,13,Loyal Users
88832,397,13,22,3,3,2,8,Loyal Users
88838,3022,6,19,1,1,2,4,Lost
88842,119,29,81,4,4,4,12,Champions
88981,129,34,111,4,4,4,12,Champions
89097,1273,7,45,1,2,3,6,Lost
89867,744,48,131,2,5,4,11,At Risk
89940,288,18,34,3,3,3,9,Loyal Users
89999,77,60,289,4,5,5,14,Champions
90070,613,9,66,2,2,4,8,Lost
90164,392,14,20,3,3,2,8,Loyal Users
90715,515,50,88,2,5,4,11,At Risk
78445,1297,39,87,1,4,4,9,At Risk
78489,133,70,257,4,5,5,14,Champions
79104,417,8,11,3,2,1,6,Casual Users
79302,424,12,17,3,3,2,8,Loyal Users
79395,289,55,346,3,5,5,13,Loyal Users
79495,27,67,558,5,5,5,15,Champions
79520,840,5,6,2,1,1,4,Lost
79699,544,56,241,2,5,5,12,At Risk
79854,1235,8,11,2,2,1,5,Lost
79959,1838,7,18,1,2,2,5,Lost
80045,676,9,9,2,2,1,5,Lost
80467,838,5,18,2,1,2,5,Lost
80562,685,19,135,2,3,4,9,Casual Users
80687,29,19,133,5,3,4,12,Loyal Users
81365,837,25,63,2,4,4,10,At Risk
81367,567,5,6,2,1,1,4,Lost
81748,3460,5,22,1,1,2,4,Lost
82275,5,52,191,5,5,5,15,Champions
82299,180,45,102,3,4,4,11,Loyal Users
82340,107,6,15,4,1,1,6,Promising
82475,416,18,50,3,3,3,9,Loyal Users
82537,26,28,53,5,4,3,12,Loyal Users
82607,961,20,40,2,3,3,8,Casual Users
82615,71,22,32,4,4,3,11,Loyal Users
82639,2279,7,15,1,2,1,4,Lost
82756,569,21,43,2,3,3,8,Casual Users
82844,431,6,10,3,1,1,5,Casual Users
83063,5,168,495,5,5,5,15,Champions
83164,191,39,250,3,4,5,12,Loyal Users
83329,447,11,13,3,2,1,6,Casual Users
83418,2451,6,14,1,1,1,3,Lost
83515,113,94,218,4,5,5,14,Champions
83644,3,75,363,5,5,5,15,Champions
83930,538,12,34,2,3,3,8,Casual Users
84015,1006,6,11,2,1,1,4,Lost
84323,6,177,297,5,5,5,15,Champions
84382,874,7,15,2,2,1,5,Lost
84424,397,32,68,3,4,4,11,Loyal Users
84778,735,7,38,2,2,3,7,Lost
84993,284,8,9,3,2,1,6,Casual Users
85101,541,7,36,2,2,3,7,Lost
85338,4712,6,7,1,1,1,3,Lost
85555,1160,13,25,2,3,2,7,Casual Users
86120,170,20,75,3,3,4,10,Loyal Users
86189,105,16,48,4,3,3,10,Loyal Users
86554,82,42,124,4,4,4,12,Champions
86561,78,67,415,4,5,5,14,Champions
86647,42,131,225,5,5,5,15,Champions
86791,143,24,51,4,4,3,11,Loyal Users
86886,142,59,158,4,5,5,14,Champions
87101,281,37,108,3,4,4,11,Loyal Users
87191,144,12,79,4,3,4,11,Loyal Users
87233,860,17,75,2,3,4,9,Casual Users
87556,976,8,33,2,2,3,7,Lost
88222,735,8,10,2,2,1,5,Lost
88277,976,36,78,2,4,4,10,At Risk
88404,229,18,22,3,3,2,8,Loyal Users
88730,4205,8,27,1,2,2,5,Lost
88802,168,6,12,3,1,1,5,Casual Users
88845,34,26,46,5,4,3,12,Loyal Users
89062,258,14,43,3,3,3,9,Loyal Users
89131,104,7,18,4,2,2,8,Promising
89473,50,44,200,5,4,5,14,Champions
89525,24,38,137,5,4,4,13,Champions
89671,1498,17,40,1,3,3,7,Casual Users
89716,300,27,47,3,4,3,10,Loyal Users
89919,1,111,553,5,5,5,15,Champions
90099,1923,24,31,1,4,2,7,At Risk
90112,962,18,128,2,3,4,9,Casual Users
90275,371,14,41,3,3,3,9,Loyal Users
90400,26,35,237,5,4,5,14,Champions
90432,17,75,368,5,5,5,15,Champions
78455,22,33,130,5,4,4,13,Champions
78490,959,10,60,2,2,3,7,Lost
78542,88,134,604,4,5,5,14,Champions
78765,41,18,104,5,3,4,12,Loyal Users
78864,121,23,117,4,4,4,12,Champions
79251,671,16,32,2,3,3,8,Casual Users
79296,326,41,81,3,4,4,11,Loyal Users
79462,4412,6,6,1,1,1,3,Lost
79686,81,24,202,4,4,5,13,Champions
80195,3026,6,18,1,1,2,4,Lost
80379,1,51,207,5,5,5,15,Champions
80380,131,6,20,4,1,2,7,Promising
80494,244,29,75,3,4,4,11,Loyal Users
80532,466,40,186,3,4,5,12,Loyal Users
80879,939,7,40,2,2,3,7,Lost
81194,145,38,133,4,4,4,12,Champions
81380,177,13,56,3,3,3,9,Loyal Users
81660,716,18,31,2,3,2,7,Casual Users
81723,286,15,22,3,3,2,8,Loyal Users
81772,8,9,27,5,2,2,9,Promising
81878,301,27,33,3,4,3,10,Loyal Users
82126,123,43,98,4,4,4,12,Champions
82909,32,109,552,5,5,5,15,Champions
83485,549,7,11,2,2,1,5,Lost
83623,112,73,456,4,5,5,14,Champions
83641,1125,7,10,2,2,1,5,Lost
83708,329,14,53,3,3,3,9,Loyal Users
83718,573,11,28,2,2,2,6,Lost
83935,134,7,32,4,2,3,9,Promising
83936,1,12,71,5,3,4,12,Loyal Users
84090,733,9,25,2,2,2,6,Lost
84595,1336,19,25,1,3,2,6,Casual Users
84839,560,11,21,2,2,2,6,Lost
84888,1282,15,44,1,3,3,7,Casual Users
84983,412,51,78,3,5,4,12,Loyal Users
85131,782,27,134,2,4,4,10,At Risk
85599,1,41,75,5,4,4,13,Champions
85681,2424,13,57,1,3,3,7,Casual Users
85810,257,26,51,3,4,3,10,Loyal Users
85861,267,53,286,3,5,5,13,Loyal Users
85870,1975,6,15,1,1,1,3,Lost
85940,2322,6,10,1,1,1,3,Lost
85959,21,68,304,5,5,5,15,Champions
86270,194,94,528,3,5,5,13,Loyal Users
86392,68,70,677,5,5,5,15,Champions
86445,105,48,88,4,5,4,13,Champions
86479,85,22,57,4,4,3,11,Loyal Users
86773,272,34,68,3,4,4,11,Loyal Users
86888,1847,8,47,1,2,3,6,Lost
87109,273,10,12,3,2,1,6,Casual Users
87262,408,7,17,3,2,2,7,Casual Users
87582,144,19,104,4,3,4,11,Loyal Users
88061,145,60,342,4,5,5,14,Champions
88512,287,5,19,3,1,2,6,Casual Users
88708,1,146,612,5,5,5,15,Champions
88903,984,9,18,2,2,2,6,Lost
88955,831,17,26,2,3,2,7,Casual Users
89284,285,47,318,3,5,5,13,Loyal Users
89321,425,8,96,3,2,4,9,Casual Users
89468,962,65,85,2,5,4,11,At Risk
89588,45,59,95,5,5,4,14,Champions
90133,454,79,362,3,5,5,13,Loyal Users
90192,4122,11,12,1,2,1,4,Lost
90201,3490,10,19,1,2,2,5,Lost
90285,510,13,14,2,3,1,6,Casual Users
90489,4838,13,39,1,3,3,7,Casual Users
90598,113,130,873,4,5,5,14,Champions
90701,15,114,284,5,5,5,15,Champions
78309,4878,8,21,1,2,2,5,Lost
78458,90,42,260,4,4,5,13,Champions
78574,157,12,17,4,3,2,9,Loyal Users
78938,103,69,261,4,5,5,14,Champions
79218,3,13,24,5,3,2,10,Loyal Users
79472,590,5,8,2,1,1,4,Lost
79725,420,30,181,3,4,5,12,Loyal Users
80292,923,5,8,2,1,1,4,Lost
80575,20,89,575,5,5,5,15,Champions
80643,5,50,305,5,5,5,15,Champions
80787,273,94,259,3,5,5,13,Loyal Users
80933,3,9,17,5,2,2,9,Promising
81228,1405,9,12,1,2,1,4,Lost
81456,120,8,38,4,2,3,9,Promising
81497,996,6,30,2,1,2,5,Lost
81844,165,13,23,4,3,2,9,Loyal Users
82142,158,17,42,4,3,3,10,Loyal Users
82179,395,14,18,3,3,2,8,Loyal Users
82501,2629,7,19,1,2,2,5,Lost
82525,3809,11,34,1,2,3,6,Lost
83010,70,120,505,4,5,5,14,Champions
83075,4291,53,135,1,5,4,10,At Risk
83278,186,73,169,3,5,5,13,Loyal Users
83339,242,8,16,3,2,2,7,Casual Users
83483,1136,8,24,2,2,2,6,Lost
83537,7,38,118,5,4,4,13,Champions
83782,97,19,122,4,3,4,11,Loyal Users
84022,28,133,599,5,5,5,15,Champions
84087,132,44,75,4,4,4,12,Champions
84130,30,23,100,5,4,4,13,Champions
84186,265,7,24,3,2,2,7,Casual Users
84402,1313,50,217,1,5,5,11,At Risk
84439,652,9,23,2,2,2,6,Lost
84842,1,71,149,5,5,5,15,Champions
85006,976,10,35,2,2,3,7,Lost
85095,1264,37,126,1,4,4,9,At Risk
85110,601,11,168,2,2,5,9,Lost
85132,11,67,161,5,5,5,15,Champions
85529,4297,6,6,1,1,1,3,Lost
85793,507,7,16,2,2,2,6,Lost
85916,62,82,155,5,5,5,15,Champions
86054,1725,5,22,1,1,2,4,Lost
86061,81,11,52,4,2,3,9,Promising
86091,5,6,27,5,1,2,8,Promising
86396,322,32,82,3,4,4,11,Loyal Users
86800,134,5,27,4,1,2,7,Promising
87069,2410,8,10,1,2,1,4,Lost
87280,286,30,82,3,4,4,11,Loyal Users
87437,31,60,136,5,5,4,14,Champions
87475,38,147,721,5,5,5,15,Champions
87505,122,16,16,4,3,2,9,Loyal Users
87570,10,6,21,5,1,2,8,Promising
87587,730,32,148,2,4,5,11,At Risk
89040,813,8,26,2,2,2,6,Lost
89050,1937,7,8,1,2,1,4,Lost
89325,110,26,36,4,4,3,11,Loyal Users
89677,1589,8,11,1,2,1,4,Lost
90335,1887,6,7,1,1,1,3,Lost
90849,69,7,55,5,2,3,10,Promising
90905,8,33,100,5,4,4,13,Champions
78553,2096,8,9,1,2,1,4,Lost
78572,145,59,98,4,5,4,13,Champions
78803,1697,15,49,1,3,3,7,Casual Users
78934,26,120,235,5,5,5,15,Champions
79323,440,13,16,3,3,2,8,Loyal Users
79498,64,198,571,5,5,5,15,Champions
79524,145,67,355,4,5,5,14,Champions
79529,2,29,58,5,4,3,12,Loyal Users
79706,46,158,850,5,5,5,15,Champions
79751,415,15,25,3,3,2,8,Loyal Users
79860,865,28,191,2,4,5,11,At Risk
80403,422,5,8,3,1,1,5,Casual Users
80774,2330,9,22,1,2,2,5,Lost
81144,586,5,9,2,1,1,4,Lost
81192,81,8,19,4,2,2,8,Promising
81691,245,47,300,3,5,5,13,Loyal Users
81876,6,15,29,5,3,2,10,Loyal Users
81911,20,23,39,5,4,3,12,Loyal Users
82171,139,17,44,4,3,3,10,Loyal Users
82339,2487,7,22,1,2,2,5,Lost
82420,1133,25,49,2,4,3,9,At Risk
83102,1375,6,14,1,1,1,3,Lost
83152,68,21,133,5,3,4,12,Loyal Users
83355,1861,5,8,1,1,1,3,Lost
83454,175,16,63,3,3,4,10,Loyal Users
83470,406,5,28,3,1,2,6,Casual Users
83622,4693,5,11,1,1,1,3,Lost
83743,2760,21,69,1,3,4,8,Casual Users
84316,1076,5,9,2,1,1,4,Lost
84742,538,9,24,2,2,2,6,Lost
84795,1358,5,13,1,1,1,3,Lost
84889,439,10,10,3,2,1,6,Casual Users
85020,407,15,25,3,3,2,8,Loyal Users
85074,10,33,43,5,4,3,12,Loyal Users
85274,356,8,114,3,2,4,9,Casual Users
85301,319,45,144,3,4,4,11,Loyal Users
85585,46,38,67,5,4,4,13,Champions
85715,508,9,15,2,2,1,5,Lost
85746,391,19,46,3,3,3,9,Loyal Users
85821,842,32,92,2,4,4,10,At Risk
86412,762,28,61,2,4,3,9,At Risk
87124,1249,10,15,2,2,1,5,Lost
87169,525,7,24,2,2,2,6,Lost
87211,2446,10,14,1,2,1,4,Lost
87270,106,51,205,4,5,5,14,Champions
87381,318,22,69,3,4,4,11,Loyal Users
87585,869,12,17,2,3,2,7,Casual Users
87855,482,6,15,2,1,1,4,Lost
87894,5128,9,9,1,2,1,4,Lost
88068,786,42,187,2,4,5,11,At Risk
88886,4121,11,22,1,2,2,5,Lost
89115,1017,5,12,2,1,1,4,Lost
89226,109,32,134,4,4,4,12,Champions
89807,264,20,152,3,3,5,11,Loyal Users
90018,367,42,144,3,4,4,11,Loyal Users
90031,469,16,25,3,3,2,8,Loyal Users
90153,4450,32,43,1,4,3,8,At Risk
90216,440,16,248,3,3,5,11,Loyal Users
90298,870,7,30,2,2,2,6,Lost
90452,89,50,214,4,5,5,14,Champions
90470,113,48,92,4,5,4,13,Champions
90825,91,17,98,4,3,4,11,Loyal Users
90920,4840,20,68,1,3,4,8,Casual Users
78424,159,15,30,4,3,2,9,Loyal Users
78451,147,32,303,4,4,5,13,Champions
79023,2738,8,18,1,2,2,5,Lost
79396,45,57,167,5,5,5,15,Champions
79853,528,44,56,2,4,3,9,At Risk
80058,894,21,184,2,3,5,10,Casual Users
80138,329,10,68,3,2,4,9,Casual Users
80326,120,9,20,4,2,2,8,Promising
80441,121,6,30,4,1,2,7,Promising
80690,670,5,50,2,1,3,6,Lost
80707,850,5,5,2,1,1,4,Lost
80765,76,69,679,4,5,5,14,Champions
81193,1128,21,211,2,3,5,10,Casual Users
81223,112,100,393,4,5,5,14,Champions
81280,2,257,649,5,5,5,15,Champions
81378,2179,15,32,1,3,3,7,Casual Users
81388,56,27,126,5,4,4,13,Champions
81459,253,31,244,3,4,5,12,Loyal Users
81514,262,6,9,3,1,1,5,Casual Users
81569,111,73,297,4,5,5,14,Champions
81622,591,58,194,2,5,5,12,At Risk
81682,1101,143,455,2,5,5,12,At Risk
81813,9,10,17,5,2,2,9,Promising
81861,9,70,142,5,5,4,14,Champions
82004,12,126,614,5,5,5,15,Champions
82535,132,79,157,4,5,5,14,Champions
82777,3415,6,6,1,1,1,3,Lost
82789,1117,13,72,2,3,4,9,Casual Users
82803,24,12,37,5,3,3,11,Loyal Users
83162,114,67,156,4,5,5,14,Champions
83290,591,23,58,2,4,3,9,At Risk
83335,101,41,103,4,4,4,12,Champions
83351,2415,9,10,1,2,1,4,Lost
83400,167,52,124,3,5,4,12,Loyal Users
84136,4713,8,8,1,2,1,4,Lost
84167,584,15,45,2,3,3,8,Casual Users
84556,257,33,56,3,4,3,10,Loyal Users
84790,1,34,94,5,4,4,13,Champions
84832,408,8,21,3,2,2,7,Casual Users
84861,143,8,21,4,2,2,8,Promising
85099,208,43,370,3,4,5,12,Loyal Users
85339,4,25,92,5,4,4,13,Champions
85503,102,63,88,4,5,4,13,Champions
86058,2558,6,32,1,1,3,5,Lost
86149,48,12,22,5,3,2,10,Loyal Users
86424,141,15,36,4,3,3,10,Loyal Users
86636,437,11,20,3,2,2,7,Casual Users
87473,35,46,71,5,5,4,14,Champions
87485,1396,12,27,1,3,2,6,Casual Users
87510,18,92,234,5,5,5,15,Champions
87563,274,12,82,3,3,4,10,Loyal Users
87678,299,46,63,3,5,4,12,Loyal Users
87707,153,7,29,4,2,2,8,Promising
87922,2880,5,7,1,1,1,3,Lost
87945,1291,7,7,1,2,1,4,Lost
87956,1240,9,14,2,2,1,5,Lost
88195,691,6,10,2,1,1,4,Lost
88198,1193,11,19,2,2,2,6,Lost
88208,21,17,84,5,3,4,12,Loyal Users
88466,1151,9,17,2,2,2,6,Lost
88757,24,44,136,5,4,4,13,Champions
88821,229,8,18,3,2,2,7,Casual Users
89470,1119,6,17,2,1,2,5,Lost
89921,3113,6,11,1,1,1,3,Lost
89972,431,93,154,3,5,5,13,Loyal Users
90185,1116,7,23,2,2,2,6,Lost
90207,716,7,24,2,2,2,6,Lost
90283,210,8,56,3,2,3,8,Casual Users
90588,144,19,22,4,3,2,9,Loyal Users
90713,268,10,53,3,2,3,8,Casual Users
90931,1282,14,25,1,3,2,6,Casual Users
78898,457,23,60,3,4,3,10,Loyal Users
79144,2799,11,15,1,2,1,4,Lost
80141,6,50,129,5,5,4,14,Champions
80516,83,18,127,4,3,4,11,Loyal Users
80988,110,42,119,4,4,4,12,Champions
81298,1134,8,12,2,2,1,5,Lost
81356,798,14,21,2,3,2,7,Casual Users
81680,1827,8,10,1,2,1,4,Lost
82031,297,5,15,3,1,1,5,Casual Users
82203,47,22,53,5,4,3,12,Loyal Users
82643,5,9,29,5,2,2,9,Promising
82716,109,8,15,4,2,1,7,Promising
82735,259,37,82,3,4,4,11,Loyal Users
82888,333,22,22,3,4,2,9,Loyal Users
82932,1259,10,23,1,2,2,5,Lost
83133,74,43,133,4,4,4,12,Champions
84318,1405,6,23,1,1,2,4,Lost
84575,74,30,120,4,4,4,12,Champions
84586,278,9,10,3,2,1,6,Casual Users
85019,950,102,252,2,5,5,12,At Risk
85049,109,16,26,4,3,2,9,Loyal Users
85169,363,19,32,3,3,3,9,Loyal Users
85196,101,7,21,4,2,2,8,Promising
85398,887,7,13,2,2,1,5,Lost
85514,286,107,393,3,5,5,13,Loyal Users
85961,281,17,46,3,3,3,9,Loyal Users
86035,119,16,29,4,3,2,9,Loyal Users
86259,564,9,16,2,2,2,6,Lost
86345,6,12,19,5,3,2,10,Loyal Users
86495,1429,6,12,1,1,1,3,Lost
86551,1436,20,28,1,3,2,6,Casual Users
86849,2,19,95,5,3,4,12,Loyal Users
86876,433,19,58,3,3,3,9,Loyal Users
87041,222,59,312,3,5,5,13,Loyal Users
87057,140,14,35,4,3,3,10,Loyal Users
87085,34,22,32,5,4,3,12,Loyal Users
87091,8,78,200,5,5,5,15,Champions
87100,134,23,72,4,4,4,12,Champions
87775,776,37,77,2,4,4,10,At Risk
87862,270,43,162,3,4,5,12,Loyal Users
88495,548,9,20,2,2,2,6,Lost
88796,1,52,97,5,5,4,14,Champions
89014,872,14,19,2,3,2,7,Casual Users
89192,49,26,83,5,4,4,13,Champions
89239,1166,8,27,2,2,2,6,Lost
90384,1594,6,6,1,1,1,3,Lost
90420,241,7,40,3,2,3,8,Casual Users
90500,2109,13,28,1,3,2,6,Casual Users
90520,1807,41,91,1,4,4,9,At Risk
90535,37,33,62,5,4,3,12,Loyal Users
90779,660,29,102,2,4,4,10,At Risk
90887,90,38,164,4,4,5,13,Champions
90967,59,87,175,5,5,5,15,Champions
78447,1629,5,8,1,1,1,3,Lost
78528,93,39,143,4,4,4,12,Champions
78564,382,16,116,3,3,4,10,Loyal Users
78797,26,15,26,5,3,2,10,Loyal Users
78871,708,7,15,2,2,1,5,Lost
78903,786,10,33,2,2,3,7,Lost
79128,0,27,57,5,4,3,12,Loyal Users
79485,1126,51,68,2,5,4,11,At Risk
79593,107,92,569,4,5,5,14,Champions
80029,124,14,23,4,3,2,9,Loyal Users
80079,1661,12,42,1,3,3,7,Casual Users
80303,35,113,492,5,5,5,15,Champions
80459,230,55,151,3,5,5,13,Loyal Users
80631,93,57,97,4,5,4,13,Champions
81028,502,10,19,2,2,2,6,Lost
81173,275,113,508,3,5,5,13,Loyal Users
81688,97,166,313,4,5,5,14,Champions
82287,180,5,15,3,1,1,5,Casual Users
82506,338,54,60,3,5,3,11,Loyal Users
82721,1564,20,30,1,3,2,6,Casual Users
82788,25,43,117,5,4,4,13,Champions
82904,1762,7,27,1,2,2,5,Lost
83645,47,52,188,5,5,5,15,Champions
83767,5974,5,5,1,1,1,3,Lost
84338,399,9,42,3,2,3,8,Casual Users
84376,1247,29,163,2,4,5,11,At Risk
84715,674,6,38,2,1,3,6,Lost
84764,221,13,61,3,3,3,9,Loyal Users
84924,23,135,259,5,5,5,15,Champions
85166,137,9,15,4,2,1,7,Promising
85411,90,60,256,4,5,5,14,Champions
85447,1564,13,22,1,3,2,6,Casual Users
86122,834,19,47,2,3,3,8,Casual Users
86350,664,10,33,2,2,3,7,Lost
86688,84,26,56,4,4,3,11,Loyal Users
86765,3802,9,9,1,2,1,4,Lost
87152,2,35,140,5,4,4,13,Champions
87712,441,5,5,3,1,1,5,Casual Users
87867,88,77,447,4,5,5,14,Champions
88303,2,38,61,5,4,3,12,Loyal Users
88639,4,46,132,5,5,4,14,Champions
89289,443,9,31,3,2,2,7,Casual Users
89433,145,21,159,4,3,5,12,Loyal Users
89712,568,9,9,2,2,1,5,Lost
89736,1963,5,8,1,1,1,3,Lost
89925,66,87,372,5,5,5,15,Champions
89975,251,24,66,3,4,4,11,Loyal Users
90009,793,7,11,2,2,1,5,Lost
90479,3310,6,11,1,1,1,3,Lost
90491,8,16,58,5,3,3,11,Loyal Users
78288,256,12,16,3,3,2,8,Loyal Users
78413,1601,8,24,1,2,2,5,Lost
78580,3,101,295,5,5,5,15,Champions
78606,2233,6,26,1,1,2,4,Lost
78620,1,41,92,5,4,4,13,Champions
79110,118,46,86,4,5,4,13,Champions
79311,139,10,19,4,2,2,8,Promising
79322,214,10,16,3,2,2,7,Casual Users
79449,550,7,21,2,2,2,6,Lost
80022,1154,13,30,2,3,2,7,Casual Users
80215,86,55,201,4,5,5,14,Champions
80347,30,113,369,5,5,5,15,Champions
80402,233,37,74,3,4,4,11,Loyal Users
80619,793,9,12,2,2,1,5,Lost
80736,13,47,143,5,5,4,14,Champions
81101,8,48,139,5,5,4,14,Champions
81111,61,12,34,5,3,3,11,Loyal Users
81231,92,5,16,4,1,2,7,Promising
81250,267,24,211,3,4,5,12,Loyal Users
81441,84,98,364,4,5,5,14,Champions
81550,31,36,116,5,4,4,13,Champions
81658,121,39,138,4,4,4,12,Champions
81960,551,25,46,2,4,3,9,At Risk
82014,1817,6,23,1,1,2,4,Lost
82195,3301,5,11,1,1,1,3,Lost
82197,10,40,219,5,4,5,14,Champions
82241,146,12,166,4,3,5,12,Loyal Users
82244,153,6,16,4,1,2,7,Promising
82250,115,137,200,4,5,5,14,Champions
82327,124,60,138,4,5,4,13,Champions
82505,1700,17,29,1,3,2,6,Casual Users
82752,123,71,109,4,5,4,13,Champions
82955,274,21,52,3,3,3,9,Loyal Users
82956,412,18,32,3,3,3,9,Loyal Users
83509,3845,8,8,1,2,1,4,Lost
83520,129,38,79,4,4,4,12,Champions
83640,283,28,74,3,4,4,11,Loyal Users
83739,670,16,31,2,3,2,7,Casual Users
84003,1518,5,18,1,1,2,4,Lost
84242,434,17,27,3,3,2,8,Loyal Users
84541,17,31,47,5,4,3,12,Loyal Users
85520,699,35,68,2,4,4,10,At Risk
85815,132,69,202,4,5,5,14,Champions
85837,108,78,395,4,5,5,14,Champions
86141,1628,8,27,1,2,2,5,Lost
86398,26,115,230,5,5,5,15,Champions
86481,293,14,21,3,3,2,8,Loyal Users
86567,961,5,6,2,1,1,4,Lost
86664,684,15,48,2,3,3,8,Casual Users
86912,570,6,11,2,1,1,4,Lost
87212,268,8,28,3,2,2,7,Casual Users
87216,664,11,20,2,2,2,6,Lost
87306,210,10,16,3,2,2,7,Casual Users
87328,91,91,341,4,5,5,14,Champions
87442,11,61,101,5,5,4,14,Champions
87620,600,6,16,2,1,2,5,Lost
88228,85,50,150,4,5,5,14,Champions
88609,210,46,57,3,5,3,11,Loyal Users
88805,721,30,62,2,4,3,9,At Risk
89019,416,74,174,3,5,5,13,Loyal Users
89249,507,8,24,2,2,2,6,Lost
89416,103,5,7,4,1,1,6,Promising
89531,3307,7,66,1,2,4,7,Lost
89887,13,28,117,5,4,4,13,Champions
90006,16,121,158,5,5,5,15,Champions
90054,7,102,237,5,5,5,15,Champions
90309,23,48,381,5,5,5,15,Champions
90438,606,10,14,2,2,1,5,Lost
90710,8,6,6,5,1,1,7,Promising
90871,3558,17,86,1,3,4,8,Casual Users
78562,1583,5,30,1,1,2,4,Lost
78825,1719,6,12,1,1,1,3,Lost
78878,727,15,46,2,3,3,8,Casual Users
79182,2187,16,28,1,3,2,6,Casual Users
79399,1218,7,44,2,2,3,7,Lost
79406,999,18,21,2,3,2,7,Casual Users
79418,931,8,33,2,2,3,7,Lost
79437,29,71,404,5,5,5,15,Champions
79653,285,33,103,3,4,4,11,Loyal Users
79737,1009,8,8,2,2,1,5,Lost
79800,108,81,297,4,5,5,14,Champions
80026,15,24,61,5,4,3,12,Loyal Users
80359,86,6,9,4,1,1,6,Promising
80453,810,17,70,2,3,4,9,Casual Users
80852,0,158,271,5,5,5,15,Champions
81014,0,225,326,5,5,5,15,Champions
81069,108,5,10,4,1,1,6,Promising
81071,58,19,53,5,3,3,11,Loyal Users
81301,1,34,57,5,4,3,12,Loyal Users
81986,191,48,122,3,5,4,12,Loyal Users
81988,36,64,255,5,5,5,15,Champions
82278,129,37,105,4,4,4,12,Champions
82356,254,26,67,3,4,4,11,Loyal Users
82468,709,7,12,2,2,1,5,Lost
82532,1832,5,20,1,1,2,4,Lost
82912,857,8,17,2,2,2,6,Lost
82990,64,68,244,5,5,5,15,Champions
83061,1172,47,197,2,5,5,12,At Risk
83446,526,5,46,2,1,3,6,Lost
83857,122,34,131,4,4,4,12,Champions
83969,116,68,211,4,5,5,14,Champions
84214,288,66,478,3,5,5,13,Loyal Users
84261,522,5,13,2,1,1,4,Lost
84364,8,47,409,5,5,5,15,Champions
84499,420,32,123,3,4,4,11,Loyal Users
84826,245,11,37,3,2,3,8,Casual Users
85141,20,5,6,5,1,1,7,Promising
85242,1087,7,8,2,2,1,5,Lost
85282,576,14,52,2,3,3,8,Casual Users
85315,46,52,269,5,5,5,15,Champions
85359,1388,47,98,1,5,4,10,At Risk
85563,84,55,218,4,5,5,14,Champions
85859,124,32,81,4,4,4,12,Champions
85970,468,21,27,3,3,2,8,Loyal Users
86048,83,13,25,4,3,2,9,Loyal Users
86135,1981,7,40,1,2,3,6,Lost
86213,35,95,226,5,5,5,15,Champions
86291,29,84,230,5,5,5,15,Champions
86394,147,49,72,4,5,4,13,Champions
86566,1374,16,46,1,3,3,7,Casual Users
86812,860,7,25,2,2,2,6,Lost
86817,3518,29,237,1,4,5,10,At Risk
87390,4252,19,60,1,3,3,7,Casual Users
87609,1489,12,15,1,3,1,5,Casual Users
87856,1288,10,22,1,2,2,5,Lost
88043,310,17,47,3,3,3,9,Loyal Users
88503,2032,5,7,1,1,1,3,Lost
88636,71,6,10,4,1,1,6,Promising
88952,4,206,774,5,5,5,15,Champions
89626,222,58,115,3,5,4,12,Loyal Users
89756,4105,20,44,1,3,3,7,Casual Users
89806,1830,9,16,1,2,2,5,Lost
89902,526,9,59,2,2,3,7,Lost
90610,56,126,436,5,5,5,15,Champions
90781,300,47,94,3,5,4,12,Loyal Users
90802,91,80,426,4,5,5,14,Champions
78333,678,11,15,2,2,1,5,Lost
78656,698,47,150,2,5,5,12,At Risk
78804,286,6,11,3,1,1,5,Casual Users
79043,443,16,26,3,3,2,8,Loyal Users
79070,701,12,33,2,3,3,8,Casual Users
79079,8,106,455,5,5,5,15,Champions
79249,305,6,11,3,1,1,5,Casual Users
79968,206,52,115,3,5,4,12,Loyal Users
79973,63,66,146,5,5,4,14,Champions
80572,141,9,15,4,2,1,7,Promising
80656,2923,11,56,1,2,3,6,Lost
80712,24,25,57,5,4,3,12,Loyal Users
80893,23,32,51,5,4,3,12,Loyal Users
81022,5,40,98,5,4,4,13,Champions
81257,1468,40,175,1,4,5,10,At Risk
81940,1989,8,15,1,2,1,4,Lost
82243,532,13,137,2,3,4,9,Casual Users
82264,2,44,268,5,4,5,14,Champions
82283,1700,22,60,1,4,3,8,At Risk
82402,326,7,8,3,2,1,6,Casual Users
82726,128,46,202,4,5,5,14,Champions
82748,46,47,340,5,5,5,15,Champions
82836,0,108,265,5,5,5,15,Champions
83126,1001,34,97,2,4,4,10,At Risk
83136,9,79,135,5,5,4,14,Champions
83212,1875,8,28,1,2,2,5,Lost
83308,26,38,80,5,4,4,13,Champions
83615,476,57,209,2,5,5,12,At Risk
83780,143,8,25,4,2,2,8,Promising
83839,6,101,187,5,5,5,15,Champions
83983,72,59,205,4,5,5,14,Champions
84429,730,42,83,2,4,4,10,At Risk
84513,170,18,94,3,3,4,10,Loyal Users
84557,738,33,89,2,4,4,10,At Risk
85649,4376,7,40,1,2,3,6,Lost
85686,22,32,76,5,4,4,13,Champions
85708,4872,6,17,1,1,2,4,Lost
85797,832,6,11,2,1,1,4,Lost
85903,1303,19,40,1,3,3,7,Casual Users
86484,729,13,24,2,3,2,7,Casual Users
86735,164,63,210,4,5,5,14,Champions
86778,1218,12,57,2,3,3,8,Casual Users
86830,11,141,665,5,5,5,15,Champions
87007,82,74,280,4,5,5,14,Champions
87025,149,10,11,4,2,1,7,Promising
87727,2001,18,37,1,3,3,7,Casual Users
88005,863,14,23,2,3,2,7,Casual Users
88678,354,15,25,3,3,2,8,Loyal Users
88897,822,6,27,2,1,2,5,Lost
89243,208,18,91,3,3,4,10,Loyal Users
89285,524,6,14,2,1,1,4,Lost
89376,46,13,57,5,3,3,11,Loyal Users
89643,1853,13,14,1,3,1,5,Casual Users
90623,1174,21,43,2,3,3,8,Casual Users
90930,708,10,13,2,2,1,5,Lost
78347,79,12,47,4,3,3,10,Loyal Users
78605,59,32,71,5,4,4,13,Champions
78813,135,31,51,4,4,3,11,Loyal Users
78872,869,51,69,2,5,4,11,At Risk
79012,4,89,277,5,5,5,15,Champions
79192,205,27,63,3,4,4,11,Loyal Users
79306,12,10,56,5,2,3,10,Promising
79555,258,22,78,3,4,4,11,Loyal Users
79599,1113,8,24,2,2,2,6,Lost
79729,420,30,59,3,4,3,10,Loyal Users
79839,425,40,95,3,4,4,11,Loyal Users
79873,3426,7,17,1,2,2,5,Lost
79924,247,38,53,3,4,3,10,Loyal Users
80067,58,79,224,5,5,5,15,Champions
80412,3,74,180,5,5,5,15,Champions
80457,193,141,358,3,5,5,13,Loyal Users
80548,692,11,18,2,2,2,6,Lost
80860,656,14,72,2,3,4,9,Casual Users
81338,0,23,211,5,4,5,14,Champions
81508,532,21,37,2,3,3,8,Casual Users
81727,113,44,165,4,4,5,13,Champions
81893,25,44,303,5,4,5,14,Champions
81901,1677,10,25,1,2,2,5,Lost
82075,1027,8,29,2,2,2,6,Lost
82096,279,13,24,3,3,2,8,Loyal Users
82184,1354,18,89,1,3,4,8,Casual Users
82211,424,59,123,3,5,4,12,Loyal Users
82597,3697,7,18,1,2,2,5,Lost
82678,663,30,83,2,4,4,10,At Risk
82824,3214,80,412,1,5,5,11,At Risk
82899,97,37,116,4,4,4,12,Champions
83080,2,148,533,5,5,5,15,Champions
83145,116,100,215,4,5,5,14,Champions
83494,763,30,163,2,4,5,11,At Risk
84476,3833,9,9,1,2,1,4,Lost
84730,127,27,46,4,4,3,11,Loyal Users
85037,567,40,116,2,4,4,10,At Risk
85147,129,56,111,4,5,4,13,Champions
85314,4589,7,7,1,2,1,4,Lost
85322,889,35,120,2,4,4,10,At Risk
85538,132,112,241,4,5,5,14,Champions
85675,71,24,73,4,4,4,12,Champions
86382,293,5,7,3,1,1,5,Casual Users
86702,1683,47,89,1,5,4,10,At Risk
86795,2216,7,32,1,2,3,6,Lost
86798,3308,7,21,1,2,2,5,Lost
87046,365,5,13,3,1,1,5,Casual Users
87105,1832,8,14,1,2,1,4,Lost
87209,5828,5,7,1,1,1,3,Lost
87438,154,24,92,4,4,4,12,Champions
87863,162,5,10,4,1,1,6,Promising
87947,266,20,46,3,3,3,9,Loyal Users
87973,58,7,25,5,2,2,9,Promising
88008,590,13,69,2,3,4,9,Casual Users
88029,117,13,15,4,3,1,8,Loyal Users
88089,2406,6,21,1,1,2,4,Lost
88284,967,25,62,2,4,3,9,At Risk
88474,407,21,36,3,3,3,9,Loyal Users
88538,257,19,69,3,3,4,10,Loyal Users
88729,985,16,45,2,3,3,8,Casual Users
88795,137,18,27,4,3,2,9,Loyal Users
88844,67,6,10,5,1,1,7,Promising
89010,5692,16,37,1,3,3,7,Casual Users
89214,76,26,46,4,4,3,11,Loyal Users
89273,372,11,20,3,2,2,7,Casual Users
89380,281,47,166,3,5,5,13,Loyal Users
89829,33,45,130,5,4,4,13,Champions
89835,1704,6,8,1,1,1,3,Lost
90428,25,7,8,5,2,1,8,Promising
90495,2693,7,14,1,2,1,4,Lost
90626,549,24,85,2,4,4,10,At Risk
91005,113,33,86,4,4,4,12,Champions
91057,438,7,21,3,2,2,7,Casual Users
78406,19,57,125,5,5,4,14,Champions
78568,1576,5,21,1,1,2,4,Lost
78767,63,21,95,5,3,4,12,Loyal Users
78999,135,10,29,4,2,2,8,Promising
79000,108,63,253,4,5,5,14,Champions
79005,1,263,615,5,5,5,15,Champions
79640,702,6,9,2,1,1,4,Lost
79964,1253,5,30,2,1,2,5,Lost
80202,735,15,80,2,3,4,9,Casual Users
80319,1759,7,7,1,2,1,4,Lost
80492,550,13,45,2,3,3,8,Casual Users
81376,118,87,113,4,5,4,13,Champions
81452,2812,100,143,1,5,4,10,At Risk
81470,111,30,139,4,4,4,12,Champions
81786,119,5,11,4,1,1,6,Promising
82225,135,88,309,4,5,5,14,Champions
82240,128,11,23,4,2,2,8,Promising
82403,1151,6,13,2,1,1,4,Lost
82445,850,12,43,2,3,3,8,Casual Users
82982,2389,5,6,1,1,1,3,Lost
83269,1085,5,8,2,1,1,4,Lost
83314,145,43,71,4,4,4,12,Champions
83629,247,15,23,3,3,2,8,Loyal Users
83791,109,44,106,4,4,4,12,Champions
83921,23,5,22,5,1,2,8,Promising
84170,98,19,50,4,3,3,10,Loyal Users
84458,1982,5,5,1,1,1,3,Lost
84579,1008,10,16,2,2,2,6,Lost
85001,2918,5,8,1,1,1,3,Lost
85261,569,5,8,2,1,1,4,Lost
85560,120,36,69,4,4,4,12,Champions
85639,1,14,40,5,3,3,11,Loyal Users
85671,56,156,457,5,5,5,15,Champions
86564,3965,8,10,1,2,1,4,Lost
86715,12,17,33,5,3,3,11,Loyal Users
87144,676,5,7,2,1,1,4,Lost
87408,1932,50,225,1,5,5,11,At Risk
87460,12,12,23,5,3,2,10,Loyal Users
87669,278,5,8,3,1,1,5,Casual Users
88625,651,5,23,2,1,2,5,Lost
89006,156,13,38,4,3,3,10,Loyal Users
89450,1797,10,46,1,2,3,6,Lost
89811,409,5,5,3,1,1,5,Casual Users
89822,435,59,264,3,5,5,13,Loyal Users
89850,298,6,23,3,1,2,6,Casual Users
90629,119,51,85,4,5,4,13,Champions
90800,11,19,20,5,3,2,10,Loyal Users
90949,424,21,24,3,3,2,8,Loyal Users
90953,3578,22,70,1,4,4,9,At Risk
91064,31,84,230,5,5,5,15,Champions
78456,1025,19,67,2,3,4,9,Casual Users
78534,26,114,549,5,5,5,15,Champions
78854,199,39,46,3,4,3,10,Loyal Users
79368,711,33,61,2,4,3,9,At Risk
79526,32,27,84,5,4,4,13,Champions
79745,659,7,7,2,2,1,5,Lost
80000,83,22,57,4,4,3,11,Loyal Users
80224,1670,8,8,1,2,1,4,Lost
80285,125,46,130,4,5,4,13,Champions
80733,43,52,154,5,5,5,15,Champions
81198,229,46,145,3,5,4,12,Loyal Users
81201,7,128,626,5,5,5,15,Champions
81275,1748,10,17,1,2,2,5,Lost
81512,2680,6,9,1,1,1,3,Lost
82305,547,5,14,2,1,1,4,Lost
82314,1577,15,38,1,3,3,7,Casual Users
83271,246,18,77,3,3,4,10,Loyal Users
83459,1038,15,33,2,3,3,8,Casual Users
84379,105,20,36,4,3,3,10,Loyal Users
84484,2437,15,25,1,3,2,6,Casual Users
84528,9,65,401,5,5,5,15,Champions
84555,856,14,26,2,3,2,7,Casual Users
84884,822,6,21,2,1,2,5,Lost
84965,110,40,51,4,4,3,11,Loyal Users
85283,4,32,59,5,4,3,12,Loyal Users
85335,12,63,101,5,5,4,14,Champions
85368,783,10,13,2,2,1,5,Lost
85704,115,51,244,4,5,5,14,Champions
85904,24,46,134,5,5,4,14,Champions
86020,229,26,46,3,4,3,10,Loyal Users
86053,629,15,72,2,3,4,9,Casual Users
86195,588,6,10,2,1,1,4,Lost
86290,120,39,396,4,4,5,13,Champions
86302,303,9,141,3,2,4,9,Casual Users
86449,736,7,14,2,2,1,5,Lost
86629,40,65,86,5,5,4,14,Champions
87110,101,93,324,4,5,5,14,Champions
87126,1535,19,67,1,3,4,8,Casual Users
87257,1,6,7,5,1,1,7,Promising
87290,315,5,6,3,1,1,5,Casual Users
87589,1410,6,50,1,1,3,5,Lost
87703,91,27,95,4,4,4,12,Champions
87758,729,28,61,2,4,3,9,At Risk
88583,25,99,197,5,5,5,15,Champions
88627,2117,7,10,1,2,1,4,Lost
88864,421,11,38,3,2,3,8,Casual Users
88933,1002,25,40,2,4,3,9,At Risk
89568,665,27,93,2,4,4,10,At Risk
89767,1269,20,33,1,3,3,7,Casual Users
89903,6,58,76,5,5,4,14,Champions
90014,19,102,224,5,5,5,15,Champions
90627,3,16,18,5,3,2,10,Loyal Users
91038,3,118,134,5,5,4,14,Champions
78371,392,71,263,3,5,5,13,Loyal Users
78398,69,33,198,5,4,5,14,Champions
78781,300,89,255,3,5,5,13,Loyal Users
78832,82,7,19,4,2,2,8,Promising
78966,35,85,210,5,5,5,15,Champions
78967,1300,14,26,1,3,2,6,Casual Users
79426,109,5,16,4,1,2,7,Promising
79428,406,5,25,3,1,2,6,Casual Users
79551,446,12,26,3,3,2,8,Loyal Users
79845,45,70,264,5,5,5,15,Champions
79999,112,13,21,4,3,2,9,Loyal Users
80174,1131,9,24,2,2,2,6,Lost
80478,232,8,59,3,2,3,8,Casual Users
80605,847,5,15,2,1,1,4,Lost
80759,580,11,15,2,2,1,5,Lost
80955,116,18,47,4,3,3,10,Loyal Users
81124,10,28,54,5,4,3,12,Loyal Users
81131,1149,10,22,2,2,2,6,Lost
81345,91,43,182,4,4,5,13,Champions
81360,66,70,462,5,5,5,15,Champions
81533,454,35,110,3,4,4,11,Loyal Users
81766,1144,41,141,2,4,4,10,At Risk
82247,613,9,27,2,2,2,6,Lost
82675,3642,11,58,1,2,3,6,Lost
83035,2118,12,83,1,3,4,8,Casual Users
83194,728,8,79,2,2,4,8,Lost
83342,370,5,8,3,1,1,5,Casual Users
83764,639,5,9,2,1,1,4,Lost
83822,3970,5,13,1,1,1,3,Lost
84049,87,44,147,4,4,5,13,Champions
84073,263,20,51,3,3,3,9,Loyal Users
84150,132,26,38,4,4,3,11,Loyal Users
84570,19,49,98,5,5,4,14,Champions
84801,32,88,166,5,5,5,15,Champions
85065,12,23,106,5,4,4,13,Champions
85214,34,73,197,5,5,5,15,Champions
85256,3172,6,20,1,1,2,4,Lost
85376,1416,9,22,1,2,2,5,Lost
85392,11,121,168,5,5,5,15,Champions
85500,65,41,123,5,4,4,13,Champions
85778,423,18,166,3,3,5,11,Loyal Users
85893,93,36,84,4,4,4,12,Champions
85990,119,105,202,4,5,5,14,Champions
86222,147,25,56,4,4,3,11,Loyal Users
86438,2533,5,10,1,1,1,3,Lost
86756,245,13,44,3,3,3,9,Loyal Users
87300,384,6,24,3,1,2,6,Casual Users
87348,86,124,478,4,5,5,14,Champions
88045,304,17,26,3,3,2,8,Loyal Users
88256,4677,14,32,1,3,3,7,Casual Users
88432,77,11,31,4,2,2,8,Promising
88614,4454,9,20,1,2,2,5,Lost
89217,201,57,118,3,5,4,12,Loyal Users
89294,25,120,497,5,5,5,15,Champions
89488,54,7,7,5,2,1,8,Promising
89513,59,55,87,5,5,4,14,Champions
89761,483,8,14,2,2,1,5,Lost
89910,153,6,6,4,1,1,6,Promising
89913,1220,23,91,2,4,4,10,At Risk
89943,2840,10,33,1,2,3,6,Lost
90258,270,25,111,3,4,4,11,Loyal Users
90334,1117,39,205,2,4,5,11,At Risk
90339,3,14,61,5,3,3,11,Loyal Users
90991,228,30,345,3,4,5,12,Loyal Users
91007,624,20,31,2,3,2,7,Casual Users
78437,31,92,485,5,5,5,15,Champions
78515,8,112,1123,5,5,5,15,Champions
78751,168,17,51,3,3,3,9,Loyal Users
78777,1000,7,8,2,2,1,5,Lost
78793,2124,8,16,1,2,2,5,Lost
79281,4412,6,22,1,1,2,4,Lost
79450,16,76,107,5,5,4,14,Champions
79613,1241,5,12,2,1,1,4,Lost
79684,270,14,39,3,3,3,9,Loyal Users
80200,12,10,25,5,2,2,9,Promising
80295,134,92,439,4,5,5,14,Champions
80560,507,33,468,2,4,5,11,At Risk
80732,1718,10,13,1,2,1,4,Lost
81097,14,108,550,5,5,5,15,Champions
81306,145,5,27,4,1,2,7,Promising
81308,142,11,120,4,2,4,10,Promising
81341,3211,11,11,1,2,1,4,Lost
81416,115,52,259,4,5,5,14,Champions
82111,153,18,45,4,3,3,10,Loyal Users
82332,524,56,238,2,5,5,12,At Risk
82370,1859,7,38,1,2,3,6,Lost
82471,2087,5,10,1,1,1,3,Lost
82472,692,31,79,2,4,4,10,At Risk
82544,9,57,120,5,5,4,14,Champions
82558,752,15,33,2,3,3,8,Casual Users
82764,121,7,28,4,2,2,8,Promising
82931,101,13,58,4,3,3,10,Loyal Users
83253,5465,10,11,1,2,1,4,Lost
83401,1384,22,55,1,4,3,8,At Risk
84109,131,16,56,4,3,3,10,Loyal Users
84433,1286,15,15,1,3,1,5,Casual Users
84747,107,28,83,4,4,4,12,Champions
84849,0,67,218,5,5,5,15,Champions
85111,242,26,38,3,4,3,10,Loyal Users
85159,978,6,48,2,1,3,6,Lost
85262,295,10,17,3,2,2,7,Casual Users
85933,26,6,14,5,1,1,7,Promising
86066,30,18,59,5,3,3,11,Loyal Users
86365,228,6,22,3,1,2,6,Casual Users
86501,2084,5,7,1,1,1,3,Lost
86502,16,96,203,5,5,5,15,Champions
86638,112,39,55,4,4,3,11,Loyal Users
86659,275,12,103,3,3,4,10,Loyal Users
86668,2234,18,21,1,3,2,6,Casual Users
88112,38,36,90,5,4,4,13,Champions
88203,144,35,228,4,4,5,13,Champions
88360,1021,25,32,2,4,3,9,At Risk
88676,310,34,227,3,4,5,12,Loyal Users
88835,87,8,13,4,2,1,7,Promising
88927,101,94,168,4,5,5,14,Champions
89051,9,116,765,5,5,5,15,Champions
89095,78,5,8,4,1,1,6,Promising
89164,21,17,35,5,3,3,11,Loyal Users
89390,85,5,6,4,1,1,6,Promising
89723,2565,17,25,1,3,2,6,Casual Users
89725,710,10,14,2,2,1,5,Lost
90050,1412,19,65,1,3,4,8,Casual Users
90219,4589,5,9,1,1,1,3,Lost
90344,2477,10,32,1,2,3,6,Lost
90556,2406,8,18,1,2,2,5,Lost
90651,101,30,122,4,4,4,12,Champions
78382,661,10,48,2,2,3,7,Lost
78486,108,50,104,4,5,4,13,Champions
78519,73,125,488,4,5,5,14,Champions
78581,155,11,40,4,2,3,9,Promising
78654,1570,7,28,1,2,2,5,Lost
79039,91,5,26,4,1,2,7,Promising
79500,171,7,34,3,2,3,8,Casual Users
79674,65,69,278,5,5,5,15,Champions
79844,585,15,55,2,3,3,8,Casual Users
79870,711,14,17,2,3,2,7,Casual Users
79996,594,19,43,2,3,3,8,Casual Users
80105,356,6,30,3,1,2,6,Casual Users
80146,92,139,555,4,5,5,14,Champions
80234,0,21,31,5,3,2,10,Loyal Users
80436,119,31,49,4,4,3,11,Loyal Users
80460,30,28,137,5,4,4,13,Champions
80756,4828,7,14,1,2,1,4,Lost
81057,439,32,58,3,4,3,10,Loyal Users
81102,1000,32,59,2,4,3,9,At Risk
81373,569,10,45,2,2,3,7,Lost
82107,172,56,167,3,5,5,13,Loyal Users
82379,5,118,938,5,5,5,15,Champions
82399,391,14,26,3,3,2,8,Loyal Users
82400,386,24,45,3,4,3,10,Loyal Users
82504,412,5,7,3,1,1,5,Casual Users
82659,1763,18,20,1,3,2,6,Casual Users
82668,69,96,214,5,5,5,15,Champions
82802,23,76,339,5,5,5,15,Champions
83316,225,24,84,3,4,4,11,Loyal Users
83333,859,12,12,2,3,1,6,Casual Users
83366,11,179,620,5,5,5,15,Champions
83451,403,26,36,3,4,3,10,Loyal Users
83664,121,156,686,4,5,5,14,Champions
83691,228,24,57,3,4,3,10,Loyal Users
83699,1200,5,73,2,1,4,7,Lost
83851,871,11,17,2,2,2,6,Lost
84276,151,31,302,4,4,5,13,Champions
84553,132,5,8,4,1,1,6,Promising
84961,538,7,23,2,2,2,6,Lost
84995,0,121,671,5,5,5,15,Champions
85011,39,29,39,5,4,3,12,Loyal Users
85083,23,44,94,5,4,4,13,Champions
85136,1112,13,26,2,3,2,7,Casual Users
85471,307,24,58,3,4,3,10,Loyal Users
85584,4143,5,11,1,1,1,3,Lost
85606,422,6,12,3,1,1,5,Casual Users
85695,980,12,26,2,3,2,7,Casual Users
85781,0,184,849,5,5,5,15,Champions
85881,4,48,115,5,5,4,14,Champions
85923,122,14,109,4,3,4,11,Loyal Users
85926,480,19,65,2,3,4,9,Casual Users
85949,527,41,117,2,4,4,10,At Risk
86264,140,22,58,4,4,3,11,Loyal Users
86309,97,75,160,4,5,5,14,Champions
86370,2666,23,154,1,4,5,10,At Risk
87019,2,7,11,5,2,1,8,Promising
87363,494,14,114,2,3,4,9,Casual Users
87681,13,11,40,5,2,3,10,Promising
87967,69,54,232,5,5,5,15,Champions
88510,413,7,39,3,2,3,8,Casual Users
88815,57,7,18,5,2,2,9,Promising
88816,4118,13,117,1,3,4,8,Casual Users
88874,3,60,152,5,5,5,15,Champions
88900,118,103,231,4,5,5,14,Champions
88974,2950,7,29,1,2,2,5,Lost
89297,19,105,495,5,5,5,15,Champions
89457,838,7,13,2,2,1,5,Lost
89981,1821,5,11,1,1,1,3,Lost
90103,49,36,67,5,4,4,13,Champions
90165,2657,20,33,1,3,3,7,Casual Users
90578,1885,12,14,1,3,1,5,Casual Users
90597,1,122,580,5,5,5,15,Champions
90695,115,21,65,4,3,4,11,Loyal Users
90921,1851,8,22,1,2,2,5,Lost
79031,1228,5,39,2,1,3,6,Lost
79046,2413,5,6,1,1,1,3,Lost
79173,0,91,336,5,5,5,15,Champions
79180,101,56,141,4,5,4,13,Champions
79272,15,26,67,5,4,4,13,Champions
79545,118,73,112,4,5,4,13,Champions
79556,5,19,72,5,3,4,12,Loyal Users
79570,4731,8,13,1,2,1,4,Lost
79985,64,133,603,5,5,5,15,Champions
80073,219,35,177,3,4,5,12,Loyal Users
80660,422,21,24,3,3,2,8,Loyal Users
80708,3594,10,18,1,2,2,5,Lost
81460,17,85,334,5,5,5,15,Champions
81625,704,16,42,2,3,3,8,Casual Users
81633,586,23,82,2,4,4,10,At Risk
82687,115,9,49,4,2,3,9,Promising
83422,1577,7,11,1,2,1,4,Lost
83618,68,60,140,5,5,4,14,Champions
83836,2217,5,13,1,1,1,3,Lost
83952,12,113,751,5,5,5,15,Champions
84140,420,17,46,3,3,3,9,Loyal Users
84444,861,5,5,2,1,1,4,Lost
84492,1388,115,298,1,5,5,11,At Risk
84645,136,27,35,4,4,3,11,Loyal Users
84870,66,19,21,5,3,2,10,Loyal Users
84932,104,8,12,4,2,1,7,Promising
85287,5,70,256,5,5,5,15,Champions
85414,2,107,302,5,5,5,15,Champions
85571,323,32,46,3,4,3,10,Loyal Users
85756,106,14,55,4,3,3,10,Loyal Users
85819,133,54,115,4,5,4,13,Champions
85860,76,106,231,4,5,5,14,Champions
85928,4,62,189,5,5,5,15,Champions
86008,81,40,151,4,4,5,13,Champions
86044,1012,5,6,2,1,1,4,Lost
86072,2794,6,9,1,1,1,3,Lost
86322,96,146,216,4,5,5,14,Champions
86661,384,16,44,3,3,3,9,Loyal Users
86811,109,17,27,4,3,2,9,Loyal Users
86823,126,77,340,4,5,5,14,Champions
87080,307,7,21,3,2,2,7,Casual Users
87425,13,13,17,5,3,2,10,Loyal Users
87547,1405,8,12,1,2,1,4,Lost
87549,850,8,11,2,2,1,5,Lost
87667,17,18,22,5,3,2,10,Loyal Users
87763,660,47,187,2,5,5,12,At Risk
87875,688,20,55,2,3,3,8,Casual Users
88009,26,173,315,5,5,5,15,Champions
88051,17,190,594,5,5,5,15,Champions
88179,48,28,47,5,4,3,12,Loyal Users
88418,561,12,47,2,3,3,8,Casual Users
88478,101,19,31,4,3,2,9,Loyal Users
88578,614,67,344,2,5,5,12,At Risk
88586,226,7,8,3,2,1,6,Casual Users
88721,1673,16,57,1,3,3,7,Casual Users
88732,1404,14,75,1,3,4,8,Casual Users
88733,3416,29,71,1,4,4,9,At Risk
88797,272,14,28,3,3,2,8,Loyal Users
88837,542,123,623,2,5,5,12,At Risk
89061,26,53,221,5,5,5,15,Champions
89203,156,13,27,4,3,2,9,Loyal Users
89301,1379,6,27,1,1,2,4,Lost
89357,3966,5,7,1,1,1,3,Lost
89366,28,9,15,5,2,1,8,Promising
89939,439,35,60,3,4,3,10,Loyal Users
90326,600,17,30,2,3,2,7,Casual Users
90338,428,36,82,3,4,4,11,Loyal Users
90410,4504,12,18,1,3,2,6,Casual Users
90448,41,32,110,5,4,4,13,Champions
78352,139,43,127,4,4,4,12,Champions
78869,17,83,183,5,5,5,15,Champions
78884,2245,5,8,1,1,1,3,Lost
79097,1404,12,35,1,3,3,7,Casual Users
79169,419,43,88,3,4,4,11,Loyal Users
79171,65,98,311,5,5,5,15,Champions
79261,546,36,110,2,4,4,10,At Risk
79627,2866,14,35,1,3,3,7,Casual Users
79724,283,17,27,3,3,2,8,Loyal Users
79804,117,6,15,4,1,1,6,Promising
79978,241,14,32,3,3,3,9,Loyal Users
80158,3567,9,27,1,2,2,5,Lost
80242,34,9,29,5,2,2,9,Promising
80552,1239,21,53,2,3,3,8,Casual Users
81139,827,12,161,2,3,5,10,Casual Users
81150,127,33,314,4,4,5,13,Champions
81217,116,19,25,4,3,2,9,Loyal Users
81546,15,85,560,5,5,5,15,Champions
81685,1186,8,146,2,2,4,8,Lost
81792,17,166,539,5,5,5,15,Champions
82019,204,24,208,3,4,5,12,Loyal Users
82348,23,21,35,5,3,3,11,Loyal Users
82443,2,193,467,5,5,5,15,Champions
82522,211,10,21,3,2,2,7,Casual Users
82663,103,159,510,4,5,5,14,Champions
82724,1398,12,31,1,3,2,6,Casual Users
83109,5495,5,13,1,1,1,3,Lost
83189,122,11,50,4,2,3,9,Promising
83296,805,5,13,2,1,1,4,Lost
83318,110,27,36,4,4,3,11,Loyal Users
83330,3545,13,13,1,3,1,5,Casual Users
83522,19,61,132,5,5,4,14,Champions
84303,1392,5,6,1,1,1,3,Lost
84368,61,37,229,5,4,5,14,Champions
84398,158,19,84,4,3,4,11,Loyal Users
84759,145,47,159,4,5,5,14,Champions
85329,1880,13,24,1,3,2,6,Casual Users
85604,401,49,403,3,5,5,13,Loyal Users
85852,427,32,104,3,4,4,11,Loyal Users
85896,1097,5,11,2,1,1,4,Lost
85919,2104,13,101,1,3,4,8,Casual Users
86081,878,8,27,2,2,2,6,Lost
86524,438,20,25,3,3,2,8,Loyal Users
86646,132,25,53,4,4,3,11,Loyal Users
88279,823,65,96,2,5,4,11,At Risk
88525,112,9,19,4,2,2,8,Promising
88596,32,85,249,5,5,5,15,Champions
88713,2256,5,8,1,1,1,3,Lost
88817,2402,15,44,1,3,3,7,Casual Users
89627,516,5,5,2,1,1,4,Lost
89676,118,5,5,4,1,1,6,Promising
90466,25,57,105,5,5,4,14,Champions
90606,1582,9,12,1,2,1,4,Lost
90940,76,7,11,4,2,1,7,Promising
90944,40,101,355,5,5,5,15,Champions
90994,0,94,703,5,5,5,15,Champions
78320,220,83,179,3,5,5,13,Loyal Users
78348,682,11,71,2,2,4,8,Lost
78432,2141,11,21,1,2,2,5,Lost
78684,26,92,462,5,5,5,15,Champions
78828,26,42,279,5,4,5,14,Champions
78928,331,37,62,3,4,3,10,Loyal Users
79123,212,11,110,3,2,4,9,Casual Users
79158,253,15,39,3,3,3,9,Loyal Users
79225,9,13,98,5,3,4,12,Loyal Users
79242,444,27,147,3,4,5,12,Loyal Users
80506,1864,12,17,1,3,2,6,Casual Users
80526,662,23,45,2,4,3,9,At Risk
80826,407,5,69,3,1,4,8,Casual Users
80913,2391,8,15,1,2,1,4,Lost
80949,94,7,12,4,2,1,7,Promising
81323,31,71,187,5,5,5,15,Champions
81383,1,78,432,5,5,5,15,Champions
81519,539,22,72,2,4,4,10,At Risk
81704,760,7,37,2,2,3,7,Lost
81765,84,33,89,4,4,4,12,Champions
81970,1128,5,23,2,1,2,5,Lost
82642,3878,5,9,1,1,1,3,Lost
82984,109,61,137,4,5,4,13,Champions
83411,192,23,32,3,4,3,10,Loyal Users
83429,1481,17,135,1,3,4,8,Casual Users
83490,1183,10,18,2,2,2,6,Lost
83717,475,77,126,2,5,4,11,At Risk
84061,121,61,268,4,5,5,14,Champions
84221,95,36,66,4,4,4,12,Champions
84324,259,51,111,3,5,4,12,Loyal Users
84417,456,13,20,3,3,2,8,Loyal Users
85024,36,93,466,5,5,5,15,Champions
85201,106,16,33,4,3,3,10,Loyal Users
85308,2840,8,21,1,2,2,5,Lost
85838,4023,33,162,1,4,5,10,At Risk
85874,1136,7,10,2,2,1,5,Lost
86158,1252,22,199,2,4,5,11,At Risk
86437,940,17,34,2,3,3,8,Casual Users
87162,33,77,200,5,5,5,15,Champions
87217,183,19,55,3,3,3,9,Loyal Users
87296,0,51,70,5,5,4,14,Champions
87371,805,13,28,2,3,2,7,Casual Users
87470,1544,5,18,1,1,2,4,Lost
87783,119,78,340,4,5,5,14,Champions
87904,24,180,506,5,5,5,15,Champions
88079,3,178,304,5,5,5,15,Champions
88083,269,122,275,3,5,5,13,Loyal Users
88165,647,5,7,2,1,1,4,Lost
88376,129,12,17,4,3,2,9,Loyal Users
88859,436,12,19,3,3,2,8,Loyal Users
88891,1407,10,67,1,2,4,7,Lost
89085,436,13,42,3,3,3,9,Loyal Users
89963,29,26,36,5,4,3,12,Loyal Users
89984,1818,9,39,1,2,3,6,Lost
90100,456,24,189,3,4,5,12,Loyal Users
90529,809,11,22,2,2,2,6,Lost
90690,2444,21,55,1,3,3,7,Casual Users
90820,18,69,284,5,5,5,15,Champions
78454,2566,31,38,1,4,3,8,At Risk
78500,16,7,26,5,2,2,9,Promising
79208,481,66,105,2,5,4,11,At Risk
79270,240,77,504,3,5,5,13,Loyal Users
79546,616,28,166,2,4,5,11,At Risk
79842,98,41,156,4,4,5,13,Champions
80153,5,42,96,5,4,4,13,Champions
80422,1841,36,112,1,4,4,9,At Risk
81068,1544,8,48,1,2,3,6,Lost
81075,545,40,104,2,4,4,10,At Risk
81093,149,30,156,4,4,5,13,Champions
81797,273,32,88,3,4,4,11,Loyal Users
82185,410,16,43,3,3,3,9,Loyal Users
82323,828,6,18,2,1,2,5,Lost
82405,131,55,201,4,5,5,14,Champions
82534,467,11,16,3,2,2,7,Casual Users
82636,92,7,11,4,2,1,7,Promising
82857,935,5,6,2,1,1,4,Lost
83443,2117,5,15,1,1,1,3,Lost
83899,1509,8,9,1,2,1,4,Lost
83960,419,6,10,3,1,1,5,Casual Users
84249,1510,9,11,1,2,1,4,Lost
84627,1089,5,18,2,1,2,5,Lost
84885,152,80,316,4,5,5,14,Champions
85170,1601,16,30,1,3,2,6,Casual Users
85230,123,74,285,4,5,5,14,Champions
85434,220,16,76,3,3,4,10,Loyal Users
85493,56,13,34,5,3,3,11,Loyal Users
85612,417,13,17,3,3,2,8,Loyal Users
85624,1031,11,32,2,2,3,7,Lost
85740,2672,5,19,1,1,2,4,Lost
85790,628,8,21,2,2,2,6,Lost
86019,116,31,87,4,4,4,12,Champions
86243,24,93,368,5,5,5,15,Champions
86721,338,22,200,3,4,5,12,Loyal Users
86737,2705,12,12,1,3,1,5,Casual Users
86766,267,12,53,3,3,3,9,Loyal Users
87117,1129,11,56,2,2,3,7,Lost
87142,2990,11,19,1,2,2,5,Lost
87389,80,90,381,4,5,5,14,Champions
87934,162,11,24,4,2,2,8,Promising
88111,193,13,38,3,3,3,9,Loyal Users
88292,2,53,179,5,5,5,15,Champions
88783,39,100,165,5,5,5,15,Champions
88829,13,78,228,5,5,5,15,Champions
89092,90,24,159,4,4,5,13,Champions
89119,86,13,20,4,3,2,9,Loyal Users
89564,125,21,125,4,3,4,11,Loyal Users
89600,843,12,44,2,3,3,8,Casual Users
89605,11,8,21,5,2,2,9,Promising
89965,42,71,218,5,5,5,15,Champions
78483,2139,6,27,1,1,2,4,Lost
78586,682,32,102,2,4,4,10,At Risk
78725,1649,14,26,1,3,2,6,Casual Users
78860,1537,13,21,1,3,2,6,Casual Users
78942,118,91,93,4,5,4,13,Champions
79230,105,16,84,4,3,4,11,Loyal Users
79277,568,16,32,2,3,3,8,Casual Users
79704,1059,9,19,2,2,2,6,Lost
79716,2682,5,15,1,1,1,3,Lost
79779,134,31,91,4,4,4,12,Champions
79792,615,47,78,2,5,4,11,At Risk
79933,17,56,156,5,5,5,15,Champions
80108,407,8,45,3,2,3,8,Casual Users
80128,1201,11,21,2,2,2,6,Lost
80276,1731,14,21,1,3,2,6,Casual Users
80377,222,43,303,3,4,5,12,Loyal Users
80389,147,24,64,4,4,4,12,Champions
80931,3641,19,34,1,3,3,7,Casual Users
80973,135,35,57,4,4,3,11,Loyal Users
81120,3165,7,13,1,2,1,4,Lost
81455,1951,5,19,1,1,2,4,Lost
81530,220,7,9,3,2,1,6,Casual Users
82062,9,13,51,5,3,3,11,Loyal Users
82078,19,73,101,5,5,4,14,Champions
82117,210,48,117,3,5,4,12,Loyal Users
82526,69,49,247,5,5,5,15,Champions
82685,1224,13,19,2,3,2,7,Casual Users
82686,1416,10,43,1,2,3,6,Lost
82744,67,38,64,5,4,4,13,Champions
82996,272,10,35,3,2,3,8,Casual Users
83087,85,20,40,4,3,3,10,Loyal Users
83187,477,5,10,2,1,1,4,Lost
83679,9,36,61,5,4,3,12,Loyal Users
83800,811,20,45,2,3,3,8,Casual Users
84224,719,6,21,2,1,2,5,Lost
84400,170,12,25,3,3,2,8,Loyal Users
84522,168,99,129,3,5,4,12,Loyal Users
84906,4435,10,27,1,2,2,5,Lost
85155,823,7,22,2,2,2,6,Lost
85433,2089,11,59,1,2,3,6,Lost
85561,37,77,134,5,5,4,14,Champions
85907,15,9,23,5,2,2,9,Promising
86119,561,11,27,2,2,2,6,Lost
86176,1,138,330,5,5,5,15,Champions
86178,362,8,13,3,2,1,6,Casual Users
86254,1162,8,26,2,2,2,6,Lost
86262,239,5,26,3,1,2,6,Casual Users
86297,1102,8,25,2,2,2,6,Lost
86351,834,5,27,2,1,2,5,Lost
86825,109,25,146,4,4,4,12,Champions
86879,97,34,274,4,4,5,13,Champions
86922,833,5,6,2,1,1,4,Lost
87145,232,43,271,3,4,5,12,Loyal Users
87848,973,14,32,2,3,3,8,Casual Users
88297,422,14,31,3,3,2,8,Loyal Users
88575,2390,8,8,1,2,1,4,Lost
88720,1291,8,19,1,2,2,5,Lost
89414,84,61,174,4,5,5,14,Champions
89499,4,146,469,5,5,5,15,Champions
89633,6,7,10,5,2,1,8,Promising
89861,260,34,49,3,4,3,10,Loyal Users
89876,358,42,83,3,4,4,11,Loyal Users
89968,1107,13,47,2,3,3,8,Casual Users
90194,414,57,86,3,5,4,12,Loyal Users
90196,417,12,51,3,3,3,9,Loyal Users
90614,401,51,166,3,5,5,13,Loyal Users
90631,24,16,27,5,3,2,10,Loyal Users
90819,8,29,55,5,4,3,12,Loyal Users
90903,12,30,40,5,4,3,12,Loyal Users
90914,164,11,83,4,2,4,10,Promising
78325,5,103,301,5,5,5,15,Champions
78529,306,8,12,3,2,1,6,Casual Users
78653,1119,20,61,2,3,3,8,Casual Users
78702,1372,16,98,1,3,4,8,Casual Users
78867,175,7,13,3,2,1,6,Casual Users
79112,2850,13,17,1,3,2,6,Casual Users
79124,216,15,61,3,3,3,9,Loyal Users
79511,1894,5,15,1,1,1,3,Lost
79572,39,44,106,5,4,4,13,Champions
79698,497,14,69,2,3,4,9,Casual Users
79984,8,96,257,5,5,5,15,Champions
80847,30,55,110,5,5,4,14,Champions
80850,572,7,8,2,2,1,5,Lost
80868,140,33,51,4,4,3,11,Loyal Users
80928,363,14,52,3,3,3,9,Loyal Users
81052,91,35,367,4,4,5,13,Champions
81230,15,73,211,5,5,5,15,Champions
81235,278,45,62,3,4,3,10,Loyal Users
81347,220,13,20,3,3,2,8,Loyal Users
81401,130,26,57,4,4,3,11,Loyal Users
81656,274,15,97,3,3,4,10,Loyal Users
81934,39,9,27,5,2,2,9,Promising
82383,2253,7,12,1,2,1,4,Lost
82473,190,33,102,3,4,4,11,Loyal Users
82781,1711,9,39,1,2,3,6,Lost
83000,1299,13,225,1,3,5,9,Casual Users
83166,775,7,8,2,2,1,5,Lost
83503,281,11,59,3,2,3,8,Casual Users
83870,109,40,131,4,4,4,12,Champions
84105,578,6,21,2,1,2,5,Lost
84225,4,24,126,5,4,4,13,Champions
84418,201,23,43,3,4,3,10,Loyal Users
84438,5628,6,8,1,1,1,3,Lost
84481,4825,14,41,1,3,3,7,Casual Users
84648,2857,8,44,1,2,3,6,Lost
84726,765,5,9,2,1,1,4,Lost
84844,659,6,17,2,1,2,5,Lost
84907,2566,5,7,1,1,1,3,Lost
84986,319,11,25,3,2,2,7,Casual Users
85249,70,39,158,4,4,5,13,Champions
85543,1674,7,11,1,2,1,4,Lost
85713,421,25,48,3,4,3,10,Loyal Users
85988,19,133,264,5,5,5,15,Champions
86192,48,6,23,5,1,2,8,Promising
86261,101,59,107,4,5,4,13,Champions
86372,2548,14,23,1,3,2,6,Casual Users
86492,82,29,94,4,4,4,12,Champions
86930,284,29,119,3,4,4,11,Loyal Users
86948,274,5,7,3,1,1,5,Casual Users
87141,1613,27,79,1,4,4,9,At Risk
87275,133,27,67,4,4,4,12,Champions
87324,155,60,85,4,5,4,13,Champions
87350,291,19,110,3,3,4,10,Loyal Users
87399,283,23,42,3,4,3,10,Loyal Users
87733,1087,7,55,2,2,3,7,Lost
87841,103,17,68,4,3,4,11,Loyal Users
87896,445,22,59,3,4,3,10,Loyal Users
88606,326,38,85,3,4,4,11,Loyal Users
88689,3120,12,71,1,3,4,8,Casual Users
88839,1133,6,39,2,1,3,6,Lost
88949,1017,14,26,2,3,2,7,Casual Users
89456,274,18,48,3,3,3,9,Loyal Users
89504,622,21,78,2,3,4,9,Casual Users
89724,2483,15,21,1,3,2,6,Casual Users
89890,1889,8,65,1,2,4,7,Lost
90188,1407,5,6,1,1,1,3,Lost
90287,84,70,135,4,5,4,13,Champions
90303,218,19,57,3,3,3,9,Loyal Users
90643,2609,14,21,1,3,2,6,Casual Users
90741,10,50,184,5,5,5,15,Champions
91044,2250,17,23,1,3,2,6,Casual Users
78475,9,54,235,5,5,5,15,Champions
78839,2121,18,24,1,3,2,6,Casual Users
79143,118,51,126,4,5,4,13,Champions
79181,263,13,25,3,3,2,8,Loyal Users
79326,694,26,60,2,4,3,9,At Risk
79410,1039,9,43,2,2,3,7,Lost
79738,163,56,194,4,5,5,14,Champions
79754,427,11,41,3,2,3,8,Casual Users
81143,1822,10,28,1,2,2,5,Lost
81203,407,5,7,3,1,1,5,Casual Users
81262,1061,42,84,2,4,4,10,At Risk
81427,58,35,129,5,4,4,13,Champions
81724,838,38,92,2,4,4,10,At Risk
82080,98,90,454,4,5,5,14,Champions
82231,70,38,55,4,4,3,11,Loyal Users
82237,33,64,157,5,5,5,15,Champions
82261,606,32,72,2,4,4,10,At Risk
82353,132,37,49,4,4,3,11,Loyal Users
82354,1691,8,19,1,2,2,5,Lost
82559,3364,7,24,1,2,2,5,Lost
82589,139,17,23,4,3,2,9,Loyal Users
82625,4920,6,10,1,1,1,3,Lost
82927,198,25,76,3,4,4,11,Loyal Users
82941,4982,7,15,1,2,1,4,Lost
83248,2,175,525,5,5,5,15,Champions
83277,1276,5,28,1,1,2,4,Lost
83337,285,46,124,3,5,4,12,Loyal Users
83428,104,14,14,4,3,1,8,Loyal Users
83555,116,79,447,4,5,5,14,Champions
83567,422,23,55,3,4,3,10,Loyal Users
83579,463,14,63,3,3,4,10,Loyal Users
83783,103,73,433,4,5,5,14,Champions
84065,273,39,51,3,4,3,10,Loyal Users
84197,32,5,12,5,1,1,7,Promising
84227,282,17,81,3,3,4,10,Loyal Users
84866,420,15,39,3,3,3,9,Loyal Users
85137,870,9,19,2,2,2,6,Lost
85330,26,64,529,5,5,5,15,Champions
85425,130,45,222,4,4,5,13,Champions
86006,2246,18,61,1,3,3,7,Casual Users
86403,163,6,21,4,1,2,7,Promising
86677,138,6,11,4,1,1,6,Promising
86745,139,61,112,4,5,4,13,Champions
86982,91,18,99,4,3,4,11,Loyal Users
87050,718,25,67,2,4,4,10,At Risk
87888,44,18,77,5,3,4,12,Loyal Users
87983,10,81,129,5,5,4,14,Champions
88069,834,9,16,2,2,2,6,Lost
88123,22,83,145,5,5,4,14,Champions
88379,637,11,14,2,2,1,5,Lost
88734,15,20,74,5,3,4,12,Loyal Users
88866,106,99,206,4,5,5,14,Champions
88936,132,12,21,4,3,2,9,Loyal Users
89116,261,13,36,3,3,3,9,Loyal Users
89424,2409,5,5,1,1,1,3,Lost
89630,5764,23,23,1,4,2,7,At Risk
89818,280,8,14,3,2,1,6,Casual Users
89898,416,7,15,3,2,1,6,Casual Users
90271,142,19,60,4,3,3,10,Loyal Users
90345,508,16,29,2,3,2,7,Casual Users
90548,165,13,21,4,3,2,9,Loyal Users
90688,230,13,54,3,3,3,9,Loyal Users
90759,1486,6,6,1,1,1,3,Lost
90904,2856,13,39,1,3,3,7,Casual Users
78472,1281,19,57,1,3,3,7,Casual Users
78522,12,84,142,5,5,4,14,Champions
78524,573,17,147,2,3,5,10,Casual Users
78602,40,43,204,5,4,5,14,Champions
78711,3959,6,28,1,1,2,4,Lost
78778,885,15,23,2,3,2,7,Casual Users
78951,398,7,10,3,2,1,6,Casual Users
78952,13,48,196,5,5,5,15,Champions
79539,109,17,28,4,3,2,9,Loyal Users
79676,3556,5,13,1,1,1,3,Lost
79678,130,38,202,4,4,5,13,Champions
79727,286,70,109,3,5,4,12,Loyal Users
79920,1,78,122,5,5,4,14,Champions
80047,2955,13,77,1,3,4,8,Casual Users
80395,37,82,227,5,5,5,15,Champions
80455,91,20,169,4,3,5,12,Loyal Users
80671,115,60,387,4,5,5,14,Champions
80780,641,12,48,2,3,3,8,Casual Users
80857,321,20,33,3,3,3,9,Loyal Users
80935,128,56,101,4,5,4,13,Champions
80966,130,56,215,4,5,5,14,Champions
81234,0,138,384,5,5,5,15,Champions
81541,504,34,87,2,4,4,10,At Risk
81646,11,12,25,5,3,2,10,Loyal Users
81710,26,6,7,5,1,1,7,Promising
81946,70,23,108,4,4,4,12,Champions
82660,523,16,92,2,3,4,9,Casual Users
82743,630,21,108,2,3,4,9,Casual Users
82806,569,35,42,2,4,3,9,At Risk
82831,141,15,28,4,3,2,9,Loyal Users
84253,98,78,389,4,5,5,14,Champions
84335,22,6,33,5,1,3,9,Promising
84397,2018,9,11,1,2,1,4,Lost
84478,688,40,99,2,4,4,10,At Risk
84482,27,10,73,5,2,4,11,Promising
84543,1448,12,35,1,3,3,7,Casual Users
84639,209,19,27,3,3,2,8,Loyal Users
84848,384,11,21,3,2,2,7,Casual Users
84954,425,32,32,3,4,3,10,Loyal Users
84985,7,60,86,5,5,4,14,Champions
85233,1449,24,32,1,4,3,8,At Risk
85496,51,146,327,5,5,5,15,Champions
85512,29,134,409,5,5,5,15,Champions
85603,1994,9,20,1,2,2,5,Lost
85667,1564,9,16,1,2,2,5,Lost
85737,524,9,18,2,2,2,6,Lost
85741,131,10,51,4,2,3,9,Promising
86238,31,7,12,5,2,1,8,Promising
86250,120,36,95,4,4,4,12,Champions
86514,683,35,127,2,4,4,10,At Risk
86898,108,35,100,4,4,4,12,Champions
86907,110,6,8,4,1,1,6,Promising
87132,412,10,22,3,2,2,7,Casual Users
87269,672,37,186,2,4,5,11,At Risk
87394,221,12,15,3,3,1,7,Loyal Users
87447,273,8,13,3,2,1,6,Casual Users
87516,25,80,110,5,5,4,14,Champions
87682,623,15,19,2,3,2,7,Casual Users
87871,438,20,36,3,3,3,9,Loyal Users
88019,2276,17,47,1,3,3,7,Casual Users
88183,164,59,157,4,5,5,14,Champions
88234,32,30,38,5,4,3,12,Loyal Users
88311,282,61,183,3,5,5,13,Loyal Users
88338,2717,19,33,1,3,3,7,Casual Users
88505,174,74,103,3,5,4,12,Loyal Users
88517,415,22,187,3,4,5,12,Loyal Users
89004,1087,10,62,2,2,3,7,Lost
89105,3306,28,65,1,4,4,9,At Risk
89248,126,14,21,4,3,2,9,Loyal Users
89361,25,75,250,5,5,5,15,Champions
89402,2383,8,36,1,2,3,6,Lost
89479,420,51,128,3,5,4,12,Loyal Users
90118,1277,21,86,1,3,4,8,Casual Users
90145,437,7,7,3,2,1,6,Casual Users
90314,24,99,143,5,5,4,14,Champions
90374,814,5,11,2,1,1,4,Lost
90469,719,29,66,2,4,4,10,At Risk
90471,60,87,174,5,5,5,15,Champions
90613,934,27,87,2,4,4,10,At Risk
78558,706,16,24,2,3,2,7,Casual Users
78874,146,66,197,4,5,5,14,Champions
79098,242,37,197,3,4,5,12,Loyal Users
79481,156,10,22,4,2,2,8,Promising
79694,91,20,38,4,3,3,10,Loyal Users
79742,271,25,41,3,4,3,10,Loyal Users
80392,110,122,414,4,5,5,14,Champions
80427,1948,6,9,1,1,1,3,Lost
80775,1545,5,5,1,1,1,3,Lost
81079,1760,10,23,1,2,2,5,Lost
81117,901,5,7,2,1,1,4,Lost
81295,551,20,82,2,3,4,9,Casual Users
81643,1950,8,18,1,2,2,5,Lost
81941,2,81,124,5,5,4,14,Champions
81956,411,25,185,3,4,5,12,Loyal Users
81987,608,6,13,2,1,1,4,Lost
82700,2628,7,16,1,2,2,5,Lost
82796,1658,9,16,1,2,2,5,Lost
82832,115,63,575,4,5,5,14,Champions
82929,508,6,29,2,1,2,5,Lost
82936,45,142,534,5,5,5,15,Champions
83382,324,8,26,3,2,2,7,Casual Users
83676,542,15,46,2,3,3,8,Casual Users
84760,527,10,31,2,2,2,6,Lost
84922,667,10,17,2,2,2,6,Lost
85461,38,134,318,5,5,5,15,Champions
85567,677,7,9,2,2,1,5,Lost
85849,410,8,13,3,2,1,6,Casual Users
85887,4128,11,16,1,2,2,5,Lost
85939,126,32,37,4,4,3,11,Loyal Users
85942,712,10,10,2,2,1,5,Lost
86201,141,33,45,4,4,3,11,Loyal Users
86320,2419,12,23,1,3,2,6,Casual Users
86341,129,5,19,4,1,2,7,Promising
86509,33,235,668,5,5,5,15,Champions
86953,8,18,65,5,3,4,12,Loyal Users
87679,280,15,132,3,3,4,10,Loyal Users
87718,683,14,20,2,3,2,7,Casual Users
87908,6,81,272,5,5,5,15,Champions
88471,4381,10,16,1,2,2,5,Lost
88616,108,159,331,4,5,5,14,Champions
88629,151,90,360,4,5,5,14,Champions
88705,2471,5,9,1,1,1,3,Lost
88807,554,27,52,2,4,3,9,At Risk
89060,286,48,134,3,5,4,12,Loyal Users
89471,118,61,80,4,5,4,13,Champions
89634,236,27,83,3,4,4,11,Loyal Users
89892,9,67,396,5,5,5,15,Champions
89914,266,12,15,3,3,1,7,Loyal Users
91025,130,62,147,4,5,5,14,Champions
78392,1,32,113,5,4,4,13,Champions
78563,272,12,24,3,3,2,8,Loyal Users
78910,541,14,44,2,3,3,8,Casual Users
79138,1869,5,10,1,1,1,3,Lost
79255,316,17,32,3,3,3,9,Loyal Users
79274,277,126,557,3,5,5,13,Loyal Users
79536,81,129,246,4,5,5,14,Champions
79644,848,19,38,2,3,3,8,Casual Users
79682,124,32,129,4,4,4,12,Champions
79748,270,9,45,3,2,3,8,Casual Users
79874,116,33,115,4,4,4,12,Champions
80113,887,9,18,2,2,2,6,Lost
80281,925,16,40,2,3,3,8,Casual Users
80339,191,54,119,3,5,4,12,Loyal Users
80342,193,13,14,3,3,1,7,Loyal Users
80369,1156,7,26,2,2,2,6,Lost
80500,20,48,54,5,5,3,13,Loyal Users
80767,2624,9,25,1,2,2,5,Lost
80989,239,12,13,3,3,1,7,Loyal Users
81026,247,5,70,3,1,4,8,Casual Users
81063,66,6,11,5,1,1,7,Promising
81272,120,18,64,4,3,4,11,Loyal Users
81354,680,19,35,2,3,3,8,Casual Users
81478,9,82,140,5,5,4,14,Champions
81543,1735,10,23,1,2,2,5,Lost
81739,101,96,630,4,5,5,14,Champions
81864,1,14,40,5,3,3,11,Loyal Users
81865,1706,7,16,1,2,2,5,Lost
81929,16,31,61,5,4,3,12,Loyal Users
81932,3971,6,32,1,1,3,5,Lost
82120,3000,7,21,1,2,2,5,Lost
82125,3255,6,8,1,1,1,3,Lost
82178,374,6,7,3,1,1,5,Casual Users
82293,185,6,7,3,1,1,5,Casual Users
82360,84,23,49,4,4,3,11,Loyal Users
82412,861,12,45,2,3,3,8,Casual Users
82462,87,24,58,4,4,3,11,Loyal Users
82578,16,17,40,5,3,3,11,Loyal Users
82841,1009,39,131,2,4,4,10,At Risk
83274,14,66,505,5,5,5,15,Champions
83523,512,17,33,2,3,3,8,Casual Users
84297,283,18,61,3,3,3,9,Loyal Users
84448,21,5,27,5,1,2,8,Promising
84525,860,10,40,2,2,3,7,Lost
84626,230,10,25,3,2,2,7,Casual Users
84690,205,20,35,3,3,3,9,Loyal Users
84782,69,114,790,5,5,5,15,Champions
85172,139,74,254,4,5,5,14,Champions
85388,1181,7,10,2,2,1,5,Lost
85628,97,96,477,4,5,5,14,Champions
85744,266,6,20,3,1,2,6,Casual Users
85890,44,21,60,5,3,3,11,Loyal Users
85898,866,8,13,2,2,1,5,Lost
85938,661,5,6,2,1,1,4,Lost
86321,2,170,478,5,5,5,15,Champions
86331,479,15,78,2,3,4,9,Casual Users
86788,72,16,158,4,3,5,12,Loyal Users
86848,379,11,40,3,2,3,8,Casual Users
86932,5,7,7,5,2,1,8,Promising
87062,427,24,90,3,4,4,11,Loyal Users
87347,108,31,98,4,4,4,12,Champions
87464,67,15,54,5,3,3,11,Loyal Users
87493,2374,7,11,1,2,1,4,Lost
87659,108,52,115,4,5,4,13,Champions
87746,11,16,22,5,3,2,10,Loyal Users
88052,35,108,397,5,5,5,15,Champions
88309,359,20,43,3,3,3,9,Loyal Users
88566,247,13,27,3,3,2,8,Loyal Users
88937,136,23,57,4,4,3,11,Loyal Users
89158,857,24,90,2,4,4,10,At Risk
89207,648,7,16,2,2,2,6,Lost
89543,47,25,67,5,4,4,13,Champions
89691,419,7,11,3,2,1,6,Casual Users
89752,254,9,17,3,2,2,7,Casual Users
89758,1604,8,19,1,2,2,5,Lost
89896,48,82,330,5,5,5,15,Champions
90138,678,13,13,2,3,1,6,Casual Users
90649,161,112,377,4,5,5,14,Champions
90795,26,43,120,5,4,4,13,Champions
91008,665,16,35,2,3,3,8,Casual Users
91141,51,175,283,5,5,5,15,Champions
91299,588,21,43,2,3,3,8,Casual Users
91367,96,9,72,4,2,4,10,Promising
91446,683,5,9,2,1,1,4,Lost
91784,332,18,156,3,3,5,11,Loyal Users
91785,126,22,38,4,4,3,11,Loyal Users
91937,7,45,394,5,4,5,14,Champions
92080,1578,24,50,1,4,3,8,At Risk
92182,415,5,21,3,1,2,6,Casual Users
92188,401,28,64,3,4,4,11,Loyal Users
92235,209,28,47,3,4,3,10,Loyal Users
92317,232,14,26,3,3,2,8,Loyal Users
92644,58,11,20,5,2,2,9,Promising
92834,144,13,27,4,3,2,9,Loyal Users
92959,122,20,155,4,3,5,12,Loyal Users
93319,30,92,493,5,5,5,15,Champions
93341,421,31,44,3,4,3,10,Loyal Users
93407,1,34,64,5,4,4,13,Champions
93486,84,41,179,4,4,5,13,Champions
93948,16,61,114,5,5,4,14,Champions
94265,41,78,142,5,5,4,14,Champions
94377,92,16,83,4,3,4,11,Loyal Users
94695,23,194,358,5,5,5,15,Champions
94819,983,16,48,2,3,3,8,Casual Users
94851,424,6,25,3,1,2,6,Casual Users
94950,257,27,73,3,4,4,11,Loyal Users
95080,11,207,356,5,5,5,15,Champions
95476,65,32,150,5,4,5,14,Champions
95715,2876,19,55,1,3,3,7,Casual Users
95940,156,41,143,4,4,4,12,Champions
95994,1284,7,15,1,2,1,4,Lost
96044,1795,12,52,1,3,3,7,Casual Users
96224,25,64,108,5,5,4,14,Champions
96261,106,6,11,4,1,1,6,Promising
96393,59,22,25,5,4,2,11,Loyal Users
96469,108,39,59,4,4,3,11,Loyal Users
96488,275,17,26,3,3,2,8,Loyal Users
96853,1449,5,10,1,1,1,3,Lost
97004,1,65,246,5,5,5,15,Champions
97092,13,135,316,5,5,5,15,Champions
97186,1326,6,17,1,1,2,4,Lost
97218,1671,9,11,1,2,1,4,Lost
97413,2549,6,9,1,1,1,3,Lost
97419,266,10,20,3,2,2,7,Casual Users
97564,115,9,9,4,2,1,7,Promising
98143,630,7,37,2,2,3,7,Lost
99168,247,5,10,3,1,1,5,Casual Users
99239,867,5,6,2,1,1,4,Lost
99454,19,33,236,5,4,5,14,Champions
99621,142,15,83,4,3,4,11,Loyal Users
99786,1241,12,26,2,3,2,7,Casual Users
99817,831,61,198,2,5,5,12,At Risk
99861,438,9,57,3,2,3,8,Casual Users
91088,88,116,353,4,5,5,14,Champions
91279,1264,55,76,1,5,4,10,At Risk
91298,604,50,106,2,5,4,11,At Risk
91412,242,7,12,3,2,1,6,Casual Users
91690,123,7,60,4,2,3,9,Promising
92008,6,5,5,5,1,1,7,Promising
92858,6,126,415,5,5,5,15,Champions
93037,1977,9,16,1,2,2,5,Lost
93131,723,10,10,2,2,1,5,Lost
93285,99,84,139,4,5,4,13,Champions
93291,1000,21,84,2,3,4,9,Casual Users
93630,26,45,89,5,4,4,13,Champions
93633,414,17,20,3,3,2,8,Loyal Users
93643,1,76,207,5,5,5,15,Champions
93691,412,12,41,3,3,3,9,Loyal Users
94621,22,115,544,5,5,5,15,Champions
95151,662,7,16,2,2,2,6,Lost
96290,629,15,32,2,3,3,8,Casual Users
96415,530,12,64,2,3,4,9,Casual Users
96441,2551,5,5,1,1,1,3,Lost
96555,133,24,58,4,4,3,11,Loyal Users
96565,396,5,8,3,1,1,5,Casual Users
96933,30,10,22,5,2,2,9,Promising
97143,14,23,43,5,4,3,12,Loyal Users
97705,3913,14,22,1,3,2,6,Casual Users
97749,53,90,172,5,5,5,15,Champions
97872,115,23,86,4,4,4,12,Champions
98064,10,50,78,5,5,4,14,Champions
98271,46,9,10,5,2,1,8,Promising
98464,254,44,118,3,4,4,11,Loyal Users
99899,702,14,19,2,3,2,7,Casual Users
99996,60,17,48,5,3,3,11,Loyal Users
91084,68,32,141,5,4,4,13,Champions
91473,127,38,161,4,4,5,13,Champions
91516,583,11,12,2,2,1,5,Lost
92191,4373,12,12,1,3,1,5,Casual Users
92285,495,16,48,2,3,3,8,Casual Users
92895,1282,19,23,1,3,2,6,Casual Users
92984,128,37,98,4,4,4,12,Champions
93112,355,11,47,3,2,3,8,Casual Users
93145,12,149,214,5,5,5,15,Champions
93240,679,10,17,2,2,2,6,Lost
93431,77,76,151,4,5,5,14,Champions
93432,401,13,21,3,3,2,8,Loyal Users
93487,139,64,220,4,5,5,14,Champions
93645,453,118,366,3,5,5,13,Loyal Users
93806,1432,16,99,1,3,4,8,Casual Users
93905,93,9,12,4,2,1,7,Promising
94025,48,99,448,5,5,5,15,Champions
94274,131,5,42,4,1,3,8,Promising
94283,232,12,22,3,3,2,8,Loyal Users
94284,91,35,85,4,4,4,12,Champions
94642,522,11,104,2,2,4,8,Lost
94792,933,15,31,2,3,2,7,Casual Users
95156,24,82,169,5,5,5,15,Champions
95268,2536,20,84,1,3,4,8,Casual Users
95398,1001,8,23,2,2,2,6,Lost
95421,27,124,464,5,5,5,15,Champions
95701,51,5,41,5,1,3,9,Promising
95707,122,80,255,4,5,5,14,Champions
96382,20,78,265,5,5,5,15,Champions
96554,191,47,69,3,5,4,12,Loyal Users
96706,1560,6,25,1,1,2,4,Lost
96840,92,15,18,4,3,2,9,Loyal Users
96978,1148,47,121,2,5,4,11,At Risk
97094,259,43,76,3,4,4,11,Loyal Users
97109,990,8,11,2,2,1,5,Lost
97128,47,151,272,5,5,5,15,Champions
97180,23,137,207,5,5,5,15,Champions
97318,2808,5,7,1,1,1,3,Lost
97385,972,10,18,2,2,2,6,Lost
97435,1825,6,14,1,1,1,3,Lost
97682,145,10,20,4,2,2,8,Promising
97804,257,78,218,3,5,5,13,Loyal Users
98046,26,17,71,5,3,4,12,Loyal Users
98184,107,45,107,4,4,4,12,Champions
98290,526,6,9,2,1,1,4,Lost
98376,211,117,334,3,5,5,13,Loyal Users
98521,1299,15,21,1,3,2,6,Casual Users
98654,1600,36,60,1,4,3,8,At Risk
98766,23,37,58,5,4,3,12,Loyal Users
99130,145,45,117,4,4,4,12,Champions
99630,77,86,333,4,5,5,14,Champions
91200,1473,8,12,1,2,1,4,Lost
91653,735,6,13,2,1,1,4,Lost
91678,243,43,151,3,4,5,12,Loyal Users
91755,30,20,63,5,3,4,12,Loyal Users
91919,1763,10,68,1,2,4,7,Lost
91934,215,7,13,3,2,1,6,Casual Users
91973,2143,28,52,1,4,3,8,At Risk
91990,76,14,38,4,3,3,10,Loyal Users
92350,237,27,66,3,4,4,11,Loyal Users
92406,806,16,42,2,3,3,8,Casual Users
93477,9,12,66,5,3,4,12,Loyal Users
93891,423,25,109,3,4,4,11,Loyal Users
94722,195,9,21,3,2,2,7,Casual Users
94723,41,36,83,5,4,4,13,Champions
94726,302,18,19,3,3,2,8,Loyal Users
94767,5,166,593,5,5,5,15,Champions
94788,2132,6,8,1,1,1,3,Lost
94967,27,26,42,5,4,3,12,Loyal Users
95040,334,36,138,3,4,4,11,Loyal Users
95650,425,50,110,3,5,4,12,Loyal Users
95789,15,79,158,5,5,5,15,Champions
95896,660,16,38,2,3,3,8,Casual Users
96813,40,11,60,5,2,3,10,Promising
96873,75,47,100,4,5,4,13,Champions
96976,245,8,21,3,2,2,7,Casual Users
97181,105,16,20,4,3,2,9,Loyal Users
97579,116,56,155,4,5,5,14,Champions
97796,45,27,243,5,4,5,14,Champions
97828,2129,10,69,1,2,4,7,Lost
97980,461,19,37,3,3,3,9,Loyal Users
98002,860,21,142,2,3,4,9,Casual Users
98306,49,23,67,5,4,4,13,Champions
98390,261,32,76,3,4,4,11,Loyal Users
98398,912,7,13,2,2,1,5,Lost
99557,292,17,45,3,3,3,9,Loyal Users
91070,108,30,138,4,4,4,12,Champions
91170,422,15,50,3,3,3,9,Loyal Users
91432,111,19,26,4,3,2,9,Loyal Users
91497,2410,9,12,1,2,1,4,Lost
91868,246,16,195,3,3,5,11,Loyal Users
92353,380,11,15,3,2,1,6,Casual Users
92428,817,28,51,2,4,3,9,At Risk
92511,17,11,18,5,2,2,9,Promising
92748,1,90,161,5,5,5,15,Champions
93556,554,6,6,2,1,1,4,Lost
93951,679,5,6,2,1,1,4,Lost
94109,33,17,59,5,3,3,11,Loyal Users
94202,116,7,10,4,2,1,7,Promising
94768,3329,5,16,1,1,2,4,Lost
94846,27,94,161,5,5,5,15,Champions
94918,65,26,52,5,4,3,12,Loyal Users
95334,2136,52,137,1,5,4,10,At Risk
95453,24,151,211,5,5,5,15,Champions
95526,522,7,11,2,2,1,5,Lost
95586,3,64,222,5,5,5,15,Champions
95934,539,18,166,2,3,5,10,Casual Users
95943,15,132,719,5,5,5,15,Champions
96098,3691,39,114,1,4,4,9,At Risk
96158,624,6,9,2,1,1,4,Lost
96199,3697,6,18,1,1,2,4,Lost
96369,1092,6,14,2,1,1,4,Lost
96704,1376,6,11,1,1,1,3,Lost
96972,15,49,206,5,5,5,15,Champions
97016,811,8,21,2,2,2,6,Lost
97346,2466,16,39,1,3,3,7,Casual Users
97509,108,38,68,4,4,4,12,Champions
98155,110,126,276,4,5,5,14,Champions
98396,6,27,73,5,4,4,13,Champions
98922,299,60,172,3,5,5,13,Loyal Users
99152,429,5,8,3,1,1,5,Casual Users
99799,101,10,89,4,2,4,10,Promising
91502,1253,16,16,2,3,2,7,Casual Users
91652,4,101,361,5,5,5,15,Champions
91889,19,19,203,5,3,5,13,Loyal Users
92427,87,45,61,4,4,3,11,Loyal Users
92611,453,6,36,3,1,3,7,Casual Users
92618,3513,5,16,1,1,2,4,Lost
92828,36,75,374,5,5,5,15,Champions
92831,6,44,102,5,4,4,13,Champions
92852,729,10,21,2,2,2,6,Lost
92855,66,15,53,5,3,3,11,Loyal Users
93596,38,58,83,5,5,4,14,Champions
93818,146,56,190,4,5,5,14,Champions
94078,2154,5,5,1,1,1,3,Lost
94348,2280,10,21,1,2,2,5,Lost
94369,69,169,686,5,5,5,15,Champions
94402,510,27,80,2,4,4,10,At Risk
94696,679,11,24,2,2,2,6,Lost
94714,669,11,16,2,2,2,6,Lost
94820,1452,7,15,1,2,1,4,Lost
94857,483,10,70,2,2,4,8,Lost
95515,2654,5,5,1,1,1,3,Lost
95751,414,11,20,3,2,2,7,Casual Users
96111,123,15,36,4,3,3,10,Loyal Users
96212,23,100,280,5,5,5,15,Champions
96801,971,11,31,2,2,2,6,Lost
96893,1410,18,32,1,3,3,7,Casual Users
97044,1822,7,18,1,2,2,5,Lost
97249,1715,12,21,1,3,2,6,Casual Users
97305,894,23,82,2,4,4,10,At Risk
97354,1092,6,7,2,1,1,4,Lost
97358,30,52,206,5,5,5,15,Champions
97573,1366,9,9,1,2,1,4,Lost
97832,4674,5,5,1,1,1,3,Lost
98147,795,31,73,2,4,4,10,At Risk
98833,5513,21,73,1,3,4,8,Casual Users
99028,86,189,465,4,5,5,14,Champions
99222,262,12,23,3,3,2,8,Loyal Users
99616,251,66,130,3,5,4,12,Loyal Users
99625,558,10,19,2,2,2,6,Lost
91319,3641,5,12,1,1,1,3,Lost
91704,38,55,155,5,5,5,15,Champions
91884,577,31,59,2,4,3,9,At Risk
92043,1705,5,32,1,1,3,5,Lost
92063,1233,6,7,2,1,1,4,Lost
92098,1980,5,12,1,1,1,3,Lost
92176,280,58,75,3,5,4,12,Loyal Users
92402,43,55,114,5,5,4,14,Champions
92675,157,74,154,4,5,5,14,Champions
92740,643,11,65,2,2,4,8,Lost
92956,1240,8,17,2,2,2,6,Lost
93020,330,18,150,3,3,5,11,Loyal Users
93206,1857,8,19,1,2,2,5,Lost
93344,796,7,8,2,2,1,5,Lost
93391,254,29,97,3,4,4,11,Loyal Users
93925,84,70,123,4,5,4,13,Champions
93970,2373,9,35,1,2,3,6,Lost
94243,79,14,139,4,3,4,11,Loyal Users
94367,40,47,92,5,5,4,14,Champions
94729,409,12,39,3,3,3,9,Loyal Users
94910,565,14,23,2,3,2,7,Casual Users
95738,132,27,62,4,4,3,11,Loyal Users
95871,122,101,398,4,5,5,14,Champions
96050,20,49,123,5,5,4,14,Champions
96076,1053,19,35,2,3,3,8,Casual Users
96094,824,7,37,2,2,3,7,Lost
96841,448,11,50,3,2,3,8,Casual Users
97167,3132,11,28,1,2,2,5,Lost
97448,241,22,36,3,4,3,10,Loyal Users
97742,447,8,13,3,2,1,6,Casual Users
97879,1839,56,417,1,5,5,11,At Risk
97956,450,6,14,3,1,1,5,Casual Users
98096,444,22,97,3,4,4,11,Loyal Users
98146,1607,20,135,1,3,4,8,Casual Users
98198,27,82,258,5,5,5,15,Champions
98541,40,32,46,5,4,3,12,Loyal Users
98771,122,57,122,4,5,4,13,Champions
98896,127,90,204,4,5,5,14,Champions
99034,300,13,80,3,3,4,10,Loyal Users
99072,296,33,84,3,4,4,11,Loyal Users
99547,1261,18,37,1,3,3,7,Casual Users
99624,1927,6,8,1,1,1,3,Lost
99784,1413,8,29,1,2,2,5,Lost
91188,14,13,39,5,3,3,11,Loyal Users
91328,0,8,13,5,2,1,8,Promising
91389,347,5,10,3,1,1,5,Casual Users
91403,1371,5,6,1,1,1,3,Lost
91798,3492,8,37,1,2,3,6,Lost
92112,520,15,32,2,3,3,8,Casual Users
92228,1118,9,29,2,2,2,6,Lost
92710,125,116,650,4,5,5,14,Champions
92752,18,41,211,5,4,5,14,Champions
93065,86,28,46,4,4,3,11,Loyal Users
93203,3,28,142,5,4,4,13,Champions
93256,447,9,75,3,2,4,9,Casual Users
93409,2508,11,23,1,2,2,5,Lost
93513,877,5,13,2,1,1,4,Lost
93978,226,31,51,3,4,3,10,Loyal Users
94240,320,55,86,3,5,4,12,Loyal Users
94296,583,11,69,2,2,4,8,Lost
94306,24,85,172,5,5,5,15,Champions
94576,603,17,44,2,3,3,8,Casual Users
94643,1563,17,27,1,3,2,6,Casual Users
94901,1677,5,7,1,1,1,3,Lost
95720,90,38,77,4,4,4,12,Champions
95937,74,83,181,4,5,5,14,Champions
95970,3022,24,80,1,4,4,9,At Risk
96087,111,80,418,4,5,5,14,Champions
96201,1227,6,46,2,1,3,6,Lost
96285,155,23,153,4,4,5,13,Champions
96419,178,21,34,3,3,3,9,Loyal Users
96427,487,41,112,2,4,4,10,At Risk
96620,100,81,321,4,5,5,14,Champions
96954,332,9,21,3,2,2,7,Casual Users
97127,1997,6,32,1,1,3,5,Lost
97340,284,30,79,3,4,4,11,Loyal Users
97503,307,19,29,3,3,2,8,Loyal Users
97789,1714,14,27,1,3,2,6,Casual Users
97992,1475,5,9,1,1,1,3,Lost
98097,27,74,370,5,5,5,15,Champions
98426,110,40,118,4,4,4,12,Champions
98489,967,7,22,2,2,2,6,Lost
98826,428,6,7,3,1,1,5,Casual Users
99158,1392,12,16,1,3,2,6,Casual Users
99538,129,96,455,4,5,5,14,Champions
99546,1,11,30,5,2,2,9,Promising
99797,563,18,79,2,3,4,9,Casual Users
99983,7,19,26,5,3,2,10,Loyal Users
91113,128,80,264,4,5,5,14,Champions
91220,26,12,61,5,3,3,11,Loyal Users
91281,5,44,102,5,4,4,13,Champions
91294,127,10,34,4,2,3,9,Promising
91591,104,54,179,4,5,5,14,Champions
91789,1335,5,44,1,1,3,5,Lost
92248,870,19,72,2,3,4,9,Casual Users
92295,2397,5,9,1,1,1,3,Lost
92308,131,19,28,4,3,2,9,Loyal Users
92503,3388,7,18,1,2,2,5,Lost
92717,393,22,64,3,4,4,11,Loyal Users
93100,1802,6,25,1,1,2,4,Lost
93640,2,129,429,5,5,5,15,Champions
93967,161,29,78,4,4,4,12,Champions
94138,601,37,118,2,4,4,10,At Risk
94199,314,7,10,3,2,1,6,Casual Users
94257,236,23,114,3,4,4,11,Loyal Users
94491,10,115,380,5,5,5,15,Champions
95072,46,68,137,5,5,4,14,Champions
95516,111,43,119,4,4,4,12,Champions
95809,50,35,241,5,4,5,14,Champions
96496,480,11,12,2,2,1,5,Lost
96770,144,5,13,4,1,1,6,Promising
96918,1015,114,433,2,5,5,12,At Risk
97191,151,54,115,4,5,4,13,Champions
97357,437,49,168,3,5,5,13,Loyal Users
97417,3444,19,28,1,3,2,6,Casual Users
97558,10,23,56,5,4,3,12,Loyal Users
97686,82,54,125,4,5,4,13,Champions
97915,8,47,295,5,5,5,15,Champions
98122,11,9,40,5,2,3,10,Promising
98384,82,10,18,4,2,2,8,Promising
98965,2135,12,28,1,3,2,6,Casual Users
98997,151,24,74,4,4,4,12,Champions
99261,457,10,19,3,2,2,7,Casual Users
99721,584,23,77,2,4,4,10,At Risk
91153,13,82,253,5,5,5,15,Champions
91187,49,197,405,5,5,5,15,Champions
91449,1106,6,17,2,1,2,5,Lost
91782,64,40,193,5,4,5,14,Champions
91926,2750,7,22,1,2,2,5,Lost
91941,25,70,714,5,5,5,15,Champions
91954,104,9,14,4,2,1,7,Promising
92164,49,44,119,5,4,4,13,Champions
92553,843,19,35,2,3,3,8,Casual Users
92657,1576,61,172,1,5,5,11,At Risk
92699,168,24,37,3,4,3,10,Loyal Users
92794,997,8,9,2,2,1,5,Lost
92850,169,5,5,3,1,1,5,Casual Users
92953,311,8,55,3,2,3,8,Casual Users
92990,142,16,59,4,3,3,10,Loyal Users
93343,92,28,56,4,4,3,11,Loyal Users
93471,410,9,74,3,2,4,9,Casual Users
93639,28,5,40,5,1,3,9,Promising
93743,110,165,577,4,5,5,14,Champions
93810,7,162,529,5,5,5,15,Champions
93886,1261,10,18,1,2,2,5,Lost
94211,440,6,33,3,1,3,7,Casual Users
94248,1529,18,38,1,3,3,7,Casual Users
94268,301,5,7,3,1,1,5,Casual Users
94575,1,238,494,5,5,5,15,Champions
94856,741,13,18,2,3,2,7,Casual Users
94927,1271,5,53,1,1,3,5,Lost
95118,79,16,33,4,3,3,10,Loyal Users
95561,132,70,185,4,5,5,14,Champions
95634,65,36,247,5,4,5,14,Champions
95695,117,41,82,4,4,4,12,Champions
95991,1,73,430,5,5,5,15,Champions
96092,5,55,139,5,5,4,14,Champions
96839,526,13,37,2,3,3,8,Casual Users
96843,4,40,136,5,4,4,13,Champions
97017,1964,11,34,1,2,3,6,Lost
97101,237,20,48,3,3,3,9,Loyal Users
97238,538,19,45,2,3,3,8,Casual Users
97665,506,14,18,2,3,2,7,Casual Users
97685,2572,8,12,1,2,1,4,Lost
97706,251,7,11,3,2,1,6,Casual Users
97834,444,50,103,3,5,4,12,Loyal Users
98578,3191,6,11,1,1,1,3,Lost
98601,25,27,48,5,4,3,12,Loyal Users
98624,144,54,111,4,5,4,13,Champions
98927,62,28,96,5,4,4,13,Champions
99343,17,13,72,5,3,4,12,Loyal Users
99383,706,8,28,2,2,2,6,Lost
99563,106,168,562,4,5,5,14,Champions
99574,1279,31,92,1,4,4,9,At Risk
99873,40,75,141,5,5,4,14,Champions
91078,17,39,55,5,4,3,12,Loyal Users
91474,715,10,18,2,2,2,6,Lost
91686,1373,9,17,1,2,2,5,Lost
92057,291,42,113,3,4,4,11,Loyal Users
92162,431,15,38,3,3,3,9,Loyal Users
92209,3539,5,19,1,1,2,4,Lost
92485,169,75,367,3,5,5,13,Loyal Users
93018,161,27,58,4,4,3,11,Loyal Users
93466,17,67,200,5,5,5,15,Champions
93975,273,10,13,3,2,1,6,Casual Users
93999,2,23,37,5,4,3,12,Loyal Users
94488,155,21,37,4,3,3,10,Loyal Users
95472,670,25,34,2,4,3,9,At Risk
95493,962,28,81,2,4,4,10,At Risk
95739,206,16,30,3,3,2,8,Loyal Users
95754,95,8,9,4,2,1,7,Promising
95768,813,6,12,2,1,1,4,Lost
95771,73,9,28,4,2,2,8,Promising
95841,284,19,51,3,3,3,9,Loyal Users
96156,35,131,386,5,5,5,15,Champions
96266,744,10,69,2,2,4,8,Lost
96519,973,9,37,2,2,3,7,Lost
96583,397,12,15,3,3,1,7,Loyal Users
96625,78,15,19,4,3,2,9,Loyal Users
96676,4095,8,78,1,2,4,7,Lost
96879,116,8,15,4,2,1,7,Promising
96952,605,22,31,2,4,2,8,At Risk
97135,642,16,89,2,3,4,9,Casual Users
97587,0,52,101,5,5,4,14,Champions
98482,2520,36,173,1,4,5,10,At Risk
98524,10,159,427,5,5,5,15,Champions
98611,153,15,57,4,3,3,10,Loyal Users
98736,10,54,232,5,5,5,15,Champions
98738,1978,11,23,1,2,2,5,Lost
99402,8,17,31,5,3,2,10,Loyal Users
99519,72,5,16,4,1,2,7,Promising
99750,3657,5,24,1,1,2,4,Lost
99762,405,25,61,3,4,3,10,Loyal Users
91081,72,123,745,4,5,5,14,Champions
91452,140,14,40,4,3,3,10,Loyal Users
91602,497,34,127,2,4,4,10,At Risk
91995,1005,18,44,2,3,3,8,Casual Users
92038,22,65,144,5,5,4,14,Champions
92066,276,24,48,3,4,3,10,Loyal Users
92371,834,37,81,2,4,4,10,At Risk
92396,113,11,52,4,2,3,9,Promising
93041,4,116,242,5,5,5,15,Champions
94255,370,16,19,3,3,2,8,Loyal Users
94864,282,19,30,3,3,2,8,Loyal Users
95466,831,13,20,2,3,2,7,Casual Users
95467,293,16,50,3,3,3,9,Loyal Users
95810,3278,19,134,1,3,4,8,Casual Users
95874,325,32,53,3,4,3,10,Loyal Users
96322,974,8,9,2,2,1,5,Lost
96596,4469,5,7,1,1,1,3,Lost
96731,283,20,33,3,3,3,9,Loyal Users
97036,670,20,54,2,3,3,8,Casual Users
97178,8,11,72,5,2,4,11,Promising
98346,506,12,16,2,3,2,7,Casual Users
98425,636,91,148,2,5,5,12,At Risk
98479,4271,8,17,1,2,2,5,Lost
99952,117,7,28,4,2,2,8,Promising
91127,255,6,6,3,1,1,5,Casual Users
91181,99,98,451,4,5,5,14,Champions
91274,55,16,134,5,3,4,12,Loyal Users
91311,2,217,501,5,5,5,15,Champions
91443,74,37,139,4,4,4,12,Champions
92083,495,17,58,2,3,3,8,Casual Users
92232,91,9,59,4,2,3,9,Promising
92362,383,26,57,3,4,3,10,Loyal Users
92764,129,5,5,4,1,1,6,Promising
92796,1714,12,15,1,3,1,5,Casual Users
93120,2594,6,20,1,1,2,4,Lost
93168,301,15,23,3,3,2,8,Loyal Users
93193,105,10,11,4,2,1,7,Promising
93315,12,112,198,5,5,5,15,Champions
93411,0,65,154,5,5,5,15,Champions
93762,2646,5,6,1,1,1,3,Lost
93778,268,33,86,3,4,4,11,Loyal Users
93899,823,10,103,2,2,4,8,Lost
94022,283,8,17,3,2,2,7,Casual Users
94144,570,10,23,2,2,2,6,Lost
95142,417,24,39,3,4,3,10,Loyal Users
95254,75,11,40,4,2,3,9,Promising
95435,285,11,28,3,2,2,7,Casual Users
95612,74,116,434,4,5,5,14,Champions
96223,26,39,103,5,4,4,13,Champions
96277,836,5,25,2,1,2,5,Lost
96533,957,5,7,2,1,1,4,Lost
97105,3252,27,69,1,4,4,9,At Risk
97555,189,28,52,3,4,3,10,Loyal Users
97567,40,25,40,5,4,3,12,Loyal Users
97622,252,57,100,3,5,4,12,Loyal Users
97853,1704,5,7,1,1,1,3,Lost
97895,132,39,51,4,4,3,11,Loyal Users
98009,40,41,64,5,4,4,13,Champions
98169,12,33,49,5,4,3,12,Loyal Users
98222,9,12,31,5,3,2,10,Loyal Users
98419,402,21,25,3,3,2,8,Loyal Users
98571,3,32,72,5,4,4,13,Champions
99046,5,6,53,5,1,3,9,Promising
99958,224,99,215,3,5,5,13,Loyal Users
91107,520,50,205,2,5,5,12,At Risk
91398,115,15,80,4,3,4,11,Loyal Users
91667,864,78,429,2,5,5,12,At Risk
92230,269,10,11,3,2,1,6,Casual Users
92341,266,66,88,3,5,4,12,Loyal Users
92731,3571,8,20,1,2,2,5,Lost
92966,1280,24,155,1,4,5,10,At Risk
93568,215,59,286,3,5,5,13,Loyal Users
93663,312,71,94,3,5,4,12,Loyal Users
93950,2491,9,29,1,2,2,5,Lost
94099,575,14,29,2,3,2,7,Casual Users
94115,239,12,12,3,3,1,7,Loyal Users
94706,209,12,34,3,3,3,9,Loyal Users
94952,145,5,12,4,1,1,6,Promising
94961,6,103,594,5,5,5,15,Champions
95202,461,32,146,3,4,4,11,Loyal Users
95433,251,13,133,3,3,4,10,Loyal Users
95454,4648,7,20,1,2,2,5,Lost
95457,130,190,242,4,5,5,14,Champions
96114,1097,48,77,2,5,4,11,At Risk
96134,948,10,22,2,2,2,6,Lost
96226,1324,27,179,1,4,5,10,At Risk
96392,51,18,28,5,3,2,10,Loyal Users
96434,4813,10,14,1,2,1,4,Lost
96711,31,139,308,5,5,5,15,Champions
96870,1813,9,16,1,2,2,5,Lost
97023,416,49,58,3,5,3,11,Loyal Users
97456,2434,6,19,1,1,2,4,Lost
98089,83,7,10,4,2,1,7,Promising
98559,2137,7,11,1,2,1,4,Lost
98616,136,39,99,4,4,4,12,Champions
98706,2284,33,72,1,4,4,9,At Risk
98718,61,61,235,5,5,5,15,Champions
98759,111,20,80,4,3,4,11,Loyal Users
99010,163,18,24,4,3,2,9,Loyal Users
99430,24,100,652,5,5,5,15,Champions
99672,111,5,30,4,1,2,7,Promising
99738,40,39,89,5,4,4,13,Champions
99793,101,20,46,4,3,3,10,Loyal Users
91215,150,33,70,4,4,4,12,Champions
91468,3590,11,12,1,2,1,4,Lost
91885,954,7,21,2,2,2,6,Lost
92447,527,29,50,2,4,3,9,At Risk
92603,277,17,147,3,3,5,11,Loyal Users
92759,97,55,191,4,5,5,14,Champions
92780,223,16,33,3,3,3,9,Loyal Users
92802,55,127,630,5,5,5,15,Champions
92919,408,36,79,3,4,4,11,Loyal Users
93361,3,41,166,5,4,5,14,Champions
93389,7,30,76,5,4,4,13,Champions
93648,91,73,199,4,5,5,14,Champions
93816,101,36,251,4,4,5,13,Champions
94028,2417,6,10,1,1,1,3,Lost
94083,465,40,59,3,4,3,10,Loyal Users
94234,176,54,217,3,5,5,13,Loyal Users
94539,10,95,173,5,5,5,15,Champions
95039,388,15,24,3,3,2,8,Loyal Users
95313,504,45,361,2,4,5,11,At Risk
95748,201,48,159,3,5,5,13,Loyal Users
96272,447,6,9,3,1,1,5,Casual Users
96334,841,15,34,2,3,3,8,Casual Users
96524,237,7,25,3,2,2,7,Casual Users
96945,22,52,89,5,5,4,14,Champions
97323,3857,6,12,1,1,1,3,Lost
97534,11,64,87,5,5,4,14,Champions
97541,143,47,122,4,5,4,13,Champions
97744,5384,6,18,1,1,2,4,Lost
97858,4499,8,8,1,2,1,4,Lost
98085,30,69,260,5,5,5,15,Champions
98094,3558,10,26,1,2,2,5,Lost
98432,1594,21,21,1,3,2,6,Casual Users
99216,2274,9,10,1,2,1,4,Lost
99500,3464,5,5,1,1,1,3,Lost
91271,335,15,52,3,3,3,9,Loyal Users
91314,454,8,11,3,2,1,6,Casual Users
91348,1118,13,55,2,3,3,8,Casual Users
91379,1588,6,6,1,1,1,3,Lost
91545,37,51,135,5,5,4,14,Champions
91643,840,12,15,2,3,1,6,Casual Users
91819,14,53,163,5,5,5,15,Champions
91963,2,28,47,5,4,3,12,Loyal Users
92315,4860,6,14,1,1,1,3,Lost
92548,132,11,11,4,2,1,7,Promising
92637,116,24,77,4,4,4,12,Champions
92879,2717,6,8,1,1,1,3,Lost
93090,13,18,69,5,3,4,12,Loyal Users
93308,938,8,43,2,2,3,7,Lost
93543,16,16,35,5,3,3,11,Loyal Users
93553,307,8,18,3,2,2,7,Casual Users
93570,29,32,54,5,4,3,12,Loyal Users
94128,162,47,280,4,5,5,14,Champions
94159,113,50,188,4,5,5,14,Champions
94292,17,63,101,5,5,4,14,Champions
94388,1187,72,190,2,5,5,12,At Risk
94408,78,138,175,4,5,5,14,Champions
94455,120,24,59,4,4,3,11,Loyal Users
94481,423,12,16,3,3,2,8,Loyal Users
94571,285,14,130,3,3,4,10,Loyal Users
94626,68,127,258,5,5,5,15,Champions
94801,1168,5,6,2,1,1,4,Lost
94976,796,9,52,2,2,3,7,Lost
95069,292,12,28,3,3,2,8,Loyal Users
95788,1440,12,42,1,3,3,7,Casual Users
96001,44,36,106,5,4,4,13,Champions
96016,2240,16,80,1,3,4,8,Casual Users
96138,5,27,39,5,4,3,12,Loyal Users
96142,2,24,49,5,4,3,12,Loyal Users
96420,87,32,47,4,4,3,11,Loyal Users
96926,80,86,291,4,5,5,14,Champions
96937,10,63,167,5,5,5,15,Champions
96999,245,62,120,3,5,4,12,Loyal Users
97039,2558,5,9,1,1,1,3,Lost
97043,144,9,32,4,2,3,9,Promising
97620,420,12,17,3,3,2,8,Loyal Users
98006,66,12,28,5,3,2,10,Loyal Users
98077,5,102,351,5,5,5,15,Champions
98304,1520,10,33,1,2,3,6,Lost
98458,2,11,23,5,2,2,9,Promising
98573,127,85,136,4,5,4,13,Champions
98901,3564,5,6,1,1,1,3,Lost
99388,425,8,28,3,2,2,7,Casual Users
99642,1434,8,8,1,2,1,4,Lost
99684,105,22,37,4,4,3,11,Loyal Users
99685,115,75,157,4,5,5,14,Champions
99725,27,54,85,5,5,4,14,Champions
99834,262,35,61,3,4,3,10,Loyal Users
91116,14,7,9,5,2,1,8,Promising
91177,832,10,27,2,2,2,6,Lost
91638,425,8,10,3,2,1,6,Casual Users
91833,412,11,15,3,2,1,6,Casual Users
91921,4,10,40,5,2,3,10,Promising
91922,136,76,403,4,5,5,14,Champions
92374,3239,5,5,1,1,1,3,Lost
92429,21,198,668,5,5,5,15,Champions
92658,146,8,13,4,2,1,7,Promising
93702,235,11,22,3,2,2,7,Casual Users
93775,271,25,272,3,4,5,12,Loyal Users
93893,694,9,40,2,2,3,7,Lost
93921,305,53,98,3,5,4,12,Loyal Users
94156,16,22,38,5,4,3,12,Loyal Users
94278,98,105,137,4,5,4,13,Champions
94724,8,41,154,5,4,5,14,Champions
94756,6,89,481,5,5,5,15,Champions
94839,112,17,50,4,3,3,10,Loyal Users
94986,2410,7,37,1,2,3,6,Lost
95022,195,45,109,3,4,4,11,Loyal Users
95122,34,58,168,5,5,5,15,Champions
95284,129,10,18,4,2,2,8,Promising
95302,25,112,260,5,5,5,15,Champions
95755,411,39,73,3,4,4,11,Loyal Users
95853,297,7,42,3,2,3,8,Casual Users
95889,855,7,9,2,2,1,5,Lost
96339,1822,25,102,1,4,4,9,At Risk
96763,263,46,93,3,5,4,12,Loyal Users
96869,337,54,99,3,5,4,12,Loyal Users
96947,429,22,36,3,4,3,10,Loyal Users
97098,130,17,35,4,3,3,10,Loyal Users
97296,1012,12,30,2,3,2,7,Casual Users
97299,335,5,6,3,1,1,5,Casual Users
97319,1580,11,20,1,2,2,5,Lost
97360,2869,6,13,1,1,1,3,Lost
97810,3117,5,6,1,1,1,3,Lost
98001,160,5,6,4,1,1,6,Promising
98035,603,6,23,2,1,2,5,Lost
98210,1254,11,11,2,2,1,5,Lost
98360,423,22,45,3,4,3,10,Loyal Users
98437,127,145,317,4,5,5,14,Champions
98439,1557,19,33,1,3,3,7,Casual Users
98781,35,62,312,5,5,5,15,Champions
98996,148,74,446,4,5,5,14,Champions
99094,17,17,20,5,3,2,10,Loyal Users
99279,2670,5,14,1,1,1,3,Lost
99306,145,5,7,4,1,1,6,Promising
99325,113,16,39,4,3,3,10,Loyal Users
99796,272,29,79,3,4,4,11,Loyal Users
91105,154,28,65,4,4,4,12,Champions
91136,454,6,6,3,1,1,5,Casual Users
91410,58,114,357,5,5,5,15,Champions
91687,63,5,10,5,1,1,7,Promising
91700,4,93,158,5,5,5,15,Champions
91772,72,42,99,4,4,4,12,Champions
92234,122,11,29,4,2,2,8,Promising
92307,129,6,24,4,1,2,7,Promising
92947,468,19,81,3,3,4,10,Loyal Users
92961,94,12,13,4,3,1,8,Loyal Users
93102,84,18,104,4,3,4,11,Loyal Users
93154,6,95,312,5,5,5,15,Champions
93187,408,22,42,3,4,3,10,Loyal Users
93399,1455,5,14,1,1,1,3,Lost
93403,147,24,35,4,4,3,11,Loyal Users
93863,5,22,48,5,4,3,12,Loyal Users
93910,732,7,8,2,2,1,5,Lost
94244,1257,8,12,2,2,1,5,Lost
94353,3283,5,7,1,1,1,3,Lost
94404,4,47,148,5,5,5,15,Champions
94405,526,12,31,2,3,2,7,Casual Users
94413,1713,10,13,1,2,1,4,Lost
95139,2166,22,59,1,4,3,8,At Risk
95200,5037,6,11,1,1,1,3,Lost
95315,170,19,51,3,3,3,9,Loyal Users
95479,1306,11,25,1,2,2,5,Lost
95575,2133,7,20,1,2,2,5,Lost
95907,124,8,13,4,2,1,7,Promising
96110,566,11,16,2,2,2,6,Lost
96463,1451,5,7,1,1,1,3,Lost
96472,934,43,242,2,4,5,11,At Risk
96558,5252,8,31,1,2,2,5,Lost
96591,386,25,54,3,4,3,10,Loyal Users
96884,139,6,10,4,1,1,6,Promising
97583,30,20,51,5,3,3,11,Loyal Users
97803,791,8,47,2,2,3,7,Lost
98005,412,54,91,3,5,4,12,Loyal Users
98679,156,58,98,4,5,4,13,Champions
99023,4,8,45,5,2,3,10,Promising
99496,322,20,112,3,3,4,10,Loyal Users
99662,387,22,51,3,4,3,10,Loyal Users
99670,119,128,430,4,5,5,14,Champions
91266,6,16,18,5,3,2,10,Loyal Users
91426,3,90,181,5,5,5,15,Champions
91479,1148,31,114,2,4,4,10,At Risk
91618,136,11,42,4,2,3,9,Promising
91670,724,9,10,2,2,1,5,Lost
91688,1396,7,8,1,2,1,4,Lost
91775,46,103,671,5,5,5,15,Champions
91820,1723,18,43,1,3,3,7,Casual Users
92001,43,23,88,5,4,4,13,Champions
92195,2001,15,17,1,3,2,6,Casual Users
93072,26,90,371,5,5,5,15,Champions
93150,16,57,67,5,5,4,14,Champions
93349,1880,37,64,1,4,4,9,At Risk
93449,2647,11,13,1,2,1,4,Lost
93565,25,90,499,5,5,5,15,Champions
94112,385,15,22,3,3,2,8,Loyal Users
94184,1682,5,16,1,1,2,4,Lost
94911,1472,15,32,1,3,3,7,Casual Users
94924,402,16,34,3,3,3,9,Loyal Users
95024,55,7,15,5,2,1,8,Promising
95343,131,30,41,4,4,3,11,Loyal Users
96072,258,9,13,3,2,1,6,Casual Users
96215,718,16,55,2,3,3,8,Casual Users
96243,689,7,11,2,2,1,5,Lost
96245,17,80,216,5,5,5,15,Champions
96495,80,10,22,4,2,2,8,Promising
96513,203,22,42,3,4,3,10,Loyal Users
96700,435,57,354,3,5,5,13,Loyal Users
96765,6,12,26,5,3,2,10,Loyal Users
96777,4545,14,57,1,3,3,7,Casual Users
97580,93,21,31,4,3,2,9,Loyal Users
97634,13,40,79,5,4,4,13,Champions
98071,1816,5,44,1,1,3,5,Lost
98083,0,132,689,5,5,5,15,Champions
98111,1573,27,255,1,4,5,10,At Risk
98112,2309,17,30,1,3,2,6,Casual Users
98139,32,16,177,5,3,5,13,Loyal Users
99192,221,9,17,3,2,2,7,Casual Users
99224,3338,6,7,1,1,1,3,Lost
99338,2483,6,20,1,1,2,4,Lost
99579,95,65,131,4,5,4,13,Champions
91423,1008,34,54,2,4,3,9,At Risk
92585,2580,7,8,1,2,1,4,Lost
92661,1672,13,14,1,3,1,5,Casual Users
92664,2427,29,80,1,4,4,9,At Risk
92814,3986,6,13,1,1,1,3,Lost
92842,713,20,26,2,3,2,7,Casual Users
93084,2292,6,7,1,1,1,3,Lost
93094,120,18,38,4,3,3,10,Loyal Users
93215,795,18,41,2,3,3,8,Casual Users
93229,406,5,11,3,1,1,5,Casual Users
93611,128,56,130,4,5,4,13,Champions
93615,37,38,65,5,4,4,13,Champions
93733,90,23,276,4,4,5,13,Champions
93871,3630,9,17,1,2,2,5,Lost
94702,1498,7,11,1,2,1,4,Lost
94720,77,54,80,4,5,4,13,Champions
94962,287,24,53,3,4,3,10,Loyal Users
94994,263,31,47,3,4,3,10,Loyal Users
95116,329,39,76,3,4,4,11,Loyal Users
95251,156,18,31,4,3,2,9,Loyal Users
95363,254,8,69,3,2,4,9,Casual Users
95621,1538,8,13,1,2,1,4,Lost
95902,6,48,90,5,5,4,14,Champions
95995,1361,6,7,1,1,1,3,Lost
96207,3114,6,23,1,1,2,4,Lost
96490,826,15,52,2,3,3,8,Casual Users
96863,9,89,244,5,5,5,15,Champions
96956,15,92,271,5,5,5,15,Champions
96971,80,12,27,4,3,2,9,Loyal Users
97145,118,98,179,4,5,5,14,Champions
97212,3,31,150,5,4,5,14,Champions
97229,110,14,17,4,3,2,9,Loyal Users
98167,25,111,417,5,5,5,15,Champions
98181,284,25,52,3,4,3,10,Loyal Users
98207,158,15,57,4,3,3,10,Loyal Users
98441,373,7,7,3,2,1,6,Casual Users
99179,546,14,42,2,3,3,8,Casual Users
99603,1551,5,10,1,1,1,3,Lost
99930,308,17,19,3,3,2,8,Loyal Users
91121,4,44,66,5,4,4,13,Champions
91133,110,22,69,4,4,4,12,Champions
91160,434,9,14,3,2,1,6,Casual Users
91214,4230,5,18,1,1,2,4,Lost
91522,3714,7,29,1,2,2,5,Lost
91577,13,72,468,5,5,5,15,Champions
91753,2733,8,46,1,2,3,6,Lost
92738,136,58,191,4,5,5,14,Champions
92857,2,33,176,5,4,5,14,Champions
93099,154,94,243,4,5,5,14,Champions
93413,2822,6,11,1,1,1,3,Lost
93649,1035,15,35,2,3,3,8,Casual Users
93927,2273,7,13,1,2,1,4,Lost
94013,649,5,15,2,1,1,4,Lost
94127,4468,11,12,1,2,1,4,Lost
94312,109,11,63,4,2,4,10,Promising
94502,124,80,176,4,5,5,14,Champions
94510,737,6,16,2,1,2,5,Lost
94869,878,7,8,2,2,1,5,Lost
94980,2551,14,16,1,3,2,6,Casual Users
95097,584,12,60,2,3,3,8,Casual Users
95303,701,11,21,2,2,2,6,Lost
96194,1975,10,15,1,2,1,4,Lost
96847,732,24,39,2,4,3,9,At Risk
96899,433,16,25,3,3,2,8,Loyal Users
96941,2858,5,10,1,1,1,3,Lost
97042,2991,46,93,1,5,4,10,At Risk
97367,17,106,374,5,5,5,15,Champions
98642,44,79,329,5,5,5,15,Champions
98648,17,23,45,5,4,3,12,Loyal Users
98993,1401,26,56,1,4,3,8,At Risk
98995,500,7,9,2,2,1,5,Lost
99066,295,50,294,3,5,5,13,Loyal Users
99088,1156,13,25,2,3,2,7,Casual Users
99254,14,15,102,5,3,4,12,Loyal Users
99260,260,7,16,3,2,2,7,Casual Users
99354,442,26,73,3,4,4,11,Loyal Users
99845,128,53,90,4,5,4,13,Champions
99876,1,19,91,5,3,4,12,Loyal Users
91588,7,92,301,5,5,5,15,Champions
91841,5127,6,6,1,1,1,3,Lost
92030,63,89,149,5,5,5,15,Champions
92081,1029,8,14,2,2,1,5,Lost
92382,418,21,33,3,3,3,9,Loyal Users
92577,141,7,12,4,2,1,7,Promising
92793,724,10,24,2,2,2,6,Lost
92853,861,5,15,2,1,1,4,Lost
93017,122,10,16,4,2,2,8,Promising
93109,408,56,233,3,5,5,13,Loyal Users
93158,110,21,183,4,3,5,12,Loyal Users
93257,322,7,7,3,2,1,6,Casual Users
93454,281,84,124,3,5,4,12,Loyal Users
93680,31,37,163,5,4,5,14,Champions
93759,117,88,547,4,5,5,14,Champions
93855,184,35,180,3,4,5,12,Loyal Users
94003,3493,7,7,1,2,1,4,Lost
94006,2153,14,28,1,3,2,6,Casual Users
94038,198,8,23,3,2,2,7,Casual Users
94442,57,23,41,5,4,3,12,Loyal Users
94469,587,10,21,2,2,2,6,Lost
95081,850,6,9,2,1,1,4,Lost
95130,242,10,15,3,2,1,6,Casual Users
95814,292,35,104,3,4,4,11,Loyal Users
96026,740,12,45,2,3,3,8,Casual Users
96128,431,10,51,3,2,3,8,Casual Users
96397,227,9,32,3,2,3,8,Casual Users
96400,179,6,6,3,1,1,5,Casual Users
96604,101,33,84,4,4,4,12,Champions
97166,998,28,76,2,4,4,10,At Risk
97387,189,12,23,3,3,2,8,Loyal Users
97464,1104,13,18,2,3,2,7,Casual Users
97606,548,22,42,2,4,3,9,At Risk
97642,268,29,51,3,4,3,10,Loyal Users
97807,172,92,431,3,5,5,13,Loyal Users
98115,367,60,234,3,5,5,13,Loyal Users
98711,4020,5,7,1,1,1,3,Lost
98878,1373,25,46,1,4,3,8,At Risk
98902,3847,5,5,1,1,1,3,Lost
98920,237,88,245,3,5,5,13,Loyal Users
98921,24,34,148,5,4,5,14,Champions
98962,28,10,16,5,2,2,9,Promising
99641,1156,11,32,2,2,3,7,Lost
99752,1825,6,8,1,1,1,3,Lost
99806,4447,5,19,1,1,2,4,Lost
99904,449,60,337,3,5,5,13,Loyal Users
91385,133,35,65,4,4,4,12,Champions
91765,2575,11,23,1,2,2,5,Lost
91831,1155,29,161,2,4,5,11,At Risk
91931,0,111,226,5,5,5,15,Champions
92491,1593,21,44,1,3,3,7,Casual Users
92631,422,102,250,3,5,5,13,Loyal Users
92800,2637,6,6,1,1,1,3,Lost
93083,538,10,12,2,2,1,5,Lost
93666,543,5,11,2,1,1,4,Lost
93877,1858,6,15,1,1,1,3,Lost
94106,730,22,52,2,4,3,9,At Risk
94341,5575,6,19,1,1,2,4,Lost
94526,1194,31,52,2,4,3,9,At Risk
95079,277,22,39,3,4,3,10,Loyal Users
95392,44,186,473,5,5,5,15,Champions
95523,118,10,13,4,2,1,7,Promising
95859,266,27,62,3,4,3,10,Loyal Users
95878,111,43,124,4,4,4,12,Champions
96313,138,49,81,4,5,4,13,Champions
97084,1708,6,52,1,1,3,5,Lost
97416,121,28,50,4,4,3,11,Loyal Users
97423,766,17,30,2,3,2,7,Casual Users
97666,1107,6,12,2,1,1,4,Lost
97790,133,15,79,4,3,4,11,Loyal Users
98059,10,74,627,5,5,5,15,Champions
98202,565,21,43,2,3,3,8,Casual Users
98671,418,36,81,3,4,4,11,Loyal Users
98814,0,176,450,5,5,5,15,Champions
98919,255,5,21,3,1,2,6,Casual Users
98967,530,5,11,2,1,1,4,Lost
99007,1839,11,15,1,2,1,4,Lost
99039,117,14,30,4,3,2,9,Loyal Users
99056,49,20,29,5,3,2,10,Loyal Users
99101,2,5,18,5,1,2,8,Promising
99204,7,79,175,5,5,5,15,Champions
99413,802,19,27,2,3,2,7,Casual Users
91087,613,27,51,2,4,3,9,At Risk
91330,14,30,88,5,4,4,13,Champions
91458,574,6,12,2,1,1,4,Lost
91581,1206,5,7,2,1,1,4,Lost
91696,143,52,78,4,5,4,13,Champions
92026,285,5,10,3,1,1,5,Casual Users
92387,443,31,55,3,4,3,10,Loyal Users
92865,274,21,97,3,3,4,10,Loyal Users
92917,315,6,19,3,1,2,6,Casual Users
93160,193,32,42,3,4,3,10,Loyal Users
93286,113,7,8,4,2,1,7,Promising
93287,895,10,18,2,2,2,6,Lost
93547,1498,7,8,1,2,1,4,Lost
93809,1486,23,102,1,4,4,9,At Risk
93981,281,17,131,3,3,4,10,Loyal Users
93987,29,21,36,5,3,3,11,Loyal Users
94059,1024,5,23,2,1,2,5,Lost
94514,168,26,210,3,4,5,12,Loyal Users
94535,187,36,73,3,4,4,11,Loyal Users
94604,2040,9,23,1,2,2,5,Lost
94651,51,95,607,5,5,5,15,Champions
94863,277,48,101,3,5,4,12,Loyal Users
94866,2199,10,17,1,2,2,5,Lost
94971,102,24,29,4,4,2,10,Loyal Users
95045,1647,6,73,1,1,4,6,Lost
95287,74,113,276,4,5,5,14,Champions
95300,162,13,17,4,3,2,9,Loyal Users
95677,1714,46,184,1,5,5,11,At Risk
96164,209,10,73,3,2,4,9,Casual Users
96217,57,86,458,5,5,5,15,Champions
96551,1790,5,7,1,1,1,3,Lost
96920,120,8,14,4,2,1,7,Promising
96960,7,115,287,5,5,5,15,Champions
96962,2683,7,18,1,2,2,5,Lost
97107,849,11,29,2,2,2,6,Lost
97188,4,9,40,5,2,3,10,Promising
97891,84,12,36,4,3,3,10,Loyal Users
98379,955,68,124,2,5,4,11,At Risk
98402,1231,9,40,2,2,3,7,Lost
98414,81,20,68,4,3,4,11,Loyal Users
98672,381,6,10,3,1,1,5,Casual Users
98860,8,46,72,5,5,4,14,Champions
99324,1140,6,7,2,1,1,4,Lost
91256,133,69,246,4,5,5,14,Champions
91368,1590,5,20,1,1,2,4,Lost
91639,4701,5,11,1,1,1,3,Lost
91786,5,53,116,5,5,4,14,Champions
92010,1,62,190,5,5,5,15,Champions
92045,29,76,191,5,5,5,15,Champions
92185,5,192,762,5,5,5,15,Champions
92218,1964,18,58,1,3,3,7,Casual Users
92334,414,16,28,3,3,2,8,Loyal Users
92533,143,5,46,4,1,3,8,Promising
93364,110,56,103,4,5,4,13,Champions
93572,259,12,15,3,3,1,7,Loyal Users
93602,308,7,15,3,2,1,6,Casual Users
94108,954,11,13,2,2,1,5,Lost
94447,21,41,216,5,4,5,14,Champions
94477,723,20,48,2,3,3,8,Casual Users
94505,1224,16,60,2,3,3,8,Casual Users
94545,2147,8,12,1,2,1,4,Lost
94691,68,17,23,5,3,2,10,Loyal Users
94803,67,16,28,5,3,2,10,Loyal Users
95193,130,8,19,4,2,2,8,Promising
95281,125,63,130,4,5,4,13,Champions
95311,1817,5,16,1,1,2,4,Lost
95487,129,48,99,4,5,4,13,Champions
95958,39,9,34,5,2,3,10,Promising
96342,398,5,6,3,1,1,5,Casual Users
96728,2698,12,20,1,3,2,6,Casual Users
97355,150,21,64,4,3,4,11,Loyal Users
97497,143,62,121,4,5,4,13,Champions
97760,842,6,12,2,1,1,4,Lost
97786,536,15,41,2,3,3,8,Casual Users
97990,122,108,571,4,5,5,14,Champions
98190,699,30,98,2,4,4,10,At Risk
98215,482,14,21,2,3,2,7,Casual Users
98595,2379,5,22,1,1,2,4,Lost
99035,450,11,33,3,2,3,8,Casual Users
99175,2950,8,16,1,2,2,5,Lost
99319,126,41,95,4,4,4,12,Champions
99368,284,8,29,3,2,2,7,Casual Users
99404,313,9,14,3,2,1,6,Casual Users
91641,0,92,265,5,5,5,15,Champions
91647,283,15,34,3,3,3,9,Loyal Users
91675,25,22,72,5,4,4,13,Champions
92542,5103,5,13,1,1,1,3,Lost
93293,11,6,7,5,1,1,7,Promising
93325,16,50,89,5,5,4,14,Champions
93441,171,15,23,3,3,2,8,Loyal Users
93536,314,7,11,3,2,1,6,Casual Users
93993,119,15,25,4,3,2,9,Loyal Users
94121,114,14,35,4,3,3,10,Loyal Users
94152,116,27,145,4,4,4,12,Champions
94201,119,8,28,4,2,2,8,Promising
94417,3469,6,10,1,1,1,3,Lost
95216,4314,5,5,1,1,1,3,Lost
95365,12,14,140,5,3,4,12,Loyal Users
95740,10,65,113,5,5,4,14,Champions
95891,2166,6,21,1,1,2,4,Lost
96099,64,7,10,5,2,1,8,Promising
96125,179,23,83,3,4,4,11,Loyal Users
96188,537,24,54,2,4,3,9,At Risk
96345,147,16,93,4,3,4,11,Loyal Users
96595,15,84,153,5,5,5,15,Champions
96691,5631,7,8,1,2,1,4,Lost
96744,146,20,34,4,3,3,10,Loyal Users
96789,35,41,64,5,4,4,13,Champions
96969,854,6,6,2,1,1,4,Lost
98299,14,36,63,5,4,4,13,Champions
98475,121,54,213,4,5,5,14,Champions
98698,130,9,37,4,2,3,9,Promising
98703,553,61,145,2,5,4,11,At Risk
98767,64,70,191,5,5,5,15,Champions
98815,290,34,228,3,4,5,12,Loyal Users
99098,2279,7,15,1,2,1,4,Lost
99356,216,24,56,3,4,3,10,Loyal Users
99406,137,12,38,4,3,3,10,Loyal Users
99573,3425,5,5,1,1,1,3,Lost
99744,1829,31,82,1,4,4,9,At Risk
99808,3561,5,10,1,1,1,3,Lost
99896,140,5,8,4,1,1,6,Promising
99905,553,15,24,2,3,2,7,Casual Users
91166,110,9,15,4,2,1,7,Promising
91257,33,70,114,5,5,4,14,Champions
91296,2886,5,8,1,1,1,3,Lost
91619,2426,6,9,1,1,1,3,Lost
91808,24,116,495,5,5,5,15,Champions
92027,368,52,74,3,5,4,12,Loyal Users
92219,213,32,244,3,4,5,12,Loyal Users
92224,121,60,179,4,5,5,14,Champions
92253,448,7,12,3,2,1,6,Casual Users
92342,21,17,35,5,3,3,11,Loyal Users
92875,78,80,575,4,5,5,14,Champions
93250,83,49,122,4,5,4,13,Champions
93581,68,20,82,5,3,4,12,Loyal Users
93751,688,8,61,2,2,3,7,Lost
93752,322,10,28,3,2,2,7,Casual Users
93869,2330,5,5,1,1,1,3,Lost
94614,104,114,166,4,5,5,14,Champions
94645,85,12,23,4,3,2,9,Loyal Users
94712,80,5,14,4,1,1,6,Promising
94827,2265,9,40,1,2,3,6,Lost
95019,15,143,594,5,5,5,15,Champions
95033,65,99,294,5,5,5,15,Champions
95675,71,26,165,4,4,5,13,Champions
95688,26,101,211,5,5,5,15,Champions
95710,1551,6,18,1,1,2,4,Lost
96028,47,155,506,5,5,5,15,Champions
96169,285,14,35,3,3,3,9,Loyal Users
96353,117,46,78,4,5,4,13,Champions
96454,69,30,133,5,4,4,13,Champions
97322,6,131,362,5,5,5,15,Champions
98531,1964,6,18,1,1,2,4,Lost
98657,1233,34,50,2,4,3,9,At Risk
98961,1826,5,13,1,1,1,3,Lost
99000,826,22,54,2,4,3,9,At Risk
99051,5155,14,17,1,3,2,6,Casual Users
99530,602,6,8,2,1,1,4,Lost
99567,397,42,196,3,4,5,12,Loyal Users
99811,31,25,51,5,4,3,12,Loyal Users
99908,848,14,28,2,3,2,7,Casual Users
99951,182,33,87,3,4,4,11,Loyal Users
91185,34,14,65,5,3,4,12,Loyal Users
91381,111,13,80,4,3,4,11,Loyal Users
92388,2553,24,46,1,4,3,8,At Risk
92431,304,10,88,3,2,4,9,Casual Users
92459,4512,7,8,1,2,1,4,Lost
92700,897,65,150,2,5,5,12,At Risk
92982,1586,10,22,1,2,2,5,Lost
93126,31,106,207,5,5,5,15,Champions
93478,164,21,84,4,3,4,11,Loyal Users
93626,3,139,546,5,5,5,15,Champions
93731,682,6,6,2,1,1,4,Lost
93953,1160,11,23,2,2,2,6,Lost
94338,165,9,65,4,2,4,10,Promising
94372,288,6,32,3,1,3,7,Casual Users
94480,147,11,26,4,2,2,8,Promising
94501,273,5,12,3,1,1,5,Casual Users
94525,309,5,5,3,1,1,5,Casual Users
94605,26,54,120,5,5,4,14,Champions
94787,19,5,5,5,1,1,7,Promising
94847,1837,18,150,1,3,5,9,Casual Users
94875,108,49,84,4,5,4,13,Champions
95189,107,63,246,4,5,5,14,Champions
95198,223,21,78,3,3,4,10,Loyal Users
95488,117,14,28,4,3,2,9,Loyal Users
95792,1076,12,44,2,3,3,8,Casual Users
96035,2837,7,22,1,2,2,5,Lost
96291,38,109,163,5,5,5,15,Champions
96672,3700,5,11,1,1,1,3,Lost
96917,218,13,25,3,3,2,8,Loyal Users
97079,833,7,22,2,2,2,6,Lost
97141,38,9,102,5,2,4,11,Promising
97198,4833,6,19,1,1,2,4,Lost
97430,379,55,110,3,5,4,12,Loyal Users
97487,3666,5,7,1,1,1,3,Lost
97496,26,29,58,5,4,3,12,Loyal Users
97981,36,136,458,5,5,5,15,Champions
97993,18,9,34,5,2,3,10,Promising
98194,536,16,48,2,3,3,8,Casual Users
98983,1889,7,16,1,2,2,5,Lost
99092,416,21,47,3,3,3,9,Loyal Users
99787,514,8,27,2,2,2,6,Lost
91132,23,24,36,5,4,3,12,Loyal Users
91221,636,6,13,2,1,1,4,Lost
91792,119,59,190,4,5,5,14,Champions
91958,81,37,126,4,4,4,12,Champions
92183,241,59,327,3,5,5,13,Loyal Users
92373,11,26,58,5,4,3,12,Loyal Users
92863,3031,7,19,1,2,2,5,Lost
93038,140,22,90,4,4,4,12,Champions
93824,1077,9,29,2,2,2,6,Lost
93852,2884,9,13,1,2,1,4,Lost
94331,2644,6,20,1,1,2,4,Lost
94717,7,23,39,5,4,3,12,Loyal Users
94741,137,5,14,4,1,1,6,Promising
95058,342,6,172,3,1,5,9,Casual Users
95459,347,7,7,3,2,1,6,Casual Users
95684,13,25,69,5,4,4,13,Champions
95706,528,5,46,2,1,3,6,Lost
95711,833,16,29,2,3,2,7,Casual Users
95733,684,12,41,2,3,3,8,Casual Users
95903,40,70,375,5,5,5,15,Champions
95929,2127,7,29,1,2,2,5,Lost
95939,44,95,216,5,5,5,15,Champions
96136,3984,8,13,1,2,1,4,Lost
96367,0,76,129,5,5,4,14,Champions
96448,7,97,451,5,5,5,15,Champions
96683,7,33,59,5,4,3,12,Loyal Users
97200,123,108,156,4,5,5,14,Champions
97320,269,8,21,3,2,2,7,Casual Users
97646,4419,6,6,1,1,1,3,Lost
98075,93,59,404,4,5,5,14,Champions
98730,3251,6,14,1,1,1,3,Lost
98890,848,14,14,2,3,1,6,Casual Users
99054,1721,6,14,1,1,1,3,Lost
99214,224,16,25,3,3,2,8,Loyal Users
99295,358,22,29,3,4,2,9,Loyal Users
99702,125,5,31,4,1,2,7,Promising
99712,32,51,69,5,5,4,14,Champions
99746,735,69,316,2,5,5,12,At Risk
99948,46,60,97,5,5,4,14,Champions
91491,188,28,31,3,4,2,9,Loyal Users
91495,1326,41,107,1,4,4,9,At Risk
91717,34,13,34,5,3,3,11,Loyal Users
91866,4268,7,16,1,2,2,5,Lost
92378,147,18,26,4,3,2,9,Loyal Users
92480,143,101,298,4,5,5,14,Champions
92861,92,10,11,4,2,1,7,Promising
92935,0,64,384,5,5,5,15,Champions
93239,259,23,32,3,4,3,10,Loyal Users
93241,806,7,13,2,2,1,5,Lost
93790,1991,7,7,1,2,1,4,Lost
94007,1313,12,176,1,3,5,9,Casual Users
94010,449,42,104,3,4,4,11,Loyal Users
94085,465,7,25,3,2,2,7,Casual Users
94242,823,6,24,2,1,2,5,Lost
94443,300,5,6,3,1,1,5,Casual Users
94464,881,7,20,2,2,2,6,Lost
94520,2408,10,15,1,2,1,4,Lost
94744,227,17,175,3,3,5,11,Loyal Users
94954,79,156,325,4,5,5,14,Champions
95145,1369,10,12,1,2,1,4,Lost
95212,1703,8,19,1,2,2,5,Lost
95687,539,6,20,2,1,2,5,Lost
96317,409,7,109,3,2,4,9,Casual Users
96321,722,6,9,2,1,1,4,Lost
96333,8,197,343,5,5,5,15,Champions
96446,1433,44,89,1,4,4,9,At Risk
96649,1954,14,25,1,3,2,6,Casual Users
96866,1730,10,41,1,2,3,6,Lost
97684,1845,5,6,1,1,1,3,Lost
97711,12,35,75,5,4,4,13,Champions
98291,3321,11,30,1,2,2,5,Lost
98734,853,17,21,2,3,2,7,Casual Users
99231,1011,5,17,2,1,2,5,Lost
99263,32,15,19,5,3,2,10,Loyal Users
99304,140,304,645,4,5,5,14,Champions
99703,2442,14,18,1,3,2,6,Casual Users
91198,1272,5,8,1,1,1,3,Lost
92145,698,46,113,2,5,4,11,At Risk
92356,10,13,21,5,3,2,10,Loyal Users
92547,132,23,40,4,4,3,11,Loyal Users
92866,278,6,12,3,1,1,5,Casual Users
92915,146,106,294,4,5,5,14,Champions
93012,901,10,31,2,2,2,6,Lost
93052,160,11,11,4,2,1,7,Promising
93096,928,12,153,2,3,5,10,Casual Users
93202,5,33,401,5,4,5,14,Champions
93303,300,13,28,3,3,2,8,Loyal Users
93542,44,48,123,5,5,4,14,Champions
93704,159,8,14,4,2,1,7,Promising
94009,2590,5,31,1,1,2,4,Lost
94101,4021,7,19,1,2,2,5,Lost
94126,527,8,10,2,2,1,5,Lost
94219,165,5,10,4,1,1,6,Promising
94379,1293,14,75,1,3,4,8,Casual Users
94593,409,6,19,3,1,2,6,Casual Users
94721,1131,24,129,2,4,4,10,At Risk
94899,2442,14,90,1,3,4,8,Casual Users
94921,7,31,106,5,4,4,13,Champions
94933,375,13,20,3,3,2,8,Loyal Users
95148,142,13,64,4,3,4,11,Loyal Users
95182,272,34,78,3,4,4,11,Loyal Users
95322,2,61,124,5,5,4,14,Champions
95326,1791,12,26,1,3,2,6,Casual Users
95495,859,5,9,2,1,1,4,Lost
96154,227,13,30,3,3,2,8,Loyal Users
96327,101,30,162,4,4,5,13,Champions
96455,50,117,611,5,5,5,15,Champions
96730,1972,5,5,1,1,1,3,Lost
97255,541,47,200,2,5,5,12,At Risk
97293,1282,6,26,1,1,2,4,Lost
97407,1295,29,46,1,4,3,8,At Risk
97455,36,8,10,5,2,1,8,Promising
97527,1047,8,22,2,2,2,6,Lost
97673,7,14,35,5,3,3,11,Loyal Users
97801,1975,5,10,1,1,1,3,Lost
98293,3174,6,17,1,1,2,4,Lost
98369,11,29,37,5,4,3,12,Loyal Users
98515,2243,7,30,1,2,2,5,Lost
98520,960,8,46,2,2,3,7,Lost
98550,1730,6,9,1,1,1,3,Lost
98744,39,12,114,5,3,4,12,Loyal Users
91445,613,42,53,2,4,3,9,At Risk
91498,65,16,39,5,3,3,11,Loyal Users
92069,247,13,20,3,3,2,8,Loyal Users
92170,226,17,62,3,3,3,9,Loyal Users
92375,282,15,39,3,3,3,9,Loyal Users
92487,2587,6,8,1,1,1,3,Lost
92589,87,25,33,4,4,3,11,Loyal Users
92885,785,19,25,2,3,2,7,Casual Users
93246,22,175,772,5,5,5,15,Champions
93641,82,28,43,4,4,3,11,Loyal Users
93747,275,57,125,3,5,4,12,Loyal Users
94180,2998,7,9,1,2,1,4,Lost
94479,961,7,15,2,2,1,5,Lost
94759,560,5,7,2,1,1,4,Lost
94867,9,10,13,5,2,1,8,Promising
95229,1253,25,29,2,4,2,8,At Risk
95450,402,12,43,3,3,3,9,Loyal Users
95826,2132,8,43,1,2,3,6,Lost
95876,15,76,220,5,5,5,15,Champions
96249,84,19,87,4,3,4,11,Loyal Users
96597,405,23,71,3,4,4,11,Loyal Users
96826,2837,6,6,1,1,1,3,Lost
97015,603,16,121,2,3,4,9,Casual Users
97133,125,28,168,4,4,5,13,Champions
97386,248,5,9,3,1,1,5,Casual Users
97733,1685,7,14,1,2,1,4,Lost
97823,958,7,11,2,2,1,5,Lost
98023,301,46,127,3,5,4,12,Loyal Users
98062,10,89,325,5,5,5,15,Champions
98381,699,9,14,2,2,1,5,Lost
98395,801,6,25,2,1,2,5,Lost
98503,146,7,9,4,2,1,7,Promising
98523,853,25,129,2,4,4,10,At Risk
98898,298,56,231,3,5,5,13,Loyal Users
99040,5,77,303,5,5,5,15,Champions
99112,531,12,25,2,3,2,7,Casual Users
99491,740,9,20,2,2,2,6,Lost
91313,433,7,27,3,2,2,7,Casual Users
91335,1095,6,6,2,1,1,4,Lost
91571,602,41,155,2,4,5,11,At Risk
91906,940,7,55,2,2,3,7,Lost
91924,427,5,26,3,1,2,6,Casual Users
92132,394,38,53,3,4,3,10,Loyal Users
92302,3269,9,33,1,2,3,6,Lost
92560,71,17,97,4,3,4,11,Loyal Users
92627,3010,16,40,1,3,3,7,Casual Users
92698,837,16,20,2,3,2,7,Casual Users
92886,105,51,87,4,5,4,13,Champions
93554,16,10,66,5,2,4,11,Promising
93847,226,38,62,3,4,3,10,Loyal Users
93895,109,46,299,4,5,5,14,Champions
93896,3696,9,16,1,2,2,5,Lost
94266,259,28,134,3,4,4,11,Loyal Users
94297,5532,6,15,1,1,1,3,Lost
94370,930,5,12,2,1,1,4,Lost
94554,282,13,24,3,3,2,8,Loyal Users
94964,4444,12,43,1,3,3,7,Casual Users
95477,688,8,14,2,2,1,5,Lost
95668,404,8,11,3,2,1,6,Casual Users
95678,1997,6,8,1,1,1,3,Lost
95723,387,43,475,3,4,5,12,Loyal Users
95838,97,46,143,4,5,4,13,Champions
95872,659,34,59,2,4,3,9,At Risk
96184,262,14,54,3,3,3,9,Loyal Users
96234,1445,5,133,1,1,4,6,Lost
96265,79,23,39,4,4,3,11,Loyal Users
96916,1092,15,18,2,3,2,7,Casual Users
96936,81,67,165,4,5,5,14,Champions
97359,1271,5,5,1,1,1,3,Lost
97476,2849,12,13,1,3,1,5,Casual Users
97575,604,11,16,2,2,2,6,Lost
97856,833,23,39,2,4,3,9,At Risk
98461,116,24,69,4,4,4,12,Champions
98778,4742,5,8,1,1,1,3,Lost
98932,292,24,30,3,4,2,9,Loyal Users
98953,1961,17,25,1,3,2,6,Casual Users
99374,488,7,12,2,2,1,5,Lost
99386,33,97,370,5,5,5,15,Champions
99426,405,26,57,3,4,3,10,Loyal Users
99942,1718,6,29,1,1,2,4,Lost
91083,3863,7,21,1,2,2,5,Lost
91380,45,98,293,5,5,5,15,Champions
91500,264,38,72,3,4,4,11,Loyal Users
91603,3448,6,34,1,1,3,5,Lost
91715,58,24,116,5,4,4,13,Champions
91910,23,140,301,5,5,5,15,Champions
91984,415,5,7,3,1,1,5,Casual Users
92291,127,107,257,4,5,5,14,Champions
92727,188,8,10,3,2,1,6,Casual Users
92888,351,14,26,3,3,2,8,Loyal Users
93152,986,46,216,2,5,5,12,At Risk
93274,40,67,333,5,5,5,15,Champions
93321,393,148,461,3,5,5,13,Loyal Users
93550,0,214,476,5,5,5,15,Champions
93575,239,43,111,3,4,4,11,Loyal Users
93903,130,25,91,4,4,4,12,Champions
94066,63,74,122,5,5,4,14,Champions
94941,168,41,88,3,4,4,11,Loyal Users
94999,3546,5,5,1,1,1,3,Lost
95008,1027,6,14,2,1,1,4,Lost
95533,125,38,85,4,4,4,12,Champions
95584,26,28,214,5,4,5,14,Champions
95627,576,8,16,2,2,2,6,Lost
95803,65,73,126,5,5,4,14,Champions
96145,256,15,23,3,3,2,8,Loyal Users
96200,1622,31,92,1,4,4,9,At Risk
96281,5,117,399,5,5,5,15,Champions
96316,1407,20,101,1,3,4,8,Casual Users
96402,813,7,51,2,2,3,7,Lost
96410,132,23,47,4,4,3,11,Loyal Users
96824,130,41,247,4,4,5,13,Champions
96829,3,14,152,5,3,5,13,Loyal Users
96857,2093,24,65,1,4,4,9,At Risk
97093,1279,5,6,1,1,1,3,Lost
97211,159,13,32,4,3,3,10,Loyal Users
97333,967,5,14,2,1,1,4,Lost
97508,83,53,179,4,5,5,14,Champions
97572,138,55,147,4,5,5,14,Champions
97833,2073,5,8,1,1,1,3,Lost
97976,2204,7,17,1,2,2,5,Lost
98389,1152,6,23,2,1,2,5,Lost
98566,122,24,125,4,4,4,12,Champions
98680,432,18,65,3,3,4,10,Loyal Users
98731,265,12,29,3,3,2,8,Loyal Users
98840,3541,13,62,1,3,3,7,Casual Users
98871,1680,10,26,1,2,2,5,Lost
99127,277,108,328,3,5,5,13,Loyal Users
99326,2299,6,27,1,1,2,4,Lost
99468,589,5,14,2,1,1,4,Lost
99650,58,125,204,5,5,5,15,Champions
91196,162,31,49,4,4,3,11,Loyal Users
91365,968,11,25,2,2,2,6,Lost
91734,741,5,5,2,1,1,4,Lost
91750,40,9,17,5,2,2,9,Promising
91871,29,5,14,5,1,1,7,Promising
92004,4,16,37,5,3,3,11,Loyal Users
92109,151,14,36,4,3,3,10,Loyal Users
92255,697,5,18,2,1,2,5,Lost
92288,22,5,35,5,1,3,9,Promising
92662,432,52,103,3,5,4,12,Loyal Users
93128,37,102,202,5,5,5,15,Champions
93263,655,8,16,2,2,2,6,Lost
93353,9,95,145,5,5,4,14,Champions
93358,153,34,81,4,4,4,12,Champions
93428,2812,7,10,1,2,1,4,Lost
94031,1563,10,53,1,2,3,6,Lost
94041,661,6,14,2,1,1,4,Lost
94105,407,13,24,3,3,2,8,Loyal Users
94120,245,10,30,3,2,2,7,Casual Users
94549,888,7,19,2,2,2,6,Lost
94753,8,70,486,5,5,5,15,Champions
95044,252,52,165,3,5,5,13,Loyal Users
95282,131,29,68,4,4,4,12,Champions
95745,19,28,76,5,4,4,13,Champions
96006,124,15,101,4,3,4,11,Loyal Users
96351,3159,15,55,1,3,3,7,Casual Users
96521,1543,5,8,1,1,1,3,Lost
96796,405,11,17,3,2,2,7,Casual Users
96837,456,20,38,3,3,3,9,Loyal Users
97327,5,71,110,5,5,4,14,Champions
97941,36,106,345,5,5,5,15,Champions
98582,130,71,235,4,5,5,14,Champions
98811,10,27,75,5,4,4,13,Champions
98893,1415,5,17,1,1,2,4,Lost
99097,569,10,43,2,2,3,7,Lost
99149,655,105,299,2,5,5,12,At Risk
99293,954,33,111,2,4,4,10,At Risk
99543,71,104,808,4,5,5,14,Champions
99612,844,6,7,2,1,1,4,Lost
99638,4,122,524,5,5,5,15,Champions
99665,1148,9,19,2,2,2,6,Lost
91241,62,193,411,5,5,5,15,Champions
91343,318,82,247,3,5,5,13,Loyal Users
91600,412,30,105,3,4,4,11,Loyal Users
91626,278,28,39,3,4,3,10,Loyal Users
91983,116,13,43,4,3,3,10,Loyal Users
92049,5,105,234,5,5,5,15,Champions
92050,135,34,119,4,4,4,12,Champions
92056,3678,5,24,1,1,2,4,Lost
92213,2217,17,113,1,3,4,8,Casual Users
92530,145,19,33,4,3,3,10,Loyal Users
92629,139,25,96,4,4,4,12,Champions
92820,839,11,17,2,2,2,6,Lost
92876,353,30,36,3,4,3,10,Loyal Users
92994,27,6,8,5,1,1,7,Promising
93098,4725,5,5,1,1,1,3,Lost
93376,1199,49,261,2,5,5,12,At Risk
93419,1690,5,10,1,1,1,3,Lost
93452,98,132,647,4,5,5,14,Champions
93838,397,14,19,3,3,2,8,Loyal Users
94524,14,15,24,5,3,2,10,Loyal Users
94728,111,16,23,4,3,2,9,Loyal Users
94852,7,50,222,5,5,5,15,Champions
95026,1365,5,6,1,1,1,3,Lost
95218,284,16,53,3,3,3,9,Loyal Users
96720,5,42,93,5,4,4,13,Champions
96792,13,61,247,5,5,5,15,Champions
97065,1070,6,28,2,1,2,5,Lost
97466,111,120,661,4,5,5,14,Champions
97533,690,39,195,2,4,5,11,At Risk
98087,7,8,18,5,2,2,9,Promising
98250,67,22,87,5,4,4,13,Champions
98791,399,8,37,3,2,3,8,Casual Users
98797,112,83,109,4,5,4,13,Champions
98827,1709,6,16,1,1,2,4,Lost
99091,1576,12,48,1,3,3,7,Casual Users
99724,689,10,16,2,2,2,6,Lost
99807,291,8,34,3,2,3,8,Casual Users
99867,775,10,23,2,2,2,6,Lost
91393,100,29,62,4,4,3,11,Loyal Users
91420,133,5,10,4,1,1,6,Promising
91541,80,22,57,4,4,3,11,Loyal Users
91655,307,13,24,3,3,2,8,Loyal Users
91759,2487,14,25,1,3,2,6,Casual Users
92363,817,179,490,2,5,5,12,At Risk
92532,4580,5,5,1,1,1,3,Lost
92681,0,180,470,5,5,5,15,Champions
92938,1694,18,52,1,3,3,7,Casual Users
93192,25,95,239,5,5,5,15,Champions
93439,3043,5,23,1,1,2,4,Lost
93557,171,23,90,3,4,4,11,Loyal Users
93653,82,11,18,4,2,2,8,Promising
93713,56,60,246,5,5,5,15,Champions
93890,696,13,77,2,3,4,9,Casual Users
94086,1713,11,30,1,2,2,5,Lost
94137,129,48,107,4,5,4,13,Champions
94319,5,10,33,5,2,3,10,Promising
94468,744,10,13,2,2,1,5,Lost
94588,389,12,30,3,3,2,8,Loyal Users
94966,168,41,105,3,4,4,11,Loyal Users
95126,23,17,59,5,3,3,11,Loyal Users
95829,811,5,12,2,1,1,4,Lost
96079,3187,7,60,1,2,3,6,Lost
96126,218,7,12,3,2,1,6,Casual Users
96288,13,44,165,5,4,5,14,Champions
96460,110,10,17,4,2,2,8,Promising
96994,77,34,108,4,4,4,12,Champions
97073,1656,6,28,1,1,2,4,Lost
97116,408,13,19,3,3,2,8,Loyal Users
97213,164,16,79,4,3,4,11,Loyal Users
97759,409,31,81,3,4,4,11,Loyal Users
97926,1554,7,16,1,2,2,5,Lost
98036,1267,14,46,1,3,3,7,Casual Users
98643,121,120,185,4,5,5,14,Champions
99504,2,23,73,5,4,4,13,Champions
99812,130,30,66,4,4,4,12,Champions
99871,452,9,61,3,2,3,8,Casual Users
100000,2437,8,14,1,2,1,4,Lost
91357,170,10,28,3,2,2,7,Casual Users
91526,205,62,95,3,5,4,12,Loyal Users
91548,18,112,481,5,5,5,15,Champions
92203,96,5,6,4,1,1,6,Promising
92250,1705,9,11,1,2,1,4,Lost
92408,86,6,7,4,1,1,6,Promising
92555,5723,8,11,1,2,1,4,Lost
92556,20,104,256,5,5,5,15,Champions
92654,2,57,232,5,5,5,15,Champions
92893,962,7,16,2,2,2,6,Lost
93199,98,154,314,4,5,5,14,Champions
93551,1662,9,21,1,2,2,5,Lost
93591,592,8,12,2,2,1,5,Lost
93760,280,17,63,3,3,4,10,Loyal Users
93968,1003,9,10,2,2,1,5,Lost
94081,249,23,60,3,4,3,10,Loyal Users
94168,92,109,220,4,5,5,14,Champions
94196,4565,6,6,1,1,1,3,Lost
94350,119,40,150,4,4,5,13,Champions
94628,256,88,214,3,5,5,13,Loyal Users
94959,6,82,176,5,5,5,15,Champions
95227,226,5,20,3,1,2,6,Casual Users
95280,246,13,33,3,3,3,9,Loyal Users
95386,943,8,17,2,2,2,6,Lost
95656,175,88,420,3,5,5,13,Loyal Users
95778,436,6,27,3,1,2,6,Casual Users
96368,88,20,41,4,3,3,10,Loyal Users
97431,92,31,63,4,4,4,12,Champions
97478,10,98,383,5,5,5,15,Champions
97636,108,62,230,4,5,5,14,Champions
97894,36,39,227,5,4,5,14,Champions
97951,692,36,54,2,4,3,9,At Risk
98129,1447,13,66,1,3,4,8,Casual Users
98142,1667,10,42,1,2,3,6,Lost
98658,1,53,186,5,5,5,15,Champions
98862,635,10,18,2,2,2,6,Lost
99594,125,12,16,4,3,2,9,Loyal Users
99819,234,8,13,3,2,1,6,Casual Users
99849,145,18,54,4,3,3,10,Loyal Users
99928,44,38,198,5,4,5,14,Champions
91069,2303,27,80,1,4,4,9,At Risk
91100,23,70,174,5,5,5,15,Champions
91344,291,30,52,3,4,3,10,Loyal Users
92368,1461,5,7,1,1,1,3,Lost
92859,572,10,10,2,2,1,5,Lost
93577,377,5,12,3,1,1,5,Casual Users
93642,30,5,13,5,1,1,7,Promising
93715,176,11,17,3,2,2,7,Casual Users
93723,90,33,121,4,4,4,12,Champions
93754,5719,6,7,1,1,1,3,Lost
93831,742,7,30,2,2,2,6,Lost
93988,683,8,38,2,2,3,7,Lost
93995,90,10,11,4,2,1,7,Promising
94287,2039,10,29,1,2,2,5,Lost
94347,1527,42,169,1,4,5,10,At Risk
94506,13,68,457,5,5,5,15,Champions
94947,76,14,85,4,3,4,11,Loyal Users
95172,2,60,196,5,5,5,15,Champions
95250,367,8,51,3,2,3,8,Casual Users
95560,658,6,6,2,1,1,4,Lost
95608,1,181,293,5,5,5,15,Champions
95719,2122,8,12,1,2,1,4,Lost
95990,385,7,8,3,2,1,6,Casual Users
96107,7,90,368,5,5,5,15,Champions
96124,40,62,234,5,5,5,15,Champions
96357,850,6,11,2,1,1,4,Lost
96384,37,73,296,5,5,5,15,Champions
96662,87,121,613,4,5,5,14,Champions
98109,405,114,350,3,5,5,13,Loyal Users
98294,510,31,110,2,4,4,10,At Risk
98338,696,44,71,2,4,4,10,At Risk
98474,1556,6,16,1,1,2,4,Lost
98509,103,34,107,4,4,4,12,Champions
98562,72,79,773,4,5,5,14,Champions
98866,31,150,543,5,5,5,15,Champions
98915,545,10,17,2,2,2,6,Lost
98994,83,16,95,4,3,4,11,Loyal Users
99036,4978,5,6,1,1,1,3,Lost
99086,254,9,19,3,2,2,7,Casual Users
99147,3455,6,7,1,1,1,3,Lost
99280,93,17,35,4,3,3,10,Loyal Users
99489,662,14,18,2,3,2,7,Casual Users
99772,407,9,21,3,2,2,7,Casual Users
91124,578,7,11,2,2,1,5,Lost
91283,1279,9,22,1,2,2,5,Lost
91551,3189,6,11,1,1,1,3,Lost
91565,826,15,21,2,3,2,7,Casual Users
91628,130,26,94,4,4,4,12,Champions
91646,686,14,58,2,3,3,8,Casual Users
91991,13,47,198,5,5,5,15,Champions
92104,2523,13,27,1,3,2,6,Casual Users
92261,126,162,327,4,5,5,14,Champions
92274,27,45,134,5,4,4,13,Champions
92367,1373,5,7,1,1,1,3,Lost
92458,570,9,74,2,2,4,8,Lost
92601,23,141,443,5,5,5,15,Champions
92614,57,13,153,5,3,5,13,Loyal Users
92838,1885,5,5,1,1,1,3,Lost
92934,415,10,23,3,2,2,7,Casual Users
93166,2078,6,9,1,1,1,3,Lost
93236,587,13,26,2,3,2,7,Casual Users
93382,83,16,20,4,3,2,9,Loyal Users
93444,445,10,23,3,2,2,7,Casual Users
93475,125,89,212,4,5,5,14,Champions
93584,415,11,29,3,2,2,7,Casual Users
93631,414,11,31,3,2,2,7,Casual Users
93749,3627,5,7,1,1,1,3,Lost
94495,3,70,95,5,5,4,14,Champions
94496,51,56,149,5,5,5,15,Champions
94590,2659,10,55,1,2,3,6,Lost
95028,40,240,636,5,5,5,15,Champions
95443,591,5,15,2,1,1,4,Lost
95594,963,10,11,2,2,1,5,Lost
95721,912,10,31,2,2,2,6,Lost
96239,691,10,11,2,2,1,5,Lost
96326,356,25,90,3,4,4,11,Loyal Users
96912,721,12,28,2,3,2,7,Casual Users
96922,220,23,187,3,4,5,12,Loyal Users
96966,2548,5,36,1,1,3,5,Lost
97019,241,51,143,3,5,4,12,Loyal Users
97149,451,156,270,3,5,5,13,Loyal Users
97174,77,10,64,4,2,4,10,Promising
97368,108,22,32,4,4,3,11,Loyal Users
97608,4,15,23,5,3,2,10,Loyal Users
97890,100,52,146,4,5,4,13,Champions
98136,97,12,23,4,3,2,9,Loyal Users
98621,63,192,763,5,5,5,15,Champions
98757,541,14,104,2,3,4,9,Casual Users
98936,413,11,42,3,2,3,8,Casual Users
99002,127,85,415,4,5,5,14,Champions
99238,1136,11,43,2,2,3,7,Lost
99317,2699,6,14,1,1,1,3,Lost
99863,291,48,190,3,5,5,13,Loyal Users
91114,773,20,29,2,3,2,7,Casual Users
91125,1741,34,168,1,4,5,10,At Risk
91240,834,5,25,2,1,2,5,Lost
91362,133,21,57,4,3,3,10,Loyal Users
91457,3130,7,7,1,2,1,4,Lost
91521,190,93,154,3,5,5,13,Loyal Users
91560,92,67,212,4,5,5,14,Champions
91777,103,19,44,4,3,3,10,Loyal Users
91817,170,25,68,3,4,4,11,Loyal Users
91916,73,77,212,4,5,5,14,Champions
92233,234,41,64,3,4,4,11,Loyal Users
92278,301,9,13,3,2,1,6,Casual Users
92486,132,7,22,4,2,2,8,Promising
92538,162,16,24,4,3,2,9,Loyal Users
92704,3142,5,25,1,1,2,4,Lost
92864,183,8,15,3,2,1,6,Casual Users
93057,88,113,482,4,5,5,14,Champions
93560,539,8,11,2,2,1,5,Lost
93623,101,54,134,4,5,4,13,Champions
93796,866,9,18,2,2,2,6,Lost
93822,1467,11,77,1,2,4,7,Lost
93861,397,35,62,3,4,3,10,Loyal Users
94173,37,9,11,5,2,1,8,Promising
94258,2146,13,26,1,3,2,6,Casual Users
94303,268,39,110,3,4,4,11,Loyal Users
94558,431,6,10,3,1,1,5,Casual Users
94693,148,22,76,4,4,4,12,Champions
95099,5,6,13,5,1,1,7,Promising
95127,148,10,28,4,2,2,8,Promising
95253,374,27,53,3,4,3,10,Loyal Users
95764,8,7,11,5,2,1,8,Promising
96083,5081,15,90,1,3,4,8,Casual Users
96508,1249,11,23,2,2,2,6,Lost
96695,149,32,95,4,4,4,12,Champions
96705,140,11,25,4,2,2,8,Promising
96807,3732,6,27,1,1,2,4,Lost
96891,3329,5,14,1,1,1,3,Lost
97012,61,71,114,5,5,4,14,Champions
97119,699,15,32,2,3,3,8,Casual Users
97253,2055,5,72,1,1,4,6,Lost
97363,5,128,635,5,5,5,15,Champions
97379,517,34,73,2,4,4,10,At Risk
97505,245,29,78,3,4,4,11,Loyal Users
97631,3,55,78,5,5,4,14,Champions
98628,121,8,57,4,2,3,9,Promising
99082,7,67,142,5,5,4,14,Champions
99602,29,65,132,5,5,4,14,Champions
91156,992,13,40,2,3,3,8,Casual Users
91465,98,52,99,4,5,4,13,Champions
91508,327,22,29,3,4,2,9,Loyal Users
91685,101,238,550,4,5,5,14,Champions
92037,104,23,39,4,4,3,11,Loyal Users
92239,84,32,53,4,4,3,11,Loyal Users
92329,44,94,461,5,5,5,15,Champions
92337,182,16,19,3,3,2,8,Loyal Users
92623,571,7,13,2,2,1,5,Lost
93054,129,10,60,4,2,3,9,Promising
93201,123,85,191,4,5,5,14,Champions
93231,696,7,7,2,2,1,5,Lost
93425,257,5,7,3,1,1,5,Casual Users
93918,794,7,9,2,2,1,5,Lost
94446,323,19,54,3,3,3,9,Loyal Users
94458,151,20,28,4,3,2,9,Loyal Users
94809,214,40,220,3,4,5,12,Loyal Users
95043,109,47,131,4,5,4,13,Champions
95060,0,47,221,5,5,5,15,Champions
95092,370,24,55,3,4,3,10,Loyal Users
95208,1612,18,38,1,3,3,7,Casual Users
95222,826,16,76,2,3,4,9,Casual Users
95643,1981,20,33,1,3,3,7,Casual Users
95847,1318,8,29,1,2,2,5,Lost
96033,169,27,156,3,4,5,12,Loyal Users
96100,1026,11,24,2,2,2,6,Lost
96552,5993,8,8,1,2,1,4,Lost
96585,133,15,24,4,3,2,9,Loyal Users
96787,536,7,72,2,2,4,8,Lost
96820,1826,7,39,1,2,3,6,Lost
96838,213,13,76,3,3,4,10,Loyal Users
97076,891,7,35,2,2,3,7,Lost
97172,24,17,52,5,3,3,11,Loyal Users
97251,422,25,55,3,4,3,10,Loyal Users
97778,103,8,13,4,2,1,7,Promising
97884,101,7,10,4,2,1,7,Promising
98354,471,36,64,2,4,4,10,At Risk
98560,159,39,166,4,4,5,13,Champions
98591,860,15,128,2,3,4,9,Casual Users
98749,220,21,39,3,3,3,9,Loyal Users
98763,4693,10,30,1,2,2,5,Lost
99332,1008,60,118,2,5,4,11,At Risk
99360,543,12,20,2,3,2,7,Casual Users
99481,142,5,11,4,1,1,6,Promising
99535,132,17,92,4,3,4,11,Loyal Users
99607,416,73,233,3,5,5,13,Loyal Users
99618,2318,6,15,1,1,1,3,Lost
99835,465,44,235,3,4,5,12,Loyal Users
99882,3,138,522,5,5,5,15,Champions
99918,2440,5,8,1,1,1,3,Lost
91326,95,6,6,4,1,1,6,Promising
91396,0,42,122,5,4,4,13,Champions
91466,2315,32,181,1,4,5,10,At Risk
91556,470,5,6,3,1,1,5,Casual Users
91674,70,156,450,4,5,5,14,Champions
92186,867,33,98,2,4,4,10,At Risk
92521,83,16,95,4,3,4,11,Loyal Users
92746,31,100,152,5,5,5,15,Champions
93235,333,23,75,3,4,4,11,Loyal Users
93345,145,49,101,4,5,4,13,Champions
93374,478,31,129,2,4,4,10,At Risk
93394,384,14,17,3,3,2,8,Loyal Users
93440,815,20,84,2,3,4,9,Casual Users
93826,2,22,41,5,4,3,12,Loyal Users
94485,143,13,17,4,3,2,9,Loyal Users
95637,145,8,19,4,2,2,8,Promising
95749,3124,8,68,1,2,4,7,Lost
95972,86,27,36,4,4,3,11,Loyal Users
96037,17,5,8,5,1,1,7,Promising
96636,384,42,85,3,4,4,11,Loyal Users
96780,267,11,84,3,2,4,9,Casual Users
96998,1744,6,7,1,1,1,3,Lost
97131,143,60,90,4,5,4,13,Champions
97415,329,8,38,3,2,3,8,Casual Users
98052,1996,20,38,1,3,3,7,Casual Users
98303,3829,9,28,1,2,2,5,Lost
98470,14,36,82,5,4,4,13,Champions
98880,463,7,9,3,2,1,6,Casual Users
99707,6,30,47,5,4,3,12,Loyal Users
99922,141,9,29,4,2,2,8,Promising
91076,263,22,69,3,4,4,11,Loyal Users
91131,113,61,190,4,5,5,14,Champions
91165,379,18,35,3,3,3,9,Loyal Users
91195,206,7,8,3,2,1,6,Casual Users
91818,277,8,13,3,2,1,6,Casual Users
92443,86,19,38,4,3,3,10,Loyal Users
92551,230,6,17,3,1,2,6,Casual Users
92563,424,6,7,3,1,1,5,Casual Users
93237,2158,5,27,1,1,2,4,Lost
93273,3,95,444,5,5,5,15,Champions
93338,257,23,144,3,4,4,11,Loyal Users
93430,2123,5,7,1,1,1,3,Lost
93738,582,12,12,2,3,1,6,Casual Users
93741,137,9,78,4,2,4,10,Promising
94071,413,57,75,3,5,4,12,Loyal Users
94097,217,39,69,3,4,4,11,Loyal Users
94183,1199,45,71,2,4,4,10,At Risk
94213,3678,6,11,1,1,1,3,Lost
94298,13,69,519,5,5,5,15,Champions
94993,509,80,291,2,5,5,12,At Risk
95580,4,17,23,5,3,2,10,Loyal Users
95705,799,32,48,2,4,3,9,At Risk
95945,235,117,439,3,5,5,13,Loyal Users
96214,362,36,55,3,4,3,10,Loyal Users
96241,145,29,74,4,4,4,12,Champions
96296,631,8,20,2,2,2,6,Lost
96300,346,26,34,3,4,3,10,Loyal Users
96362,14,19,26,5,3,2,10,Loyal Users
96391,81,5,8,4,1,1,6,Promising
96504,135,19,46,4,3,3,10,Loyal Users
96858,181,19,74,3,3,4,10,Loyal Users
97292,137,51,113,4,5,4,13,Champions
97372,414,52,135,3,5,4,12,Loyal Users
97481,4210,17,42,1,3,3,7,Casual Users
97488,1529,5,7,1,1,1,3,Lost
97515,804,7,27,2,2,2,6,Lost
97553,1591,12,95,1,3,4,8,Casual Users
97679,91,16,170,4,3,5,12,Loyal Users
98152,92,65,298,4,5,5,14,Champions
98243,236,6,11,3,1,1,5,Casual Users
98491,209,15,43,3,3,3,9,Loyal Users
98588,2,14,55,5,3,3,11,Loyal Users
98710,274,34,125,3,4,4,11,Loyal Users
99060,5175,9,30,1,2,2,5,Lost
99190,413,38,88,3,4,4,11,Loyal Users
99479,2187,9,14,1,2,1,4,Lost
99741,105,110,448,4,5,5,14,Champions
91174,1800,10,21,1,2,2,5,Lost
91489,59,32,88,5,4,4,13,Champions
91875,11,45,165,5,4,5,14,Champions
91938,5,30,66,5,4,4,13,Champions
93295,362,129,632,3,5,5,13,Loyal Users
93392,3,189,519,5,5,5,15,Champions
93878,145,10,40,4,2,3,9,Promising
93897,858,6,7,2,1,1,4,Lost
94182,78,54,226,4,5,5,14,Champions
94719,276,18,20,3,3,2,8,Loyal Users
94834,619,34,72,2,4,4,10,At Risk
94844,319,23,35,3,4,3,10,Loyal Users
94877,3039,20,51,1,3,3,7,Casual Users
95055,678,39,233,2,4,5,11,At Risk
95480,11,25,46,5,4,3,12,Loyal Users
95666,3179,8,8,1,2,1,4,Lost
95685,1215,7,18,2,2,2,6,Lost
95996,489,39,62,2,4,3,9,At Risk
96304,145,73,113,4,5,4,13,Champions
96453,3,55,81,5,5,4,14,Champions
96630,2898,6,33,1,1,3,5,Lost
97009,3,91,430,5,5,5,15,Champions
97020,54,30,84,5,4,4,13,Champions
97089,367,6,11,3,1,1,5,Casual Users
97278,42,43,155,5,4,5,14,Champions
97353,13,45,371,5,4,5,14,Champions
97393,41,82,162,5,5,5,15,Champions
97479,2682,13,32,1,3,3,7,Casual Users
97758,64,12,98,5,3,4,12,Loyal Users
98011,1857,5,21,1,1,2,4,Lost
98014,325,10,48,3,2,3,8,Casual Users
98051,567,10,29,2,2,2,6,Lost
98061,17,43,137,5,4,4,13,Champions
98229,2,77,297,5,5,5,15,Champions
98267,115,8,9,4,2,1,7,Promising
98874,840,11,72,2,2,4,8,Lost
99057,2125,10,38,1,2,3,6,Lost
99142,679,22,119,2,4,4,10,At Risk
99399,3721,9,16,1,2,2,5,Lost
99407,2681,5,17,1,1,2,4,Lost
99444,24,76,205,5,5,5,15,Champions
99467,878,7,10,2,2,1,5,Lost
99501,602,10,11,2,2,1,5,Lost
99569,39,78,348,5,5,5,15,Champions
99590,536,45,185,2,4,5,11,At Risk
99661,123,7,30,4,2,2,8,Promising
99803,21,10,14,5,2,1,8,Promising
99878,1628,10,10,1,2,1,4,Lost
99975,30,82,197,5,5,5,15,Champions
92041,292,62,136,3,5,4,12,Loyal Users
92324,393,21,47,3,3,3,9,Loyal Users
92451,518,22,160,2,4,5,11,At Risk
92602,118,70,159,4,5,5,14,Champions
92781,0,28,37,5,4,3,12,Loyal Users
92971,2503,6,46,1,1,3,5,Lost
93463,2118,17,22,1,3,2,6,Casual Users
93468,172,9,16,3,2,2,7,Casual Users
93549,1102,11,25,2,2,2,6,Lost
93777,8,5,13,5,1,1,7,Promising
94321,107,74,95,4,5,4,13,Champions
94340,80,153,365,4,5,5,14,Champions
94434,30,16,132,5,3,4,12,Loyal Users
94471,473,14,18,2,3,2,7,Casual Users
94889,435,11,18,3,2,2,7,Casual Users
94978,102,28,62,4,4,3,11,Loyal Users
95041,78,12,40,4,3,3,10,Loyal Users
95057,244,11,49,3,2,3,8,Casual Users
95062,8,25,79,5,4,4,13,Champions
95110,96,13,42,4,3,3,10,Loyal Users
95366,51,85,149,5,5,5,15,Champions
95403,233,40,127,3,4,4,11,Loyal Users
95485,3,62,132,5,5,4,14,Champions
95948,0,32,40,5,4,3,12,Loyal Users
96130,1036,14,19,2,3,2,7,Casual Users
96587,5283,6,9,1,1,1,3,Lost
96646,4,61,256,5,5,5,15,Champions
96699,831,11,25,2,2,2,6,Lost
96721,336,22,36,3,4,3,10,Loyal Users
96732,822,7,23,2,2,2,6,Lost
97257,2750,6,21,1,1,2,4,Lost
97328,28,71,109,5,5,4,14,Champions
97445,26,52,100,5,5,4,14,Champions
97607,2265,5,10,1,1,1,3,Lost
97793,366,6,18,3,1,2,6,Casual Users
98182,141,18,61,4,3,3,10,Loyal Users
98261,582,5,9,2,1,1,4,Lost
98753,249,27,38,3,4,3,10,Loyal Users
98758,880,55,252,2,5,5,12,At Risk
99043,17,95,900,5,5,5,15,Champions
99110,1161,6,42,2,1,3,6,Lost
99189,137,34,105,4,4,4,12,Champions
99330,274,11,15,3,2,1,6,Casual Users
99397,566,11,23,2,2,2,6,Lost
99486,216,11,19,3,2,2,7,Casual Users
99854,161,6,8,4,1,1,6,Promising
99875,1102,11,48,2,2,3,7,Lost
99911,5571,5,5,1,1,1,3,Lost
99929,531,29,35,2,4,3,9,At Risk
99999,29,19,37,5,3,3,11,Loyal Users
91123,80,7,9,4,2,1,7,Promising
91323,294,43,102,3,4,4,11,Loyal Users
91539,270,31,68,3,4,4,11,Loyal Users
91614,1662,69,159,1,5,5,11,At Risk
91679,867,34,53,2,4,3,9,At Risk
91810,125,96,225,4,5,5,14,Champions
91846,135,27,92,4,4,4,12,Champions
91972,2710,9,27,1,2,2,5,Lost
92140,1266,10,38,1,2,3,6,Lost
92242,141,5,44,4,1,3,8,Promising
92390,523,38,91,2,4,4,10,At Risk
92943,568,15,17,2,3,2,7,Casual Users
93032,1831,6,11,1,1,1,3,Lost
93106,316,6,12,3,1,1,5,Casual Users
93124,0,79,112,5,5,4,14,Champions
93159,1845,6,23,1,1,2,4,Lost
93298,4821,9,77,1,2,4,7,Lost
93330,940,13,19,2,3,2,7,Casual Users
93535,708,10,48,2,2,3,7,Lost
93667,11,28,72,5,4,4,13,Champions
93696,4,24,58,5,4,3,12,Loyal Users
94057,1290,10,10,1,2,1,4,Lost
94131,681,5,11,2,1,1,4,Lost
94246,23,127,405,5,5,5,15,Champions
94411,1439,5,9,1,1,1,3,Lost
94435,13,8,12,5,2,1,8,Promising
94473,162,31,64,4,4,4,12,Champions
94569,698,5,33,2,1,3,6,Lost
94972,219,31,58,3,4,3,10,Loyal Users
95159,21,26,62,5,4,3,12,Loyal Users
95799,124,120,297,4,5,5,14,Champions
96115,16,122,515,5,5,5,15,Champions
96171,1567,10,13,1,2,1,4,Lost
96246,441,30,70,3,4,4,11,Loyal Users
96877,1314,8,12,1,2,1,4,Lost
97057,36,33,228,5,4,5,14,Champions
97139,2015,5,10,1,1,1,3,Lost
97184,3264,9,28,1,2,2,5,Lost
97649,930,32,61,2,4,3,9,At Risk
97696,863,39,93,2,4,4,10,At Risk
97746,16,13,26,5,3,2,10,Loyal Users
97764,2277,12,14,1,3,1,5,Casual Users
97839,512,5,15,2,1,1,4,Lost
97973,15,16,24,5,3,2,10,Loyal Users
98328,41,13,30,5,3,2,10,Loyal Users
98331,48,52,87,5,5,4,14,Champions
98518,1966,12,13,1,3,1,5,Casual Users
99183,7,98,257,5,5,5,15,Champions
99677,7,116,429,5,5,5,15,Champions
91334,411,19,50,3,3,3,9,Loyal Users
91648,65,133,541,5,5,5,15,Champions
92215,1587,11,25,1,2,2,5,Lost
92328,170,12,23,3,3,2,8,Loyal Users
92582,287,46,86,3,5,4,12,Loyal Users
92968,674,11,24,2,2,2,6,Lost
93002,83,43,102,4,4,4,12,Champions
93169,91,36,87,4,4,4,12,Champions
93175,1520,5,9,1,1,1,3,Lost
93272,386,49,146,3,5,4,12,Loyal Users
93279,4426,6,14,1,1,1,3,Lost
93313,411,6,9,3,1,1,5,Casual Users
93592,2621,5,5,1,1,1,3,Lost
93940,968,16,42,2,3,3,8,Casual Users
95219,8,154,558,5,5,5,15,Champions
95226,91,24,59,4,4,3,11,Loyal Users
95266,91,93,214,4,5,5,14,Champions
95492,134,24,41,4,4,3,11,Loyal Users
95954,2662,8,38,1,2,3,6,Lost
96185,1143,20,36,2,3,3,8,Casual Users
96258,15,91,219,5,5,5,15,Champions
96271,352,8,14,3,2,1,6,Casual Users
96361,2397,10,14,1,2,1,4,Lost
96654,164,41,89,4,4,4,12,Champions
96779,892,7,26,2,2,2,6,Lost
96924,4931,5,15,1,1,1,3,Lost
97060,415,110,225,3,5,5,13,Loyal Users
97168,165,25,179,4,4,5,13,Champions
97236,2374,9,17,1,2,2,5,Lost
97484,233,22,80,3,4,4,11,Loyal Users
97616,399,39,86,3,4,4,11,Loyal Users
97709,4941,5,11,1,1,1,3,Lost
97718,248,103,139,3,5,4,12,Loyal Users
98272,89,41,201,4,4,5,13,Champions
98321,37,128,332,5,5,5,15,Champions
98415,1507,25,70,1,4,4,9,At Risk
99148,1831,5,5,1,1,1,3,Lost
99370,17,214,400,5,5,5,15,Champions
99417,604,19,64,2,3,4,9,Casual Users
99698,1587,6,31,1,1,2,4,Lost
99822,115,70,188,4,5,5,14,Champions
91202,1490,7,19,1,2,2,5,Lost
91247,604,30,110,2,4,4,10,At Risk
91450,414,42,57,3,4,3,10,Loyal Users
91513,222,32,71,3,4,4,11,Loyal Users
91515,63,89,373,5,5,5,15,Champions
91546,188,69,91,3,5,4,12,Loyal Users
91701,213,20,27,3,3,2,8,Loyal Users
91794,12,48,161,5,5,5,15,Champions
91927,0,81,208,5,5,5,15,Champions
91985,282,35,53,3,4,3,10,Loyal Users
92326,64,54,319,5,5,5,15,Champions
92418,3,88,507,5,5,5,15,Champions
92507,679,12,24,2,3,2,7,Casual Users
92517,812,36,119,2,4,4,10,At Risk
92638,47,52,179,5,5,5,15,Champions
93304,1803,20,46,1,3,3,7,Casual Users
93461,2083,5,9,1,1,1,3,Lost
93894,4713,9,26,1,2,2,5,Lost
94052,1778,8,24,1,2,2,5,Lost
94225,599,8,43,2,2,3,7,Lost
94229,13,9,15,5,2,1,8,Promising
94322,427,10,25,3,2,2,7,Casual Users
94548,1307,5,7,1,1,1,3,Lost
94664,305,45,64,3,4,4,11,Loyal Users
94681,274,22,68,3,4,4,11,Loyal Users
95481,532,15,30,2,3,2,7,Casual Users
95660,124,23,48,4,4,3,11,Loyal Users
95855,1637,28,57,1,4,3,8,At Risk
96196,132,12,63,4,3,4,11,Loyal Users
96506,91,10,32,4,2,3,9,Promising
96514,136,8,28,4,2,2,8,Promising
96537,76,41,84,4,4,4,12,Champions
96549,295,7,20,3,2,2,7,Casual Users
96752,277,10,24,3,2,2,7,Casual Users
96950,20,40,57,5,4,3,12,Loyal Users
96996,129,12,51,4,3,3,10,Loyal Users
97335,0,104,293,5,5,5,15,Champions
97554,514,16,27,2,3,2,7,Casual Users
97815,0,143,456,5,5,5,15,Champions
97942,9,53,107,5,5,4,14,Champions
97949,3758,8,11,1,2,1,4,Lost
97987,111,82,259,4,5,5,14,Champions
98283,153,63,201,4,5,5,14,Champions
98544,50,11,25,5,2,2,9,Promising
98623,2283,18,49,1,3,3,7,Casual Users
98830,38,28,48,5,4,3,12,Loyal Users
99106,368,8,15,3,2,1,6,Casual Users
99107,293,12,16,3,3,2,8,Loyal Users
99159,2540,6,20,1,1,2,4,Lost
99223,456,15,66,3,3,4,10,Loyal Users
99415,24,17,62,5,3,3,11,Loyal Users
99509,88,46,140,4,5,4,13,Champions
99690,1744,9,26,1,2,2,5,Lost
99760,213,54,109,3,5,4,12,Loyal Users
99898,957,18,23,2,3,2,7,Casual Users
91142,641,8,8,2,2,1,5,Lost
91192,281,34,71,3,4,4,11,Loyal Users
91248,1536,17,36,1,3,3,7,Casual Users
91573,645,19,35,2,3,3,8,Casual Users
92600,16,49,103,5,5,4,14,Champions
92694,6085,5,19,1,1,2,4,Lost
92811,140,17,94,4,3,4,11,Loyal Users
93013,725,47,54,2,5,3,10,At Risk
93502,75,53,165,4,5,5,14,Champions
93539,309,49,107,3,5,4,12,Loyal Users
93799,341,189,281,3,5,5,13,Loyal Users
93931,2689,16,36,1,3,3,7,Casual Users
94247,98,67,164,4,5,5,14,Champions
94579,25,88,137,5,5,4,14,Champions
94730,322,7,16,3,2,2,7,Casual Users
94748,2,110,178,5,5,5,15,Champions
94855,133,5,93,4,1,4,9,Promising
95100,127,35,131,4,4,4,12,Champions
95207,431,5,8,3,1,1,5,Casual Users
95329,400,15,22,3,3,2,8,Loyal Users
95747,66,81,155,5,5,5,15,Champions
95807,158,12,43,4,3,3,10,Loyal Users
95812,107,13,18,4,3,2,9,Loyal Users
95928,98,12,40,4,3,3,10,Loyal Users
96082,837,9,22,2,2,2,6,Lost
96437,188,47,154,3,5,5,13,Loyal Users
96573,3019,20,32,1,3,3,7,Casual Users
96738,184,108,345,3,5,5,13,Loyal Users
97148,107,19,62,4,3,3,10,Loyal Users
97341,69,86,280,5,5,5,15,Champions
97957,87,80,294,4,5,5,14,Champions
98287,6,11,56,5,2,3,10,Promising
98586,2,25,34,5,4,3,12,Loyal Users
98722,11,102,393,5,5,5,15,Champions
98837,19,78,342,5,5,5,15,Champions
98838,974,8,61,2,2,3,7,Lost
98845,211,11,145,3,2,4,9,Casual Users
99114,874,10,23,2,2,2,6,Lost
99240,232,25,49,3,4,3,10,Loyal Users
91172,1271,11,25,1,2,2,5,Lost
91767,3471,140,524,1,5,5,11,At Risk
91832,1847,20,31,1,3,2,6,Casual Users
92223,868,13,60,2,3,3,8,Casual Users
92672,114,7,13,4,2,1,7,Promising
92705,28,22,45,5,4,3,12,Loyal Users
93919,403,26,141,3,4,4,11,Loyal Users
93928,132,73,155,4,5,5,14,Champions
94254,3,29,37,5,4,3,12,Loyal Users
94563,21,19,34,5,3,3,11,Loyal Users
94665,153,15,24,4,3,2,9,Loyal Users
94703,946,9,35,2,2,3,7,Lost
94878,167,15,42,3,3,3,9,Loyal Users
95255,269,29,113,3,4,4,11,Loyal Users
95534,29,75,362,5,5,5,15,Champions
95737,490,18,112,2,3,4,9,Casual Users
95842,886,30,39,2,4,3,9,At Risk
96070,1996,10,12,1,2,1,4,Lost
96147,29,57,143,5,5,4,14,Champions
96232,4665,6,11,1,1,1,3,Lost
96244,4,33,64,5,4,4,13,Champions
96355,257,5,6,3,1,1,5,Casual Users
96500,116,91,235,4,5,5,14,Champions
96959,801,32,171,2,4,5,11,At Risk
97011,27,47,103,5,5,4,14,Champions
97492,44,99,290,5,5,5,15,Champions
97777,424,22,33,3,4,3,10,Loyal Users
97812,122,54,294,4,5,5,14,Champions
98264,143,123,250,4,5,5,14,Champions
98268,468,9,17,3,2,2,7,Casual Users
98382,2533,5,6,1,1,1,3,Lost
98450,187,40,108,3,4,4,11,Loyal Users
98500,2,111,738,5,5,5,15,Champions
98530,1715,5,33,1,1,3,5,Lost
98685,1829,12,47,1,3,3,7,Casual Users
98829,0,176,430,5,5,5,15,Champions
98999,279,28,54,3,4,3,10,Loyal Users
99019,2155,16,73,1,3,4,8,Casual Users
99483,3852,30,37,1,4,3,8,At Risk
99810,4532,10,26,1,2,2,5,Lost
91161,271,12,15,3,3,1,7,Loyal Users
91162,10,45,88,5,4,4,13,Champions
91499,1126,14,49,2,3,3,8,Casual Users
91549,984,5,6,2,1,1,4,Lost
91668,1003,17,27,2,3,2,7,Casual Users
91925,37,49,148,5,5,5,15,Champions
91962,49,83,368,5,5,5,15,Champions
91965,307,15,31,3,3,2,8,Loyal Users
92113,232,10,41,3,2,3,8,Casual Users
92231,46,49,510,5,5,5,15,Champions
92770,49,30,149,5,4,5,14,Champions
92774,274,8,78,3,2,4,9,Casual Users
93067,283,16,62,3,3,3,9,Loyal Users
93388,76,86,355,4,5,5,14,Champions
93746,13,21,47,5,3,3,11,Loyal Users
94012,107,60,115,4,5,4,13,Champions
94035,4123,6,26,1,1,2,4,Lost
94065,3750,11,27,1,2,2,5,Lost
94116,35,191,532,5,5,5,15,Champions
94125,5936,9,29,1,2,2,5,Lost
94631,224,13,18,3,3,2,8,Loyal Users
94823,1887,7,8,1,2,1,4,Lost
94903,348,41,247,3,4,5,12,Loyal Users
95115,954,5,5,2,1,1,4,Lost
95154,99,5,6,4,1,1,6,Promising
95309,272,8,17,3,2,2,7,Casual Users
95963,566,21,92,2,3,4,9,Casual Users
96031,945,13,79,2,3,4,9,Casual Users
96175,1114,114,238,2,5,5,12,At Risk
96786,136,16,65,4,3,4,11,Loyal Users
97088,180,7,26,3,2,2,7,Casual Users
97288,145,38,156,4,4,5,13,Champions
97321,463,5,5,3,1,1,5,Casual Users
97536,4599,6,46,1,1,3,5,Lost
97626,1,68,189,5,5,5,15,Champions
97630,885,14,27,2,3,2,7,Casual Users
97713,1371,20,50,1,3,3,7,Casual Users
97726,842,7,30,2,2,2,6,Lost
97802,87,22,28,4,4,2,10,Loyal Users
97906,83,6,9,4,1,1,6,Promising
97931,165,48,99,4,5,4,13,Champions
98058,719,5,14,2,1,1,4,Lost
98378,293,15,15,3,3,1,7,Loyal Users
98421,445,10,15,3,2,1,6,Casual Users
98786,37,80,216,5,5,5,15,Champions
98816,79,102,293,4,5,5,14,Champions
99195,2122,7,9,1,2,1,4,Lost
99729,611,10,61,2,2,3,7,Lost
99733,119,26,43,4,4,3,11,Loyal Users
99749,1683,25,50,1,4,3,8,At Risk
99824,2,87,200,5,5,5,15,Champions
91143,1374,7,28,1,2,2,5,Lost
91146,3016,5,9,1,1,1,3,Lost
91395,399,5,9,3,1,1,5,Casual Users
91733,104,5,18,4,1,2,7,Promising
91843,868,14,23,2,3,2,7,Casual Users
92062,29,117,363,5,5,5,15,Champions
92174,273,29,55,3,4,3,10,Loyal Users
92256,56,6,29,5,1,2,8,Promising
92272,171,12,83,3,3,4,10,Loyal Users
92810,1647,6,8,1,1,1,3,Lost
92928,769,5,27,2,1,2,5,Lost
93077,2590,6,12,1,1,1,3,Lost
93219,2922,64,114,1,5,4,10,At Risk
93390,107,45,81,4,4,4,12,Champions
93418,807,9,28,2,2,2,6,Lost
93561,4284,18,124,1,3,4,8,Casual Users
93771,1,116,160,5,5,5,15,Champions
93920,541,9,10,2,2,1,5,Lost
93943,1401,20,23,1,3,2,6,Casual Users
93994,287,23,147,3,4,5,12,Loyal Users
94079,36,46,246,5,5,5,15,Champions
94134,274,10,60,3,2,3,8,Casual Users
94325,291,89,168,3,5,5,13,Loyal Users
94494,42,64,145,5,5,4,14,Champions
94560,1713,6,12,1,1,1,3,Lost
94561,168,46,183,3,5,5,13,Loyal Users
94816,17,181,241,5,5,5,15,Champions
94858,142,15,27,4,3,2,9,Loyal Users
95054,303,13,20,3,3,2,8,Loyal Users
95305,228,6,26,3,1,2,6,Casual Users
95342,68,8,29,5,2,2,9,Promising
95389,649,12,42,2,3,3,8,Casual Users
95618,0,134,303,5,5,5,15,Champions
95850,129,101,158,4,5,5,14,Champions
95915,415,9,26,3,2,2,7,Casual Users
96387,240,32,80,3,4,4,11,Loyal Users
96538,59,86,331,5,5,5,15,Champions
96785,104,5,37,4,1,3,8,Promising
97196,3457,6,11,1,1,1,3,Lost
97273,5,65,385,5,5,5,15,Champions
97449,725,18,37,2,3,3,8,Casual Users
97946,124,117,256,4,5,5,14,Champions
98128,23,51,231,5,5,5,15,Champions
98789,2430,11,24,1,2,2,5,Lost
98876,1540,34,43,1,4,3,8,At Risk
99029,1820,14,82,1,3,4,8,Casual Users
99100,678,26,85,2,4,4,10,At Risk
99742,1099,19,34,2,3,3,8,Casual Users
99792,92,89,227,4,5,5,14,Champions
99919,1547,6,14,1,1,1,3,Lost
91531,14,74,128,5,5,4,14,Champions
91590,1850,8,20,1,2,2,5,Lost
91727,4305,7,30,1,2,2,5,Lost
91757,488,7,41,2,2,3,7,Lost
91918,736,17,134,2,3,4,9,Casual Users
91982,424,28,60,3,4,3,10,Loyal Users
92275,4385,36,64,1,4,4,9,At Risk
92292,45,36,65,5,4,4,13,Champions
92496,463,33,71,3,4,4,11,Loyal Users
92823,98,75,118,4,5,4,13,Champions
93044,452,12,120,3,3,4,10,Loyal Users
93059,834,31,80,2,4,4,10,At Risk
93569,124,98,244,4,5,5,14,Champions
93868,418,6,21,3,1,2,6,Casual Users
93901,111,33,47,4,4,3,11,Loyal Users
94420,169,112,214,3,5,5,13,Loyal Users
94738,1850,16,49,1,3,3,7,Casual Users
95077,800,25,100,2,4,4,10,At Risk
95245,17,19,61,5,3,3,11,Loyal Users
95439,114,36,108,4,4,4,12,Champions
95632,388,15,17,3,3,2,8,Loyal Users
95753,1158,9,24,2,2,2,6,Lost
95832,4,7,15,5,2,1,8,Promising
95905,120,16,62,4,3,3,10,Loyal Users
96121,266,22,108,3,4,4,11,Loyal Users
96407,155,28,60,4,4,3,11,Loyal Users
96429,162,120,263,4,5,5,14,Champions
96712,450,15,28,3,3,2,8,Loyal Users
97208,24,46,165,5,5,5,15,Champions
97375,372,84,114,3,5,4,12,Loyal Users
98088,387,19,39,3,3,3,9,Loyal Users
98445,2441,9,12,1,2,1,4,Lost
98495,2603,13,39,1,3,3,7,Casual Users
98579,244,23,70,3,4,4,11,Loyal Users
98754,15,5,7,5,1,1,7,Promising
99357,93,35,63,4,4,4,12,Champions
99421,69,82,322,5,5,5,15,Champions
99585,142,28,83,4,4,4,12,Champions
99748,2135,6,15,1,1,1,3,Lost
99798,82,98,232,4,5,5,14,Champions
99804,172,9,18,3,2,2,7,Casual Users
91286,4,147,313,5,5,5,15,Champions
91300,942,29,109,2,4,4,10,At Risk
91747,20,64,228,5,5,5,15,Champions
91773,668,31,65,2,4,4,10,At Risk
92061,4251,24,58,1,4,3,8,At Risk
92502,176,72,95,3,5,4,12,Loyal Users
92606,29,74,303,5,5,5,15,Champions
92839,0,36,95,5,4,4,13,Champions
93314,4,37,143,5,4,4,13,Champions
93360,2431,8,14,1,2,1,4,Lost
94014,503,10,62,2,2,3,7,Lost
94051,2511,10,27,1,2,2,5,Lost
94088,1276,25,47,1,4,3,8,At Risk
94165,2572,5,9,1,1,1,3,Lost
94310,281,8,13,3,2,1,6,Casual Users
94870,1755,7,10,1,2,1,4,Lost
94997,145,44,276,4,4,5,13,Champions
95020,131,17,40,4,3,3,10,Loyal Users
95327,11,26,55,5,4,3,12,Loyal Users
95468,44,138,287,5,5,5,15,Champions
95475,3554,6,11,1,1,1,3,Lost
95593,94,212,417,4,5,5,14,Champions
95620,8,48,286,5,5,5,15,Champions
96775,841,9,25,2,2,2,6,Lost
96798,1,158,417,5,5,5,15,Champions
97250,1950,10,34,1,2,3,6,Lost
97254,263,9,24,3,2,2,7,Casual Users
97470,473,5,17,2,1,2,5,Lost
97648,1202,17,28,2,3,2,7,Casual Users
97737,3,6,52,5,1,3,9,Promising
98218,576,16,28,2,3,2,7,Casual Users
98223,829,17,49,2,3,3,8,Casual Users
98312,214,8,54,3,2,3,8,Casual Users
98561,113,61,203,4,5,5,14,Champions
98819,120,19,136,4,3,4,11,Loyal Users
98875,3143,8,9,1,2,1,4,Lost
99018,2216,15,50,1,3,3,7,Casual Users
99108,395,6,30,3,1,2,6,Casual Users
99160,799,20,179,2,3,5,10,Casual Users
99288,3401,5,26,1,1,2,4,Lost
99403,94,30,53,4,4,3,11,Loyal Users
99828,658,5,7,2,1,1,4,Lost
99909,4278,6,8,1,1,1,3,Lost
91089,127,7,56,4,2,3,9,Promising
91111,90,55,87,4,5,4,13,Champions
91976,2387,79,188,1,5,5,11,At Risk
92165,104,24,87,4,4,4,12,Champions
92171,125,45,66,4,4,4,12,Champions
92197,326,12,44,3,3,3,9,Loyal Users
92469,409,8,15,3,2,1,6,Casual Users
92685,583,7,8,2,2,1,5,Lost
93151,1134,6,8,2,1,1,4,Lost
93792,1708,7,48,1,2,3,6,Lost
93982,15,61,270,5,5,5,15,Champions
94782,80,30,89,4,4,4,12,Champions
95781,87,49,88,4,5,4,13,Champions
96311,1430,6,8,1,1,1,3,Lost
96464,1095,7,13,2,2,1,5,Lost
96544,3717,6,35,1,1,3,5,Lost
96599,109,7,19,4,2,2,8,Promising
97049,179,8,10,3,2,1,6,Casual Users
97577,141,5,9,4,1,1,6,Promising
97700,4,8,11,5,2,1,8,Promising
97830,86,23,122,4,4,4,12,Champions
97921,937,10,117,2,2,4,8,Lost
98341,1899,11,12,1,2,1,4,Lost
98536,2570,5,5,1,1,1,3,Lost
98688,128,107,218,4,5,5,14,Champions
99063,1821,33,107,1,4,4,9,At Risk
99316,695,17,84,2,3,4,9,Casual Users
99435,2877,5,13,1,1,1,3,Lost
91205,8,18,26,5,3,2,10,Loyal Users
91442,1581,5,7,1,1,1,3,Lost
92125,114,22,68,4,4,4,12,Champions
92179,1805,8,70,1,2,4,7,Lost
92339,95,103,462,4,5,5,14,Champions
92452,382,34,58,3,4,3,10,Loyal Users
92733,106,28,46,4,4,3,11,Loyal Users
93356,16,7,28,5,2,2,9,Promising
93458,76,20,122,4,3,4,11,Loyal Users
93757,414,10,16,3,2,2,7,Casual Users
93842,1280,11,45,1,2,3,6,Lost
94356,150,6,11,4,1,1,6,Promising
94656,120,36,59,4,4,3,11,Loyal Users
94675,161,15,93,4,3,4,11,Loyal Users
94949,13,8,9,5,2,1,8,Promising
94985,132,62,186,4,5,5,14,Champions
95133,410,21,56,3,3,3,9,Loyal Users
95362,133,9,11,4,2,1,7,Promising
95379,1112,17,18,2,3,2,7,Casual Users
95554,102,13,134,4,3,4,11,Loyal Users
96105,627,12,15,2,3,1,6,Casual Users
96165,265,16,109,3,3,4,10,Loyal Users
96370,123,17,50,4,3,3,10,Loyal Users
96449,571,21,39,2,3,3,8,Casual Users
96582,11,7,15,5,2,1,8,Promising
96961,88,29,171,4,4,5,13,Champions
96983,2798,6,48,1,1,3,5,Lost
97270,3,17,83,5,3,4,12,Loyal Users
97301,14,77,108,5,5,4,14,Champions
97356,15,23,163,5,4,5,14,Champions
97563,261,7,15,3,2,1,6,Casual Users
97702,654,18,34,2,3,3,8,Casual Users
97816,1252,29,78,2,4,4,10,At Risk
97835,353,17,30,3,3,2,8,Loyal Users
98177,2843,5,12,1,1,1,3,Lost
98296,1,18,22,5,3,2,10,Loyal Users
98308,786,56,111,2,5,4,11,At Risk
98400,540,14,23,2,3,2,7,Casual Users
98465,1599,13,37,1,3,3,7,Casual Users
98831,708,8,9,2,2,1,5,Lost
98832,1730,9,9,1,2,1,4,Lost
99017,997,14,35,2,3,3,8,Casual Users
99068,506,28,106,2,4,4,10,At Risk
99233,1700,5,11,1,1,1,3,Lost
99349,2364,10,29,1,2,2,5,Lost
99364,3,32,67,5,4,4,13,Champions
99378,5,64,259,5,5,5,15,Champions
99482,65,9,10,5,2,1,8,Promising
99783,24,90,206,5,5,5,15,Champions
91510,113,69,452,4,5,5,14,Champions
91660,11,88,283,5,5,5,15,Champions
91790,526,64,159,2,5,5,12,At Risk
91989,3,20,77,5,3,4,12,Loyal Users
92208,168,152,482,3,5,5,13,Loyal Users
92293,2,129,279,5,5,5,15,Champions
92322,487,49,151,2,5,5,12,At Risk
92438,418,11,37,3,2,3,8,Casual Users
92537,239,46,85,3,5,4,12,Loyal Users
92550,105,28,75,4,4,4,12,Champions
92901,262,103,213,3,5,5,13,Loyal Users
93422,436,17,57,3,3,3,9,Loyal Users
93654,3603,15,16,1,3,2,6,Casual Users
93872,419,9,60,3,2,3,8,Casual Users
94191,570,33,80,2,4,4,10,At Risk
94515,324,16,58,3,3,3,9,Loyal Users
94660,171,25,142,3,4,4,11,Loyal Users
94935,28,47,73,5,5,4,14,Champions
95194,257,40,74,3,4,4,11,Loyal Users
95844,311,85,133,3,5,4,12,Loyal Users
95919,165,9,13,4,2,1,7,Promising
95969,303,6,7,3,1,1,5,Casual Users
95993,242,69,93,3,5,4,12,Loyal Users
96009,120,11,19,4,2,2,8,Promising
96167,224,8,16,3,2,2,7,Casual Users
96399,1575,7,8,1,2,1,4,Lost
96576,4419,5,26,1,1,2,4,Lost
96713,839,25,63,2,4,4,10,At Risk
96753,382,7,39,3,2,3,8,Casual Users
96981,418,5,5,3,1,1,5,Casual Users
97070,807,17,19,2,3,2,7,Casual Users
97083,659,16,34,2,3,3,8,Casual Users
97164,2985,10,58,1,2,3,6,Lost
97824,2527,10,12,1,2,1,4,Lost
97908,3,27,133,5,4,4,13,Champions
98170,979,11,39,2,2,3,7,Lost
98256,54,5,9,5,1,1,7,Promising
98336,3287,8,19,1,2,2,5,Lost
98809,8,61,156,5,5,5,15,Champions
98825,267,9,24,3,2,2,7,Casual Users
98974,97,5,30,4,1,2,7,Promising
99146,108,12,60,4,3,3,10,Loyal Users
99314,258,49,208,3,5,5,13,Loyal Users
99611,126,15,44,4,3,3,10,Loyal Users
91620,1523,15,111,1,3,4,8,Casual Users
91630,125,123,215,4,5,5,14,Champions
92264,809,13,39,2,3,3,8,Casual Users
92349,69,113,556,5,5,5,15,Champions
92442,3,50,127,5,5,4,14,Champions
92592,545,10,14,2,2,1,5,Lost
93053,144,31,53,4,4,3,11,Loyal Users
93423,3170,9,10,1,2,1,4,Lost
93508,332,5,8,3,1,1,5,Casual Users
93853,29,48,106,5,5,4,14,Champions
93881,420,5,12,3,1,1,5,Casual Users
94033,3994,41,93,1,4,4,9,At Risk
94407,107,22,37,4,4,3,11,Loyal Users
95271,7,44,168,5,4,5,14,Champions
95430,1907,15,29,1,3,2,6,Casual Users
95521,140,64,161,4,5,5,14,Champions
95578,285,5,14,3,1,1,5,Casual Users
96836,145,15,63,4,3,4,11,Loyal Users
97154,1124,6,44,2,1,3,6,Lost
97284,1693,7,13,1,2,1,4,Lost
97475,17,15,47,5,3,3,11,Loyal Users
97624,1093,12,15,2,3,1,6,Casual Users
97699,520,8,10,2,2,1,5,Lost
97703,1121,11,26,2,2,2,6,Lost
97869,191,101,366,3,5,5,13,Loyal Users
97883,656,5,6,2,1,1,4,Lost
97922,688,8,29,2,2,2,6,Lost
97925,124,11,35,4,2,3,9,Promising
98361,586,13,28,2,3,2,7,Casual Users
98610,4099,6,10,1,1,1,3,Lost
98864,485,10,15,2,2,1,5,Lost
98949,14,38,146,5,4,4,13,Champions
99299,1248,8,38,2,2,3,7,Lost
99586,129,44,110,4,4,4,12,Champions
99663,116,74,119,4,5,4,13,Champions
99709,181,20,65,3,3,4,10,Loyal Users
99719,1026,9,24,2,2,2,6,Lost
99740,138,17,35,4,3,3,10,Loyal Users
99763,278,29,46,3,4,3,10,Loyal Users
99974,5,35,77,5,4,4,13,Champions
91409,547,8,71,2,2,4,8,Lost
91706,1398,22,103,1,4,4,9,At Risk
91835,1655,10,62,1,2,3,6,Lost
92249,422,136,460,3,5,5,13,Loyal Users
92289,9,122,499,5,5,5,15,Champions
93043,2012,64,124,1,5,4,10,At Risk
93081,312,47,76,3,5,4,12,Loyal Users
93339,1083,7,33,2,2,3,7,Lost
93722,88,13,14,4,3,1,8,Loyal Users
93788,1525,6,18,1,1,2,4,Lost
93841,285,24,59,3,4,3,10,Loyal Users
94124,343,66,98,3,5,4,12,Loyal Users
94136,380,6,9,3,1,1,5,Casual Users
94203,5404,6,7,1,1,1,3,Lost
94365,160,18,25,4,3,2,9,Loyal Users
94391,134,35,55,4,4,3,11,Loyal Users
94657,6,40,123,5,4,4,13,Champions
94734,842,6,37,2,1,3,6,Lost
94845,3234,5,46,1,1,3,5,Lost
95598,385,23,139,3,4,4,11,Loyal Users
95625,57,41,57,5,4,3,12,Loyal Users
95982,57,135,360,5,5,5,15,Champions
96193,113,10,69,4,2,4,10,Promising
96458,61,20,25,5,3,2,10,Loyal Users
96510,122,24,34,4,4,3,11,Loyal Users
96710,11,17,24,5,3,2,10,Loyal Users
96845,1277,47,97,1,5,4,10,At Risk
96850,247,40,58,3,4,3,10,Loyal Users
96880,3361,6,10,1,1,1,3,Lost
97403,283,88,136,3,5,4,12,Loyal Users
97537,14,54,103,5,5,4,14,Champions
97688,347,16,105,3,3,4,10,Loyal Users
97736,1732,21,61,1,3,3,7,Casual Users
98026,1240,28,75,2,4,4,10,At Risk
98270,649,6,20,2,1,2,5,Lost
98519,413,15,23,3,3,2,8,Loyal Users
98564,143,33,86,4,4,4,12,Champions
98806,396,5,7,3,1,1,5,Casual Users
98813,3,71,97,5,5,4,14,Champions
98990,2260,8,9,1,2,1,4,Lost
98998,1893,8,10,1,2,1,4,Lost
99247,2,52,156,5,5,5,15,Champions
99313,1309,8,14,1,2,1,4,Lost
99379,24,16,71,5,3,4,12,Loyal Users
99436,350,8,12,3,2,1,6,Casual Users
99502,5,6,22,5,1,2,8,Promising
99532,57,84,361,5,5,5,15,Champions
99578,15,74,126,5,5,4,14,Champions
99636,2,79,576,5,5,5,15,Champions
99745,101,23,97,4,4,4,12,Champions
99795,91,159,592,4,5,5,14,Champions
99950,28,9,14,5,2,1,8,Promising
91218,530,36,133,2,4,4,10,At Risk
91293,421,46,78,3,5,4,12,Loyal Users
91402,1599,10,100,1,2,4,7,Lost
91437,4563,5,15,1,1,1,3,Lost
91501,89,17,29,4,3,2,9,Loyal Users
91543,75,48,140,4,5,4,13,Champions
91650,91,15,32,4,3,3,10,Loyal Users
92216,96,140,215,4,5,5,14,Champions
92512,679,9,9,2,2,1,5,Lost
92691,407,12,40,3,3,3,9,Loyal Users
92776,227,5,7,3,1,1,5,Casual Users
92840,42,42,216,5,4,5,14,Champions
93189,577,5,5,2,1,1,4,Lost
93212,3483,14,82,1,3,4,8,Casual Users
93883,1295,8,26,1,2,2,5,Lost
94001,59,9,18,5,2,2,9,Promising
94232,123,21,42,4,3,3,10,Loyal Users
94378,487,100,117,2,5,4,11,At Risk
94385,69,141,282,5,5,5,15,Champions
94619,665,37,82,2,4,4,10,At Risk
94773,2886,11,13,1,2,1,4,Lost
94948,3300,7,10,1,2,1,4,Lost
95086,14,27,35,5,4,3,12,Loyal Users
95161,270,7,13,3,2,1,6,Casual Users
95205,75,102,307,4,5,5,14,Champions
95296,1548,32,106,1,4,4,9,At Risk
95388,271,16,21,3,3,2,8,Loyal Users
95546,11,162,328,5,5,5,15,Champions
95616,247,38,88,3,4,4,11,Loyal Users
95671,244,11,31,3,2,2,7,Casual Users
95918,7,88,300,5,5,5,15,Champions
96359,1458,7,7,1,2,1,4,Lost
96386,96,27,52,4,4,3,11,Loyal Users
96390,18,11,29,5,2,2,9,Promising
96439,370,23,39,3,4,3,10,Loyal Users
96589,287,30,53,3,4,3,10,Loyal Users
96626,657,8,8,2,2,1,5,Lost
96816,996,12,22,2,3,2,7,Casual Users
96868,5677,6,16,1,1,2,4,Lost
97175,17,21,68,5,3,4,12,Loyal Users
97223,1327,13,54,1,3,3,7,Casual Users
97361,526,33,141,2,4,4,10,At Risk
97444,51,6,8,5,1,1,7,Promising
97750,504,27,49,2,4,3,9,At Risk
97971,299,10,23,3,2,2,7,Casual Users
98281,8,25,38,5,4,3,12,Loyal Users
98386,23,22,142,5,4,4,13,Champions
98570,284,30,94,3,4,4,11,Loyal Users
98739,17,20,63,5,3,4,12,Loyal Users
98764,2683,30,42,1,4,3,8,At Risk
98774,125,123,237,4,5,5,14,Champions
99021,91,138,446,4,5,5,14,Champions
99392,81,35,201,4,4,5,13,Champions
99443,858,7,35,2,2,3,7,Lost
99485,98,140,218,4,5,5,14,Champions
99944,60,102,304,5,5,5,15,Champions
91209,2611,13,29,1,3,2,6,Casual Users
91645,1473,8,71,1,2,4,7,Lost
92033,104,38,53,4,4,3,11,Loyal Users
92039,26,58,397,5,5,5,15,Champions
92143,69,14,42,5,3,3,11,Loyal Users
92286,7,56,199,5,5,5,15,Champions
92641,69,7,13,5,2,1,8,Promising
92701,149,88,1017,4,5,5,14,Champions
92843,295,16,22,3,3,2,8,Loyal Users
93185,9,117,316,5,5,5,15,Champions
93379,187,75,162,3,5,5,13,Loyal Users
93805,489,14,50,2,3,3,8,Casual Users
94145,389,29,135,3,4,4,11,Loyal Users
94146,1694,5,9,1,1,1,3,Lost
94406,139,34,55,4,4,3,11,Loyal Users
94412,93,19,87,4,3,4,11,Loyal Users
94555,50,70,315,5,5,5,15,Champions
94610,2104,6,10,1,1,1,3,Lost
94951,6,51,146,5,5,4,14,Champions
95325,175,19,122,3,3,4,10,Loyal Users
95693,8,88,469,5,5,5,15,Champions
95956,431,6,16,3,1,2,6,Casual Users
96638,3940,17,18,1,3,2,6,Casual Users
96736,794,41,81,2,4,4,10,At Risk
96814,94,10,21,4,2,2,8,Promising
97161,105,101,841,4,5,5,14,Champions
97870,225,13,33,3,3,3,9,Loyal Users
98213,113,67,132,4,5,4,13,Champions
98217,843,11,11,2,2,1,5,Lost
98343,154,12,54,4,3,3,10,Loyal Users
98574,26,37,47,5,4,3,12,Loyal Users
98576,136,92,184,4,5,5,14,Champions
98647,1911,6,16,1,1,2,4,Lost
98670,137,27,80,4,4,4,12,Champions
98686,273,9,10,3,2,1,6,Casual Users
98844,72,148,704,4,5,5,14,Champions
99156,517,18,48,2,3,3,8,Casual Users
99194,91,46,408,4,5,5,14,Champions
99366,238,10,26,3,2,2,7,Casual Users
99645,13,57,338,5,5,5,15,Champions
99660,680,18,40,2,3,3,8,Casual Users
99747,1796,13,28,1,3,2,6,Casual Users
99931,267,18,33,3,3,3,9,Loyal Users
91382,232,63,168,3,5,5,13,Loyal Users
91482,654,11,15,2,2,1,5,Lost
91503,1847,15,49,1,3,3,7,Casual Users
91509,340,5,52,3,1,3,7,Casual Users
91518,174,76,400,3,5,5,13,Loyal Users
91762,164,17,114,4,3,4,11,Loyal Users
92019,107,27,62,4,4,3,11,Loyal Users
92202,4862,13,65,1,3,4,8,Casual Users
92392,62,21,75,5,3,4,12,Loyal Users
92576,990,49,90,2,5,4,11,At Risk
92979,23,31,35,5,4,3,12,Loyal Users
93136,397,6,8,3,1,1,5,Casual Users
93323,3108,8,94,1,2,4,7,Lost
93429,72,71,284,4,5,5,14,Champions
93582,94,6,11,4,1,1,6,Promising
93637,447,5,18,3,1,2,6,Casual Users
93647,188,11,21,3,2,2,7,Casual Users
93673,549,8,11,2,2,1,5,Lost
93789,1262,5,7,1,1,1,3,Lost
93986,216,24,35,3,4,3,10,Loyal Users
94040,90,33,227,4,4,5,13,Champions
94230,836,6,20,2,1,2,5,Lost
94483,26,166,803,5,5,5,15,Champions
95001,13,72,242,5,5,5,15,Champions
95233,992,7,44,2,2,3,7,Lost
95834,1135,11,23,2,2,2,6,Lost
95863,75,50,81,4,5,4,13,Champions
95925,30,44,236,5,4,5,14,Champions
96004,2306,5,7,1,1,1,3,Lost
96061,545,6,15,2,1,1,4,Lost
96085,408,27,69,3,4,4,11,Loyal Users
96141,234,26,167,3,4,5,12,Loyal Users
96144,15,107,212,5,5,5,15,Champions
96303,15,61,217,5,5,5,15,Champions
96306,39,123,521,5,5,5,15,Champions
96371,2433,6,8,1,1,1,3,Lost
96530,443,20,63,3,3,4,10,Loyal Users
96561,124,7,24,4,2,2,8,Promising
96571,191,6,8,3,1,1,5,Casual Users
96580,313,39,82,3,4,4,11,Loyal Users
96768,2,142,690,5,5,5,15,Champions
97018,11,16,30,5,3,2,10,Loyal Users
97031,44,12,20,5,3,2,10,Loyal Users
97334,2146,18,22,1,3,2,6,Casual Users
97619,21,39,53,5,4,3,12,Loyal Users
97861,220,6,11,3,1,1,5,Casual Users
98025,196,98,319,3,5,5,13,Loyal Users
98344,11,56,160,5,5,5,15,Champions
98454,569,8,16,2,2,2,6,Lost
98713,424,9,17,3,2,2,7,Casual Users
98858,1742,5,12,1,1,1,3,Lost
99025,113,8,75,4,2,4,10,Promising
99185,1291,9,70,1,2,4,7,Lost
99627,1373,6,6,1,1,1,3,Lost
99870,2554,6,17,1,1,2,4,Lost
99907,113,12,36,4,3,3,10,Loyal Users
99961,1,54,198,5,5,5,15,Champions
91102,140,11,122,4,2,4,10,Promising
91168,710,35,59,2,4,3,9,At Risk
91270,122,16,22,4,3,2,9,Loyal Users
91390,2088,8,13,1,2,1,4,Lost
91397,2,39,88,5,4,4,13,Champions
91570,3704,8,18,1,2,2,5,Lost
91834,687,10,95,2,2,4,8,Lost
92014,113,55,317,4,5,5,14,Champions
92166,139,32,113,4,4,4,12,Champions
92714,135,140,827,4,5,5,14,Champions
92804,1307,7,17,1,2,2,5,Lost
92882,77,75,353,4,5,5,14,Champions
92991,7,33,125,5,4,4,13,Champions
93006,5,102,668,5,5,5,15,Champions
93261,104,39,326,4,4,5,13,Champions
93269,3704,11,39,1,2,3,6,Lost
93516,8,130,217,5,5,5,15,Champions
93780,2033,23,115,1,4,4,9,At Risk
93884,66,166,599,5,5,5,15,Champions
94445,30,102,524,5,5,5,15,Champions
94616,96,63,536,4,5,5,14,Champions
94654,387,12,32,3,3,3,9,Loyal Users
94709,174,26,63,3,4,4,11,Loyal Users
94970,154,13,93,4,3,4,11,Loyal Users
95007,1588,8,8,1,2,1,4,Lost
95094,2130,8,11,1,2,1,4,Lost
95927,172,17,136,3,3,4,10,Loyal Users
96655,78,53,187,4,5,5,14,Champions
96689,123,62,139,4,5,4,13,Champions
96875,29,9,25,5,2,2,9,Promising
97078,4700,10,26,1,2,2,5,Lost
97202,130,65,482,4,5,5,14,Champions
97233,208,30,122,3,4,4,11,Loyal Users
97316,1483,6,7,1,1,1,3,Lost
97440,305,5,7,3,1,1,5,Casual Users
97629,1254,35,289,2,4,5,11,At Risk
97795,130,5,9,4,1,1,6,Promising
97991,619,29,85,2,4,4,10,At Risk
98117,65,41,125,5,4,4,13,Champions
98506,1311,25,50,1,4,3,8,At Risk
98590,65,81,322,5,5,5,15,Champions
98633,128,32,153,4,4,5,13,Champions
98691,425,24,125,3,4,4,11,Loyal Users
99076,4,8,45,5,2,3,10,Promising
99138,4298,9,9,1,2,1,4,Lost
99164,359,31,70,3,4,4,11,Loyal Users
99348,10,89,456,5,5,5,15,Champions
99609,103,74,263,4,5,5,14,Champions
91467,333,5,6,3,1,1,5,Casual Users
91486,556,30,58,2,4,3,9,At Risk
91490,662,14,25,2,3,2,7,Casual Users
91713,26,65,252,5,5,5,15,Champions
91895,1123,68,289,2,5,5,12,At Risk
91923,16,54,289,5,5,5,15,Champions
92267,231,15,111,3,3,4,10,Loyal Users
92478,17,53,178,5,5,5,15,Champions
92729,1858,5,6,1,1,1,3,Lost
93146,1407,14,134,1,3,4,8,Casual Users
93284,27,6,41,5,1,3,9,Promising
93307,120,128,834,4,5,5,14,Champions
93381,112,16,59,4,3,3,10,Loyal Users
93434,11,32,60,5,4,3,12,Loyal Users
93467,1804,8,71,1,2,4,7,Lost
93737,98,128,263,4,5,5,14,Champions
94245,863,13,29,2,3,2,7,Casual Users
94304,3439,7,7,1,2,1,4,Lost
94344,14,85,149,5,5,5,15,Champions
94832,1825,16,69,1,3,4,8,Casual Users
95006,14,59,151,5,5,5,15,Champions
95071,289,6,11,3,1,1,5,Casual Users
95275,671,12,27,2,3,2,7,Casual Users
95555,4486,17,58,1,3,3,7,Casual Users
95769,1045,11,32,2,2,3,7,Lost
95895,275,74,133,3,5,4,12,Loyal Users
95904,1560,6,8,1,1,1,3,Lost
96733,1541,5,19,1,1,2,4,Lost
97156,142,16,64,4,3,4,11,Loyal Users
97342,139,7,10,4,2,1,7,Promising
97405,123,5,16,4,1,2,7,Promising
97463,15,8,57,5,2,3,10,Promising
97731,407,22,84,3,4,4,11,Loyal Users
97743,213,12,13,3,3,1,7,Loyal Users
97748,1136,8,13,2,2,1,5,Lost
97805,1708,5,16,1,1,2,4,Lost
98704,251,8,57,3,2,3,8,Casual Users
98776,83,25,81,4,4,4,12,Champions
98917,38,39,214,5,4,5,14,Champions
98969,92,20,67,4,3,4,11,Loyal Users
98972,2082,8,35,1,2,3,6,Lost
99031,11,35,67,5,4,4,13,Champions
99671,5,77,173,5,5,5,15,Champions
99790,838,25,106,2,4,4,10,At Risk
91157,79,8,9,4,2,1,7,Promising
91297,727,16,22,2,3,2,7,Casual Users
91907,1049,12,71,2,3,4,9,Casual Users
91971,21,65,121,5,5,4,14,Champions
92146,747,5,7,2,1,1,4,Lost
92461,622,14,30,2,3,2,7,Casual Users
92706,1264,5,22,1,1,2,4,Lost
92724,2282,7,10,1,2,1,4,Lost
92925,121,8,22,4,2,2,8,Promising
93031,1697,5,57,1,1,3,5,Lost
93042,4,83,346,5,5,5,15,Champions
93357,146,14,35,4,3,3,10,Loyal Users
93417,295,9,138,3,2,4,9,Casual Users
93815,254,6,29,3,1,2,6,Casual Users
94044,1826,102,469,1,5,5,11,At Risk
94478,619,8,10,2,2,1,5,Lost
94559,873,9,21,2,2,2,6,Lost
94602,109,9,38,4,2,3,9,Promising
94973,102,30,54,4,4,3,11,Loyal Users
95023,116,208,354,4,5,5,14,Champions
95164,9,220,438,5,5,5,15,Champions
95217,693,7,51,2,2,3,7,Lost
95514,2,73,157,5,5,5,15,Champions
95585,258,222,497,3,5,5,13,Loyal Users
95653,526,15,78,2,3,4,9,Casual Users
96103,1385,6,7,1,1,1,3,Lost
96106,294,10,51,3,2,3,8,Casual Users
96189,1146,5,31,2,1,2,5,Lost
96432,3103,8,8,1,2,1,4,Lost
96600,10,32,64,5,4,4,13,Champions
96867,1736,6,17,1,1,2,4,Lost
96902,12,122,358,5,5,5,15,Champions
97027,136,38,69,4,4,4,12,Champions
97162,305,18,32,3,3,3,9,Loyal Users
97231,647,7,9,2,2,1,5,Lost
97260,10,52,110,5,5,4,14,Champions
97989,250,12,18,3,3,2,8,Loyal Users
98161,467,21,35,3,3,3,9,Loyal Users
98200,72,59,263,4,5,5,14,Champions
98246,125,36,63,4,4,4,12,Champions
99102,3,33,114,5,4,4,13,Champions
99250,528,15,53,2,3,3,8,Casual Users
99651,2712,9,16,1,2,2,5,Lost
99705,134,14,18,4,3,2,9,Loyal Users
99717,62,20,169,5,3,5,13,Loyal Users
91363,1,56,203,5,5,5,15,Champions
91460,2151,10,17,1,2,2,5,Lost
91604,638,5,14,2,1,1,4,Lost
92139,2544,32,78,1,4,4,9,At Risk
92529,1528,5,17,1,1,2,4,Lost
92832,429,5,11,3,1,1,5,Casual Users
92873,1287,13,39,1,3,3,7,Casual Users
93027,2072,9,18,1,2,2,5,Lost
93028,2623,5,5,1,1,1,3,Lost
93297,48,17,197,5,3,5,13,Loyal Users
93367,287,30,87,3,4,4,11,Loyal Users
93375,7,24,38,5,4,3,12,Loyal Users
93405,1,169,912,5,5,5,15,Champions
93537,1692,25,117,1,4,4,9,At Risk
94026,384,29,295,3,4,5,12,Loyal Users
94565,718,28,64,2,4,4,10,At Risk
94587,17,25,44,5,4,3,12,Loyal Users
94930,1165,15,29,2,3,2,7,Casual Users
94931,669,21,42,2,3,3,8,Casual Users
95053,8,23,116,5,4,4,13,Champions
95153,152,72,197,4,5,5,14,Champions
95173,52,26,64,5,4,4,13,Champions
95183,1806,6,10,1,1,1,3,Lost
95370,1145,7,14,2,2,1,5,Lost
95647,1951,24,79,1,4,4,9,At Risk
95652,137,6,14,4,1,1,6,Promising
96089,91,5,6,4,1,1,6,Promising
96424,450,11,33,3,2,3,8,Casual Users
96702,66,47,86,5,5,4,14,Champions
97064,494,56,100,2,5,4,11,At Risk
97246,170,18,40,3,3,3,9,Loyal Users
97433,23,45,147,5,4,5,14,Champions
97490,133,105,173,4,5,5,14,Champions
97651,2915,7,14,1,2,1,4,Lost
97966,674,6,13,2,1,1,4,Lost
98353,121,16,102,4,3,4,11,Loyal Users
98471,117,20,22,4,3,2,9,Loyal Users
98719,154,28,56,4,4,3,11,Loyal Users
98805,264,37,166,3,4,5,12,Loyal Users
98863,83,138,242,4,5,5,14,Champions
99333,52,37,166,5,4,5,14,Champions
99393,146,55,109,4,5,4,13,Champions
99722,317,8,18,3,2,2,7,Casual Users
91071,10,73,534,5,5,5,15,Champions
91169,4465,6,13,1,1,1,3,Lost
91176,117,24,66,4,4,4,12,Champions
91231,62,10,21,5,2,2,9,Promising
91277,417,40,79,3,4,4,11,Loyal Users
91392,789,15,61,2,3,3,8,Casual Users
91505,85,212,526,4,5,5,14,Champions
91722,3115,5,8,1,1,1,3,Lost
91735,2289,31,47,1,4,3,8,At Risk
92844,859,41,116,2,4,4,10,At Risk
92845,138,16,68,4,3,4,11,Loyal Users
93014,6,5,9,5,1,1,7,Promising
93113,409,19,59,3,3,3,9,Loyal Users
93228,4750,5,6,1,1,1,3,Lost
93383,1264,60,92,1,5,4,10,At Risk
93480,138,5,11,4,1,1,6,Promising
93959,1000,17,44,2,3,3,8,Casual Users
93989,19,174,374,5,5,5,15,Champions
94263,226,38,80,3,4,4,11,Loyal Users
94398,537,55,80,2,5,4,11,At Risk
94636,121,16,55,4,3,3,10,Loyal Users
94698,125,6,47,4,1,3,8,Promising
94790,255,31,81,3,4,4,11,Loyal Users
94956,497,35,49,2,4,3,9,At Risk
95000,34,35,42,5,4,3,12,Loyal Users
95261,277,6,8,3,1,1,5,Casual Users
95352,90,8,85,4,2,4,10,Promising
95385,48,66,170,5,5,5,15,Champions
95484,379,21,40,3,3,3,9,Loyal Users
95545,2849,5,10,1,1,1,3,Lost
95619,436,39,139,3,4,4,11,Loyal Users
95641,955,20,75,2,3,4,9,Casual Users
95967,1686,5,13,1,1,1,3,Lost
96286,131,64,185,4,5,5,14,Champions
96323,116,5,5,4,1,1,6,Promising
96474,571,11,24,2,2,2,6,Lost
96610,482,7,12,2,2,1,5,Lost
96657,130,12,47,4,3,3,10,Loyal Users
96761,274,12,13,3,3,1,7,Loyal Users
97397,436,45,260,3,4,5,12,Loyal Users
97442,30,57,324,5,5,5,15,Champions
97512,1121,21,52,2,3,3,8,Casual Users
97585,846,10,32,2,2,3,7,Lost
97932,20,82,688,5,5,5,15,Champions
98646,365,6,9,3,1,1,5,Casual Users
99208,28,34,49,5,4,3,12,Loyal Users
99257,78,8,24,4,2,2,8,Promising
99439,305,54,122,3,5,4,12,Loyal Users
99480,4,100,181,5,5,5,15,Champions
99498,406,29,51,3,4,3,10,Loyal Users
99901,472,9,20,2,2,2,6,Lost
91164,404,40,159,3,4,5,12,Loyal Users
91178,302,59,64,3,5,4,12,Loyal Users
91580,79,15,49,4,3,3,10,Loyal Users
91662,0,6,25,5,1,2,8,Promising
91758,1411,8,12,1,2,1,4,Lost
92092,1611,8,44,1,2,3,6,Lost
92544,1021,6,38,2,1,3,6,Lost
92669,673,23,58,2,4,3,9,At Risk
92898,133,115,175,4,5,5,14,Champions
93260,1739,12,48,1,3,3,7,Casual Users
93400,107,105,421,4,5,5,14,Champions
93555,1,155,405,5,5,5,15,Champions
93635,23,15,19,5,3,2,10,Loyal Users
93836,204,24,110,3,4,4,11,Loyal Users
94087,130,8,16,4,2,2,8,Promising
94397,3240,8,33,1,2,3,6,Lost
94450,97,57,216,4,5,5,14,Champions
94755,672,35,66,2,4,4,10,At Risk
95191,38,105,547,5,5,5,15,Champions
95696,444,12,54,3,3,3,9,Loyal Users
96132,1334,7,24,1,2,2,5,Lost
96157,929,13,128,2,3,4,9,Casual Users
96176,1716,7,34,1,2,3,6,Lost
96310,1393,28,31,1,4,2,7,At Risk
96377,958,6,21,2,1,2,5,Lost
96546,186,7,26,3,2,2,7,Casual Users
96570,518,16,107,2,3,4,9,Casual Users
96724,1765,5,5,1,1,1,3,Lost
96755,122,14,21,4,3,2,9,Loyal Users
96904,408,23,41,3,4,3,10,Loyal Users
96940,104,96,185,4,5,5,14,Champions
97108,22,52,89,5,5,4,14,Champions
97507,145,11,48,4,2,3,9,Promising
97552,139,7,11,4,2,1,7,Promising
97605,199,21,108,3,3,4,10,Loyal Users
97914,141,22,57,4,4,3,11,Loyal Users
98116,0,149,679,5,5,5,15,Champions
98204,65,87,597,5,5,5,15,Champions
98257,162,9,48,4,2,3,9,Promising
98918,854,12,24,2,3,2,7,Casual Users
98939,1321,7,38,1,2,3,6,Lost
98955,243,79,282,3,5,5,13,Loyal Users
99255,478,15,18,2,3,2,7,Casual Users
99346,725,35,132,2,4,4,10,At Risk
99433,880,5,7,2,1,1,4,Lost
99512,1570,9,28,1,2,2,5,Lost
99584,4,28,47,5,4,3,12,Loyal Users
99635,570,45,88,2,4,4,10,At Risk
99676,466,16,19,3,3,2,8,Loyal Users
99802,1360,7,10,1,2,1,4,Lost
99921,285,8,23,3,2,2,7,Casual Users
91171,38,28,42,5,4,3,12,Loyal Users
91289,287,5,12,3,1,1,5,Casual Users
91290,21,55,211,5,5,5,15,Champions
91324,125,15,23,4,3,2,9,Loyal Users
91828,113,24,91,4,4,4,12,Champions
92015,65,12,92,5,3,4,12,Loyal Users
92100,84,12,14,4,3,1,8,Loyal Users
92294,627,8,10,2,2,1,5,Lost
92300,441,7,35,3,2,3,8,Casual Users
92413,4121,8,13,1,2,1,4,Lost
93862,102,6,38,4,1,3,8,Promising
93944,2,8,13,5,2,1,8,Promising
94212,7,96,258,5,5,5,15,Champions
94564,35,9,19,5,2,2,9,Promising
94745,149,15,54,4,3,3,10,Loyal Users
95050,61,30,62,5,4,3,12,Loyal Users
95361,105,10,13,4,2,1,7,Promising
95588,1092,10,43,2,2,3,7,Lost
95601,1,101,386,5,5,5,15,Champions
95750,115,69,469,4,5,5,14,Champions
95780,139,26,81,4,4,4,12,Champions
95952,47,51,71,5,5,4,14,Champions
96052,971,9,33,2,2,3,7,Lost
96161,434,25,142,3,4,4,11,Loyal Users
96297,65,8,16,5,2,2,9,Promising
96346,127,12,31,4,3,2,9,Loyal Users
96525,249,185,319,3,5,5,13,Loyal Users
96532,139,17,24,4,3,2,9,Loyal Users
96640,350,17,59,3,3,3,9,Loyal Users
96650,831,28,71,2,4,4,10,At Risk
96817,403,15,34,3,3,3,9,Loyal Users
97261,127,37,114,4,4,4,12,Champions
97352,3,47,71,5,5,4,14,Champions
97878,2434,6,10,1,1,1,3,Lost
98068,120,11,63,4,2,4,10,Promising
98078,122,6,10,4,1,1,6,Promising
98156,689,6,56,2,1,3,6,Lost
98772,530,81,292,2,5,5,12,At Risk
98846,58,12,24,5,3,2,10,Loyal Users
98867,154,25,36,4,4,3,11,Loyal Users
99205,106,62,230,4,5,5,14,Champions
99345,77,35,298,4,4,5,13,Champions
99460,482,7,30,2,2,2,6,Lost
99513,667,10,75,2,2,4,8,Lost
91791,422,26,124,3,4,4,11,Loyal Users
92052,761,10,10,2,2,1,5,Lost
92514,2247,10,21,1,2,2,5,Lost
92574,282,18,21,3,3,2,8,Loyal Users
92684,1595,6,6,1,1,1,3,Lost
92758,72,60,268,4,5,5,14,Champions
92815,24,76,374,5,5,5,15,Champions
92909,662,77,117,2,5,4,11,At Risk
93455,95,70,118,4,5,4,13,Champions
94361,1432,5,15,1,1,1,3,Lost
94389,123,24,116,4,4,4,12,Champions
94527,3658,6,8,1,1,1,3,Lost
94598,139,38,194,4,4,5,13,Champions
94613,224,11,53,3,2,3,8,Casual Users
95458,83,8,33,4,2,3,9,Promising
95540,132,61,102,4,5,4,13,Champions
95846,135,187,303,4,5,5,14,Champions
96096,298,21,87,3,3,4,10,Loyal Users
96109,114,138,716,4,5,5,14,Champions
96247,435,20,48,3,3,3,9,Loyal Users
96452,95,7,10,4,2,1,7,Promising
96502,1869,13,20,1,3,2,6,Casual Users
96619,271,24,81,3,4,4,11,Loyal Users
96782,441,10,32,3,2,3,8,Casual Users
97204,196,11,16,3,2,2,7,Casual Users
97263,2220,7,11,1,2,1,4,Lost
97944,2,68,169,5,5,5,15,Champions
98449,571,23,61,2,4,3,9,At Risk
98565,1,151,594,5,5,5,15,Champions
98728,469,18,101,3,3,4,10,Loyal Users
98834,414,17,94,3,3,4,10,Loyal Users
98963,1318,9,10,1,2,1,4,Lost
99297,2998,9,30,1,2,2,5,Lost
99322,4512,10,27,1,2,2,5,Lost
99381,409,48,131,3,5,4,12,Loyal Users
99588,181,11,14,3,2,1,6,Casual Users
99859,5,127,391,5,5,5,15,Champions
99976,211,39,74,3,4,4,11,Loyal Users
91096,4251,7,11,1,2,1,4,Lost
91347,741,20,101,2,3,4,9,Casual Users
91864,786,8,11,2,2,1,5,Lost
91975,78,56,79,4,5,4,13,Champions
92129,424,8,60,3,2,3,8,Casual Users
92173,538,9,33,2,2,3,7,Lost
92296,2834,5,41,1,1,3,5,Lost
92357,89,74,585,4,5,5,14,Champions
92561,696,9,9,2,2,1,5,Lost
93070,308,8,51,3,2,3,8,Casual Users
93119,22,143,1093,5,5,5,15,Champions
93252,77,11,28,4,2,2,8,Promising
93882,119,18,43,4,3,3,10,Loyal Users
93904,896,10,27,2,2,2,6,Lost
94596,12,19,51,5,3,3,11,Loyal Users
95848,66,64,142,5,5,4,14,Champions
96019,271,18,28,3,3,2,8,Loyal Users
96038,1601,23,64,1,4,4,9,At Risk
96305,77,84,303,4,5,5,14,Champions
96667,49,76,221,5,5,5,15,Champions
97614,42,38,111,5,4,4,13,Champions
97615,612,6,6,2,1,1,4,Lost
97644,20,9,33,5,2,3,10,Promising
97727,416,13,30,3,3,2,8,Loyal Users
97840,15,40,113,5,4,4,13,Champions
98981,596,14,44,2,3,3,8,Casual Users
99182,276,7,52,3,2,3,8,Casual Users
99292,0,63,102,5,5,4,14,Champions
99493,12,138,694,5,5,5,15,Champions
99874,27,17,50,5,3,3,11,Loyal Users
99883,1573,8,9,1,2,1,4,Lost
91400,1696,7,8,1,2,1,4,Lost
91456,555,8,12,2,2,1,5,Lost
91517,2719,5,10,1,1,1,3,Lost
91872,18,17,45,5,3,3,11,Loyal Users
91882,426,12,76,3,3,4,10,Loyal Users
91936,65,28,145,5,4,4,13,Champions
91978,379,11,92,3,2,4,9,Casual Users
91999,1121,7,12,2,2,1,5,Lost
92313,1265,5,8,1,1,1,3,Lost
92361,3282,7,15,1,2,1,4,Lost
92615,1023,47,301,2,5,5,12,At Risk
92745,438,25,38,3,4,3,10,Loyal Users
92936,26,136,230,5,5,5,15,Champions
93588,91,37,76,4,4,4,12,Champions
93748,458,18,77,3,3,4,10,Loyal Users
93870,70,18,21,4,3,2,9,Loyal Users
94358,4,59,138,5,5,4,14,Champions
94507,3657,18,28,1,3,2,6,Casual Users
94630,7,59,184,5,5,5,15,Champions
94669,260,72,125,3,5,4,12,Loyal Users
94739,25,94,202,5,5,5,15,Champions
94872,1264,16,18,1,3,2,6,Casual Users
95013,158,61,79,4,5,4,13,Champions
95204,179,17,84,3,3,4,10,Loyal Users
95659,33,52,194,5,5,5,15,Champions
96058,7,120,411,5,5,5,15,Champions
96119,316,18,46,3,3,3,9,Loyal Users
96143,225,60,125,3,5,4,12,Loyal Users
96274,236,25,70,3,4,4,11,Loyal Users
96486,1416,6,36,1,1,3,5,Lost
96800,125,29,45,4,4,3,11,Loyal Users
96842,469,8,16,3,2,2,7,Casual Users
97120,118,28,40,4,4,3,11,Loyal Users
97163,3265,9,11,1,2,1,4,Lost
97170,1846,10,46,1,2,3,6,Lost
97280,2041,9,92,1,2,4,7,Lost
97310,16,5,10,5,1,1,7,Promising
97596,275,17,75,3,3,4,10,Loyal Users
97632,2927,8,35,1,2,3,6,Lost
97701,1242,60,163,2,5,5,12,At Risk
98557,643,13,23,2,3,2,7,Casual Users
98632,33,57,146,5,5,4,14,Champions
98756,1155,18,56,2,3,3,8,Casual Users
99362,438,24,69,3,4,4,11,Loyal Users
99432,1496,5,8,1,1,1,3,Lost
99667,1265,13,36,1,3,3,7,Casual Users
99894,885,8,20,2,2,2,6,Lost
99963,1134,11,14,2,2,1,5,Lost
91359,25,6,6,5,1,1,7,Promising
92332,598,12,51,2,3,3,8,Casual Users
92570,495,10,11,2,2,1,5,Lost
92593,4,8,10,5,2,1,8,Promising
92650,677,5,53,2,1,3,6,Lost
92692,417,34,111,3,4,4,11,Loyal Users
93224,232,36,81,3,4,4,11,Loyal Users
93442,1,16,80,5,3,4,12,Loyal Users
93873,408,5,65,3,1,4,8,Casual Users
93977,128,15,39,4,3,3,10,Loyal Users
94027,658,8,79,2,2,4,8,Lost
94090,424,30,169,3,4,5,12,Loyal Users
94209,1086,34,60,2,4,3,9,At Risk
94327,117,15,106,4,3,4,11,Loyal Users
94337,2733,10,13,1,2,1,4,Lost
94425,87,7,10,4,2,1,7,Promising
94438,34,84,269,5,5,5,15,Champions
94439,190,16,55,3,3,3,9,Loyal Users
94465,53,7,17,5,2,2,9,Promising
94683,1122,16,35,2,3,3,8,Casual Users
94737,492,9,16,2,2,2,6,Lost
94810,49,60,70,5,5,4,14,Champions
94905,101,58,417,4,5,5,14,Champions
95184,987,5,22,2,1,2,5,Lost
95611,151,103,243,4,5,5,14,Champions
95617,41,64,331,5,5,5,15,Champions
95877,123,12,17,4,3,2,9,Loyal Users
95959,147,64,187,4,5,5,14,Champions
96017,1358,12,45,1,3,3,7,Casual Users
96101,28,99,194,5,5,5,15,Champions
96197,734,19,36,2,3,3,8,Casual Users
96220,1416,11,18,1,2,2,5,Lost
96320,122,24,103,4,4,4,12,Champions
96577,237,8,19,3,2,2,7,Casual Users
96588,12,37,104,5,4,4,13,Champions
96592,273,7,12,3,2,1,6,Casual Users
96861,2554,6,12,1,1,1,3,Lost
97232,1498,8,19,1,2,2,5,Lost
97782,1717,77,147,1,5,5,11,At Risk
97798,21,26,34,5,4,3,12,Loyal Users
98132,268,38,87,3,4,4,11,Loyal Users
98219,3542,20,59,1,3,3,7,Casual Users
98300,1659,5,6,1,1,1,3,Lost
98365,272,27,50,3,4,3,10,Loyal Users
98413,59,170,700,5,5,5,15,Champions
98627,250,22,47,3,4,3,10,Loyal Users
98824,578,5,10,2,1,1,4,Lost
98884,836,9,58,2,2,3,7,Lost
99466,2,217,485,5,5,5,15,Champions
99773,0,28,72,5,4,4,13,Champions
99998,1854,5,15,1,1,1,3,Lost
91301,695,35,220,2,4,5,11,At Risk
91585,22,45,64,5,4,4,13,Champions
91595,126,26,126,4,4,4,12,Champions
92160,149,23,51,4,4,3,11,Loyal Users
92200,823,49,85,2,5,4,11,At Risk
92484,27,17,47,5,3,3,11,Loyal Users
92829,43,80,212,5,5,5,15,Champions
92954,4419,13,25,1,3,2,6,Casual Users
93414,1962,11,31,1,2,2,5,Lost
93583,462,9,11,3,2,1,6,Casual Users
93695,844,10,26,2,2,2,6,Lost
93707,467,19,43,3,3,3,9,Loyal Users
93724,87,69,91,4,5,4,13,Champions
94102,3888,5,6,1,1,1,3,Lost
94188,2520,41,54,1,4,3,8,At Risk
94216,19,20,57,5,3,3,11,Loyal Users
94221,2941,97,223,1,5,5,11,At Risk
94462,26,71,338,5,5,5,15,Champions
94482,1712,7,91,1,2,4,7,Lost
94499,2661,6,8,1,1,1,3,Lost
94685,38,249,566,5,5,5,15,Champions
94711,967,23,51,2,4,3,9,At Risk
94945,25,62,163,5,5,5,15,Champions
95047,37,72,181,5,5,5,15,Champions
95101,17,17,54,5,3,3,11,Loyal Users
95196,28,101,232,5,5,5,15,Champions
95553,610,28,48,2,4,3,9,At Risk
96698,1549,6,8,1,1,1,3,Lost
96759,385,29,57,3,4,3,10,Loyal Users
96865,6,126,305,5,5,5,15,Champions
96907,457,17,29,3,3,2,8,Loyal Users
97129,379,6,7,3,1,1,5,Casual Users
97203,626,21,101,2,3,4,9,Casual Users
97309,37,28,123,5,4,4,13,Champions
97409,5691,5,6,1,1,1,3,Lost
97643,590,8,88,2,2,4,8,Lost
97888,91,66,179,4,5,5,14,Champions
97953,1015,18,52,2,3,3,8,Casual Users
98019,454,5,7,3,1,1,5,Casual Users
98145,278,50,186,3,5,5,13,Loyal Users
98311,571,14,25,2,3,2,7,Casual Users
98600,269,10,65,3,2,4,9,Casual Users
98603,80,21,66,4,3,4,11,Loyal Users
99272,3158,15,16,1,3,2,6,Casual Users
91408,687,5,17,2,1,2,5,Lost
91459,1433,28,67,1,4,4,9,At Risk
91477,557,28,47,2,4,3,9,At Risk
91597,1184,16,22,2,3,2,7,Casual Users
92051,523,17,118,2,3,4,9,Casual Users
92078,125,63,123,4,5,4,13,Champions
92290,30,6,19,5,1,2,8,Promising
92498,396,27,220,3,4,5,12,Loyal Users
92535,260,14,49,3,3,3,9,Loyal Users
92854,260,6,7,3,1,1,5,Casual Users
92900,36,11,13,5,2,1,8,Promising
93108,22,36,61,5,4,3,12,Loyal Users
93301,61,72,445,5,5,5,15,Champions
93488,1733,9,23,1,2,2,5,Lost
93745,194,6,6,3,1,1,5,Casual Users
93795,442,8,21,3,2,2,7,Casual Users
94282,125,24,54,4,4,3,11,Loyal Users
94313,3149,5,7,1,1,1,3,Lost
94457,1606,28,104,1,4,4,9,At Risk
94529,1664,11,17,1,2,2,5,Lost
94687,1857,29,87,1,4,4,9,At Risk
94743,7,31,83,5,4,4,13,Champions
94766,170,90,314,3,5,5,13,Loyal Users
94786,1433,8,23,1,2,2,5,Lost
94853,123,53,83,4,5,4,13,Champions
95066,35,69,197,5,5,5,15,Champions
95461,92,40,219,4,4,5,13,Champions
95664,2001,12,26,1,3,2,6,Casual Users
96228,2309,5,5,1,1,1,3,Lost
96665,2060,9,14,1,2,1,4,Lost
96725,2267,8,9,1,2,1,4,Lost
96896,5420,6,9,1,1,1,3,Lost
97103,1988,25,126,1,4,4,9,At Risk
97268,91,31,72,4,4,4,12,Champions
97392,177,41,81,3,4,4,11,Loyal Users
97792,19,7,17,5,2,2,9,Promising
98042,81,14,55,4,3,3,10,Loyal Users
98245,488,7,21,2,2,2,6,Lost
98498,179,141,169,3,5,5,13,Loyal Users
98882,2652,5,12,1,1,1,3,Lost
98950,450,16,50,3,3,3,9,Loyal Users
99089,130,8,19,4,2,2,8,Promising
99186,420,6,7,3,1,1,5,Casual Users
99202,2404,9,10,1,2,1,4,Lost
99248,3567,9,9,1,2,1,4,Lost
99258,13,131,404,5,5,5,15,Champions
99287,507,6,21,2,1,2,5,Lost
99478,445,5,12,3,1,1,5,Casual Users
99595,28,46,170,5,5,5,15,Champions
99695,21,70,226,5,5,5,15,Champions
99980,4245,6,9,1,1,1,3,Lost
91854,41,42,131,5,4,4,13,Champions
91879,20,9,28,5,2,2,9,Promising
92283,1570,6,10,1,1,1,3,Lost
92632,294,5,10,3,1,1,5,Casual Users
92930,31,35,55,5,4,3,12,Loyal Users
93022,1905,10,21,1,2,2,5,Lost
93079,1697,8,16,1,2,2,5,Lost
93305,1458,6,28,1,1,2,4,Lost
93416,1292,5,16,1,1,2,4,Lost
93531,788,29,74,2,4,4,10,At Risk
93612,31,101,265,5,5,5,15,Champions
93628,4,105,209,5,5,5,15,Champions
93716,41,12,55,5,3,3,11,Loyal Users
94030,265,10,55,3,2,3,8,Casual Users
94048,383,36,98,3,4,4,11,Loyal Users
94390,125,12,29,4,3,2,9,Loyal Users
94452,78,6,11,4,1,1,6,Promising
94544,1001,5,5,2,1,1,4,Lost
94763,1740,7,11,1,2,1,4,Lost
95478,637,85,157,2,5,5,12,At Risk
95724,251,28,73,3,4,4,11,Loyal Users
95913,41,63,334,5,5,5,15,Champions
96795,1346,8,14,1,2,1,4,Lost
96802,119,93,245,4,5,5,14,Champions
96815,96,38,58,4,4,3,11,Loyal Users
96885,117,27,60,4,4,3,11,Loyal Users
97383,20,102,165,5,5,5,15,Champions
97521,270,34,110,3,4,4,11,Loyal Users
97660,417,6,11,3,1,1,5,Casual Users
98084,424,7,13,3,2,1,6,Casual Users
98137,68,39,85,5,4,4,13,Champions
98260,12,5,19,5,1,2,8,Promising
98457,718,10,140,2,2,4,8,Lost
98472,1294,6,25,1,1,2,4,Lost
98481,153,18,33,4,3,3,10,Loyal Users
98817,4638,9,31,1,2,2,5,Lost
99047,82,35,51,4,4,3,11,Loyal Users
99099,4528,18,71,1,3,4,8,Casual Users
99178,1207,22,98,2,4,4,10,At Risk
99228,122,15,125,4,3,4,11,Loyal Users
99334,280,11,54,3,2,3,8,Casual Users
99450,127,66,141,4,5,4,13,Champions
91310,240,71,112,3,5,4,12,Loyal Users
91384,263,52,210,3,5,5,13,Loyal Users
91483,322,25,46,3,4,3,10,Loyal Users
91488,208,32,40,3,4,3,10,Loyal Users
91613,720,6,9,2,1,1,4,Lost
91724,1065,117,178,2,5,5,12,At Risk
91774,32,72,264,5,5,5,15,Champions
91886,13,24,36,5,4,3,12,Loyal Users
92090,1643,14,54,1,3,3,7,Casual Users
92093,1267,15,49,1,3,3,7,Casual Users
92141,690,7,9,2,2,1,5,Lost
92434,280,82,265,3,5,5,13,Loyal Users
92973,638,38,102,2,4,4,10,At Risk
93380,1133,6,36,2,1,3,6,Lost
93726,100,20,116,4,3,4,11,Loyal Users
94076,2631,7,12,1,2,1,4,Lost
94175,1022,19,40,2,3,3,8,Casual Users
95111,2241,9,23,1,2,2,5,Lost
95606,83,16,74,4,3,4,11,Loyal Users
95610,433,33,78,3,4,4,11,Loyal Users
95798,0,219,388,5,5,5,15,Champions
95815,2484,6,11,1,1,1,3,Lost
95962,127,46,96,4,5,4,13,Champions
96015,435,5,35,3,1,3,7,Casual Users
96216,8,93,550,5,5,5,15,Champions
96578,892,8,9,2,2,1,5,Lost
96607,263,43,91,3,4,4,11,Loyal Users
96633,796,6,54,2,1,3,6,Lost
97002,300,7,7,3,2,1,6,Casual Users
97007,78,87,359,4,5,5,14,Champions
97189,40,15,90,5,3,4,12,Loyal Users
97365,152,5,20,4,1,2,7,Promising
97689,3598,5,10,1,1,1,3,Lost
97707,84,12,24,4,3,2,9,Loyal Users
97979,252,6,31,3,1,2,6,Casual Users
98131,765,5,12,2,1,1,4,Lost
98729,1,24,36,5,4,3,12,Loyal Users
98887,712,20,183,2,3,5,10,Casual Users
98978,532,12,13,2,3,1,6,Casual Users
99128,2652,26,34,1,4,3,8,At Risk
99150,245,20,65,3,3,4,10,Loyal Users
99169,133,42,82,4,4,4,12,Champions
99438,156,15,145,4,3,4,11,Loyal Users
99523,81,43,67,4,4,4,12,Champions
99634,714,6,12,2,1,1,4,Lost
99723,1408,15,19,1,3,2,6,Casual Users
91148,2046,5,10,1,1,1,3,Lost
91230,1026,17,29,2,3,2,7,Casual Users
91267,110,130,364,4,5,5,14,Champions
92343,94,65,372,4,5,5,14,Champions
92425,117,23,29,4,4,2,10,Loyal Users
92444,1490,7,21,1,2,2,5,Lost
92510,1003,6,8,2,1,1,4,Lost
92518,581,11,13,2,2,1,5,Lost
92609,527,6,36,2,1,3,6,Lost
93191,2587,9,26,1,2,2,5,Lost
93208,12,53,187,5,5,5,15,Champions
93275,142,24,57,4,4,3,11,Loyal Users
93302,359,15,36,3,3,3,9,Loyal Users
93474,530,13,15,2,3,1,6,Casual Users
93675,20,73,191,5,5,5,15,Champions
93960,679,12,28,2,3,2,7,Casual Users
94107,108,30,103,4,4,4,12,Champions
94114,181,6,9,3,1,1,5,Casual Users
94275,4,9,11,5,2,1,8,Promising
94583,2722,11,21,1,2,2,5,Lost
94818,4771,10,33,1,2,3,6,Lost
95095,418,37,134,3,4,4,11,Loyal Users
95417,130,31,84,4,4,4,12,Champions
95498,274,30,119,3,4,4,11,Loyal Users
95508,826,18,48,2,3,3,8,Casual Users
95655,3104,8,9,1,2,1,4,Lost
95735,25,79,205,5,5,5,15,Champions
96129,130,60,205,4,5,5,14,Champions
96343,732,6,20,2,1,2,5,Lost
96483,4586,11,19,1,2,2,5,Lost
96679,2987,6,10,1,1,1,3,Lost
97332,105,81,147,4,5,5,14,Champions
97680,417,18,48,3,3,3,9,Loyal Users
98307,642,15,30,2,3,2,7,Casual Users
98480,362,16,38,3,3,3,9,Loyal Users
98552,75,59,168,4,5,5,14,Champions
98690,117,14,120,4,3,4,11,Loyal Users
98956,104,53,137,4,5,4,13,Champions
98970,541,5,5,2,1,1,4,Lost
99008,492,55,127,2,5,4,11,At Risk
99041,55,115,192,5,5,5,15,Champions
99077,818,7,9,2,2,1,5,Lost
99134,1708,37,91,1,4,4,9,At Risk
99155,1229,8,39,2,2,3,7,Lost
91189,1485,5,19,1,1,2,4,Lost
91197,2610,5,8,1,1,1,3,Lost
91288,924,8,12,2,2,1,5,Lost
91469,477,9,37,2,2,3,7,Lost
91890,439,17,39,3,3,3,9,Loyal Users
92059,794,32,53,2,4,3,9,At Risk
92531,126,22,41,4,4,3,11,Loyal Users
92786,534,9,32,2,2,3,7,Lost
93075,33,10,29,5,2,2,9,Promising
93125,954,11,66,2,2,4,8,Lost
93294,1008,22,31,2,4,2,8,At Risk
93517,1385,13,20,1,3,2,6,Casual Users
93808,2386,153,610,1,5,5,11,At Risk
93811,527,27,54,2,4,3,9,At Risk
94239,527,9,42,2,2,3,7,Lost
94383,829,17,26,2,3,2,7,Casual Users
94580,4626,9,22,1,2,2,5,Lost
94611,261,5,8,3,1,1,5,Casual Users
95011,3193,9,9,1,2,1,4,Lost
95056,735,6,7,2,1,1,4,Lost
95146,103,33,64,4,4,4,12,Champions
95244,2080,10,43,1,2,3,6,Lost
95285,163,53,96,4,5,4,13,Champions
95298,132,14,99,4,3,4,11,Loyal Users
95332,472,9,10,2,2,1,5,Lost
95376,425,25,86,3,4,4,11,Loyal Users
95400,32,16,110,5,3,4,12,Loyal Users
95870,430,9,37,3,2,3,8,Casual Users
96104,1687,6,28,1,1,2,4,Lost
96421,399,5,14,3,1,1,5,Casual Users
96465,114,59,78,4,5,4,13,Champions
96737,2337,5,60,1,1,3,5,Lost
98226,409,108,709,3,5,5,13,Loyal Users
98258,27,51,75,5,5,4,14,Champions
98992,4449,5,15,1,1,1,3,Lost
99071,14,33,34,5,4,3,12,Loyal Users
99848,137,7,15,4,2,1,7,Promising
91233,25,98,428,5,5,5,15,Champions
91352,417,45,276,3,4,5,12,Loyal Users
91370,4587,7,16,1,2,2,5,Lost
91484,123,13,29,4,3,2,9,Loyal Users
91905,725,8,22,2,2,2,6,Lost
92073,4638,7,7,1,2,1,4,Lost
92154,508,25,52,2,4,3,9,At Risk
92236,879,9,21,2,2,2,6,Lost
92607,4,85,139,5,5,4,14,Champions
92797,328,47,80,3,5,4,12,Loyal Users
92803,1019,8,22,2,2,2,6,Lost
92835,42,16,27,5,3,2,10,Loyal Users
93030,109,28,32,4,4,3,11,Loyal Users
93408,1534,9,13,1,2,1,4,Lost
93518,51,103,724,5,5,5,15,Champions
93658,532,7,12,2,2,1,5,Lost
93932,477,15,40,2,3,3,8,Casual Users
93973,80,12,24,4,3,2,9,Loyal Users
94198,424,24,55,3,4,3,10,Loyal Users
94228,888,8,13,2,2,1,5,Lost
94339,29,28,33,5,4,3,12,Loyal Users
94644,126,45,320,4,4,5,13,Champions
94776,61,89,565,5,5,5,15,Champions
94797,8,13,22,5,3,2,10,Loyal Users
94920,690,30,63,2,4,4,10,At Risk
95348,3161,5,10,1,1,1,3,Lost
95411,370,22,31,3,4,2,9,Loyal Users
95416,2138,8,36,1,2,3,6,Lost
95420,299,22,36,3,4,3,10,Loyal Users
95446,963,122,180,2,5,5,12,At Risk
95839,1123,16,34,2,3,3,8,Casual Users
95906,124,78,377,4,5,5,14,Champions
96413,6,25,32,5,4,3,12,Loyal Users
96528,446,36,71,3,4,4,11,Loyal Users
96874,141,38,108,4,4,4,12,Champions
96882,85,51,121,4,5,4,13,Champions
96892,128,15,17,4,3,2,9,Loyal Users
97290,2081,7,25,1,2,2,5,Lost
97308,19,13,14,5,3,1,9,Loyal Users
97526,36,119,491,5,5,5,15,Champions
97715,1677,7,11,1,2,1,4,Lost
97770,231,32,67,3,4,4,11,Loyal Users
97773,3581,5,7,1,1,1,3,Lost
97943,4495,7,8,1,2,1,4,Lost
98049,58,59,232,5,5,5,15,Champions
98076,24,22,131,5,4,4,13,Champions
98172,222,5,44,3,1,3,7,Casual Users
98251,246,8,39,3,2,3,8,Casual Users
98366,253,44,210,3,4,5,12,Loyal Users
98391,411,43,109,3,4,4,11,Loyal Users
98747,581,10,36,2,2,3,7,Lost
98760,22,83,321,5,5,5,15,Champions
98777,37,126,180,5,5,5,15,Champions
98790,518,15,45,2,3,3,8,Casual Users
99070,272,22,32,3,4,3,10,Loyal Users
99103,11,60,212,5,5,5,15,Champions
99119,14,42,193,5,4,5,14,Champions
99200,2,18,134,5,3,4,12,Loyal Users
99654,19,56,99,5,5,4,14,Champions
99758,119,26,34,4,4,3,11,Loyal Users
99761,853,6,9,2,1,1,4,Lost
99768,268,10,48,3,2,3,8,Casual Users
99789,3446,6,7,1,1,1,3,Lost
99846,966,21,99,2,3,4,9,Casual Users
99851,38,8,12,5,2,1,8,Promising
91137,3399,6,35,1,1,3,5,Lost
92099,1,29,133,5,4,4,13,Champions
92194,276,46,265,3,5,5,13,Loyal Users
92712,73,41,77,4,4,4,12,Champions
92807,301,8,14,3,2,1,6,Casual Users
93472,7,19,31,5,3,2,10,Loyal Users
93515,801,6,12,2,1,1,4,Lost
93984,165,9,28,4,2,2,8,Promising
94004,281,11,78,3,2,4,9,Casual Users
94039,283,38,143,3,4,4,11,Loyal Users
94049,79,6,14,4,1,1,6,Promising
94058,1447,18,26,1,3,2,6,Casual Users
94111,700,8,34,2,2,3,7,Lost
94147,10,184,434,5,5,5,15,Champions
94179,853,27,169,2,4,5,11,At Risk
94238,5,64,149,5,5,5,15,Champions
94253,1171,70,314,2,5,5,12,At Risk
94342,10,7,23,5,2,2,9,Promising
94937,3721,17,33,1,3,3,7,Casual Users
94942,34,71,138,5,5,4,14,Champions
95132,2648,24,30,1,4,2,7,At Risk
95758,280,25,66,3,4,4,11,Loyal Users
95987,129,16,49,4,3,3,10,Loyal Users
96000,126,19,24,4,3,2,9,Loyal Users
96191,832,20,51,2,3,3,8,Casual Users
96417,4,26,125,5,4,4,13,Champions
96442,13,36,90,5,4,4,13,Champions
96740,454,5,7,3,1,1,5,Casual Users
97578,575,20,26,2,3,2,7,Casual Users
97635,4362,8,17,1,2,2,5,Lost
98151,690,24,57,2,4,3,9,At Risk
98377,424,18,46,3,3,3,9,Loyal Users
98423,27,138,339,5,5,5,15,Champions
98484,2654,7,10,1,2,1,4,Lost
98650,410,52,133,3,5,4,12,Loyal Users
98755,415,33,95,3,4,4,11,Loyal Users
98835,21,19,31,5,3,2,10,Loyal Users
98839,7,8,25,5,2,2,9,Promising
98883,3,160,420,5,5,5,15,Champions
99061,384,24,52,3,4,3,10,Loyal Users
99245,413,8,35,3,2,3,8,Casual Users
99305,429,5,28,3,1,2,6,Casual Users
99353,409,5,38,3,1,3,7,Casual Users
99389,4997,7,9,1,2,1,4,Lost
99915,417,28,73,3,4,4,11,Loyal Users
91173,3844,5,42,1,1,3,5,Lost
91649,1523,8,13,1,2,1,4,Lost
91697,58,36,104,5,4,4,13,Champions
92005,449,10,32,3,2,3,8,Casual Users
92111,245,26,60,3,4,3,10,Loyal Users
92483,7,77,166,5,5,5,15,Champions
92903,145,27,51,4,4,3,11,Loyal Users
92920,513,6,6,2,1,1,4,Lost
93155,704,6,7,2,1,1,4,Lost
93179,388,22,44,3,4,3,10,Loyal Users
93562,278,26,43,3,4,3,10,Loyal Users
93740,416,10,42,3,2,3,8,Casual Users
94262,411,25,27,3,4,2,9,Loyal Users
94735,5667,12,20,1,3,2,6,Casual Users
94849,19,15,23,5,3,2,10,Loyal Users
94960,39,154,390,5,5,5,15,Champions
94988,1410,6,9,1,1,1,3,Lost
94990,314,6,14,3,1,1,5,Casual Users
95270,259,22,46,3,4,3,10,Loyal Users
95393,103,75,182,4,5,5,14,Champions
95440,44,66,248,5,5,5,15,Champions
95501,518,54,184,2,5,5,12,At Risk
95547,623,8,38,2,2,3,7,Lost
95900,83,139,698,4,5,5,14,Champions
95901,812,14,43,2,3,3,8,Casual Users
95947,20,82,308,5,5,5,15,Champions
96139,384,60,228,3,5,5,13,Loyal Users
96298,5192,6,26,1,1,2,4,Lost
96686,287,7,28,3,2,2,7,Casual Users
97369,141,11,27,4,2,2,8,Promising
97410,121,25,110,4,4,4,12,Champions
97523,135,22,51,4,4,3,11,Loyal Users
97618,2150,6,10,1,1,1,3,Lost
97806,1017,5,12,2,1,1,4,Lost
97817,711,11,17,2,2,2,6,Lost
98171,116,63,88,4,5,4,13,Champions
98199,2538,12,29,1,3,2,6,Casual Users
98232,5,182,324,5,5,5,15,Champions
98535,641,22,83,2,4,4,10,At Risk
98678,111,134,333,4,5,5,14,Champions
98716,4606,6,7,1,1,1,3,Lost
98741,563,41,67,2,4,4,10,At Risk
98924,0,154,259,5,5,5,15,Champions
99001,903,21,36,2,3,3,8,Casual Users
99477,99,54,85,4,5,4,13,Champions
99779,90,8,75,4,2,4,10,Promising
99892,708,5,8,2,1,1,4,Lost
91726,29,61,104,5,5,4,14,Champions
91860,1134,9,17,2,2,2,6,Lost
92305,409,29,114,3,4,4,11,Loyal Users
92648,4950,5,16,1,1,2,4,Lost
92667,4580,24,101,1,4,4,9,At Risk
92751,23,130,278,5,5,5,15,Champions
92965,383,8,12,3,2,1,6,Casual Users
93190,4959,26,153,1,4,5,10,At Risk
93505,2350,9,29,1,2,2,5,Lost
93659,113,18,33,4,3,3,10,Loyal Users
93835,837,11,12,2,2,1,5,Lost
93974,315,26,97,3,4,4,11,Loyal Users
93990,235,113,181,3,5,5,13,Loyal Users
94050,168,23,73,3,4,4,11,Loyal Users
94074,133,6,14,4,1,1,6,Promising
94075,115,65,94,4,5,4,13,Champions
94802,127,36,68,4,4,4,12,Champions
94939,29,19,131,5,3,4,12,Loyal Users
95046,122,9,14,4,2,1,7,Promising
95160,120,5,20,4,1,2,7,Promising
95165,594,6,12,2,1,1,4,Lost
95209,2,110,420,5,5,5,15,Champions
95337,166,27,95,3,4,4,11,Loyal Users
95622,4,27,72,5,4,4,13,Champions
95648,3625,7,12,1,2,1,4,Lost
95854,128,5,7,4,1,1,6,Promising
95933,452,19,47,3,3,3,9,Loyal Users
96819,117,118,428,4,5,5,14,Champions
96821,359,42,53,3,4,3,10,Loyal Users
97297,11,112,346,5,5,5,15,Champions
97997,291,8,30,3,2,2,7,Casual Users
98081,549,11,46,2,2,3,7,Lost
98154,1305,9,10,1,2,1,4,Lost
99277,3173,9,15,1,2,1,4,Lost
99708,278,8,29,3,2,2,7,Casual Users
91360,150,10,46,4,2,3,9,Promising
91542,30,65,398,5,5,5,15,Champions
91567,49,29,42,5,4,3,12,Loyal Users
91740,1771,10,27,1,2,2,5,Lost
91967,167,9,11,3,2,1,6,Casual Users
92193,313,12,30,3,3,2,8,Loyal Users
92211,271,7,23,3,2,2,7,Casual Users
92596,420,12,20,3,3,2,8,Loyal Users
92695,168,10,21,3,2,2,7,Casual Users
92779,7,37,89,5,4,4,13,Champions
92906,146,26,86,4,4,4,12,Champions
92937,466,28,78,3,4,4,11,Loyal Users
93139,103,8,8,4,2,1,7,Promising
93427,1,96,350,5,5,5,15,Champions
93540,91,22,69,4,4,4,12,Champions
93601,9,71,167,5,5,5,15,Champions
93783,29,19,37,5,3,3,11,Loyal Users
94072,686,24,78,2,4,4,10,At Risk
94394,4851,5,18,1,1,2,4,Lost
94673,1042,5,24,2,1,2,5,Lost
94784,7,47,95,5,5,4,14,Champions
94919,1330,5,5,1,1,1,3,Lost
95089,50,37,102,5,4,4,13,Champions
95242,79,24,127,4,4,4,12,Champions
95291,57,151,330,5,5,5,15,Champions
95527,380,39,156,3,4,5,12,Loyal Users
95579,682,34,220,2,4,5,11,At Risk
95760,5,57,209,5,5,5,15,Champions
95763,517,16,35,2,3,3,8,Casual Users
96073,276,14,20,3,3,2,8,Loyal Users
96102,994,8,24,2,2,2,6,Lost
96112,12,120,570,5,5,5,15,Champions
96162,118,87,143,4,5,4,13,Champions
96374,708,11,35,2,2,3,7,Lost
96822,3963,5,9,1,1,1,3,Lost
97005,406,14,21,3,3,2,8,Loyal Users
97132,1033,38,48,2,4,3,9,At Risk
97199,131,57,156,4,5,5,14,Champions
97395,1103,20,50,2,3,3,8,Casual Users
97425,86,21,144,4,3,4,11,Loyal Users
97859,2365,5,12,1,1,1,3,Lost
98252,4241,5,7,1,1,1,3,Lost
98345,181,32,211,3,4,5,12,Loyal Users
98448,32,55,612,5,5,5,15,Champions
98529,3024,16,35,1,3,3,7,Casual Users
98751,3409,9,16,1,2,2,5,Lost
99033,480,55,94,2,5,4,11,At Risk
99080,1525,7,15,1,2,1,4,Lost
99081,11,28,67,5,4,4,13,Champions
99199,4200,7,7,1,2,1,4,Lost
99589,1736,11,52,1,2,3,6,Lost
99656,419,5,11,3,1,1,5,Casual Users
99689,0,148,811,5,5,5,15,Champions
99701,22,111,374,5,5,5,15,Champions
99769,1159,28,80,2,4,4,10,At Risk
99920,9,133,737,5,5,5,15,Champions
99965,1142,5,5,2,1,1,4,Lost
91068,138,16,16,4,3,2,9,Loyal Users
91095,109,9,36,4,2,3,9,Promising
91355,720,22,63,2,4,4,10,At Risk
91462,893,9,19,2,2,2,6,Lost
91464,104,20,165,4,3,5,12,Loyal Users
91506,1050,22,30,2,4,2,8,At Risk
91644,1155,8,38,2,2,3,7,Lost
91845,132,7,8,4,2,1,7,Promising
92539,41,15,32,5,3,3,11,Loyal Users
92568,810,22,30,2,4,2,8,At Risk
92586,112,13,70,4,3,4,11,Loyal Users
92785,2926,6,19,1,1,2,4,Lost
92837,2754,10,18,1,2,2,5,Lost
93116,12,102,188,5,5,5,15,Champions
93118,122,14,28,4,3,2,9,Loyal Users
93277,246,48,206,3,5,5,13,Loyal Users
93288,102,15,89,4,3,4,11,Loyal Users
93665,5105,5,5,1,1,1,3,Lost
93705,1,60,93,5,5,4,14,Champions
94021,276,6,19,3,1,2,6,Casual Users
94043,832,5,9,2,1,1,4,Lost
94167,294,59,130,3,5,4,12,Loyal Users
94618,1658,11,27,1,2,2,5,Lost
95239,1536,17,26,1,3,2,6,Casual Users
95336,101,102,347,4,5,5,14,Champions
95490,120,80,172,4,5,5,14,Champions
95549,281,15,68,3,3,4,10,Loyal Users
95587,412,20,43,3,3,3,9,Loyal Users
95702,2943,12,30,1,3,2,6,Casual Users
96063,13,14,21,5,3,2,10,Loyal Users
96372,4005,8,8,1,2,1,4,Lost
96806,144,10,14,4,2,1,7,Promising
96851,1068,10,63,2,2,4,8,Lost
97271,404,12,16,3,3,2,8,Loyal Users
97373,1242,12,23,2,3,2,7,Casual Users
97390,132,9,22,4,2,2,8,Promising
97438,1360,7,11,1,2,1,4,Lost
97517,53,70,296,5,5,5,15,Champions
97520,1523,5,13,1,1,1,3,Lost
97965,822,7,16,2,2,2,6,Lost
98043,588,12,74,2,3,4,9,Casual Users
98335,106,6,51,4,1,3,8,Promising
98748,15,70,366,5,5,5,15,Champions
98941,575,8,8,2,2,1,5,Lost
99052,165,14,16,4,3,2,9,Loyal Users
99281,136,31,56,4,4,3,11,Loyal Users
99352,272,63,146,3,5,4,12,Loyal Users
99527,1220,14,20,2,3,2,7,Casual Users
99864,153,100,385,4,5,5,14,Champions
99887,7,9,45,5,2,3,10,Promising
91657,126,83,227,4,5,5,14,Champions
91677,146,59,141,4,5,4,13,Champions
91912,2122,13,18,1,3,2,6,Casual Users
92333,36,35,67,5,4,4,13,Champions
93597,381,8,32,3,2,3,8,Casual Users
93700,22,172,515,5,5,5,15,Champions
93866,416,5,9,3,1,1,5,Casual Users
93922,541,8,15,2,2,1,5,Lost
93942,83,44,185,4,4,5,13,Champions
94178,79,73,151,4,5,5,14,Champions
94333,686,42,409,2,4,5,11,At Risk
94547,311,31,75,3,4,4,11,Loyal Users
94635,145,28,50,4,4,3,11,Loyal Users
94661,118,14,47,4,3,3,10,Loyal Users
94862,1394,6,15,1,1,1,3,Lost
95397,876,14,45,2,3,3,8,Casual Users
95767,842,7,23,2,2,2,6,Lost
95840,1979,10,33,1,2,3,6,Lost
95974,817,31,181,2,4,5,11,At Risk
96059,132,8,38,4,2,3,9,Promising
96586,4091,6,31,1,1,2,4,Lost
97041,108,101,313,4,5,5,14,Champions
97295,1766,7,26,1,2,2,5,Lost
97324,3841,6,10,1,1,1,3,Lost
97348,1366,8,12,1,2,1,4,Lost
97970,2448,7,7,1,2,1,4,Lost
98236,50,102,288,5,5,5,15,Champions
98337,2,81,235,5,5,5,15,Champions
98410,10,121,306,5,5,5,15,Champions
98514,824,59,225,2,5,5,12,At Risk
98558,27,54,100,5,5,4,14,Champions
99162,1478,12,19,1,3,2,6,Casual Users
99327,856,5,25,2,1,2,5,Lost
99361,2878,6,12,1,1,1,3,Lost
99448,11,53,132,5,5,4,14,Champions
99455,329,32,83,3,4,4,11,Loyal Users
99552,672,31,59,2,4,3,9,At Risk
91253,650,7,18,2,2,2,6,Lost
91276,426,9,14,3,2,1,6,Casual Users
91607,30,10,21,5,2,2,9,Promising
91710,861,5,32,2,1,3,6,Lost
92121,580,6,10,2,1,1,4,Lost
92479,436,25,65,3,4,4,11,Loyal Users
92689,5,144,314,5,5,5,15,Champions
92784,547,77,98,2,5,4,11,At Risk
92941,697,53,188,2,5,5,12,At Risk
93103,691,8,27,2,2,2,6,Lost
93186,65,47,176,5,5,5,15,Champions
93245,103,13,21,4,3,2,9,Loyal Users
93371,138,72,108,4,5,4,13,Champions
93435,727,17,178,2,3,5,10,Casual Users
93644,15,70,209,5,5,5,15,Champions
93678,141,29,55,4,4,3,11,Loyal Users
94070,3345,5,13,1,1,1,3,Lost
94103,990,9,10,2,2,1,5,Lost
94380,17,5,11,5,1,1,7,Promising
94429,178,80,373,3,5,5,13,Loyal Users
94463,886,8,21,2,2,2,6,Lost
94842,101,41,411,4,4,5,13,Champions
95157,291,17,21,3,3,2,8,Loyal Users
95474,1118,21,32,2,3,3,8,Casual Users
95623,382,12,55,3,3,3,9,Loyal Users
95759,416,20,23,3,3,2,8,Loyal Users
96259,1274,7,27,1,2,2,5,Lost
96408,2016,8,13,1,2,1,4,Lost
96729,7,7,24,5,2,2,9,Promising
96767,1,50,179,5,5,5,15,Champions
96849,2891,55,97,1,5,4,10,At Risk
97008,33,53,207,5,5,5,15,Champions
97047,588,12,12,2,3,1,6,Casual Users
97287,0,5,25,5,1,2,8,Promising
97818,388,237,496,3,5,5,13,Loyal Users
97827,888,61,66,2,5,4,11,At Risk
97882,64,9,27,5,2,2,9,Promising
98039,294,7,23,3,2,2,7,Casual Users
98102,28,30,103,5,4,4,13,Champions
98103,1417,26,249,1,4,5,10,At Risk
98123,133,13,47,4,3,3,10,Loyal Users
98230,2407,6,7,1,1,1,3,Lost
98409,89,230,321,4,5,5,14,Champions
98594,129,50,123,4,5,4,13,Champions
98810,125,42,70,4,4,4,12,Champions
99074,66,72,107,5,5,4,14,Champions
99714,14,17,44,5,3,3,11,Loyal Users
99801,1232,121,197,2,5,5,12,At Risk
99869,166,14,40,3,3,3,9,Loyal Users
91232,2,22,33,5,4,3,12,Loyal Users
92106,579,12,37,2,3,3,8,Casual Users
92693,118,43,150,4,4,5,13,Champions
92772,597,26,56,2,4,3,9,At Risk
92846,2952,99,636,1,5,5,11,At Risk
93134,49,153,734,5,5,5,15,Champions
93447,411,35,109,3,4,4,11,Loyal Users
93512,512,14,17,2,3,2,7,Casual Users
93651,6,51,114,5,5,4,14,Champions
93756,238,20,103,3,3,4,10,Loyal Users
93813,41,95,564,5,5,5,15,Champions
93908,2574,5,5,1,1,1,3,Lost
94055,192,11,27,3,2,2,7,Casual Users
94235,43,16,70,5,3,4,12,Loyal Users
94259,40,67,165,5,5,5,15,Champions
94270,35,9,16,5,2,2,9,Promising
94688,3132,12,24,1,3,2,6,Casual Users
95442,4157,7,16,1,2,2,5,Lost
95856,688,55,378,2,5,5,12,At Risk
95899,45,138,300,5,5,5,15,Champions
95979,1127,16,24,2,3,2,7,Casual Users
95988,117,116,524,4,5,5,14,Champions
96027,17,48,115,5,5,4,14,Champions
96182,2456,5,9,1,1,1,3,Lost
96431,104,22,57,4,4,3,11,Loyal Users
96673,1454,10,27,1,2,2,5,Lost
96923,2633,9,17,1,2,2,5,Lost
96931,971,20,24,2,3,2,7,Casual Users
97221,728,7,24,2,2,2,6,Lost
97266,409,75,512,3,5,5,13,Loyal Users
97522,262,7,16,3,2,2,7,Casual Users
97525,5620,6,11,1,1,1,3,Lost
97876,276,46,80,3,5,4,12,Loyal Users
98408,80,7,8,4,2,1,7,Promising
98427,1201,8,12,2,2,1,5,Lost
98663,888,18,63,2,3,4,9,Casual Users
98720,2464,9,37,1,2,3,6,Lost
98808,83,27,65,4,4,4,12,Champions
99328,138,16,197,4,3,5,12,Loyal Users
99371,714,93,164,2,5,5,12,At Risk
99463,59,81,308,5,5,5,15,Champions
99536,3156,8,22,1,2,2,5,Lost
99637,855,17,61,2,3,3,8,Casual Users
99754,114,30,125,4,4,4,12,Champions
99926,91,16,118,4,3,4,11,Loyal Users
91186,203,67,130,3,5,4,12,Loyal Users
91587,3156,7,10,1,2,1,4,Lost
91745,372,42,156,3,4,5,12,Loyal Users
91760,337,10,31,3,2,2,7,Casual Users
91955,81,83,175,4,5,5,14,Champions
92198,362,6,9,3,1,1,5,Casual Users
92210,1808,15,67,1,3,4,8,Casual Users
92386,5,10,69,5,2,4,11,Promising
92646,499,25,44,2,4,3,9,At Risk
93056,60,98,317,5,5,5,15,Champions
93676,827,16,138,2,3,4,9,Casual Users
94117,711,11,25,2,2,2,6,Lost
94231,349,8,10,3,2,1,6,Casual Users
94436,42,6,8,5,1,1,7,Promising
94586,0,131,433,5,5,5,15,Champions
94659,7,50,252,5,5,5,15,Champions
95181,1320,20,36,1,3,3,7,Casual Users
95210,29,56,85,5,5,4,14,Champions
95295,131,72,289,4,5,5,14,Champions
95310,1367,8,12,1,2,1,4,Lost
95499,522,36,53,2,4,3,9,At Risk
96375,701,27,42,2,4,3,9,At Risk
96388,2265,6,9,1,1,1,3,Lost
97072,143,127,755,4,5,5,14,Champions
97412,1295,12,27,1,3,2,6,Casual Users
97457,65,69,169,5,5,5,15,Champions
97513,84,47,116,4,5,4,13,Champions
98148,18,12,18,5,3,2,10,Loyal Users
98233,383,6,8,3,1,1,5,Casual Users
98278,267,9,32,3,2,3,8,Casual Users
98323,3761,6,10,1,1,1,3,Lost
98517,122,36,225,4,4,5,13,Champions
98709,190,9,87,3,2,4,9,Casual Users
98909,543,50,163,2,5,5,12,At Risk
99129,13,18,37,5,3,3,11,Loyal Users
99418,170,18,76,3,3,4,10,Loyal Users
99441,286,20,29,3,3,2,8,Loyal Users
99459,491,7,12,2,2,1,5,Lost
99471,5,21,27,5,3,2,10,Loyal Users
99813,138,39,60,4,4,3,11,Loyal Users
99832,1703,13,23,1,3,2,6,Casual Users
99935,1520,5,5,1,1,1,3,Lost
91163,844,52,308,2,5,5,12,At Risk
91405,711,7,29,2,2,2,6,Lost
91414,23,17,79,5,3,4,12,Loyal Users
91487,219,36,77,3,4,4,11,Loyal Users
91617,394,55,154,3,5,5,13,Loyal Users
91689,28,9,10,5,2,1,8,Promising
91738,141,5,17,4,1,2,7,Promising
91903,2439,26,36,1,4,3,8,At Risk
92067,135,13,15,4,3,1,8,Loyal Users
92257,250,43,96,3,4,4,11,Loyal Users
92579,915,5,7,2,1,1,4,Lost
92610,200,6,10,3,1,1,5,Casual Users
92663,722,23,110,2,4,4,10,At Risk
92778,15,172,517,5,5,5,15,Champions
93039,1,7,17,5,2,2,9,Promising
93603,135,16,21,4,3,2,9,Loyal Users
93607,3,170,901,5,5,5,15,Champions
93784,96,15,80,4,3,4,11,Loyal Users
94272,2818,7,41,1,2,3,6,Lost
94546,994,6,8,2,1,1,4,Lost
94662,1448,10,54,1,2,3,6,Lost
94684,92,28,114,4,4,4,12,Champions
94705,71,48,57,4,5,3,12,Loyal Users
94780,124,177,280,4,5,5,14,Champions
94936,420,6,16,3,1,2,6,Casual Users
95558,0,73,294,5,5,5,15,Champions
95703,928,19,31,2,3,2,7,Casual Users
96008,30,47,451,5,5,5,15,Champions
96025,213,76,266,3,5,5,13,Loyal Users
96086,166,45,256,3,4,5,12,Loyal Users
96172,1397,8,11,1,2,1,4,Lost
96257,191,8,11,3,2,1,6,Casual Users
96318,1533,5,30,1,1,2,4,Lost
96398,1200,7,7,2,2,1,5,Lost
96540,801,5,50,2,1,3,6,Lost
97091,1875,5,7,1,1,1,3,Lost
97123,0,39,164,5,4,5,14,Champions
97510,125,53,167,4,5,5,14,Champions
97927,232,5,6,3,1,1,5,Casual Users
98056,28,92,437,5,5,5,15,Champions
98164,428,7,19,3,2,2,7,Casual Users
98165,14,66,269,5,5,5,15,Champions
98314,1822,65,174,1,5,5,11,At Risk
98393,47,56,201,5,5,5,15,Champions
98422,29,13,16,5,3,2,10,Loyal Users
98891,824,14,16,2,3,2,7,Casual Users
98897,92,8,14,4,2,1,7,Promising
98943,720,19,96,2,3,4,9,Casual Users
99085,182,6,15,3,1,1,5,Casual Users
99560,4972,8,10,1,2,1,4,Lost
99764,3849,8,14,1,2,1,4,Lost
99933,1016,6,17,2,1,2,5,Lost
91307,3591,5,12,1,1,1,3,Lost
91312,125,113,248,4,5,5,14,Champions
91320,822,7,15,2,2,1,5,Lost
91822,42,11,67,5,2,4,11,Promising
92617,1141,7,7,2,2,1,5,Lost
92703,242,5,8,3,1,1,5,Casual Users
92907,30,50,149,5,5,5,15,Champions
93395,80,43,61,4,4,3,11,Loyal Users
93519,462,6,7,3,1,1,5,Casual Users
93576,2676,21,78,1,3,4,8,Casual Users
93750,7,124,536,5,5,5,15,Champions
93767,2166,5,6,1,1,1,3,Lost
93892,1386,9,12,1,2,1,4,Lost
94349,18,52,272,5,5,5,15,Champions
94572,437,56,161,3,5,5,13,Loyal Users
94677,3,26,120,5,4,4,13,Champions
95155,4249,10,24,1,2,2,5,Lost
95263,823,9,38,2,2,3,7,Lost
95599,28,88,235,5,5,5,15,Champions
95615,1456,41,47,1,4,3,8,At Risk
95669,271,9,17,3,2,2,7,Casual Users
95825,226,46,110,3,5,4,12,Loyal Users
95989,806,19,45,2,3,3,8,Casual Users
96462,129,10,26,4,2,2,8,Promising
96516,158,37,57,4,4,3,11,Loyal Users
96603,839,7,8,2,2,1,5,Lost
96727,281,6,13,3,1,1,5,Casual Users
96791,33,62,129,5,5,4,14,Champions
96980,11,36,130,5,4,4,13,Champions
97080,1128,6,8,2,1,1,4,Lost
97102,2450,5,9,1,1,1,3,Lost
97243,3718,5,67,1,1,4,6,Lost
97402,1267,8,11,1,2,1,4,Lost
97467,2739,7,17,1,2,2,5,Lost
97663,1644,5,41,1,1,3,5,Lost
97719,5778,6,21,1,1,2,4,Lost
97811,13,120,266,5,5,5,15,Champions
97845,238,7,9,3,2,1,6,Casual Users
98189,5655,7,7,1,2,1,4,Lost
98302,268,182,504,3,5,5,13,Loyal Users
98309,8,27,92,5,4,4,13,Champions
98715,400,15,29,3,3,2,8,Loyal Users
98775,3967,6,8,1,1,1,3,Lost
98852,199,23,56,3,4,3,10,Loyal Users
98879,125,46,129,4,5,4,13,Champions
98894,1273,5,9,1,1,1,3,Lost
98925,889,9,24,2,2,2,6,Lost
99484,23,156,266,5,5,5,15,Champions
99520,1910,12,82,1,3,4,8,Casual Users
99539,33,71,335,5,5,5,15,Champions
91075,46,45,241,5,4,5,14,Champions
91287,95,10,30,4,2,2,8,Promising
91358,2049,6,6,1,1,1,3,Lost
91391,0,18,58,5,3,3,11,Loyal Users
91599,59,48,157,5,5,5,15,Champions
91826,1497,8,13,1,2,1,4,Lost
92134,5841,7,19,1,2,2,5,Lost
92463,1577,6,10,1,1,1,3,Lost
92790,610,22,87,2,4,4,10,At Risk
92899,79,37,139,4,4,4,12,Champions
93024,1826,5,19,1,1,2,4,Lost
93058,2255,9,19,1,2,2,5,Lost
93258,572,5,9,2,1,1,4,Lost
93864,2120,6,14,1,1,1,3,Lost
94222,430,30,46,3,4,3,10,Loyal Users
94289,188,36,89,3,4,4,11,Loyal Users
94509,36,187,422,5,5,5,15,Champions
94624,3178,5,29,1,1,2,4,Lost
94886,0,140,626,5,5,5,15,Champions
94955,67,64,115,5,5,4,14,Champions
95090,402,85,120,3,5,4,12,Loyal Users
95424,124,36,91,4,4,4,12,Champions
95820,132,29,97,4,4,4,12,Champions
95894,580,5,9,2,1,1,4,Lost
95924,0,64,260,5,5,5,15,Champions
95981,137,16,57,4,3,3,10,Loyal Users
96312,2149,17,88,1,3,4,8,Casual Users
96520,241,33,58,3,4,3,10,Loyal Users
96550,6,80,124,5,5,4,14,Champions
96661,6,78,135,5,5,4,14,Champions
96734,826,22,161,2,4,5,11,At Risk
96953,134,22,50,4,4,3,11,Loyal Users
97224,666,16,26,2,3,2,7,Casual Users
97230,108,92,270,4,5,5,14,Champions
97325,81,68,622,4,5,5,14,Champions
97547,74,15,41,4,3,3,10,Loyal Users
97550,106,21,85,4,3,4,11,Loyal Users
97924,13,9,12,5,2,1,8,Promising
97935,42,68,327,5,5,5,15,Champions
97964,686,10,15,2,2,1,5,Lost
98031,962,8,86,2,2,4,8,Lost
98098,873,11,22,2,2,2,6,Lost
98149,527,37,42,2,4,3,9,At Risk
98280,456,11,16,3,2,2,7,Casual Users
98857,582,5,5,2,1,1,4,Lost
98870,76,21,116,4,3,4,11,Loyal Users
98951,1567,9,20,1,2,2,5,Lost
98989,126,18,70,4,3,4,11,Loyal Users
99771,1826,5,5,1,1,1,3,Lost
175,64,139,435,5,5,5,15,Champions
387,1007,12,20,2,3,2,7,Casual Users
423,688,5,10,2,1,1,4,Lost
695,260,30,173,3,4,5,12,Loyal Users
746,381,30,49,3,4,3,10,Loyal Users
1057,4150,6,13,1,1,1,3,Lost
1159,1636,10,21,1,2,2,5,Lost
1698,2950,8,19,1,2,2,5,Lost
1865,271,44,54,3,4,3,10,Loyal Users
1982,175,52,152,3,5,5,13,Loyal Users
2029,24,57,221,5,5,5,15,Champions
2271,12,32,117,5,4,4,13,Champions
3161,287,38,126,3,4,4,11,Loyal Users
3408,0,53,120,5,5,4,14,Champions
4409,1,25,152,5,4,5,14,Champions
4889,387,24,88,3,4,4,11,Loyal Users
5975,2,12,62,5,3,3,11,Loyal Users
6641,6,107,146,5,5,4,14,Champions
6849,833,46,181,2,5,5,12,At Risk
7433,101,17,34,4,3,3,10,Loyal Users
7513,2261,7,16,1,2,2,5,Lost
8119,8,13,42,5,3,3,11,Loyal Users
8447,572,32,65,2,4,4,10,At Risk
8529,405,31,170,3,4,5,12,Loyal Users
8756,4395,5,48,1,1,3,5,Lost
8907,1279,6,37,1,1,3,5,Lost
9224,31,60,341,5,5,5,15,Champions
9268,574,17,25,2,3,2,7,Casual Users
9299,276,8,8,3,2,1,6,Casual Users
9735,138,13,18,4,3,2,9,Loyal Users
10690,1099,14,15,2,3,1,6,Casual Users
10743,101,69,250,4,5,5,14,Champions
10901,125,39,72,4,4,4,12,Champions
11110,25,21,39,5,3,3,11,Loyal Users
11223,504,13,54,2,3,3,8,Casual Users
11363,228,54,118,3,5,4,12,Loyal Users
11780,289,21,25,3,3,2,8,Loyal Users
12041,155,13,18,4,3,2,9,Loyal Users
12115,208,51,166,3,5,5,13,Loyal Users
12242,158,42,97,4,4,4,12,Champions
12330,674,23,57,2,4,3,9,At Risk
12612,499,20,118,2,3,4,9,Casual Users
12988,357,23,38,3,4,3,10,Loyal Users
13071,3972,12,20,1,3,2,6,Casual Users
13078,96,68,257,4,5,5,14,Champions
13155,258,7,14,3,2,1,6,Casual Users
13380,227,5,7,3,1,1,5,Casual Users
13435,289,9,12,3,2,1,6,Casual Users
381,981,6,22,2,1,2,5,Lost
498,422,18,101,3,3,4,10,Loyal Users
721,663,145,512,2,5,5,12,At Risk
850,1451,14,17,1,3,2,6,Casual Users
1118,2981,8,16,1,2,2,5,Lost
1121,546,12,36,2,3,3,8,Casual Users
1161,0,20,126,5,3,4,12,Loyal Users
1850,978,34,99,2,4,4,10,At Risk
2206,2079,15,89,1,3,4,8,Casual Users
2490,466,17,40,3,3,3,9,Loyal Users
2718,66,229,455,5,5,5,15,Champions
3374,30,108,494,5,5,5,15,Champions
3433,9,17,48,5,3,3,11,Loyal Users
3606,2508,15,60,1,3,3,7,Casual Users
3897,1585,8,20,1,2,2,5,Lost
3958,416,17,32,3,3,3,9,Loyal Users
4115,1145,5,9,2,1,1,4,Lost
4447,1374,37,52,1,4,3,8,At Risk
4567,1373,9,63,1,2,4,7,Lost
4578,106,5,7,4,1,1,6,Promising
4754,38,142,375,5,5,5,15,Champions
5521,1202,6,10,2,1,1,4,Lost
5532,2883,7,12,1,2,1,4,Lost
5659,44,29,38,5,4,3,12,Loyal Users
5778,77,7,22,4,2,2,8,Promising
5969,5038,10,28,1,2,2,5,Lost
6190,579,5,6,2,1,1,4,Lost
6571,2412,11,16,1,2,2,5,Lost
6573,88,17,43,4,3,3,10,Loyal Users
6707,3550,9,12,1,2,1,4,Lost
6784,72,15,33,4,3,3,10,Loyal Users
7274,2533,5,7,1,1,1,3,Lost
7299,127,22,57,4,4,3,11,Loyal Users
7370,96,17,57,4,3,3,10,Loyal Users
7640,118,37,74,4,4,4,12,Champions
7653,269,41,95,3,4,4,11,Loyal Users
7688,1230,5,5,2,1,1,4,Lost
7781,221,20,89,3,3,4,10,Loyal Users
7953,17,7,8,5,2,1,8,Promising
8128,382,6,17,3,1,2,6,Casual Users
8428,871,16,69,2,3,4,9,Casual Users
8443,3704,5,17,1,1,2,4,Lost
8467,118,104,161,4,5,5,14,Champions
8544,276,40,88,3,4,4,11,Loyal Users
8552,521,61,95,2,5,4,11,At Risk
8731,723,31,63,2,4,4,10,At Risk
9394,831,23,53,2,4,3,9,At Risk
9545,33,41,69,5,4,4,13,Champions
9638,4140,11,45,1,2,3,6,Lost
10044,68,25,35,5,4,3,12,Loyal Users
10212,103,117,604,4,5,5,14,Champions
10637,1149,32,141,2,4,4,10,At Risk
10686,223,44,72,3,4,4,11,Loyal Users
10687,283,11,47,3,2,3,8,Casual Users
11067,1411,21,37,1,3,3,7,Casual Users
11096,2413,7,7,1,2,1,4,Lost
11760,132,61,107,4,5,4,13,Champions
11991,27,9,49,5,2,3,10,Promising
12212,1,89,204,5,5,5,15,Champions
12819,25,150,590,5,5,5,15,Champions
12822,90,129,593,4,5,5,14,Champions
12931,3691,5,17,1,1,2,4,Lost
13007,0,22,36,5,4,3,12,Loyal Users
13311,230,80,242,3,5,5,13,Loyal Users
35,11,38,59,5,4,3,12,Loyal Users
503,5,35,43,5,4,3,12,Loyal Users
583,15,104,214,5,5,5,15,Champions
594,114,19,35,4,3,3,10,Loyal Users
610,44,29,112,5,4,4,13,Champions
614,505,25,95,2,4,4,10,At Risk
761,135,87,495,4,5,5,14,Champions
880,91,31,103,4,4,4,12,Champions
1072,774,14,35,2,3,3,8,Casual Users
1369,2859,5,18,1,1,2,4,Lost
1519,1378,10,36,1,2,3,6,Lost
1589,32,92,138,5,5,4,14,Champions
1815,303,10,18,3,2,2,7,Casual Users
1881,2444,5,32,1,1,3,5,Lost
2080,545,19,42,2,3,3,8,Casual Users
2324,1792,6,18,1,1,2,4,Lost
2444,2284,5,21,1,1,2,4,Lost
2445,115,49,314,4,5,5,14,Champions
2649,5565,16,41,1,3,3,7,Casual Users
2915,2019,5,26,1,1,2,4,Lost
3065,168,24,39,3,4,3,10,Loyal Users
3137,105,27,204,4,4,5,13,Champions
3316,2410,12,16,1,3,2,6,Casual Users
3468,168,5,15,3,1,1,5,Casual Users
3499,18,22,94,5,4,4,13,Champions
3545,1818,23,23,1,4,2,7,At Risk
3571,221,36,57,3,4,3,10,Loyal Users
3875,146,32,39,4,4,3,11,Loyal Users
3900,3911,15,32,1,3,3,7,Casual Users
3966,95,7,20,4,2,2,8,Promising
4343,69,14,20,5,3,2,10,Loyal Users
4412,230,118,402,3,5,5,13,Loyal Users
4552,1093,6,8,2,1,1,4,Lost
4736,548,5,7,2,1,1,4,Lost
4768,0,100,259,5,5,5,15,Champions
4824,0,83,483,5,5,5,15,Champions
5052,3125,6,31,1,1,2,4,Lost
5264,5953,5,7,1,1,1,3,Lost
5709,81,61,141,4,5,4,13,Champions
5749,129,82,180,4,5,5,14,Champions
5966,159,6,11,4,1,1,6,Promising
5970,618,8,8,2,2,1,5,Lost
5999,932,33,60,2,4,3,9,At Risk
6218,154,14,21,4,3,2,9,Loyal Users
6285,1,91,234,5,5,5,15,Champions
6332,421,10,15,3,2,1,6,Casual Users
6340,58,100,349,5,5,5,15,Champions
6354,61,79,408,5,5,5,15,Champions
7031,530,18,25,2,3,2,7,Casual Users
7114,656,9,12,2,2,1,5,Lost
7139,262,16,36,3,3,3,9,Loyal Users
7444,438,6,15,3,1,1,5,Casual Users
7494,174,38,73,3,4,4,11,Loyal Users
7767,121,76,152,4,5,5,14,Champions
7816,1297,24,37,1,4,3,8,At Risk
8194,862,9,11,2,2,1,5,Lost
8281,3178,10,12,1,2,1,4,Lost
8373,4368,5,6,1,1,1,3,Lost
8579,11,18,83,5,3,4,12,Loyal Users
8596,1565,7,17,1,2,2,5,Lost
8769,15,33,43,5,4,3,12,Loyal Users
8855,3,40,164,5,4,5,14,Champions
8966,25,56,281,5,5,5,15,Champions
8979,247,7,9,3,2,1,6,Casual Users
9432,1960,5,20,1,1,2,4,Lost
9733,80,36,98,4,4,4,12,Champions
9764,116,46,182,4,5,5,14,Champions
9987,306,55,236,3,5,5,13,Loyal Users
10119,280,13,27,3,3,2,8,Loyal Users
10141,295,6,100,3,1,4,8,Casual Users
10733,82,110,185,4,5,5,14,Champions
11035,12,8,14,5,2,1,8,Promising
11301,74,76,182,4,5,5,14,Champions
11884,865,150,188,2,5,5,12,At Risk
11903,843,24,32,2,4,3,9,At Risk
11951,258,58,208,3,5,5,13,Loyal Users
12303,32,30,78,5,4,4,13,Champions
12313,31,43,74,5,4,4,13,Champions
12379,357,31,177,3,4,5,12,Loyal Users
12518,200,22,45,3,4,3,10,Loyal Users
12696,2,5,6,5,1,1,7,Promising
12776,33,58,125,5,5,4,14,Champions
13012,807,12,21,2,3,2,7,Casual Users
13092,406,14,30,3,3,2,8,Loyal Users
13322,127,27,162,4,4,5,13,Champions
13551,148,40,114,4,4,4,12,Champions
13564,2462,13,53,1,3,3,7,Casual Users
677,36,31,127,5,4,4,13,Champions
739,127,17,59,4,3,3,10,Loyal Users
1059,959,18,34,2,3,3,8,Casual Users
1142,568,28,48,2,4,3,9,At Risk
1379,98,20,29,4,3,2,9,Loyal Users
1384,507,12,43,2,3,3,8,Casual Users
1386,583,6,17,2,1,2,5,Lost
1536,74,77,135,4,5,4,13,Champions
1932,706,7,11,2,2,1,5,Lost
2298,143,68,255,4,5,5,14,Champions
2304,15,144,414,5,5,5,15,Champions
2356,180,25,163,3,4,5,12,Loyal Users
2716,509,12,27,2,3,2,7,Casual Users
2875,2123,6,6,1,1,1,3,Lost
2947,53,100,272,5,5,5,15,Champions
3099,5495,5,14,1,1,1,3,Lost
3139,6129,10,68,1,2,4,7,Lost
3201,193,8,10,3,2,1,6,Casual Users
3511,155,9,22,4,2,2,8,Promising
3681,251,25,145,3,4,4,11,Loyal Users
3740,7,55,99,5,5,4,14,Champions
3854,506,11,42,2,2,3,7,Lost
3962,2650,5,7,1,1,1,3,Lost
4075,501,34,130,2,4,4,10,At Risk
4184,28,28,84,5,4,4,13,Champions
4274,62,50,159,5,5,5,15,Champions
4423,1688,14,31,1,3,2,6,Casual Users
4577,65,27,238,5,4,5,14,Champions
5032,1516,7,30,1,2,2,5,Lost
5130,1549,5,5,1,1,1,3,Lost
5331,573,5,7,2,1,1,4,Lost
5540,534,6,21,2,1,2,5,Lost
5767,234,69,149,3,5,5,13,Loyal Users
5972,6,141,243,5,5,5,15,Champions
6138,125,25,100,4,4,4,12,Champions
6400,415,11,20,3,2,2,7,Casual Users
6499,1395,43,162,1,4,5,10,At Risk
6602,2676,10,78,1,2,4,7,Lost
6874,149,27,208,4,4,5,13,Champions
7238,11,9,32,5,2,3,10,Promising
7352,39,164,775,5,5,5,15,Champions
7665,1371,7,15,1,2,1,4,Lost
8521,8,46,265,5,5,5,15,Champions
8692,53,7,24,5,2,2,9,Promising
8842,276,44,136,3,4,4,11,Loyal Users
9051,114,53,286,4,5,5,14,Champions
9056,217,20,80,3,3,4,10,Loyal Users
9256,1032,9,10,2,2,1,5,Lost
9703,1462,19,35,1,3,3,7,Casual Users
9943,409,7,8,3,2,1,6,Casual Users
10479,59,81,237,5,5,5,15,Champions
10489,2577,33,64,1,4,4,9,At Risk
10534,1571,5,8,1,1,1,3,Lost
10811,2505,7,23,1,2,2,5,Lost
10917,439,8,9,3,2,1,6,Casual Users
10983,25,39,52,5,4,3,12,Loyal Users
10990,882,11,19,2,2,2,6,Lost
10995,361,5,9,3,1,1,5,Casual Users
11016,183,31,139,3,4,4,11,Loyal Users
11263,1971,5,11,1,1,1,3,Lost
11284,353,28,37,3,4,3,10,Loyal Users
11706,838,25,236,2,4,5,11,At Risk
12163,81,115,571,4,5,5,14,Champions
12231,1572,15,38,1,3,3,7,Casual Users
12655,4,130,242,5,5,5,15,Champions
12787,98,41,63,4,4,4,12,Champions
12905,164,77,331,4,5,5,14,Champions
13186,1553,7,7,1,2,1,4,Lost
13233,2947,9,14,1,2,1,4,Lost
13238,369,7,11,3,2,1,6,Casual Users
13370,821,6,13,2,1,1,4,Lost
13450,3741,13,14,1,3,1,5,Casual Users
13482,68,11,22,5,2,2,9,Promising
310,142,51,152,4,5,5,14,Champions
485,1123,15,60,2,3,3,8,Casual Users
568,663,8,8,2,2,1,5,Lost
698,1373,5,29,1,1,2,4,Lost
742,677,6,7,2,1,1,4,Lost
838,36,66,88,5,5,4,14,Champions
870,108,78,326,4,5,5,14,Champions
900,1276,7,11,1,2,1,4,Lost
1377,444,9,87,3,2,4,9,Casual Users
1513,282,49,95,3,5,4,12,Loyal Users
1539,1511,10,43,1,2,3,6,Lost
1814,134,26,76,4,4,4,12,Champions
2099,1817,5,16,1,1,2,4,Lost
2273,36,9,22,5,2,2,9,Promising
2297,56,151,220,5,5,5,15,Champions
2442,303,13,24,3,3,2,8,Loyal Users
2523,4839,44,144,1,4,4,9,At Risk
2584,103,61,97,4,5,4,13,Champions
2667,4557,9,14,1,2,1,4,Lost
2906,1611,36,103,1,4,4,9,At Risk
3102,6,143,214,5,5,5,15,Champions
3304,548,29,34,2,4,3,9,At Risk
3588,2455,53,155,1,5,5,11,At Risk
3934,277,30,35,3,4,3,10,Loyal Users
3938,82,61,202,4,5,5,14,Champions
4133,129,90,199,4,5,5,14,Champions
4223,326,6,8,3,1,1,5,Casual Users
4453,249,6,8,3,1,1,5,Casual Users
4626,4671,10,13,1,2,1,4,Lost
4840,438,6,10,3,1,1,5,Casual Users
4855,14,6,8,5,1,1,7,Promising
5271,106,64,275,4,5,5,14,Champions
5558,90,5,40,4,1,3,8,Promising
5575,142,10,26,4,2,2,8,Promising
5704,271,14,50,3,3,3,9,Loyal Users
5814,825,14,99,2,3,4,9,Casual Users
6055,333,10,34,3,2,3,8,Casual Users
6075,150,29,64,4,4,4,12,Champions
6235,1310,64,144,1,5,4,10,At Risk
6360,1667,10,24,1,2,2,5,Lost
6429,547,17,44,2,3,3,8,Casual Users
6539,795,35,89,2,4,4,10,At Risk
6693,943,13,60,2,3,3,8,Casual Users
6793,371,6,45,3,1,3,7,Casual Users
6818,821,7,52,2,2,3,7,Lost
7039,809,29,74,2,4,4,10,At Risk
7379,284,30,68,3,4,4,11,Loyal Users
7389,160,17,238,4,3,5,12,Loyal Users
7416,293,11,47,3,2,3,8,Casual Users
7605,14,38,85,5,4,4,13,Champions
7618,3953,5,7,1,1,1,3,Lost
7650,101,17,195,4,3,5,12,Loyal Users
7686,855,14,19,2,3,2,7,Casual Users
7714,5116,6,10,1,1,1,3,Lost
7784,75,9,25,4,2,2,8,Promising
7846,299,76,164,3,5,5,13,Loyal Users
7923,466,8,9,3,2,1,6,Casual Users
7948,127,35,93,4,4,4,12,Champions
7973,287,14,97,3,3,4,10,Loyal Users
7995,421,32,49,3,4,3,10,Loyal Users
8299,37,20,78,5,3,4,12,Loyal Users
8651,130,53,104,4,5,4,13,Champions
8697,1103,34,71,2,4,4,10,At Risk
8746,424,32,89,3,4,4,11,Loyal Users
9087,1994,12,12,1,3,1,5,Casual Users
9195,121,43,121,4,4,4,12,Champions
9315,550,9,16,2,2,2,6,Lost
9360,1423,9,14,1,2,1,4,Lost
9417,1876,17,80,1,3,4,8,Casual Users
9466,69,118,367,5,5,5,15,Champions
9477,5436,5,9,1,1,1,3,Lost
9755,1147,5,9,2,1,1,4,Lost
10259,179,48,313,3,5,5,13,Loyal Users
10392,868,22,36,2,4,3,9,At Risk
10911,23,124,325,5,5,5,15,Champions
10956,62,56,97,5,5,4,14,Champions
10961,586,5,7,2,1,1,4,Lost
11061,233,32,104,3,4,4,11,Loyal Users
11062,2455,43,92,1,4,4,9,At Risk
11127,4388,7,13,1,2,1,4,Lost
11199,120,20,58,4,3,3,10,Loyal Users
11247,242,31,119,3,4,4,11,Loyal Users
11825,1208,11,34,2,2,3,7,Lost
12022,1525,7,27,1,2,2,5,Lost
12261,373,26,107,3,4,4,11,Loyal Users
12539,5300,5,10,1,1,1,3,Lost
12571,298,12,14,3,3,1,7,Loyal Users
12633,3607,5,11,1,1,1,3,Lost
12736,4590,40,87,1,4,4,9,At Risk
196,109,10,13,4,2,1,7,Promising
437,3,26,95,5,4,4,13,Champions
456,0,28,111,5,4,4,13,Champions
829,10,38,67,5,4,4,13,Champions
834,9,7,83,5,2,4,11,Promising
1154,19,169,590,5,5,5,15,Champions
1272,1419,6,34,1,1,3,5,Lost
1438,618,18,118,2,3,4,9,Casual Users
1451,48,6,10,5,1,1,7,Promising
1789,831,65,103,2,5,4,11,At Risk
1945,1345,7,7,1,2,1,4,Lost
1957,1417,5,6,1,1,1,3,Lost
2135,412,12,19,3,3,2,8,Loyal Users
2202,419,70,110,3,5,4,12,Loyal Users
2369,235,9,16,3,2,2,7,Casual Users
2469,379,8,48,3,2,3,8,Casual Users
2855,575,9,19,2,2,2,6,Lost
3129,98,34,76,4,4,4,12,Champions
3823,9,197,608,5,5,5,15,Champions
4440,510,8,19,2,2,2,6,Lost
4950,480,5,12,2,1,1,4,Lost
5317,45,8,24,5,2,2,9,Promising
5386,122,13,36,4,3,3,10,Loyal Users
5531,248,5,7,3,1,1,5,Casual Users
6156,570,23,111,2,4,4,10,At Risk
6433,1146,7,9,2,2,1,5,Lost
6521,304,25,63,3,4,4,11,Loyal Users
6591,343,68,378,3,5,5,13,Loyal Users
7051,759,8,19,2,2,2,6,Lost
7086,1176,46,104,2,5,4,11,At Risk
7130,1161,14,16,2,3,2,7,Casual Users
7689,698,27,50,2,4,3,9,At Risk
7803,109,98,173,4,5,5,14,Champions
8598,257,34,161,3,4,5,12,Loyal Users
8801,569,8,23,2,2,2,6,Lost
9094,379,28,83,3,4,4,11,Loyal Users
9119,44,5,10,5,1,1,7,Promising
9242,46,12,24,5,3,2,10,Loyal Users
9602,306,37,112,3,4,4,11,Loyal Users
9604,9,20,66,5,3,4,12,Loyal Users
9812,88,31,54,4,4,3,11,Loyal Users
9942,499,8,51,2,2,3,7,Lost
9994,105,95,232,4,5,5,14,Champions
10237,1269,7,42,1,2,3,6,Lost
10476,538,8,49,2,2,3,7,Lost
10561,220,27,96,3,4,4,11,Loyal Users
10625,432,7,14,3,2,1,6,Casual Users
10797,2851,5,26,1,1,2,4,Lost
11152,656,5,11,2,1,1,4,Lost
11224,77,27,80,4,4,4,12,Champions
11436,132,64,198,4,5,5,14,Champions
11567,671,25,81,2,4,4,10,At Risk
11588,3984,10,24,1,2,2,5,Lost
11597,28,11,18,5,2,2,9,Promising
11646,381,27,169,3,4,5,12,Loyal Users
12069,112,58,128,4,5,4,13,Champions
12110,60,7,8,5,2,1,8,Promising
12388,275,9,29,3,2,2,7,Casual Users
12493,255,16,26,3,3,2,8,Loyal Users
12534,21,37,120,5,4,4,13,Champions
12621,19,9,26,5,2,2,9,Promising
13348,5434,6,7,1,1,1,3,Lost
13481,447,10,15,3,2,1,6,Casual Users
217,2296,11,32,1,2,3,6,Lost
290,250,162,414,3,5,5,13,Loyal Users
441,106,13,17,4,3,2,9,Loyal Users
733,76,79,468,4,5,5,14,Champions
800,931,20,55,2,3,3,8,Casual Users
884,104,36,88,4,4,4,12,Champions
948,1958,12,16,1,3,2,6,Casual Users
986,96,26,47,4,4,3,11,Loyal Users
1560,541,17,37,2,3,3,8,Casual Users
1643,2110,8,12,1,2,1,4,Lost
1657,718,7,13,2,2,1,5,Lost
1735,234,30,106,3,4,4,11,Loyal Users
1833,65,9,24,5,2,2,9,Promising
2171,241,18,25,3,3,2,8,Loyal Users
2174,132,13,36,4,3,3,10,Loyal Users
2338,1841,22,94,1,4,4,9,At Risk
2561,70,22,63,4,4,4,12,Champions
3422,266,41,69,3,4,4,11,Loyal Users
3423,18,11,30,5,2,2,9,Promising
3563,412,20,80,3,3,4,10,Loyal Users
3647,87,9,17,4,2,2,8,Promising
3710,1530,5,13,1,1,1,3,Lost
3971,365,34,104,3,4,4,11,Loyal Users
4068,566,23,51,2,4,3,9,At Risk
4345,3720,7,39,1,2,3,6,Lost
4495,282,6,6,3,1,1,5,Casual Users
4650,156,47,104,4,5,4,13,Champions
4897,2440,23,42,1,4,3,8,At Risk
5029,850,39,142,2,4,4,10,At Risk
5387,104,13,18,4,3,2,9,Loyal Users
5630,143,12,158,4,3,5,12,Loyal Users
5856,5422,7,12,1,2,1,4,Lost
6015,35,115,838,5,5,5,15,Champions
6031,414,23,57,3,4,3,10,Loyal Users
6089,30,55,131,5,5,4,14,Champions
6309,129,8,38,4,2,3,9,Promising
6405,125,15,19,4,3,2,9,Loyal Users
6446,22,7,9,5,2,1,8,Promising
6657,841,7,14,2,2,1,5,Lost
7038,4224,10,31,1,2,2,5,Lost
7190,97,37,79,4,4,4,12,Champions
7344,55,139,468,5,5,5,15,Champions
7388,518,10,13,2,2,1,5,Lost
7596,125,50,97,4,5,4,13,Champions
7603,399,7,14,3,2,1,6,Casual Users
7724,48,29,207,5,4,5,14,Champions
8330,277,8,19,3,2,2,7,Casual Users
8446,262,21,93,3,3,4,10,Loyal Users
8703,496,10,62,2,2,3,7,Lost
9346,194,23,55,3,4,3,10,Loyal Users
9431,1979,5,24,1,1,2,4,Lost
9467,3856,10,13,1,2,1,4,Lost
9524,1410,9,13,1,2,1,4,Lost
9756,1340,5,11,1,1,1,3,Lost
10134,348,72,524,3,5,5,13,Loyal Users
10448,137,20,36,4,3,3,10,Loyal Users
10470,2960,6,18,1,1,2,4,Lost
10724,661,37,44,2,4,3,9,At Risk
10765,952,16,94,2,3,4,9,Casual Users
10958,148,59,412,4,5,5,14,Champions
11094,239,44,209,3,4,5,12,Loyal Users
11164,2715,11,33,1,2,3,6,Lost
11208,531,6,25,2,1,2,5,Lost
11561,69,18,137,5,3,4,12,Loyal Users
11742,12,60,95,5,5,4,14,Champions
11778,17,89,468,5,5,5,15,Champions
11815,28,28,145,5,4,4,13,Champions
11995,237,10,30,3,2,2,7,Casual Users
12228,90,41,144,4,4,4,12,Champions
12309,2029,7,8,1,2,1,4,Lost
12418,562,6,15,2,1,1,4,Lost
12532,30,28,89,5,4,4,13,Champions
12586,98,14,86,4,3,4,11,Loyal Users
12608,19,17,39,5,3,3,11,Loyal Users
12620,2981,8,95,1,2,4,7,Lost
12786,123,99,556,4,5,5,14,Champions
12846,106,46,66,4,5,4,13,Champions
13230,1155,8,18,2,2,2,6,Lost
13240,942,10,13,2,2,1,5,Lost
13438,432,5,17,3,1,2,6,Casual Users
13563,2,92,217,5,5,5,15,Champions
229,1689,6,14,1,1,1,3,Lost
307,560,48,66,2,5,4,11,At Risk
326,4887,5,23,1,1,2,4,Lost
537,2453,10,17,1,2,2,5,Lost
766,266,18,30,3,3,2,8,Loyal Users
823,5273,10,49,1,2,3,6,Lost
960,1120,13,41,2,3,3,8,Casual Users
1037,106,31,86,4,4,4,12,Champions
1096,169,13,38,3,3,3,9,Loyal Users
1545,145,25,28,4,4,2,10,Loyal Users
1727,2736,6,13,1,1,1,3,Lost
2081,83,87,353,4,5,5,14,Champions
2631,46,71,182,5,5,5,15,Champions
2904,242,17,22,3,3,2,8,Loyal Users
2983,981,10,22,2,2,2,6,Lost
3085,16,45,105,5,4,4,13,Champions
3273,220,13,33,3,3,3,9,Loyal Users
3326,661,12,23,2,3,2,7,Casual Users
3513,1434,11,42,1,2,3,6,Lost
4290,2941,5,42,1,1,3,5,Lost
4361,57,81,425,5,5,5,15,Champions
4444,1097,7,38,2,2,3,7,Lost
4613,646,14,73,2,3,4,9,Casual Users
4916,101,50,360,4,5,5,14,Champions
4924,95,85,200,4,5,5,14,Champions
5503,81,32,185,4,4,5,13,Champions
5600,250,12,63,3,3,4,10,Loyal Users
5840,132,26,53,4,4,3,11,Loyal Users
5923,130,6,8,4,1,1,6,Promising
5938,7,122,382,5,5,5,15,Champions
5956,40,37,298,5,4,5,14,Champions
6207,409,12,17,3,3,2,8,Loyal Users
6369,203,59,245,3,5,5,13,Loyal Users
6454,26,9,13,5,2,1,8,Promising
6551,1683,10,33,1,2,3,6,Lost
6621,704,8,32,2,2,3,7,Lost
6685,166,26,103,3,4,4,11,Loyal Users
6739,74,40,103,4,4,4,12,Champions
7227,143,14,18,4,3,2,9,Loyal Users
7268,1306,8,16,1,2,2,5,Lost
7303,403,5,20,3,1,2,6,Casual Users
7341,144,5,9,4,1,1,6,Promising
7380,137,15,34,4,3,3,10,Loyal Users
7632,144,42,230,4,4,5,13,Champions
7638,3747,7,7,1,2,1,4,Lost
7685,241,10,22,3,2,2,7,Casual Users
7872,139,107,148,4,5,5,14,Champions
8202,1752,8,13,1,2,1,4,Lost
8292,688,5,10,2,1,1,4,Lost
8300,0,37,114,5,4,4,13,Champions
8641,143,7,11,4,2,1,7,Promising
8662,97,7,8,4,2,1,7,Promising
8793,149,6,18,4,1,2,7,Promising
9107,5242,13,24,1,3,2,6,Casual Users
9192,548,5,29,2,1,2,5,Lost
9237,107,110,247,4,5,5,14,Champions
9757,5,44,61,5,4,3,12,Loyal Users
9811,264,130,657,3,5,5,13,Loyal Users
10167,541,36,68,2,4,4,10,At Risk
10213,4411,5,14,1,1,1,3,Lost
10393,114,15,39,4,3,3,10,Loyal Users
10785,4040,5,6,1,1,1,3,Lost
10801,0,58,77,5,5,4,14,Champions
11058,6,5,19,5,1,2,8,Promising
11190,1430,37,103,1,4,4,9,At Risk
11341,263,10,19,3,2,2,7,Casual Users
11428,268,19,28,3,3,2,8,Loyal Users
11749,1098,8,14,2,2,1,5,Lost
12378,705,107,295,2,5,5,12,At Risk
12382,424,6,7,3,1,1,5,Casual Users
12441,9,101,241,5,5,5,15,Champions
12581,231,27,184,3,4,5,12,Loyal Users
12617,541,5,14,2,1,1,4,Lost
13364,566,26,38,2,4,3,9,At Risk
114,306,60,120,3,5,4,12,Loyal Users
173,2550,5,9,1,1,1,3,Lost
220,429,7,8,3,2,1,6,Casual Users
278,1504,18,52,1,3,3,7,Casual Users
301,730,6,7,2,1,1,4,Lost
494,131,6,13,4,1,1,6,Promising
669,5210,13,16,1,3,2,6,Casual Users
713,128,14,39,4,3,3,10,Loyal Users
810,981,74,254,2,5,5,12,At Risk
813,11,37,83,5,4,4,13,Champions
890,298,99,441,3,5,5,13,Loyal Users
1036,361,17,21,3,3,2,8,Loyal Users
1205,3,40,353,5,4,5,14,Champions
1737,3853,40,123,1,4,4,9,At Risk
2111,1264,29,150,1,4,5,10,At Risk
2402,4838,7,7,1,2,1,4,Lost
2495,421,13,19,3,3,2,8,Loyal Users
2872,78,47,110,4,5,4,13,Champions
2929,1035,14,17,2,3,2,7,Casual Users
2970,1414,9,10,1,2,1,4,Lost
2991,135,128,804,4,5,5,14,Champions
3018,3186,26,33,1,4,3,8,At Risk
3660,117,142,699,4,5,5,14,Champions
4210,599,9,9,2,2,1,5,Lost
4215,1686,12,22,1,3,2,6,Casual Users
4690,311,33,138,3,4,4,11,Loyal Users
4881,1814,5,40,1,1,3,5,Lost
5127,1415,7,7,1,2,1,4,Lost
5131,92,44,91,4,4,4,12,Champions
5149,120,12,70,4,3,4,11,Loyal Users
5319,26,9,24,5,2,2,9,Promising
5561,175,12,13,3,3,1,7,Loyal Users
5720,64,148,331,5,5,5,15,Champions
5752,18,5,7,5,1,1,7,Promising
5795,143,17,41,4,3,3,10,Loyal Users
5825,855,5,13,2,1,1,4,Lost
6462,268,18,124,3,3,4,10,Loyal Users
6564,1850,9,36,1,2,3,6,Lost
6642,5254,5,6,1,1,1,3,Lost
6771,164,14,33,4,3,3,10,Loyal Users
7030,849,13,133,2,3,4,9,Casual Users
7761,283,42,56,3,4,3,10,Loyal Users
7961,462,5,7,3,1,1,5,Casual Users
7984,83,7,84,4,2,4,10,Promising
8079,559,35,89,2,4,4,10,At Risk
8241,36,17,39,5,3,3,11,Loyal Users
8272,221,20,62,3,3,3,9,Loyal Users
8425,1657,9,19,1,2,2,5,Lost
8565,153,89,302,4,5,5,14,Champions
8616,580,21,143,2,3,4,9,Casual Users
8730,17,49,191,5,5,5,15,Champions
8738,36,91,199,5,5,5,15,Champions
8868,2487,8,45,1,2,3,6,Lost
8916,9,19,77,5,3,4,12,Loyal Users
8940,134,5,15,4,1,1,6,Promising
8989,55,68,168,5,5,5,15,Champions
9294,137,6,7,4,1,1,6,Promising
9302,1137,5,7,2,1,1,4,Lost
9582,1124,5,47,2,1,3,6,Lost
9709,114,39,149,4,4,5,13,Champions
9792,5748,7,21,1,2,2,5,Lost
9850,547,13,29,2,3,2,7,Casual Users
9857,69,9,92,5,2,4,11,Promising
9938,217,34,134,3,4,4,11,Loyal Users
9967,2582,23,36,1,4,3,8,At Risk
10057,38,74,762,5,5,5,15,Champions
10261,620,13,37,2,3,3,8,Casual Users
10482,901,12,46,2,3,3,8,Casual Users
10615,144,8,62,4,2,3,9,Promising
10617,117,5,7,4,1,1,6,Promising
10837,24,29,75,5,4,4,13,Champions
10863,1398,11,71,1,2,4,7,Lost
10930,156,79,137,4,5,4,13,Champions
11056,32,28,85,5,4,4,13,Champions
11189,872,14,17,2,3,2,7,Casual Users
11509,746,7,8,2,2,1,5,Lost
11617,3267,5,8,1,1,1,3,Lost
12073,250,16,24,3,3,2,8,Loyal Users
12111,1266,36,95,1,4,4,9,At Risk
12363,430,53,215,3,5,5,13,Loyal Users
12663,2146,5,13,1,1,1,3,Lost
12700,405,10,17,3,2,2,7,Casual Users
12772,391,16,67,3,3,4,10,Loyal Users
12838,121,9,14,4,2,1,7,Promising
12950,3148,7,10,1,2,1,4,Lost
12970,93,69,148,4,5,5,14,Champions
13507,104,11,37,4,2,3,9,Promising
4,1719,58,96,1,5,4,10,At Risk
55,1,197,489,5,5,5,15,Champions
59,37,80,638,5,5,5,15,Champions
445,8,68,352,5,5,5,15,Champions
684,476,14,42,2,3,3,8,Casual Users
1318,432,15,51,3,3,3,9,Loyal Users
1340,581,16,35,2,3,3,8,Casual Users
1540,725,8,16,2,2,2,6,Lost
1575,59,19,32,5,3,3,11,Loyal Users
1669,129,14,28,4,3,2,9,Loyal Users
1779,1000,14,59,2,3,3,8,Casual Users
2046,3873,7,19,1,2,2,5,Lost
2204,24,32,138,5,4,4,13,Champions
2581,216,7,16,3,2,2,7,Casual Users
2993,312,11,28,3,2,2,7,Casual Users
3093,3293,7,36,1,2,3,6,Lost
3170,278,10,30,3,2,2,7,Casual Users
3229,134,19,33,4,3,3,10,Loyal Users
3339,422,8,20,3,2,2,7,Casual Users
3505,132,14,28,4,3,2,9,Loyal Users
3653,392,9,26,3,2,2,7,Casual Users
3830,96,14,24,4,3,2,9,Loyal Users
3926,304,17,52,3,3,3,9,Loyal Users
4020,3452,7,58,1,2,3,6,Lost
4333,629,6,7,2,1,1,4,Lost
4573,277,75,251,3,5,5,13,Loyal Users
4592,241,8,19,3,2,2,7,Casual Users
4646,99,5,5,4,1,1,6,Promising
4721,166,85,487,3,5,5,13,Loyal Users
5049,7,67,210,5,5,5,15,Champions
5363,4315,5,19,1,1,2,4,Lost
5511,184,14,26,3,3,2,8,Loyal Users
5556,4475,33,54,1,4,3,8,At Risk
5608,695,16,58,2,3,3,8,Casual Users
5742,1481,6,12,1,1,1,3,Lost
6003,68,148,456,5,5,5,15,Champions
6137,142,13,58,4,3,3,10,Loyal Users
6175,89,39,133,4,4,4,12,Champions
6280,1090,13,14,2,3,1,6,Casual Users
6343,2981,5,8,1,1,1,3,Lost
6344,1832,5,20,1,1,2,4,Lost
6348,304,101,190,3,5,5,13,Loyal Users
6443,1324,6,13,1,1,1,3,Lost
7187,471,8,12,2,2,1,5,Lost
7267,16,14,51,5,3,3,11,Loyal Users
7360,997,12,16,2,3,2,7,Casual Users
7750,568,8,10,2,2,1,5,Lost
7785,150,43,136,4,4,4,12,Champions
7876,36,34,65,5,4,4,13,Champions
8027,3096,8,13,1,2,1,4,Lost
8069,3842,5,6,1,1,1,3,Lost
9004,852,9,29,2,2,2,6,Lost
9173,1,96,231,5,5,5,15,Champions
9738,4,101,710,5,5,5,15,Champions
9766,5967,5,12,1,1,1,3,Lost
9817,571,8,14,2,2,1,5,Lost
9859,92,44,134,4,4,4,12,Champions
9973,113,50,138,4,5,4,13,Champions
10024,140,32,73,4,4,4,12,Champions
10154,6,144,407,5,5,5,15,Champions
10551,25,118,542,5,5,5,15,Champions
10559,1591,10,38,1,2,3,6,Lost
10850,1684,8,13,1,2,1,4,Lost
10946,11,149,387,5,5,5,15,Champions
11020,1740,5,20,1,1,2,4,Lost
12086,719,6,16,2,1,2,5,Lost
12198,153,25,96,4,4,4,12,Champions
12478,27,33,100,5,4,4,13,Champions
12947,1,131,803,5,5,5,15,Champions
12995,1,72,117,5,5,4,14,Champions
13283,2942,75,261,1,5,5,11,At Risk
13343,258,17,107,3,3,4,10,Loyal Users
13365,34,61,167,5,5,5,15,Champions
13379,7,96,242,5,5,5,15,Champions
8,1140,5,24,2,1,2,5,Lost
100,212,37,82,3,4,4,11,Loyal Users
241,2659,5,46,1,1,3,5,Lost
449,4413,7,14,1,2,1,4,Lost
450,26,8,18,5,2,2,9,Promising
495,715,10,15,2,2,1,5,Lost
717,97,31,39,4,4,3,11,Loyal Users
757,137,84,232,4,5,5,14,Champions
930,658,17,58,2,3,3,8,Casual Users
2159,41,79,320,5,5,5,15,Champions
2299,361,28,117,3,4,4,11,Loyal Users
2424,381,7,28,3,2,2,7,Casual Users
2547,2095,5,12,1,1,1,3,Lost
2574,5564,5,20,1,1,2,4,Lost
3443,1248,5,13,2,1,1,4,Lost
3575,3038,5,9,1,1,1,3,Lost
3739,961,6,8,2,1,1,4,Lost
3889,147,63,490,4,5,5,14,Champions
3959,270,34,117,3,4,4,11,Loyal Users
4044,483,8,15,2,2,1,5,Lost
4054,3272,75,381,1,5,5,11,At Risk
4066,2044,9,30,1,2,2,5,Lost
4122,557,20,37,2,3,3,8,Casual Users
4160,868,8,8,2,2,1,5,Lost
4248,3,122,344,5,5,5,15,Champions
4254,238,9,33,3,2,3,8,Casual Users
4299,98,16,23,4,3,2,9,Loyal Users
4313,159,162,220,4,5,5,14,Champions
4601,2418,6,13,1,1,1,3,Lost
5276,1084,11,13,2,2,1,5,Lost
5662,1982,45,76,1,4,4,9,At Risk
5722,657,12,47,2,3,3,8,Casual Users
6026,279,14,131,3,3,4,10,Loyal Users
6212,439,8,23,3,2,2,7,Casual Users
6363,51,13,45,5,3,3,11,Loyal Users
6425,118,28,60,4,4,3,11,Loyal Users
6567,317,5,65,3,1,4,8,Casual Users
6910,20,179,405,5,5,5,15,Champions
6966,5494,37,71,1,4,4,9,At Risk
7136,1146,36,45,2,4,3,9,At Risk
7209,142,15,40,4,3,3,10,Loyal Users
8151,25,47,203,5,5,5,15,Champions
8153,137,64,190,4,5,5,14,Champions
8309,170,26,80,3,4,4,11,Loyal Users
8432,2682,19,29,1,3,2,6,Casual Users
8667,1240,5,10,2,1,1,4,Lost
8866,392,6,14,3,1,1,5,Casual Users
8931,1299,35,133,1,4,4,9,At Risk
9155,1294,8,13,1,2,1,4,Lost
9361,282,14,100,3,3,4,10,Loyal Users
9406,121,48,109,4,5,4,13,Champions
9806,1680,6,11,1,1,1,3,Lost
9848,3360,6,17,1,1,2,4,Lost
10009,641,12,52,2,3,3,8,Casual Users
10133,1634,5,7,1,1,1,3,Lost
10317,0,138,661,5,5,5,15,Champions
10381,2458,12,16,1,3,2,6,Casual Users
10464,84,48,247,4,5,5,14,Champions
10477,94,20,24,4,3,2,9,Loyal Users
10945,154,88,172,4,5,5,14,Champions
11182,403,7,27,3,2,2,7,Casual Users
11222,0,105,449,5,5,5,15,Champions
11603,122,5,11,4,1,1,6,Promising
11959,91,88,228,4,5,5,14,Champions
12031,345,5,5,3,1,1,5,Casual Users
12100,835,9,10,2,2,1,5,Lost
12595,550,28,77,2,4,4,10,At Risk
12606,3,78,129,5,5,4,14,Champions
13128,5,122,260,5,5,5,15,Champions
13268,285,7,14,3,2,1,6,Casual Users
161,1030,7,13,2,2,1,5,Lost
555,628,7,13,2,2,1,5,Lost
687,381,6,13,3,1,1,5,Casual Users
987,633,43,134,2,4,4,10,At Risk
1066,418,5,7,3,1,1,5,Casual Users
1256,743,7,8,2,2,1,5,Lost
1279,5153,18,31,1,3,2,6,Casual Users
1385,153,32,83,4,4,4,12,Champions
1397,1612,10,20,1,2,2,5,Lost
1943,311,15,33,3,3,3,9,Loyal Users
1989,563,33,86,2,4,4,10,At Risk
1996,1997,21,32,1,3,3,7,Casual Users
2030,104,119,492,4,5,5,14,Champions
2163,16,50,95,5,5,4,14,Champions
2687,635,14,70,2,3,4,9,Casual Users
2937,80,21,202,4,3,5,12,Loyal Users
3036,264,26,46,3,4,3,10,Loyal Users
3128,160,14,143,4,3,4,11,Loyal Users
3479,1051,40,145,2,4,4,10,At Risk
3629,163,25,63,4,4,4,12,Champions
5369,3,8,15,5,2,1,8,Promising
5925,289,38,53,3,4,3,10,Loyal Users
6283,857,11,12,2,2,1,5,Lost
6816,265,17,37,3,3,3,9,Loyal Users
6848,305,13,37,3,3,3,9,Loyal Users
6892,116,22,63,4,4,4,12,Champions
6965,643,6,80,2,1,4,7,Lost
7574,1712,11,21,1,2,2,5,Lost
7597,654,35,96,2,4,4,10,At Risk
7804,35,84,554,5,5,5,15,Champions
7825,5,74,200,5,5,5,15,Champions
7867,485,8,13,2,2,1,5,Lost
8284,948,53,248,2,5,5,12,At Risk
8971,304,58,70,3,5,4,12,Loyal Users
9187,84,10,53,4,2,3,9,Promising
9221,2869,10,23,1,2,2,5,Lost
9303,15,49,89,5,5,4,14,Champions
9868,61,29,255,5,4,5,14,Champions
10614,104,104,801,4,5,5,14,Champions
10722,1086,6,42,2,1,3,6,Lost
10859,447,10,55,3,2,3,8,Casual Users
10870,1681,9,68,1,2,4,7,Lost
11005,3414,7,14,1,2,1,4,Lost
11178,1693,8,15,1,2,1,4,Lost
11272,421,25,47,3,4,3,10,Loyal Users
11372,691,20,53,2,3,3,8,Casual Users
11523,246,12,29,3,3,2,8,Loyal Users
11537,3555,9,10,1,2,1,4,Lost
11818,89,38,226,4,4,5,13,Champions
12197,75,36,122,4,4,4,12,Champions
12311,384,19,36,3,3,3,9,Loyal Users
13319,119,113,263,4,5,5,14,Champions
13474,4466,14,37,1,3,3,7,Casual Users
23,164,14,23,4,3,2,9,Loyal Users
39,1034,16,45,2,3,3,8,Casual Users
679,969,19,56,2,3,3,8,Casual Users
719,532,16,95,2,3,4,9,Casual Users
922,70,87,495,4,5,5,14,Champions
981,135,47,131,4,5,4,13,Champions
1015,2715,5,8,1,1,1,3,Lost
1022,2315,14,24,1,3,2,6,Casual Users
1060,12,10,30,5,2,2,9,Promising
1169,700,11,23,2,2,2,6,Lost
1254,515,13,21,2,3,2,7,Casual Users
1315,81,143,572,4,5,5,14,Champions
1685,1176,8,19,2,2,2,6,Lost
2440,2291,15,24,1,3,2,6,Casual Users
2579,527,30,55,2,4,3,9,At Risk
2784,281,10,60,3,2,3,8,Casual Users
2854,1832,14,18,1,3,2,6,Casual Users
2933,1072,5,17,2,1,2,5,Lost
2959,223,24,86,3,4,4,11,Loyal Users
3157,4687,9,9,1,2,1,4,Lost
3292,156,8,24,4,2,2,8,Promising
3465,724,8,8,2,2,1,5,Lost
4002,84,35,289,4,4,5,13,Champions
4105,2573,7,14,1,2,1,4,Lost
4560,516,7,10,2,2,1,5,Lost
4731,4833,49,156,1,5,5,11,At Risk
4939,1917,13,44,1,3,3,7,Casual Users
5064,4253,5,22,1,1,2,4,Lost
5200,3166,8,54,1,2,3,6,Lost
5418,127,5,9,4,1,1,6,Promising
5432,982,13,22,2,3,2,7,Casual Users
5602,125,109,227,4,5,5,14,Champions
5603,391,14,39,3,3,3,9,Loyal Users
5792,986,28,37,2,4,3,9,At Risk
5797,19,46,190,5,5,5,15,Champions
5998,582,15,62,2,3,3,8,Casual Users
6198,227,30,77,3,4,4,11,Loyal Users
6390,136,44,261,4,4,5,13,Champions
6653,4738,12,43,1,3,3,7,Casual Users
7462,2436,5,7,1,1,1,3,Lost
7941,101,29,84,4,4,4,12,Champions
8122,1589,12,32,1,3,3,7,Casual Users
8606,1835,7,58,1,2,3,6,Lost
8805,97,42,152,4,4,5,13,Champions
8820,411,8,14,3,2,1,6,Casual Users
8925,105,75,105,4,5,4,13,Champions
8998,122,46,61,4,5,3,12,Loyal Users
9527,10,67,152,5,5,5,15,Champions
9717,815,22,78,2,4,4,10,At Risk
9728,2805,33,62,1,4,3,8,At Risk
10137,27,51,147,5,5,5,15,Champions
10255,0,47,192,5,5,5,15,Champions
10349,231,7,13,3,2,1,6,Casual Users
10510,220,18,37,3,3,3,9,Loyal Users
10879,29,115,1001,5,5,5,15,Champions
11007,4410,6,11,1,1,1,3,Lost
11010,102,41,226,4,4,5,13,Champions
11239,289,22,105,3,4,4,11,Loyal Users
11415,630,28,55,2,4,3,9,At Risk
11935,859,8,21,2,2,2,6,Lost
12153,3534,5,27,1,1,2,4,Lost
12300,364,16,21,3,3,2,8,Loyal Users
12488,266,49,154,3,5,5,13,Loyal Users
13237,585,11,13,2,2,1,5,Lost
13244,684,15,75,2,3,4,9,Casual Users
49,385,10,23,3,2,2,7,Casual Users
176,373,10,10,3,2,1,6,Casual Users
380,1545,6,28,1,1,2,4,Lost
520,545,75,147,2,5,5,12,At Risk
629,614,13,15,2,3,1,6,Casual Users
672,1950,5,20,1,1,2,4,Lost
736,141,28,52,4,4,3,11,Loyal Users
791,1470,7,7,1,2,1,4,Lost
1041,1996,9,22,1,2,2,5,Lost
1075,175,36,62,3,4,3,10,Loyal Users
1076,8,16,59,5,3,3,11,Loyal Users
1111,9,25,44,5,4,3,12,Loyal Users
1116,50,160,244,5,5,5,15,Champions
1287,372,6,12,3,1,1,5,Casual Users
1462,3432,16,19,1,3,2,6,Casual Users
1614,3026,7,17,1,2,2,5,Lost
1677,114,103,211,4,5,5,14,Champions
1717,606,12,19,2,3,2,7,Casual Users
1754,9,63,208,5,5,5,15,Champions
1868,1551,23,49,1,4,3,8,At Risk
2315,249,46,89,3,5,4,12,Loyal Users
2665,658,9,11,2,2,1,5,Lost
3002,470,10,119,3,2,4,9,Casual Users
3263,579,8,20,2,2,2,6,Lost
3373,277,9,55,3,2,3,8,Casual Users
3756,30,50,87,5,5,4,14,Champions
3772,992,18,142,2,3,4,9,Casual Users
3800,825,6,10,2,1,1,4,Lost
3964,49,39,107,5,4,4,13,Champions
4080,394,14,81,3,3,4,10,Loyal Users
4252,281,9,21,3,2,2,7,Casual Users
4334,280,6,12,3,1,1,5,Casual Users
4369,61,29,92,5,4,4,13,Champions
4682,137,10,25,4,2,2,8,Promising
4693,193,8,20,3,2,2,7,Casual Users
5022,37,24,40,5,4,3,12,Loyal Users
5023,246,35,209,3,4,5,12,Loyal Users
5076,2278,16,44,1,3,3,7,Casual Users
5425,67,83,495,5,5,5,15,Champions
5542,4388,9,11,1,2,1,4,Lost
5596,232,16,190,3,3,5,11,Loyal Users
5808,578,7,34,2,2,3,7,Lost
6170,795,12,50,2,3,3,8,Casual Users
6626,59,45,84,5,4,4,13,Champions
6857,281,17,29,3,3,2,8,Loyal Users
7011,57,111,263,5,5,5,15,Champions
7354,2015,5,36,1,1,3,5,Lost
7382,497,12,21,2,3,2,7,Casual Users
7455,272,10,18,3,2,2,7,Casual Users
7487,4546,12,28,1,3,2,6,Casual Users
7713,1230,6,34,2,1,3,6,Lost
7947,196,22,86,3,4,4,11,Loyal Users
7966,92,73,238,4,5,5,14,Champions
8293,105,175,536,4,5,5,14,Champions
8581,3831,5,13,1,1,1,3,Lost
8885,799,22,104,2,4,4,10,At Risk
8936,2056,7,11,1,2,1,4,Lost
8952,585,33,39,2,4,3,9,At Risk
8984,249,45,106,3,4,4,11,Loyal Users
9253,738,11,57,2,2,3,7,Lost
9767,415,12,31,3,3,2,8,Loyal Users
9836,98,73,348,4,5,5,14,Champions
10424,153,7,38,4,2,3,9,Promising
10473,1039,10,14,2,2,1,5,Lost
10757,1722,41,160,1,4,5,10,At Risk
11145,115,5,16,4,1,2,7,Promising
11623,387,5,13,3,1,1,5,Casual Users
11683,305,20,84,3,3,4,10,Loyal Users
11856,868,10,14,2,2,1,5,Lost
12480,102,59,232,4,5,5,14,Champions
12627,1209,8,50,2,2,3,7,Lost
12957,1488,9,20,1,2,2,5,Lost
13074,940,5,23,2,1,2,5,Lost
13105,0,12,40,5,3,3,11,Loyal Users
13135,38,84,249,5,5,5,15,Champions
13362,365,23,48,3,4,3,10,Loyal Users
7,129,46,245,4,5,5,14,Champions
162,2434,5,5,1,1,1,3,Lost
514,223,5,28,3,1,2,6,Casual Users
549,125,150,300,4,5,5,14,Champions
637,77,133,479,4,5,5,14,Champions
877,1229,13,14,2,3,1,6,Casual Users
1431,1538,6,9,1,1,1,3,Lost
1432,80,65,241,4,5,5,14,Champions
1494,8,165,364,5,5,5,15,Champions
2034,2,13,29,5,3,2,10,Loyal Users
2272,277,68,216,3,5,5,13,Loyal Users
2436,356,49,266,3,5,5,13,Loyal Users
2576,1571,9,17,1,2,2,5,Lost
2756,834,6,40,2,1,3,6,Lost
2832,58,116,210,5,5,5,15,Champions
2935,2189,7,7,1,2,1,4,Lost
3154,1879,10,17,1,2,2,5,Lost
3294,566,22,72,2,4,4,10,At Risk
4490,183,89,217,3,5,5,13,Loyal Users
4550,1,31,62,5,4,3,12,Loyal Users
4909,110,43,202,4,4,5,13,Champions
5165,63,104,222,5,5,5,15,Champions
5775,997,6,14,2,1,1,4,Lost
6063,394,13,21,3,3,2,8,Loyal Users
6385,92,85,568,4,5,5,14,Champions
6570,2885,6,8,1,1,1,3,Lost
6574,944,11,50,2,2,3,7,Lost
6760,254,34,61,3,4,3,10,Loyal Users
7251,14,44,163,5,4,5,14,Champions
7377,272,26,47,3,4,3,10,Loyal Users
7561,2208,6,22,1,1,2,4,Lost
7646,257,147,417,3,5,5,13,Loyal Users
7728,1982,5,5,1,1,1,3,Lost
7763,1970,6,60,1,1,3,5,Lost
7773,545,8,20,2,2,2,6,Lost
7819,1087,6,37,2,1,3,6,Lost
7924,3247,6,7,1,1,1,3,Lost
8154,536,5,5,2,1,1,4,Lost
8583,701,13,26,2,3,2,7,Casual Users
8744,81,13,25,4,3,2,9,Loyal Users
8847,521,28,125,2,4,4,10,At Risk
9329,3283,7,11,1,2,1,4,Lost
9831,1283,15,35,1,3,3,7,Casual Users
10391,523,8,16,2,2,2,6,Lost
10795,8,79,515,5,5,5,15,Champions
11038,2752,5,8,1,1,1,3,Lost
11175,1410,9,16,1,2,2,5,Lost
11202,12,30,87,5,4,4,13,Champions
11227,266,86,159,3,5,5,13,Loyal Users
11418,278,7,32,3,2,3,8,Casual Users
11923,102,39,76,4,4,4,12,Champions
12059,139,19,31,4,3,2,9,Loyal Users
12251,661,23,34,2,4,3,9,At Risk
12629,520,19,31,2,3,2,7,Casual Users
12703,2590,12,16,1,3,2,6,Casual Users
13083,6,12,39,5,3,3,11,Loyal Users
130,308,40,67,3,4,4,11,Loyal Users
238,2806,6,53,1,1,3,5,Lost
244,777,8,10,2,2,1,5,Lost
446,296,14,57,3,3,3,9,Loyal Users
624,919,23,365,2,4,5,11,At Risk
648,424,15,32,3,3,3,9,Loyal Users
958,2162,18,37,1,3,3,7,Casual Users
1365,2076,18,31,1,3,2,6,Casual Users
1498,16,33,76,5,4,4,13,Champions
1662,1307,28,54,1,4,3,8,At Risk
1795,361,14,59,3,3,3,9,Loyal Users
2070,150,26,38,4,4,3,11,Loyal Users
2136,443,52,197,3,5,5,13,Loyal Users
2357,129,172,429,4,5,5,14,Champions
2677,988,5,5,2,1,1,4,Lost
2704,25,27,235,5,4,5,14,Champions
2717,1069,9,19,2,2,2,6,Lost
2912,707,11,15,2,2,1,5,Lost
2918,117,27,32,4,4,3,11,Loyal Users
2988,129,7,8,4,2,1,7,Promising
3024,264,25,54,3,4,3,10,Loyal Users
4109,1280,5,5,1,1,1,3,Lost
4437,404,14,45,3,3,3,9,Loyal Users
4522,33,69,210,5,5,5,15,Champions
5075,402,26,36,3,4,3,10,Loyal Users
5187,117,41,288,4,4,5,13,Champions
5834,1458,5,5,1,1,1,3,Lost
6035,230,126,344,3,5,5,13,Loyal Users
6224,548,14,19,2,3,2,7,Casual Users
6388,32,37,448,5,4,5,14,Champions
6402,126,42,160,4,4,5,13,Champions
6421,233,43,82,3,4,4,11,Loyal Users
6434,21,11,68,5,2,4,11,Promising
6854,401,7,22,3,2,2,7,Casual Users
7199,2522,5,22,1,1,2,4,Lost
7921,282,39,83,3,4,4,11,Loyal Users
7956,1996,6,6,1,1,1,3,Lost
7985,241,10,46,3,2,3,8,Casual Users
8081,405,7,15,3,2,1,6,Casual Users
8106,756,12,18,2,3,2,7,Casual Users
8339,457,36,101,3,4,4,11,Loyal Users
8454,1244,42,312,2,4,5,11,At Risk
8479,5345,6,9,1,1,1,3,Lost
8861,2648,8,13,1,2,1,4,Lost
8874,127,10,20,4,2,2,8,Promising
9033,130,57,205,4,5,5,14,Champions
9198,62,111,462,5,5,5,15,Champions
9259,106,70,245,4,5,5,14,Champions
9271,124,57,367,4,5,5,14,Champions
9288,276,8,23,3,2,2,7,Casual Users
9347,153,9,55,4,2,3,9,Promising
9743,30,9,103,5,2,4,11,Promising
10033,393,8,17,3,2,2,7,Casual Users
10446,535,26,58,2,4,3,9,At Risk
10656,8,87,550,5,5,5,15,Champions
10673,225,6,7,3,1,1,5,Casual Users
11274,40,48,120,5,5,4,14,Champions
11401,544,8,55,2,2,3,7,Lost
11747,65,22,93,5,4,4,13,Champions
11836,161,14,16,4,3,2,9,Loyal Users
12076,3398,5,15,1,1,1,3,Lost
12113,2163,8,11,1,2,1,4,Lost
12252,427,8,21,3,2,2,7,Casual Users
12276,85,54,145,4,5,4,13,Champions
12676,1237,5,22,2,1,2,5,Lost
13115,1489,6,22,1,1,2,4,Lost
13286,150,16,51,4,3,3,10,Loyal Users
84,158,7,11,4,2,1,7,Promising
136,158,12,49,4,3,3,10,Loyal Users
453,3162,18,31,1,3,2,6,Casual Users
720,412,22,80,3,4,4,11,Loyal Users
856,134,10,12,4,2,1,7,Promising
1000,262,15,27,3,3,2,8,Loyal Users
1358,1889,11,20,1,2,2,5,Lost
1422,2726,5,16,1,1,2,4,Lost
1531,933,11,32,2,2,3,7,Lost
1549,233,11,21,3,2,2,7,Casual Users
1601,7,77,203,5,5,5,15,Champions
1849,1531,17,115,1,3,4,8,Casual Users
2104,1129,9,45,2,2,3,7,Lost
2199,2333,9,17,1,2,2,5,Lost
2214,551,74,108,2,5,4,11,At Risk
2865,135,9,10,4,2,1,7,Promising
3169,949,8,14,2,2,1,5,Lost
3389,17,16,37,5,3,3,11,Loyal Users
3496,135,23,109,4,4,4,12,Champions
3628,1224,11,25,2,2,2,6,Lost
3852,178,32,49,3,4,3,10,Loyal Users
3864,439,9,54,3,2,3,8,Casual Users
4192,2154,12,69,1,3,4,8,Casual Users
4666,233,16,59,3,3,3,9,Loyal Users
4892,387,24,26,3,4,2,9,Loyal Users
4943,86,39,80,4,4,4,12,Champions
5072,1895,15,36,1,3,3,7,Casual Users
5481,69,62,311,5,5,5,15,Champions
7150,30,11,16,5,2,2,9,Promising
7292,4872,10,28,1,2,2,5,Lost
7353,718,8,16,2,2,2,6,Lost
7378,2248,9,14,1,2,1,4,Lost
7483,9,25,38,5,4,3,12,Loyal Users
7730,718,8,14,2,2,1,5,Lost
7986,1775,6,22,1,1,2,4,Lost
8014,425,21,78,3,3,4,10,Loyal Users
8173,1821,29,68,1,4,4,9,At Risk
8250,465,9,15,3,2,1,6,Casual Users
8324,1409,5,5,1,1,1,3,Lost
8503,221,11,64,3,2,4,9,Casual Users
8564,699,10,11,2,2,1,5,Lost
8852,1183,5,8,2,1,1,4,Lost
9156,2438,9,47,1,2,3,6,Lost
9619,115,13,15,4,3,1,8,Loyal Users
9871,957,20,57,2,3,3,8,Casual Users
10385,545,6,10,2,1,1,4,Lost
10496,868,6,26,2,1,2,5,Lost
10541,1508,16,28,1,3,2,6,Casual Users
10619,33,114,706,5,5,5,15,Champions
10723,4435,8,13,1,2,1,4,Lost
11256,725,12,38,2,3,3,8,Casual Users
11667,1767,21,51,1,3,3,7,Casual Users
11832,1314,10,31,1,2,2,5,Lost
12126,552,10,39,2,2,3,7,Lost
12449,27,10,10,5,2,1,8,Promising
12464,445,5,8,3,1,1,5,Casual Users
12546,246,26,94,3,4,4,11,Loyal Users
12568,105,53,84,4,5,4,13,Champions
12592,2857,32,51,1,4,3,8,At Risk
13025,29,52,182,5,5,5,15,Champions
13350,8,88,306,5,5,5,15,Champions
247,33,40,312,5,4,5,14,Champions
314,275,22,58,3,4,3,10,Loyal Users
627,755,11,22,2,2,2,6,Lost
664,3542,23,58,1,4,3,8,At Risk
691,11,57,69,5,5,4,14,Champions
728,2301,9,18,1,2,2,5,Lost
824,1892,18,34,1,3,3,7,Casual Users
1236,285,102,221,3,5,5,13,Loyal Users
1661,139,8,94,4,2,4,10,Promising
1810,130,13,25,4,3,2,9,Loyal Users
1914,2422,8,9,1,2,1,4,Lost
1998,399,51,100,3,5,4,12,Loyal Users
2053,2602,10,25,1,2,2,5,Lost
2083,170,13,30,3,3,2,8,Loyal Users
2097,123,31,77,4,4,4,12,Champions
2147,1430,6,35,1,1,3,5,Lost
2277,814,8,41,2,2,3,7,Lost
2399,583,28,42,2,4,3,9,At Risk
2940,7,14,70,5,3,4,12,Loyal Users
3158,1519,15,76,1,3,4,8,Casual Users
3251,256,21,60,3,3,3,9,Loyal Users
3319,8,156,359,5,5,5,15,Champions
3356,22,49,87,5,5,4,14,Champions
3427,823,11,18,2,2,2,6,Lost
3543,362,10,28,3,2,2,7,Casual Users
3916,1098,6,12,2,1,1,4,Lost
4149,172,7,44,3,2,3,8,Casual Users
4271,148,11,48,4,2,3,9,Promising
4716,668,16,31,2,3,2,7,Casual Users
5065,2138,5,11,1,1,1,3,Lost
5153,1573,6,6,1,1,1,3,Lost
5218,90,72,178,4,5,5,14,Champions
5627,9,14,28,5,3,2,10,Loyal Users
5658,521,16,63,2,3,4,9,Casual Users
5679,155,50,121,4,5,4,13,Champions
5683,707,9,11,2,2,1,5,Lost
5730,2557,18,91,1,3,4,8,Casual Users
6162,163,7,10,4,2,1,7,Promising
6312,183,22,128,3,4,4,11,Loyal Users
6859,573,27,53,2,4,3,9,At Risk
7105,377,15,38,3,3,3,9,Loyal Users
7461,566,8,19,2,2,2,6,Lost
7620,2,9,27,5,2,2,9,Promising
7814,4,114,244,5,5,5,15,Champions
8970,162,9,36,4,2,3,9,Promising
9002,50,45,164,5,4,5,14,Champions
9023,39,26,178,5,4,5,14,Champions
9265,108,7,44,4,2,3,9,Promising
9368,544,10,24,2,2,2,6,Lost
9696,14,8,27,5,2,2,9,Promising
9742,406,8,68,3,2,4,9,Casual Users
10781,405,32,120,3,4,4,11,Loyal Users
11424,254,5,6,3,1,1,5,Casual Users
11669,2714,10,16,1,2,2,5,Lost
11724,617,6,7,2,1,1,4,Lost
11776,267,6,6,3,1,1,5,Casual Users
12064,31,171,589,5,5,5,15,Champions
12541,280,89,343,3,5,5,13,Loyal Users
12550,1626,11,11,1,2,1,4,Lost
13124,417,43,155,3,4,5,12,Loyal Users
87,195,16,23,3,3,2,8,Loyal Users
565,4012,7,11,1,2,1,4,Lost
649,686,47,158,2,5,5,12,At Risk
1233,687,20,37,2,3,3,8,Casual Users
1374,409,13,18,3,3,2,8,Loyal Users
1495,729,17,86,2,3,4,9,Casual Users
1594,236,21,38,3,3,3,9,Loyal Users
1596,5312,8,17,1,2,2,5,Lost
1716,114,75,283,4,5,5,14,Champions
1757,729,44,90,2,4,4,10,At Risk
1845,105,47,186,4,5,5,14,Champions
2807,955,5,27,2,1,2,5,Lost
3405,2011,12,28,1,3,2,6,Casual Users
3407,1259,7,20,1,2,2,5,Lost
3662,1122,9,15,2,2,1,5,Lost
3765,1691,5,6,1,1,1,3,Lost
3777,2587,6,9,1,1,1,3,Lost
4009,0,18,57,5,3,3,11,Loyal Users
4010,8,42,78,5,4,4,13,Champions
4045,1490,38,114,1,4,4,9,At Risk
4058,11,18,27,5,3,2,10,Loyal Users
4071,31,60,314,5,5,5,15,Champions
4150,715,18,85,2,3,4,9,Casual Users
4359,1556,6,8,1,1,1,3,Lost
4427,275,100,198,3,5,5,13,Loyal Users
5014,20,220,996,5,5,5,15,Champions
5472,275,9,24,3,2,2,7,Casual Users
5549,292,7,12,3,2,1,6,Casual Users
5780,143,78,193,4,5,5,14,Champions
5799,77,15,56,4,3,3,10,Loyal Users
5866,1693,8,8,1,2,1,4,Lost
6052,193,18,39,3,3,3,9,Loyal Users
6093,3279,22,34,1,4,3,8,At Risk
6276,110,14,103,4,3,4,11,Loyal Users
6346,1642,10,17,1,2,2,5,Lost
6713,279,56,66,3,5,4,12,Loyal Users
7180,1795,6,6,1,1,1,3,Lost
7186,165,38,185,4,4,5,13,Champions
7753,904,9,27,2,2,2,6,Lost
7799,132,6,9,4,1,1,6,Promising
7883,3404,37,117,1,4,4,9,At Risk
7908,247,9,13,3,2,1,6,Casual Users
7909,223,84,292,3,5,5,13,Loyal Users
8068,4120,5,6,1,1,1,3,Lost
8112,103,43,260,4,4,5,13,Champions
8169,2,7,8,5,2,1,8,Promising
8170,863,8,32,2,2,3,7,Lost
8788,267,5,10,3,1,1,5,Casual Users
8821,4166,8,9,1,2,1,4,Lost
8862,95,26,87,4,4,4,12,Champions
10062,251,6,13,3,1,1,5,Casual Users
10077,622,6,25,2,1,2,5,Lost
10340,147,13,28,4,3,2,9,Loyal Users
10380,16,44,86,5,4,4,13,Champions
10560,71,145,519,4,5,5,14,Champions
10634,30,17,31,5,3,2,10,Loyal Users
10824,107,11,49,4,2,3,9,Promising
11129,109,16,193,4,3,5,12,Loyal Users
11221,136,38,47,4,4,3,11,Loyal Users
11235,261,14,44,3,3,3,9,Loyal Users
11488,23,12,25,5,3,2,10,Loyal Users
11511,1159,6,7,2,1,1,4,Lost
11775,4,59,162,5,5,5,15,Champions
12029,90,27,46,4,4,3,11,Loyal Users
12152,557,15,24,2,3,2,7,Casual Users
12258,3682,34,64,1,4,4,9,At Risk
12270,10,12,22,5,3,2,10,Loyal Users
12540,127,9,22,4,2,2,8,Promising
13152,664,22,69,2,4,4,10,At Risk
171,4,22,184,5,4,5,14,Champions
273,857,9,17,2,2,2,6,Lost
343,310,6,8,3,1,1,5,Casual Users
434,2180,5,13,1,1,1,3,Lost
439,527,31,243,2,4,5,11,At Risk
443,1581,25,64,1,4,4,9,At Risk
585,68,29,77,5,4,4,13,Champions
956,63,80,265,5,5,5,15,Champions
1195,177,19,65,3,3,4,10,Loyal Users
1229,754,12,15,2,3,1,6,Casual Users
1305,939,7,12,2,2,1,5,Lost
1620,6,124,305,5,5,5,15,Champions
1673,627,37,69,2,4,4,10,At Risk
1837,868,7,33,2,2,3,7,Lost
2188,94,40,248,4,4,5,13,Champions
2429,270,8,15,3,2,1,6,Casual Users
2674,418,45,87,3,4,4,11,Loyal Users
2814,230,81,133,3,5,4,12,Loyal Users
2873,6,38,204,5,4,5,14,Champions
3117,434,6,11,3,1,1,5,Casual Users
3164,2256,7,15,1,2,1,4,Lost
3331,399,8,27,3,2,2,7,Casual Users
3397,102,90,289,4,5,5,14,Champions
3454,2833,5,6,1,1,1,3,Lost
3516,126,31,49,4,4,3,11,Loyal Users
3652,234,14,29,3,3,2,8,Loyal Users
4011,37,5,16,5,1,2,8,Promising
4154,2453,5,12,1,1,1,3,Lost
4163,298,9,19,3,2,2,7,Casual Users
4377,4698,7,11,1,2,1,4,Lost
4667,358,11,18,3,2,2,7,Casual Users
5050,595,50,253,2,5,5,12,At Risk
5437,141,38,65,4,4,4,12,Champions
5443,3,94,165,5,5,5,15,Champions
5903,24,30,78,5,4,4,13,Champions
5976,90,46,277,4,5,5,14,Champions
6122,154,11,19,4,2,2,8,Promising
6257,1014,15,20,2,3,2,7,Casual Users
6408,192,30,137,3,4,4,11,Loyal Users
7004,27,16,41,5,3,3,11,Loyal Users
7076,642,16,20,2,3,2,7,Casual Users
7146,1278,13,16,1,3,2,6,Casual Users
7330,239,17,21,3,3,2,8,Loyal Users
7508,17,48,109,5,5,4,14,Champions
7779,111,73,143,4,5,4,13,Champions
7866,21,45,77,5,4,4,13,Champions
7978,135,47,121,4,5,4,13,Champions
8061,711,8,10,2,2,1,5,Lost
8323,133,13,65,4,3,4,11,Loyal Users
8383,2827,20,102,1,3,4,8,Casual Users
8572,2865,9,15,1,2,1,4,Lost
8675,113,13,70,4,3,4,11,Loyal Users
8767,3279,12,14,1,3,1,5,Casual Users
8792,239,7,19,3,2,2,7,Casual Users
9211,188,14,22,3,3,2,8,Loyal Users
9706,746,7,71,2,2,4,8,Lost
10078,6,161,307,5,5,5,15,Champions
10263,105,12,18,4,3,2,9,Loyal Users
10483,822,7,35,2,2,3,7,Lost
10563,118,13,28,4,3,2,9,Loyal Users
10806,64,38,138,5,4,4,13,Champions
11309,266,35,55,3,4,3,10,Loyal Users
11901,2678,5,17,1,1,2,4,Lost
12011,2565,11,17,1,2,2,5,Lost
12545,83,74,538,4,5,5,14,Champions
12625,1159,29,34,2,4,3,9,At Risk
12831,227,7,37,3,2,3,8,Casual Users
13387,102,47,62,4,5,3,12,Loyal Users
13391,791,5,5,2,1,1,4,Lost
13527,98,32,77,4,4,4,12,Champions
51,306,23,27,3,4,2,9,Loyal Users
194,1019,13,53,2,3,3,8,Casual Users
277,132,7,28,4,2,2,8,Promising
331,240,188,531,3,5,5,13,Loyal Users
428,74,77,111,4,5,4,13,Champions
465,44,35,92,5,4,4,13,Champions
794,247,5,29,3,1,2,6,Casual Users
957,674,61,94,2,5,4,11,At Risk
994,170,91,374,3,5,5,13,Loyal Users
1381,130,34,48,4,4,3,11,Loyal Users
1555,1694,6,10,1,1,1,3,Lost
1963,252,30,50,3,4,3,10,Loyal Users
2119,667,5,7,2,1,1,4,Lost
2187,102,14,23,4,3,2,9,Loyal Users
2262,102,16,19,4,3,2,9,Loyal Users
2333,87,25,38,4,4,3,11,Loyal Users
2705,694,14,115,2,3,4,9,Casual Users
2884,166,31,203,3,4,5,12,Loyal Users
2921,2720,7,14,1,2,1,4,Lost
3023,2259,8,59,1,2,3,6,Lost
3090,129,5,16,4,1,2,7,Promising
3803,263,9,14,3,2,1,6,Casual Users
3821,225,6,18,3,1,2,6,Casual Users
4124,918,38,90,2,4,4,10,At Risk
4539,165,44,242,4,4,5,13,Champions
4594,653,29,156,2,4,5,11,At Risk
4651,391,28,122,3,4,4,11,Loyal Users
4787,28,8,39,5,2,3,10,Promising
4804,2226,5,5,1,1,1,3,Lost
4821,1413,25,31,1,4,2,7,At Risk
4888,875,13,34,2,3,3,8,Casual Users
5278,132,7,21,4,2,2,8,Promising
5304,321,20,29,3,3,2,8,Loyal Users
5355,672,10,24,2,2,2,6,Lost
5376,525,8,19,2,2,2,6,Lost
5408,519,51,55,2,5,3,10,At Risk
5451,832,15,24,2,3,2,7,Casual Users
5501,151,16,58,4,3,3,10,Loyal Users
5668,101,37,121,4,4,4,12,Champions
5788,29,19,28,5,3,2,10,Loyal Users
5912,101,53,321,4,5,5,14,Champions
6080,795,30,91,2,4,4,10,At Risk
6102,3486,12,19,1,3,2,6,Casual Users
6107,1997,8,17,1,2,2,5,Lost
6295,717,5,6,2,1,1,4,Lost
6456,1103,70,105,2,5,4,11,At Risk
6592,124,24,133,4,4,4,12,Champions
6672,1574,14,30,1,3,2,6,Casual Users
7035,305,7,15,3,2,1,6,Casual Users
7133,569,35,142,2,4,4,10,At Risk
7545,178,32,94,3,4,4,11,Loyal Users
7884,3086,10,19,1,2,2,5,Lost
7998,1355,5,5,1,1,1,3,Lost
8134,745,27,76,2,4,4,10,At Risk
8430,117,11,21,4,2,2,8,Promising
8629,1449,9,13,1,2,1,4,Lost
9037,13,16,19,5,3,2,10,Loyal Users
9174,1069,18,180,2,3,5,10,Casual Users
9354,1967,5,13,1,1,1,3,Lost
9473,143,35,66,4,4,4,12,Champions
9495,859,54,130,2,5,4,11,At Risk
9798,1323,13,18,1,3,2,6,Casual Users
9875,1659,5,11,1,1,1,3,Lost
9959,17,48,225,5,5,5,15,Champions
10319,2049,11,11,1,2,1,4,Lost
10868,209,5,24,3,1,2,6,Casual Users
10872,605,19,26,2,3,2,7,Casual Users
10896,2107,21,193,1,3,5,9,Casual Users
11089,5003,5,5,1,1,1,3,Lost
11115,422,13,27,3,3,2,8,Loyal Users
11449,7,50,487,5,5,5,15,Champions
11586,119,67,145,4,5,4,13,Champions
12072,665,22,77,2,4,4,10,At Risk
12335,548,15,47,2,3,3,8,Casual Users
12343,94,10,19,4,2,2,8,Promising
12758,2873,8,68,1,2,4,7,Lost
12845,241,7,29,3,2,2,7,Casual Users
12927,152,19,41,4,3,3,10,Loyal Users
12944,1384,11,25,1,2,2,5,Lost
13082,28,23,51,5,4,3,12,Loyal Users
13327,526,17,37,2,3,3,8,Casual Users
13457,144,25,48,4,4,3,11,Loyal Users
391,568,6,6,2,1,1,4,Lost
438,173,65,228,3,5,5,13,Loyal Users
532,90,26,36,4,4,3,11,Loyal Users
706,163,32,67,4,4,4,12,Champions
821,15,31,148,5,4,5,14,Champions
1297,27,12,29,5,3,2,10,Loyal Users
1313,4422,6,16,1,1,2,4,Lost
1388,30,16,35,5,3,3,11,Loyal Users
1598,3,102,635,5,5,5,15,Champions
1619,2651,5,10,1,1,1,3,Lost
1790,1084,32,55,2,4,3,9,At Risk
1840,1582,18,85,1,3,4,8,Casual Users
1887,4,33,45,5,4,3,12,Loyal Users
2434,104,13,40,4,3,3,10,Loyal Users
2863,3696,5,26,1,1,2,4,Lost
3038,1148,36,64,2,4,4,10,At Risk
3052,1266,15,42,1,3,3,7,Casual Users
3188,134,7,17,4,2,2,8,Promising
3218,2066,7,13,1,2,1,4,Lost
3608,306,29,54,3,4,3,10,Loyal Users
3714,72,22,232,4,4,5,13,Champions
3763,2471,8,25,1,2,2,5,Lost
3944,116,68,133,4,5,4,13,Champions
4253,247,9,16,3,2,2,7,Casual Users
4329,113,22,90,4,4,4,12,Champions
4436,132,18,36,4,3,3,10,Loyal Users
4581,7,53,117,5,5,4,14,Champions
4632,909,6,8,2,1,1,4,Lost
4780,426,14,20,3,3,2,8,Loyal Users
5121,94,116,428,4,5,5,14,Champions
5179,294,9,32,3,2,3,8,Casual Users
5393,34,24,37,5,4,3,12,Loyal Users
5400,1118,6,7,2,1,1,4,Lost
5615,275,32,76,3,4,4,11,Loyal Users
5774,362,5,6,3,1,1,5,Casual Users
5899,114,17,47,4,3,3,10,Loyal Users
6087,131,16,42,4,3,3,10,Loyal Users
6113,1935,6,7,1,1,1,3,Lost
6168,307,24,121,3,4,4,11,Loyal Users
6264,7,46,75,5,5,4,14,Champions
7052,416,56,159,3,5,5,13,Loyal Users
7334,4800,24,24,1,4,2,7,At Risk
7493,7,108,420,5,5,5,15,Champions
7526,848,9,18,2,2,2,6,Lost
7836,41,97,450,5,5,5,15,Champions
8049,2018,7,28,1,2,2,5,Lost
8342,119,6,11,4,1,1,6,Promising
8398,5,72,341,5,5,5,15,Champions
8424,248,52,200,3,5,5,13,Loyal Users
8434,681,16,59,2,3,3,8,Casual Users
8465,111,85,189,4,5,5,14,Champions
8530,283,110,511,3,5,5,13,Loyal Users
8624,102,11,13,4,2,1,7,Promising
8835,4550,6,17,1,1,2,4,Lost
9057,110,14,26,4,3,2,9,Loyal Users
9397,1731,12,26,1,3,2,6,Casual Users
9536,3717,9,37,1,2,3,6,Lost
9648,155,36,162,4,4,5,13,Champions
9872,80,29,74,4,4,4,12,Champions
9939,2817,6,73,1,1,4,6,Lost
10316,202,77,137,3,5,4,12,Loyal Users
10431,438,5,7,3,1,1,5,Casual Users
10486,871,18,21,2,3,2,7,Casual Users
10503,1884,11,11,1,2,1,4,Lost
10554,0,66,274,5,5,5,15,Champions
10602,509,5,7,2,1,1,4,Lost
10612,69,85,146,5,5,4,14,Champions
11031,2130,5,20,1,1,2,4,Lost
11155,1454,11,55,1,2,3,6,Lost
11489,126,24,64,4,4,4,12,Champions
11548,109,20,73,4,3,4,11,Loyal Users
11554,1098,10,16,2,2,2,6,Lost
11676,80,67,277,4,5,5,14,Champions
12577,728,7,15,2,2,1,5,Lost
13064,1409,34,158,1,4,5,10,At Risk
13112,131,36,77,4,4,4,12,Champions
13140,148,33,311,4,4,5,13,Champions
13151,157,197,329,4,5,5,14,Champions
13187,474,26,44,2,4,3,9,At Risk
13204,30,57,209,5,5,5,15,Champions
13333,1389,22,41,1,4,3,8,At Risk
69,448,13,22,3,3,2,8,Loyal Users
129,845,27,48,2,4,3,9,At Risk
166,832,8,45,2,2,3,7,Lost
448,1605,8,53,1,2,3,6,Lost
467,0,6,27,5,1,2,8,Promising
928,1289,14,37,1,3,3,7,Casual Users
1200,2117,16,36,1,3,3,7,Casual Users
1234,7,142,676,5,5,5,15,Champions
1412,1087,14,34,2,3,3,8,Casual Users
1463,3,139,251,5,5,5,15,Champions
1872,421,26,104,3,4,4,11,Loyal Users
1910,4,97,257,5,5,5,15,Champions
2068,94,109,340,4,5,5,14,Champions
2077,408,21,91,3,3,4,10,Loyal Users
2590,221,19,38,3,3,3,9,Loyal Users
2864,3522,13,13,1,3,1,5,Casual Users
2881,722,20,52,2,3,3,8,Casual Users
2951,3934,5,14,1,1,1,3,Lost
3469,6019,43,43,1,4,3,8,At Risk
3589,121,71,173,4,5,5,14,Champions
3718,116,148,457,4,5,5,14,Champions
3867,3,81,322,5,5,5,15,Champions
4035,95,66,135,4,5,4,13,Champions
4715,2414,13,23,1,3,2,6,Casual Users
4760,1690,5,11,1,1,1,3,Lost
4778,2124,6,14,1,1,1,3,Lost
4997,671,28,67,2,4,4,10,At Risk
5816,17,121,870,5,5,5,15,Champions
6189,1434,12,56,1,3,3,7,Casual Users
6211,432,14,19,3,3,2,8,Loyal Users
6331,4874,5,6,1,1,1,3,Lost
6448,273,24,73,3,4,4,11,Loyal Users
6478,1200,13,40,2,3,3,8,Casual Users
6548,31,186,266,5,5,5,15,Champions
6677,2,19,26,5,3,2,10,Loyal Users
6788,1402,5,8,1,1,1,3,Lost
6895,1815,7,7,1,2,1,4,Lost
6925,16,196,454,5,5,5,15,Champions
7151,280,30,170,3,4,5,12,Loyal Users
7406,80,21,50,4,3,3,10,Loyal Users
7484,132,126,210,4,5,5,14,Champions
7535,161,22,101,4,4,4,12,Champions
8046,7,53,124,5,5,4,14,Champions
8107,112,41,142,4,4,4,12,Champions
8252,4946,14,27,1,3,2,6,Casual Users
8313,1021,5,10,2,1,1,4,Lost
8356,185,15,40,3,3,3,9,Loyal Users
8602,71,103,473,4,5,5,14,Champions
8671,283,41,92,3,4,4,11,Loyal Users
9420,1197,12,93,2,3,4,9,Casual Users
9989,140,16,53,4,3,3,10,Loyal Users
10004,1703,8,22,1,2,2,5,Lost
10072,3,13,30,5,3,2,10,Loyal Users
10287,491,19,136,2,3,4,9,Casual Users
10471,249,20,39,3,3,3,9,Loyal Users
10653,139,13,21,4,3,2,9,Loyal Users
11375,68,10,44,5,2,3,10,Promising
11438,248,7,12,3,2,1,6,Casual Users
11670,2177,9,9,1,2,1,4,Lost
11692,2726,11,30,1,2,2,5,Lost
12136,1191,12,61,2,3,3,8,Casual Users
12392,135,26,125,4,4,4,12,Champions
12728,2377,10,17,1,2,2,5,Lost
12887,75,75,218,4,5,5,14,Champions
13102,24,24,54,5,4,3,12,Loyal Users
13569,36,8,11,5,2,1,8,Promising
97,825,8,13,2,2,1,5,Lost
400,1031,10,10,2,2,1,5,Lost
543,3964,20,45,1,3,3,7,Casual Users
1001,113,40,127,4,4,4,12,Champions
1020,462,6,18,3,1,2,6,Casual Users
1230,95,21,40,4,3,3,10,Loyal Users
1261,888,13,16,2,3,2,7,Casual Users
1317,1348,8,22,1,2,2,5,Lost
1742,801,35,102,2,4,4,10,At Risk
1876,98,52,100,4,5,4,13,Champions
2143,274,19,46,3,3,3,9,Loyal Users
2194,3279,5,10,1,1,1,3,Lost
2258,141,13,33,4,3,3,10,Loyal Users
2345,142,18,104,4,3,4,11,Loyal Users
2394,284,25,94,3,4,4,11,Loyal Users
2516,675,36,47,2,4,3,9,At Risk
2585,373,14,19,3,3,2,8,Loyal Users
2751,226,46,169,3,5,5,13,Loyal Users
2790,218,5,13,3,1,1,5,Casual Users
3202,1416,8,11,1,2,1,4,Lost
3430,93,17,71,4,3,4,11,Loyal Users
4086,2291,8,8,1,2,1,4,Lost
4135,115,8,8,4,2,1,7,Promising
4180,2,37,79,5,4,4,13,Champions
5035,401,29,39,3,4,3,10,Loyal Users
5053,51,87,925,5,5,5,15,Champions
5063,245,8,27,3,2,2,7,Casual Users
5261,3779,6,41,1,1,3,5,Lost
5536,3050,7,11,1,2,1,4,Lost
5718,113,34,125,4,4,4,12,Champions
6214,955,10,63,2,2,4,8,Lost
6265,1022,28,66,2,4,4,10,At Risk
6389,254,8,19,3,2,2,7,Casual Users
6418,41,12,13,5,3,1,9,Loyal Users
6470,406,55,293,3,5,5,13,Loyal Users
6624,94,54,264,4,5,5,14,Champions
6927,230,21,39,3,3,3,9,Loyal Users
7054,3,29,89,5,4,4,13,Champions
7074,835,12,14,2,3,1,6,Casual Users
7229,71,16,42,4,3,3,10,Loyal Users
7350,50,39,100,5,4,4,13,Champions
7431,4520,5,13,1,1,1,3,Lost
7442,545,7,26,2,2,2,6,Lost
7639,118,6,10,4,1,1,6,Promising
7937,1,84,421,5,5,5,15,Champions
8347,284,33,61,3,4,3,10,Loyal Users
8353,3,29,58,5,4,3,12,Loyal Users
8528,19,25,72,5,4,4,13,Champions
8607,573,6,9,2,1,1,4,Lost
8965,203,31,49,3,4,3,10,Loyal Users
9101,21,55,209,5,5,5,15,Champions
9320,93,62,140,4,5,4,13,Champions
9559,3,73,252,5,5,5,15,Champions
9612,28,29,90,5,4,4,13,Champions
9828,609,7,61,2,2,3,7,Lost
9936,4378,21,44,1,3,3,7,Casual Users
10068,12,129,848,5,5,5,15,Champions
10093,169,39,163,3,4,5,12,Loyal Users
10105,2466,6,24,1,1,2,4,Lost
10181,115,22,36,4,4,3,11,Loyal Users
11069,140,19,44,4,3,3,10,Loyal Users
11389,7,72,252,5,5,5,15,Champions
11502,1909,8,33,1,2,3,6,Lost
11506,85,51,270,4,5,5,14,Champions
11534,4112,17,26,1,3,2,6,Casual Users
11564,375,74,187,3,5,5,13,Loyal Users
11973,695,12,64,2,3,4,9,Casual Users
11985,21,84,178,5,5,5,15,Champions
12225,9,98,195,5,5,5,15,Champions
12288,24,12,12,5,3,1,9,Loyal Users
12661,245,69,266,3,5,5,13,Loyal Users
12690,735,23,85,2,4,4,10,At Risk
12942,110,10,23,4,2,2,8,Promising
13010,694,14,75,2,3,4,9,Casual Users
13011,149,31,66,4,4,4,12,Champions
13096,147,48,86,4,5,4,13,Champions
13173,93,29,112,4,4,4,12,Champions
13396,82,37,192,4,4,5,13,Champions
13525,141,125,281,4,5,5,14,Champions
524,22,65,149,5,5,5,15,Champions
533,135,9,36,4,2,3,9,Promising
661,398,11,17,3,2,2,7,Casual Users
693,3641,7,10,1,2,1,4,Lost
1006,532,5,15,2,1,1,4,Lost
1134,3749,6,8,1,1,1,3,Lost
1607,0,50,151,5,5,5,15,Champions
1690,523,5,6,2,1,1,4,Lost
1695,657,13,15,2,3,1,6,Casual Users
1746,279,13,47,3,3,3,9,Loyal Users
1791,579,15,43,2,3,3,8,Casual Users
1965,74,74,168,4,5,5,14,Champions
2328,8,51,97,5,5,4,14,Champions
2480,145,19,52,4,3,3,10,Loyal Users
2827,254,82,142,3,5,4,12,Loyal Users
2851,688,33,72,2,4,4,10,At Risk
2966,421,16,36,3,3,3,9,Loyal Users
3357,117,36,66,4,4,4,12,Champions
3656,4096,14,33,1,3,3,7,Casual Users
3715,1737,5,10,1,1,1,3,Lost
3840,1278,5,7,1,1,1,3,Lost
3933,37,21,171,5,3,5,13,Loyal Users
3985,544,14,78,2,3,4,9,Casual Users
4123,25,24,41,5,4,3,12,Loyal Users
4142,661,5,5,2,1,1,4,Lost
4260,2055,9,29,1,2,2,5,Lost
4431,28,72,149,5,5,5,15,Champions
4433,701,6,33,2,1,3,6,Lost
4497,971,9,48,2,2,3,7,Lost
4968,291,8,20,3,2,2,7,Casual Users
5092,621,11,133,2,2,4,8,Lost
5362,126,6,15,4,1,1,6,Promising
5523,109,40,60,4,4,3,11,Loyal Users
5711,4326,7,7,1,2,1,4,Lost
5885,641,29,162,2,4,5,11,At Risk
6018,1854,20,83,1,3,4,8,Casual Users
6064,1937,5,25,1,1,2,4,Lost
6066,1027,5,11,2,1,1,4,Lost
6464,580,14,33,2,3,3,8,Casual Users
6724,3540,10,65,1,2,4,7,Lost
7193,101,62,203,4,5,5,14,Champions
7279,88,102,334,4,5,5,14,Champions
7463,44,97,508,5,5,5,15,Champions
7477,362,43,78,3,4,4,11,Loyal Users
7805,238,20,29,3,3,2,8,Loyal Users
8073,409,14,27,3,3,2,8,Loyal Users
8228,6,22,37,5,4,3,12,Loyal Users
8334,127,31,216,4,4,5,13,Champions
8469,844,14,27,2,3,2,7,Casual Users
8549,42,19,46,5,3,3,11,Loyal Users
8661,28,58,117,5,5,4,14,Champions
8892,1579,15,36,1,3,3,7,Casual Users
9070,1311,6,20,1,1,2,4,Lost
9229,102,106,116,4,5,4,13,Champions
9262,2,49,97,5,5,4,14,Champions
9307,588,5,31,2,1,2,5,Lost
9389,166,54,166,3,5,5,13,Loyal Users
9461,2964,37,114,1,4,4,9,At Risk
9502,109,49,212,4,5,5,14,Champions
9670,115,11,26,4,2,2,8,Promising
9819,3,55,242,5,5,5,15,Champions
10599,45,92,244,5,5,5,15,Champions
10677,148,31,117,4,4,4,12,Champions
10716,210,6,21,3,1,2,6,Casual Users
11034,61,22,29,5,4,2,11,Loyal Users
11281,79,14,21,4,3,2,9,Loyal Users
11288,2993,9,16,1,2,2,5,Lost
11396,99,61,206,4,5,5,14,Champions
11822,1218,11,41,2,2,3,7,Lost
11940,155,14,82,4,3,4,11,Loyal Users
12299,1145,6,12,2,1,1,4,Lost
12320,2956,12,44,1,3,3,7,Casual Users
12637,1127,11,57,2,2,3,7,Lost
13234,389,20,35,3,3,3,9,Loyal Users
13432,135,13,124,4,3,4,11,Loyal Users
13462,2559,5,5,1,1,1,3,Lost
234,1,33,137,5,4,4,13,Champions
239,2142,13,13,1,3,1,5,Casual Users
264,198,39,49,3,4,3,10,Loyal Users
312,145,132,259,4,5,5,14,Champions
389,3631,6,8,1,1,1,3,Lost
869,1214,7,42,2,2,3,7,Lost
1058,135,30,139,4,4,4,12,Champions
1081,101,24,55,4,4,3,11,Loyal Users
1209,44,62,97,5,5,4,14,Champions
1347,1271,7,20,1,2,2,5,Lost
1356,322,6,6,3,1,1,5,Casual Users
1581,982,5,7,2,1,1,4,Lost
1714,933,13,34,2,3,3,8,Casual Users
1905,7,123,182,5,5,5,15,Champions
1985,37,11,16,5,2,2,9,Promising
2020,836,15,19,2,3,2,7,Casual Users
2358,347,7,39,3,2,3,8,Casual Users
2800,75,28,112,4,4,4,12,Champions
2919,5226,5,10,1,1,1,3,Lost
3361,405,10,18,3,2,2,7,Casual Users
3537,1123,17,18,2,3,2,7,Casual Users
3799,31,9,14,5,2,1,8,Promising
3866,319,29,99,3,4,4,11,Loyal Users
4461,4867,5,9,1,1,1,3,Lost
5033,1933,13,28,1,3,2,6,Casual Users
5058,171,61,303,3,5,5,13,Loyal Users
5260,235,14,87,3,3,4,10,Loyal Users
5269,10,30,112,5,4,4,13,Champions
5563,9,12,87,5,3,4,12,Loyal Users
5631,1395,11,146,1,2,4,7,Lost
5652,2457,8,26,1,2,2,5,Lost
5717,130,15,29,4,3,2,9,Loyal Users
5798,383,17,46,3,3,3,9,Loyal Users
6231,8,20,88,5,3,4,12,Loyal Users
6262,257,30,73,3,4,4,11,Loyal Users
6347,1089,11,40,2,2,3,7,Lost
6518,56,161,242,5,5,5,15,Champions
6809,1839,5,14,1,1,1,3,Lost
6856,990,7,13,2,2,1,5,Lost
6869,134,14,21,4,3,2,9,Loyal Users
8308,108,54,231,4,5,5,14,Champions
8336,490,47,71,2,5,4,11,At Risk
8475,43,16,56,5,3,3,11,Loyal Users
8550,566,9,39,2,2,3,7,Lost
8649,132,8,22,4,2,2,8,Promising
9061,81,28,113,4,4,4,12,Champions
9374,90,9,60,4,2,3,9,Promising
9649,427,67,136,3,5,4,12,Loyal Users
9882,136,54,86,4,5,4,13,Champions
10150,106,35,49,4,4,3,11,Loyal Users
10224,1373,14,105,1,3,4,8,Casual Users
10402,12,34,73,5,4,4,13,Champions
10452,123,42,323,4,4,5,13,Champions
10957,867,7,62,2,2,3,7,Lost
11228,20,52,115,5,5,4,14,Champions
11410,411,10,18,3,2,2,7,Casual Users
11796,4102,5,6,1,1,1,3,Lost
12039,793,34,149,2,4,5,11,At Risk
12068,1643,7,11,1,2,1,4,Lost
12098,400,13,14,3,3,1,7,Loyal Users
12246,808,20,75,2,3,4,9,Casual Users
12278,233,6,17,3,1,2,6,Casual Users
12334,81,77,185,4,5,5,14,Champions
12415,1520,45,69,1,4,4,9,At Risk
13062,544,35,179,2,4,5,11,At Risk
13413,192,11,32,3,2,3,8,Casual Users
63,2,11,12,5,2,1,8,Promising
635,1873,13,122,1,3,4,8,Casual Users
885,137,16,27,4,3,2,9,Loyal Users
1638,313,33,62,3,4,3,10,Loyal Users
1724,0,90,310,5,5,5,15,Champions
1898,114,6,9,4,1,1,6,Promising
1960,37,40,85,5,4,4,13,Champions
2512,187,18,26,3,3,2,8,Loyal Users
2587,234,9,16,3,2,2,7,Casual Users
2850,6,20,35,5,3,3,11,Loyal Users
2853,247,9,29,3,2,2,7,Casual Users
3193,535,20,85,2,3,4,9,Casual Users
3417,141,24,40,4,4,3,11,Loyal Users
3598,268,25,38,3,4,3,10,Loyal Users
4008,457,13,30,3,3,2,8,Loyal Users
4026,876,8,10,2,2,1,5,Lost
4206,296,27,48,3,4,3,10,Loyal Users
4661,2858,10,41,1,2,3,6,Lost
4845,130,75,369,4,5,5,14,Champions
5136,661,6,29,2,1,2,5,Lost
5449,2013,24,39,1,4,3,8,At Risk
5522,3096,5,22,1,1,2,4,Lost
5653,9,38,57,5,4,3,12,Loyal Users
5693,2166,14,27,1,3,2,6,Casual Users
5835,106,84,624,4,5,5,14,Champions
5913,1338,21,115,1,3,4,8,Casual Users
6510,81,56,119,4,5,4,13,Champions
6789,8,26,50,5,4,3,12,Loyal Users
6997,960,9,21,2,2,2,6,Lost
7044,13,115,213,5,5,5,15,Champions
7099,106,29,60,4,4,3,11,Loyal Users
7375,69,27,45,5,4,3,12,Loyal Users
7438,1655,9,14,1,2,1,4,Lost
7492,134,11,23,4,2,2,8,Promising
7540,4139,8,12,1,2,1,4,Lost
7976,5,72,219,5,5,5,15,Champions
8066,568,61,74,2,5,4,11,At Risk
8080,277,17,31,3,3,2,8,Loyal Users
8401,1416,5,11,1,1,1,3,Lost
8441,27,27,33,5,4,3,12,Loyal Users
8520,4765,7,11,1,2,1,4,Lost
8799,438,86,215,3,5,5,13,Loyal Users
8995,534,27,41,2,4,3,9,At Risk
9128,966,10,20,2,2,2,6,Lost
9499,985,7,15,2,2,1,5,Lost
9979,9,38,92,5,4,4,13,Champions
9985,65,8,37,5,2,3,10,Promising
10144,604,26,53,2,4,3,9,At Risk
10312,4811,5,10,1,1,1,3,Lost
11032,137,10,28,4,2,2,8,Promising
11085,128,5,14,4,1,1,6,Promising
11091,831,6,30,2,1,2,5,Lost
11654,123,28,98,4,4,4,12,Champions
11656,390,5,6,3,1,1,5,Casual Users
11753,98,7,29,4,2,2,8,Promising
11967,1397,5,8,1,1,1,3,Lost
12002,411,36,48,3,4,3,10,Loyal Users
12131,109,44,54,4,4,3,11,Loyal Users
12149,2635,8,20,1,2,2,5,Lost
12150,527,8,9,2,2,1,5,Lost
12383,362,46,139,3,5,4,12,Loyal Users
12505,2855,8,33,1,2,3,6,Lost
12645,405,5,10,3,1,1,5,Casual Users
12745,271,12,57,3,3,3,9,Loyal Users
13014,146,144,170,4,5,5,14,Champions
13189,86,55,81,4,5,4,13,Champions
13367,84,9,32,4,2,3,9,Promising
13479,1982,8,48,1,2,3,6,Lost
395,180,85,132,3,5,4,12,Loyal Users
403,3703,6,12,1,1,1,3,Lost
779,929,77,335,2,5,5,12,At Risk
982,106,14,37,4,3,3,10,Loyal Users
1104,3234,9,48,1,2,3,6,Lost
1609,462,57,264,3,5,5,13,Loyal Users
1738,12,7,15,5,2,1,8,Promising
1926,1090,9,22,2,2,2,6,Lost
2498,25,13,75,5,3,4,12,Loyal Users
2728,2115,19,26,1,3,2,6,Casual Users
3101,3554,8,8,1,2,1,4,Lost
3126,474,16,112,2,3,4,9,Casual Users
3639,105,38,224,4,4,5,13,Champions
3695,285,8,33,3,2,3,8,Casual Users
3707,155,37,83,4,4,4,12,Champions
4022,117,6,9,4,1,1,6,Promising
4140,135,19,40,4,3,3,10,Loyal Users
4224,1747,5,18,1,1,2,4,Lost
4301,208,39,71,3,4,4,11,Loyal Users
4344,2452,5,99,1,1,4,6,Lost
4599,112,147,655,4,5,5,14,Champions
4752,3734,8,8,1,2,1,4,Lost
4894,294,5,8,3,1,1,5,Casual Users
5089,3439,9,10,1,2,1,4,Lost
5407,114,17,27,4,3,2,9,Loyal Users
5504,594,8,29,2,2,2,6,Lost
5677,196,17,36,3,3,3,9,Loyal Users
5898,78,36,54,4,4,3,11,Loyal Users
5985,20,151,320,5,5,5,15,Champions
6147,85,14,48,4,3,3,10,Loyal Users
6576,283,17,33,3,3,3,9,Loyal Users
6947,371,13,47,3,3,3,9,Loyal Users
7302,59,18,25,5,3,2,10,Loyal Users
7694,833,45,374,2,4,5,11,At Risk
7841,28,81,220,5,5,5,15,Champions
7899,635,16,66,2,3,4,9,Casual Users
8113,240,7,31,3,2,2,7,Casual Users
8400,1025,10,28,2,2,2,6,Lost
8626,926,17,62,2,3,3,8,Casual Users
8696,231,72,173,3,5,5,13,Loyal Users
8923,397,9,53,3,2,3,8,Casual Users
9550,132,19,34,4,3,3,10,Loyal Users
10073,476,18,23,2,3,2,7,Casual Users
10103,538,34,193,2,4,5,11,At Risk
10170,261,10,17,3,2,2,7,Casual Users
10465,81,65,104,4,5,4,13,Champions
10522,102,73,262,4,5,5,14,Champions
10573,64,14,38,5,3,3,11,Loyal Users
10662,13,6,68,5,1,4,10,Promising
10681,548,8,22,2,2,2,6,Lost
10895,700,18,31,2,3,2,7,Casual Users
11528,256,8,22,3,2,2,7,Casual Users
11618,275,17,83,3,3,4,10,Loyal Users
11635,1975,11,25,1,2,2,5,Lost
12178,30,50,78,5,5,4,14,Champions
12818,73,138,644,4,5,5,14,Champions
12915,389,27,116,3,4,4,11,Loyal Users
13090,425,8,21,3,2,2,7,Casual Users
13163,3894,7,30,1,2,2,5,Lost
13218,507,9,30,2,2,2,6,Lost
13546,546,5,6,2,1,1,4,Lost
13561,4573,5,5,1,1,1,3,Lost
459,3520,15,24,1,3,2,6,Casual Users
509,103,13,122,4,3,4,11,Loyal Users
907,369,9,16,3,2,2,7,Casual Users
1094,4263,13,33,1,3,3,7,Casual Users
1625,536,20,51,2,3,3,8,Casual Users
1780,120,12,41,4,3,3,10,Loyal Users
2129,15,17,21,5,3,2,10,Loyal Users
2172,1287,21,27,1,3,2,6,Casual Users
2350,2417,8,8,1,2,1,4,Lost
2839,885,8,21,2,2,2,6,Lost
3266,1576,44,65,1,4,4,9,At Risk
3386,132,13,18,4,3,2,9,Loyal Users
3526,144,5,53,4,1,3,8,Promising
3633,107,11,40,4,2,3,9,Promising
3651,868,54,86,2,5,4,11,At Risk
3771,3,36,57,5,4,3,12,Loyal Users
4062,2162,5,10,1,1,1,3,Lost
4164,1922,26,76,1,4,4,9,At Risk
4273,44,16,48,5,3,3,11,Loyal Users
4687,1464,12,66,1,3,4,8,Casual Users
4689,217,83,420,3,5,5,13,Loyal Users
4709,1142,5,32,2,1,3,6,Lost
4714,413,26,41,3,4,3,10,Loyal Users
4794,512,19,26,2,3,2,7,Casual Users
5574,843,6,8,2,1,1,4,Lost
5645,2785,7,12,1,2,1,4,Lost
5853,6,38,160,5,4,5,14,Champions
5915,113,60,140,4,5,4,13,Champions
5921,398,20,39,3,3,3,9,Loyal Users
6200,2012,13,45,1,3,3,7,Casual Users
6248,403,16,34,3,3,3,9,Loyal Users
6374,236,7,12,3,2,1,6,Casual Users
6493,7,12,31,5,3,2,10,Loyal Users
6728,1,15,88,5,3,4,12,Loyal Users
6821,93,124,237,4,5,5,14,Champions
6951,14,9,24,5,2,2,9,Promising
7200,458,6,9,3,1,1,5,Casual Users
7397,1538,5,8,1,1,1,3,Lost
7467,103,111,418,4,5,5,14,Champions
7479,132,21,37,4,3,3,10,Loyal Users
7656,6,6,12,5,1,1,7,Promising
7690,3434,9,14,1,2,1,4,Lost
7737,239,13,14,3,3,1,7,Loyal Users
7837,51,11,17,5,2,2,9,Promising
7862,672,31,60,2,4,3,9,At Risk
8120,4,34,53,5,4,3,12,Loyal Users
8348,117,8,10,4,2,1,7,Promising
8384,148,13,26,4,3,2,9,Loyal Users
8645,715,51,193,2,5,5,12,At Risk
9141,827,5,7,2,1,1,4,Lost
9280,250,38,49,3,4,3,10,Loyal Users
9778,2141,6,8,1,1,1,3,Lost
9880,432,11,31,3,2,2,7,Casual Users
9883,1376,5,7,1,1,1,3,Lost
10028,1941,16,20,1,3,2,6,Casual Users
10132,0,98,241,5,5,5,15,Champions
10343,695,14,19,2,3,2,7,Casual Users
10400,155,44,274,4,4,5,13,Champions
10405,530,84,304,2,5,5,12,At Risk
10427,125,38,129,4,4,4,12,Champions
10453,1665,5,6,1,1,1,3,Lost
10509,733,17,24,2,3,2,7,Casual Users
10553,1,81,155,5,5,5,15,Champions
10902,620,20,30,2,3,2,7,Casual Users
11904,1971,10,15,1,2,1,4,Lost
11998,78,28,41,4,4,3,11,Loyal Users
12201,120,10,14,4,2,1,7,Promising
12433,1437,181,551,1,5,5,11,At Risk
12434,33,74,241,5,5,5,15,Champions
12779,50,42,128,5,4,4,13,Champions
13159,158,5,14,4,1,1,6,Promising
10,2893,7,9,1,2,1,4,Lost
77,42,58,355,5,5,5,15,Champions
102,444,13,15,3,3,1,7,Loyal Users
361,1297,143,353,1,5,5,11,At Risk
589,612,38,110,2,4,4,10,At Risk
814,400,63,94,3,5,4,12,Loyal Users
848,272,36,83,3,4,4,11,Loyal Users
1007,227,5,10,3,1,1,5,Casual Users
1098,231,32,53,3,4,3,10,Loyal Users
1346,1855,11,33,1,2,3,6,Lost
1401,92,67,177,4,5,5,14,Champions
1443,654,13,33,2,3,3,8,Casual Users
1459,807,9,45,2,2,3,7,Lost
1647,661,8,22,2,2,2,6,Lost
1755,13,88,147,5,5,5,15,Champions
1825,996,123,364,2,5,5,12,At Risk
1921,3,29,136,5,4,4,13,Champions
1970,2,56,98,5,5,4,14,Champions
2120,273,5,7,3,1,1,5,Casual Users
2167,3481,5,11,1,1,1,3,Lost
2226,639,12,78,2,3,4,9,Casual Users
2230,1378,21,65,1,3,4,8,Casual Users
2769,364,28,65,3,4,4,11,Loyal Users
3343,13,143,860,5,5,5,15,Champions
3597,271,9,26,3,2,2,7,Casual Users
3745,902,7,77,2,2,4,8,Lost
3787,1235,11,50,2,2,3,7,Lost
4156,118,55,136,4,5,4,13,Champions
4245,66,96,974,5,5,5,15,Champions
4402,4425,5,6,1,1,1,3,Lost
4676,2698,7,10,1,2,1,4,Lost
4734,2013,5,6,1,1,1,3,Lost
4761,15,97,440,5,5,5,15,Champions
4981,4422,6,9,1,1,1,3,Lost
5468,1160,5,15,2,1,1,4,Lost
5469,711,17,33,2,3,3,8,Casual Users
5506,417,5,10,3,1,1,5,Casual Users
5559,1800,5,9,1,1,1,3,Lost
5696,39,119,249,5,5,5,15,Champions
5781,489,10,13,2,2,1,5,Lost
6120,540,8,17,2,2,2,6,Lost
6163,2476,5,15,1,1,1,3,Lost
6272,69,48,120,5,5,4,14,Champions
6327,415,6,15,3,1,1,5,Casual Users
6411,30,87,274,5,5,5,15,Champions
6812,657,23,28,2,4,2,8,At Risk
7629,683,13,19,2,3,2,7,Casual Users
7721,71,24,59,4,4,3,11,Loyal Users
8366,1837,11,35,1,2,3,6,Lost
8522,148,9,16,4,2,2,8,Promising
8728,802,7,20,2,2,2,6,Lost
8958,20,5,7,5,1,1,7,Promising
9127,119,47,111,4,5,4,13,Champions
9386,257,11,41,3,2,3,8,Casual Users
9639,10,69,197,5,5,5,15,Champions
9686,1445,40,142,1,4,4,9,At Risk
9699,150,48,132,4,5,4,13,Champions
9993,423,7,39,3,2,3,8,Casual Users
10440,144,21,159,4,3,5,12,Loyal Users
10736,672,121,274,2,5,5,12,At Risk
10755,1118,14,23,2,3,2,7,Casual Users
11416,84,64,195,4,5,5,14,Champions
11443,161,6,21,4,1,2,7,Promising
11498,256,78,338,3,5,5,13,Loyal Users
11507,317,5,8,3,1,1,5,Casual Users
11529,4,15,24,5,3,2,10,Loyal Users
11546,227,53,109,3,5,4,12,Loyal Users
11908,305,51,380,3,5,5,13,Loyal Users
11965,998,9,19,2,2,2,6,Lost
12119,1839,12,15,1,3,1,5,Casual Users
12176,457,32,115,3,4,4,11,Loyal Users
12282,149,5,9,4,1,1,6,Promising
12508,77,23,36,4,4,3,11,Loyal Users
12689,712,38,162,2,4,5,11,At Risk
12890,291,39,131,3,4,4,11,Loyal Users
13041,20,40,52,5,4,3,12,Loyal Users
13086,174,23,51,3,4,3,10,Loyal Users
13366,425,38,84,3,4,4,11,Loyal Users
658,1165,5,13,2,1,1,4,Lost
1354,716,11,27,2,2,2,6,Lost
1502,2989,20,20,1,3,2,6,Casual Users
1765,1,127,321,5,5,5,15,Champions
2229,580,42,75,2,4,4,10,At Risk
2397,183,33,47,3,4,3,10,Loyal Users
2641,148,5,16,4,1,2,7,Promising
3031,2977,13,26,1,3,2,6,Casual Users
3375,53,58,474,5,5,5,15,Champions
3592,269,22,35,3,4,3,10,Loyal Users
3850,7,49,143,5,5,4,14,Champions
3855,1,86,160,5,5,5,15,Champions
3860,8,58,155,5,5,5,15,Champions
4292,113,30,68,4,4,4,12,Champions
4673,125,31,101,4,4,4,12,Champions
4932,49,103,396,5,5,5,15,Champions
4964,891,12,40,2,3,3,8,Casual Users
5008,1635,6,7,1,1,1,3,Lost
5113,66,88,147,5,5,5,15,Champions
5174,867,16,54,2,3,3,8,Casual Users
6730,1,18,35,5,3,3,11,Loyal Users
6989,4546,7,13,1,2,1,4,Lost
7059,35,73,103,5,5,4,14,Champions
7100,95,27,89,4,4,4,12,Champions
7125,2,71,218,5,5,5,15,Champions
7392,172,7,40,3,2,3,8,Casual Users
7440,666,5,9,2,1,1,4,Lost
7536,35,70,185,5,5,5,15,Champions
7681,308,25,180,3,4,5,12,Loyal Users
7755,2610,17,33,1,3,3,7,Casual Users
8283,125,55,274,4,5,5,14,Champions
8298,15,47,186,5,5,5,15,Champions
8302,831,22,59,2,4,3,9,At Risk
8759,574,5,44,2,1,3,6,Lost
8783,1446,6,19,1,1,2,4,Lost
8787,73,64,163,4,5,5,14,Champions
8860,575,64,166,2,5,5,12,At Risk
9445,1979,5,21,1,1,2,4,Lost
9567,102,63,239,4,5,5,14,Champions
9821,1407,10,39,1,2,3,6,Lost
10149,93,30,79,4,4,4,12,Champions
10199,103,34,150,4,4,5,13,Champions
10528,139,11,47,4,2,3,9,Promising
10810,101,81,534,4,5,5,14,Champions
10831,1146,6,7,2,1,1,4,Lost
11013,108,52,268,4,5,5,14,Champions
11369,723,6,17,2,1,2,5,Lost
11435,497,9,10,2,2,1,5,Lost
12302,726,8,11,2,2,1,5,Lost
12450,146,47,244,4,5,5,14,Champions
12596,69,56,113,5,5,4,14,Champions
12624,994,9,14,2,2,1,5,Lost
12628,129,5,5,4,1,1,6,Promising
12710,2,81,188,5,5,5,15,Champions
13298,698,10,19,2,2,2,6,Lost
50,7,34,212,5,4,5,14,Champions
518,439,21,29,3,3,2,8,Loyal Users
750,618,14,41,2,3,3,8,Casual Users
771,284,18,28,3,3,2,8,Loyal Users
951,2428,11,19,1,2,2,5,Lost
1214,583,7,19,2,2,2,6,Lost
1414,406,29,229,3,4,5,12,Loyal Users
1660,522,63,101,2,5,4,11,At Risk
2395,403,14,29,3,3,2,8,Loyal Users
2431,285,41,124,3,4,4,11,Loyal Users
2482,2423,6,7,1,1,1,3,Lost
2787,1436,5,5,1,1,1,3,Lost
2954,167,6,8,3,1,1,5,Casual Users
3061,371,8,22,3,2,2,7,Casual Users
3168,300,19,61,3,3,3,9,Loyal Users
3467,63,40,87,5,4,4,13,Champions
3518,1664,16,46,1,3,3,7,Casual Users
3644,1098,62,106,2,5,4,11,At Risk
3807,352,6,19,3,1,2,6,Casual Users
3998,25,15,35,5,3,3,11,Loyal Users
4087,31,17,58,5,3,3,11,Loyal Users
4605,2128,6,12,1,1,1,3,Lost
4635,2277,10,23,1,2,2,5,Lost
4722,467,20,67,3,3,4,10,Loyal Users
4805,1577,18,51,1,3,3,7,Casual Users
4814,1542,13,27,1,3,2,6,Casual Users
4890,4,48,117,5,5,4,14,Champions
5305,3602,7,32,1,2,3,6,Lost
5589,245,25,109,3,4,4,11,Loyal Users
5669,116,42,449,4,4,5,13,Champions
5769,697,17,26,2,3,2,7,Casual Users
5860,824,7,30,2,2,2,6,Lost
5931,261,97,138,3,5,4,12,Loyal Users
6184,1823,16,43,1,3,3,7,Casual Users
6517,30,27,46,5,4,3,12,Loyal Users
6669,20,53,98,5,5,4,14,Champions
6752,15,11,25,5,2,2,9,Promising
6938,18,80,98,5,5,4,14,Champions
7320,683,6,11,2,1,1,4,Lost
7391,6,22,75,5,4,4,13,Champions
7920,423,7,22,3,2,2,7,Casual Users
7932,6,161,391,5,5,5,15,Champions
7949,656,26,61,2,4,3,9,At Risk
8180,65,28,119,5,4,4,13,Champions
8421,955,13,67,2,3,4,9,Casual Users
8431,125,45,232,4,4,5,13,Champions
8657,4302,9,9,1,2,1,4,Lost
8960,133,16,76,4,3,4,11,Loyal Users
9132,2680,8,33,1,2,3,6,Lost
9358,550,26,41,2,4,3,9,At Risk
9401,4,5,25,5,1,2,8,Promising
9793,567,15,16,2,3,2,7,Casual Users
9934,705,7,24,2,2,2,6,Lost
10086,86,49,97,4,5,4,13,Champions
10202,622,37,141,2,4,4,10,At Risk
10525,1876,8,23,1,2,2,5,Lost
10620,7,11,21,5,2,2,9,Promising
10794,31,43,127,5,4,4,13,Champions
10904,10,23,33,5,4,3,12,Loyal Users
11254,126,73,122,4,5,4,13,Champions
11673,19,47,127,5,5,4,14,Champions
11691,61,88,305,5,5,5,15,Champions
11698,432,13,18,3,3,2,8,Loyal Users
11943,75,37,52,4,4,3,11,Loyal Users
12004,426,9,15,3,2,1,6,Casual Users
12790,1166,9,9,2,2,1,5,Lost
12802,99,12,21,4,3,2,9,Loyal Users
12928,4,35,46,5,4,3,12,Loyal Users
13121,17,11,50,5,2,3,10,Promising
13475,665,8,43,2,2,3,7,Lost
13505,3522,5,8,1,1,1,3,Lost
267,509,11,32,2,2,3,7,Lost
293,140,50,129,4,5,4,13,Champions
404,988,14,37,2,3,3,8,Casual Users
527,1340,15,88,1,3,4,8,Casual Users
817,4613,8,35,1,2,3,6,Lost
1102,153,19,32,4,3,3,10,Loyal Users
1343,2676,5,6,1,1,1,3,Lost
1639,787,8,8,2,2,1,5,Lost
2012,1,13,58,5,3,3,11,Loyal Users
2290,1225,6,11,2,1,1,4,Lost
2462,232,8,45,3,2,3,8,Casual Users
2671,360,7,20,3,2,2,7,Casual Users
3429,416,8,12,3,2,1,6,Casual Users
3600,704,10,23,2,2,2,6,Lost
3682,113,24,134,4,4,4,12,Champions
3776,536,5,11,2,1,1,4,Lost
3982,295,12,13,3,3,1,7,Loyal Users
4052,910,13,16,2,3,2,7,Casual Users
4340,3436,7,30,1,2,2,5,Lost
4759,278,5,15,3,1,1,5,Casual Users
4947,434,23,57,3,4,3,10,Loyal Users
4969,3024,14,35,1,3,3,7,Casual Users
5473,4,35,51,5,4,3,12,Loyal Users
5731,662,23,30,2,4,2,8,At Risk
5776,728,20,30,2,3,2,7,Casual Users
5922,426,34,132,3,4,4,11,Loyal Users
5988,280,27,126,3,4,4,11,Loyal Users
5989,165,7,50,4,2,3,9,Promising
6001,259,16,38,3,3,3,9,Loyal Users
6144,219,84,138,3,5,4,12,Loyal Users
6432,695,12,14,2,3,1,6,Casual Users
6861,101,40,69,4,4,4,12,Champions
6897,1767,20,42,1,3,3,7,Casual Users
6899,11,34,63,5,4,4,13,Champions
6918,34,17,23,5,3,2,10,Loyal Users
7041,103,15,37,4,3,3,10,Loyal Users
7183,1327,46,57,1,5,3,9,At Risk
7376,2704,6,13,1,1,1,3,Lost
8223,5097,7,14,1,2,1,4,Lost
8327,45,21,90,5,3,4,12,Loyal Users
8368,1,110,826,5,5,5,15,Champions
8379,127,33,156,4,4,5,13,Champions
8461,420,6,13,3,1,1,5,Casual Users
8604,87,72,163,4,5,5,14,Champions
8789,168,27,84,3,4,4,11,Loyal Users
8802,534,10,10,2,2,1,5,Lost
8914,101,10,16,4,2,2,8,Promising
9201,714,16,43,2,3,3,8,Casual Users
9540,133,106,311,4,5,5,14,Champions
9634,5506,5,11,1,1,1,3,Lost
10176,1983,10,37,1,2,3,6,Lost
10356,852,12,40,2,3,3,8,Casual Users
10820,1280,12,29,1,3,2,6,Casual Users
10980,224,42,134,3,4,4,11,Loyal Users
11066,715,11,27,2,2,2,6,Lost
11200,2398,20,33,1,3,3,7,Casual Users
11453,572,5,6,2,1,1,4,Lost
11602,394,5,13,3,1,1,5,Casual Users
11953,80,18,109,4,3,4,11,Loyal Users
12171,3475,12,15,1,3,1,5,Casual Users
12439,992,31,100,2,4,4,10,At Risk
13160,221,74,398,3,5,5,13,Loyal Users
13451,1037,15,107,2,3,4,9,Casual Users
13590,102,41,127,4,4,4,12,Champions
45,2449,5,22,1,1,2,4,Lost
569,890,10,46,2,2,3,7,Lost
769,1576,20,232,1,3,5,9,Casual Users
793,1713,11,17,1,2,2,5,Lost
938,27,53,260,5,5,5,15,Champions
977,103,11,22,4,2,2,8,Promising
1333,25,74,179,5,5,5,15,Champions
1442,246,22,57,3,4,3,10,Loyal Users
1611,1956,5,22,1,1,2,4,Lost
1704,946,31,168,2,4,5,11,At Risk
1715,526,13,32,2,3,3,8,Casual Users
2091,282,38,71,3,4,4,11,Loyal Users
2309,1287,24,115,1,4,4,9,At Risk
2608,1555,24,55,1,4,3,8,At Risk
2788,306,12,24,3,3,2,8,Loyal Users
3014,126,10,73,4,2,4,10,Promising
3131,4929,10,23,1,2,2,5,Lost
3190,3694,7,27,1,2,2,5,Lost
3618,108,5,8,4,1,1,6,Promising
3724,16,149,536,5,5,5,15,Champions
4168,41,14,83,5,3,4,12,Loyal Users
4272,2862,17,79,1,3,4,8,Casual Users
4491,409,10,35,3,2,3,8,Casual Users
4959,7,113,282,5,5,5,15,Champions
5172,92,19,45,4,3,3,10,Loyal Users
5356,77,22,81,4,4,4,12,Champions
5412,566,24,48,2,4,3,9,At Risk
5557,1818,7,36,1,2,3,6,Lost
5641,358,16,37,3,3,3,9,Loyal Users
5725,21,80,523,5,5,5,15,Champions
5839,69,11,23,5,2,2,9,Promising
6136,80,58,156,4,5,5,14,Champions
6150,929,6,12,2,1,1,4,Lost
6206,30,140,464,5,5,5,15,Champions
6535,6,137,828,5,5,5,15,Champions
7743,990,31,41,2,4,3,9,At Risk
7840,54,62,186,5,5,5,15,Champions
7954,288,56,149,3,5,5,13,Loyal Users
8062,177,11,45,3,2,3,8,Casual Users
8093,278,23,53,3,4,3,10,Loyal Users
8232,125,84,273,4,5,5,14,Champions
8233,1232,5,5,2,1,1,4,Lost
8335,541,12,44,2,3,3,8,Casual Users
8635,397,40,68,3,4,4,11,Loyal Users
8717,20,66,107,5,5,4,14,Champions
8959,1098,8,11,2,2,1,5,Lost
9013,30,21,82,5,3,4,12,Loyal Users
9019,3503,8,10,1,2,1,4,Lost
9252,5090,5,6,1,1,1,3,Lost
9448,4405,17,48,1,3,3,7,Casual Users
9606,257,43,221,3,4,5,12,Loyal Users
9804,141,11,38,4,2,3,9,Promising
9874,696,14,134,2,3,4,9,Casual Users
9887,220,9,15,3,2,1,6,Casual Users
9933,4724,10,20,1,2,2,5,Lost
10067,114,21,30,4,3,2,9,Loyal Users
10080,595,8,11,2,2,1,5,Lost
10302,631,20,60,2,3,3,8,Casual Users
10408,425,11,24,3,2,2,7,Casual Users
10787,30,8,22,5,2,2,9,Promising
10927,779,11,14,2,2,1,5,Lost
10978,11,7,24,5,2,2,9,Promising
11251,92,17,85,4,3,4,11,Loyal Users
11279,5,157,435,5,5,5,15,Champions
11420,389,21,78,3,3,4,10,Loyal Users
11605,41,26,124,5,4,4,13,Champions
11734,373,35,55,3,4,3,10,Loyal Users
11754,535,24,45,2,4,3,9,At Risk
11922,992,16,71,2,3,4,9,Casual Users
12093,30,58,81,5,5,4,14,Champions
12248,130,32,100,4,4,4,12,Champions
12351,392,58,268,3,5,5,13,Loyal Users
12430,5634,6,6,1,1,1,3,Lost
12537,137,28,107,4,4,4,12,Champions
12560,56,20,113,5,3,4,12,Loyal Users
12874,45,97,390,5,5,5,15,Champions
12892,79,56,132,4,5,4,13,Champions
13169,28,36,161,5,4,5,14,Champions
13208,540,31,146,2,4,4,10,At Risk
13241,68,103,803,5,5,5,15,Champions
216,1009,7,10,2,2,1,5,Lost
759,2285,9,11,1,2,1,4,Lost
812,589,12,37,2,3,3,8,Casual Users
952,71,11,19,4,2,2,8,Promising
1039,125,7,22,4,2,2,8,Promising
1110,97,19,50,4,3,3,10,Loyal Users
1320,147,8,13,4,2,1,7,Promising
1667,570,6,11,2,1,1,4,Lost
2553,6,63,137,5,5,4,14,Champions
2986,531,12,34,2,3,3,8,Casual Users
3182,1799,8,41,1,2,3,6,Lost
3463,3572,6,31,1,1,2,4,Lost
3640,16,71,121,5,5,4,14,Champions
3646,44,73,270,5,5,5,15,Champions
3742,1420,11,65,1,2,4,7,Lost
4395,0,179,433,5,5,5,15,Champions
4442,101,19,74,4,3,4,11,Loyal Users
4456,118,15,29,4,3,2,9,Loyal Users
4496,227,21,44,3,3,3,9,Loyal Users
4579,1713,7,19,1,2,2,5,Lost
4652,121,25,41,4,4,3,11,Loyal Users
4670,146,11,33,4,2,3,9,Promising
5284,6,80,548,5,5,5,15,Champions
5832,194,15,53,3,3,3,9,Loyal Users
6187,28,50,110,5,5,4,14,Champions
6640,810,27,40,2,4,3,9,At Risk
6763,1014,7,33,2,2,3,7,Lost
6767,3281,6,10,1,1,1,3,Lost
6853,405,23,36,3,4,3,10,Loyal Users
7002,585,6,22,2,1,2,5,Lost
7069,122,13,16,4,3,2,9,Loyal Users
7211,410,19,66,3,3,4,10,Loyal Users
7951,3,86,368,5,5,5,15,Champions
8181,843,11,21,2,2,2,6,Lost
8242,2826,7,7,1,2,1,4,Lost
8580,1516,8,22,1,2,2,5,Lost
8660,131,7,44,4,2,3,9,Promising
8910,388,11,28,3,2,2,7,Casual Users
9213,338,24,31,3,4,2,9,Loyal Users
9370,112,21,92,4,3,4,11,Loyal Users
9463,284,24,87,3,4,4,11,Loyal Users
9511,939,19,74,2,3,4,9,Casual Users
9526,2,102,403,5,5,5,15,Champions
9701,62,55,275,5,5,5,15,Champions
10027,2,70,386,5,5,5,15,Champions
10095,1893,6,13,1,1,1,3,Lost
10129,1482,14,19,1,3,2,6,Casual Users
10858,2066,6,12,1,1,1,3,Lost
10972,29,31,135,5,4,4,13,Champions
11022,1401,12,46,1,3,3,7,Casual Users
11088,234,108,242,3,5,5,13,Loyal Users
11163,31,45,189,5,4,5,14,Champions
11762,120,57,272,4,5,5,14,Champions
11895,1551,11,46,1,2,3,6,Lost
12092,136,31,67,4,4,4,12,Champions
12825,2,30,42,5,4,3,12,Loyal Users
12901,428,6,20,3,1,2,6,Casual Users
13069,1998,9,17,1,2,2,5,Lost
13080,0,56,128,5,5,4,14,Champions
38,292,9,50,3,2,3,8,Casual Users
261,532,19,37,2,3,3,8,Casual Users
320,3155,8,21,1,2,2,5,Lost
418,184,19,35,3,3,3,9,Loyal Users
946,506,19,25,2,3,2,7,Casual Users
1325,116,20,118,4,3,4,11,Loyal Users
1405,307,19,32,3,3,3,9,Loyal Users
1447,639,5,15,2,1,1,4,Lost
1655,126,91,345,4,5,5,14,Champions
1809,90,38,110,4,4,4,12,Champions
1864,2027,8,13,1,2,1,4,Lost
1918,109,7,20,4,2,2,8,Promising
2679,388,25,59,3,4,3,10,Loyal Users
2719,422,88,289,3,5,5,13,Loyal Users
2722,170,17,85,3,3,4,10,Loyal Users
2737,1426,7,18,1,2,2,5,Lost
2793,8,8,51,5,2,3,10,Promising
2889,1435,5,23,1,1,2,4,Lost
2952,1230,7,15,2,2,1,5,Lost
3393,445,23,88,3,4,4,11,Loyal Users
3414,3843,36,88,1,4,4,9,At Risk
3462,465,17,29,3,3,2,8,Loyal Users
4138,157,6,42,4,1,3,8,Promising
4525,7,143,227,5,5,5,15,Champions
4643,2009,8,77,1,2,4,7,Lost
4763,263,9,12,3,2,1,6,Casual Users
5013,12,21,27,5,3,2,10,Loyal Users
5194,133,82,129,4,5,4,13,Champions
5402,120,97,171,4,5,5,14,Champions
5410,891,25,70,2,4,4,10,At Risk
5796,6,16,30,5,3,2,10,Loyal Users
5942,20,129,597,5,5,5,15,Champions
6225,527,34,67,2,4,4,10,At Risk
6513,416,6,41,3,1,3,7,Casual Users
6726,295,14,31,3,3,2,8,Loyal Users
6977,4533,5,12,1,1,1,3,Lost
7510,1016,8,10,2,2,1,5,Lost
7674,158,48,154,4,5,5,14,Champions
7958,2115,17,86,1,3,4,8,Casual Users
7963,3416,7,8,1,2,1,4,Lost
8143,8,61,157,5,5,5,15,Champions
9005,1387,29,132,1,4,4,9,At Risk
9041,17,11,17,5,2,2,9,Promising
9172,442,34,278,3,4,5,12,Loyal Users
9390,409,5,19,3,1,2,6,Casual Users
9415,132,33,75,4,4,4,12,Champions
9600,861,5,5,2,1,1,4,Lost
9620,234,49,215,3,5,5,13,Loyal Users
9751,140,21,29,4,3,2,9,Loyal Users
9962,2117,5,12,1,1,1,3,Lost
10359,2947,12,37,1,3,3,7,Casual Users
10457,1081,9,59,2,2,3,7,Lost
10710,136,37,59,4,4,3,11,Loyal Users
10782,23,64,218,5,5,5,15,Champions
11225,247,65,406,3,5,5,13,Loyal Users
11305,1072,5,88,2,1,4,7,Lost
11362,718,6,11,2,1,1,4,Lost
11414,61,31,232,5,4,5,14,Champions
11473,28,57,229,5,5,5,15,Champions
11544,810,5,6,2,1,1,4,Lost
11816,2946,7,7,1,2,1,4,Lost
12485,98,40,87,4,4,4,12,Champions
12569,566,8,17,2,2,2,6,Lost
12660,235,24,43,3,4,3,10,Loyal Users
12716,5601,6,13,1,1,1,3,Lost
12760,677,16,24,2,3,2,7,Casual Users
12783,3031,13,21,1,3,2,6,Casual Users
12963,22,58,123,5,5,4,14,Champions
13061,608,16,31,2,3,2,7,Casual Users
13281,939,5,12,2,1,1,4,Lost
13513,2582,7,28,1,2,2,5,Lost
82,1161,6,23,2,1,2,5,Lost
181,103,41,70,4,4,4,12,Champions
249,569,9,28,2,2,2,6,Lost
364,126,6,26,4,1,2,7,Promising
510,220,56,131,3,5,4,12,Loyal Users
1671,2416,6,6,1,1,1,3,Lost
1760,133,6,9,4,1,1,6,Promising
2251,244,7,12,3,2,1,6,Casual Users
2311,390,44,138,3,4,4,11,Loyal Users
2378,121,29,43,4,4,3,11,Loyal Users
2452,97,42,118,4,4,4,12,Champions
2568,1552,5,6,1,1,1,3,Lost
2901,130,15,17,4,3,2,9,Loyal Users
2992,586,6,7,2,1,1,4,Lost
3070,225,12,15,3,3,1,7,Loyal Users
3692,159,33,175,4,4,5,13,Champions
4100,413,13,38,3,3,3,9,Loyal Users
4148,2834,6,15,1,1,1,3,Lost
4225,1114,9,148,2,2,5,9,Lost
4243,44,76,172,5,5,5,15,Champions
4282,93,34,90,4,4,4,12,Champions
4370,711,5,9,2,1,1,4,Lost
4404,1587,7,11,1,2,1,4,Lost
4439,414,6,11,3,1,1,5,Casual Users
4503,27,69,306,5,5,5,15,Champions
4586,585,6,6,2,1,1,4,Lost
4879,1646,11,27,1,2,2,5,Lost
5138,201,57,105,3,5,4,12,Loyal Users
5689,9,119,397,5,5,5,15,Champions
5996,296,20,52,3,3,3,9,Loyal Users
6034,263,8,10,3,2,1,6,Casual Users
6320,886,39,90,2,4,4,10,At Risk
6501,270,35,71,3,4,4,11,Loyal Users
6991,429,6,10,3,1,1,5,Casual Users
7073,435,14,93,3,3,4,10,Loyal Users
7305,63,26,53,5,4,3,12,Loyal Users
7485,255,14,30,3,3,2,8,Loyal Users
7534,823,8,99,2,2,4,8,Lost
7626,43,75,110,5,5,4,14,Champions
7706,45,27,38,5,4,3,12,Loyal Users
7827,697,28,39,2,4,3,9,At Risk
8110,116,6,37,4,1,3,8,Promising
8276,290,15,41,3,3,3,9,Loyal Users
8418,437,26,33,3,4,3,10,Loyal Users
9332,717,6,6,2,1,1,4,Lost
9598,135,6,10,4,1,1,6,Promising
9685,33,6,6,5,1,1,7,Promising
9950,2364,16,44,1,3,3,7,Casual Users
10675,954,34,172,2,4,5,11,At Risk
10701,380,15,28,3,3,2,8,Loyal Users
11049,4129,14,14,1,3,1,5,Casual Users
11238,122,108,559,4,5,5,14,Champions
11725,31,88,114,5,5,4,14,Champions
12224,99,12,15,4,3,1,8,Loyal Users
12614,123,53,369,4,5,5,14,Champions
12746,2490,7,10,1,2,1,4,Lost
12832,110,110,374,4,5,5,14,Champions
12958,44,60,161,5,5,5,15,Champions
13059,1,47,296,5,5,5,15,Champions
13103,62,5,6,5,1,1,7,Promising
13392,273,120,212,3,5,5,13,Loyal Users
13419,467,11,16,3,2,2,7,Casual Users
13427,92,32,199,4,4,5,13,Champions
167,77,6,15,4,1,1,6,Promising
288,848,14,15,2,3,1,6,Casual Users
394,130,10,29,4,2,2,8,Promising
576,2274,86,129,1,5,4,10,At Risk
703,265,16,25,3,3,2,8,Loyal Users
945,581,30,48,2,4,3,9,At Risk
1049,3635,11,11,1,2,1,4,Lost
1705,1913,6,8,1,1,1,3,Lost
1893,2590,8,27,1,2,2,5,Lost
2055,1135,13,14,2,3,1,6,Casual Users
2958,25,73,636,5,5,5,15,Champions
3044,138,75,372,4,5,5,14,Champions
3215,113,133,429,4,5,5,14,Champions
3297,109,57,116,4,5,4,13,Champions
3317,844,5,6,2,1,1,4,Lost
3354,225,122,408,3,5,5,13,Loyal Users
3478,136,28,39,4,4,3,11,Loyal Users
3480,181,19,53,3,3,3,9,Loyal Users
3760,6,76,175,5,5,5,15,Champions
3935,2740,11,11,1,2,1,4,Lost
4103,377,14,20,3,3,2,8,Loyal Users
4228,70,26,221,4,4,5,13,Champions
4473,644,59,68,2,5,4,11,At Risk
4630,5885,5,32,1,1,3,5,Lost
5059,523,6,10,2,1,1,4,Lost
5101,140,80,156,4,5,5,14,Champions
5106,392,12,18,3,3,2,8,Loyal Users
5262,2758,5,9,1,1,1,3,Lost
5280,1710,11,15,1,2,1,4,Lost
5366,1352,25,37,1,4,3,8,At Risk
5378,2795,6,17,1,1,2,4,Lost
5426,14,136,289,5,5,5,15,Champions
5628,110,7,12,4,2,1,7,Promising
5705,23,9,23,5,2,2,9,Promising
6004,3609,7,31,1,2,2,5,Lost
6353,278,14,23,3,3,2,8,Loyal Users
6613,105,76,193,4,5,5,14,Champions
6769,1247,7,9,2,2,1,5,Lost
7138,472,10,15,2,2,1,5,Lost
7409,706,6,21,2,1,2,5,Lost
8111,30,8,32,5,2,3,10,Promising
8749,24,39,89,5,4,4,13,Champions
8937,4492,10,25,1,2,2,5,Lost
9036,73,7,7,4,2,1,7,Promising
9142,135,5,26,4,1,2,7,Promising
9326,1837,17,60,1,3,3,7,Casual Users
9486,1279,14,29,1,3,2,6,Casual Users
9521,123,48,92,4,5,4,13,Champions
9913,716,13,44,2,3,3,8,Casual Users
9997,12,15,51,5,3,3,11,Loyal Users
10361,1264,14,31,1,3,2,6,Casual Users
10382,1582,8,22,1,2,2,5,Lost
11300,152,36,507,4,4,5,13,Champions
11394,1158,9,40,2,2,3,7,Lost
11431,109,55,91,4,5,4,13,Champions
11628,4,92,469,5,5,5,15,Champions
11649,838,30,120,2,4,4,10,At Risk
11850,62,32,59,5,4,3,12,Loyal Users
11852,3303,20,23,1,3,2,6,Casual Users
12036,5086,8,12,1,2,1,4,Lost
12138,3,41,136,5,4,4,13,Champions
12305,61,54,298,5,5,5,15,Champions
12417,222,17,25,3,3,2,8,Loyal Users
12425,516,21,62,2,3,3,8,Casual Users
12670,142,13,97,4,3,4,11,Loyal Users
12823,107,158,311,4,5,5,14,Champions
12997,945,15,19,2,3,2,7,Casual Users
13222,38,109,458,5,5,5,15,Champions
13543,21,13,41,5,3,3,11,Loyal Users
80,25,18,24,5,3,2,10,Loyal Users
240,13,103,509,5,5,5,15,Champions
289,2029,18,35,1,3,3,7,Casual Users
356,85,70,147,4,5,5,14,Champions
889,670,8,8,2,2,1,5,Lost
1389,2398,48,97,1,5,4,10,At Risk
1528,528,14,36,2,3,3,8,Casual Users
1916,586,34,179,2,4,5,11,At Risk
1987,137,27,103,4,4,4,12,Champions
2540,695,13,15,2,3,1,6,Casual Users
2902,575,10,43,2,2,3,7,Lost
2980,98,25,286,4,4,5,13,Champions
3016,885,58,71,2,5,4,11,At Risk
3185,689,6,14,2,1,1,4,Lost
3278,442,24,100,3,4,4,11,Loyal Users
3486,117,126,403,4,5,5,14,Champions
3492,95,49,78,4,5,4,13,Champions
3551,3,7,13,5,2,1,8,Promising
3590,7,138,480,5,5,5,15,Champions
4233,409,45,199,3,4,5,12,Loyal Users
4379,55,27,43,5,4,3,12,Loyal Users
4790,703,15,85,2,3,4,9,Casual Users
4803,274,32,85,3,4,4,11,Loyal Users
5460,126,8,10,4,2,1,7,Promising
5497,2505,11,14,1,2,1,4,Lost
6525,179,16,23,3,3,2,8,Loyal Users
6807,1255,45,63,2,4,4,10,At Risk
6867,288,91,220,3,5,5,13,Loyal Users
6931,154,5,7,4,1,1,6,Promising
7316,362,9,9,3,2,1,6,Casual Users
7422,133,26,156,4,4,5,13,Champions
7486,244,43,81,3,4,4,11,Loyal Users
7849,2275,18,29,1,3,2,6,Casual Users
8174,9,16,83,5,3,4,12,Loyal Users
8193,289,29,63,3,4,4,11,Loyal Users
8258,408,7,71,3,2,4,9,Casual Users
8561,3568,5,27,1,1,2,4,Lost
8694,19,124,327,5,5,5,15,Champions
8791,0,131,504,5,5,5,15,Champions
8946,109,5,19,4,1,2,7,Promising
9145,691,13,19,2,3,2,7,Casual Users
9410,1,5,6,5,1,1,7,Promising
9440,104,45,72,4,4,4,12,Champions
9736,139,18,34,4,3,3,10,Loyal Users
9955,39,93,200,5,5,5,15,Champions
9974,7,62,107,5,5,4,14,Champions
10008,4308,13,31,1,3,2,6,Casual Users
10308,2572,5,5,1,1,1,3,Lost
10594,5,31,150,5,4,5,14,Champions
10700,10,36,83,5,4,4,13,Champions
10860,414,7,11,3,2,1,6,Casual Users
11118,683,12,28,2,3,2,7,Casual Users
11198,489,26,38,2,4,3,9,At Risk
11295,1462,11,19,1,2,2,5,Lost
11472,158,20,47,4,3,3,10,Loyal Users
11576,178,40,57,3,4,3,10,Loyal Users
11592,27,26,118,5,4,4,13,Champions
12051,3973,6,16,1,1,2,4,Lost
12371,922,18,38,2,3,3,8,Casual Users
12714,5015,9,9,1,2,1,4,Lost
12778,3866,14,44,1,3,3,7,Casual Users
12812,474,6,7,2,1,1,4,Lost
12829,168,5,14,3,1,1,5,Casual Users
12960,130,52,151,4,5,5,14,Champions
13113,614,11,30,2,2,2,6,Lost
13198,280,54,231,3,5,5,13,Loyal Users
25,857,5,7,2,1,1,4,Lost
73,408,7,10,3,2,1,6,Casual Users
245,409,5,39,3,1,3,7,Casual Users
427,55,77,239,5,5,5,15,Champions
591,144,15,20,4,3,2,9,Loyal Users
763,1257,9,15,2,2,1,5,Lost
816,2732,74,274,1,5,5,11,At Risk
1147,858,36,59,2,4,3,9,At Risk
1484,933,14,15,2,3,1,6,Casual Users
1923,4239,23,34,1,4,3,8,At Risk
2112,630,30,213,2,4,5,11,At Risk
2114,306,38,120,3,4,4,11,Loyal Users
2254,5,119,438,5,5,5,15,Champions
2270,2815,6,102,1,1,4,6,Lost
2316,2107,5,15,1,1,1,3,Lost
2578,18,52,284,5,5,5,15,Champions
2596,2756,7,16,1,2,2,5,Lost
2672,91,16,44,4,3,3,10,Loyal Users
2928,127,14,52,4,3,3,10,Loyal Users
3217,129,47,219,4,5,5,14,Champions
3318,69,112,157,5,5,5,15,Champions
3351,557,11,17,2,2,2,6,Lost
3616,261,18,41,3,3,3,9,Loyal Users
3851,415,14,45,3,3,3,9,Loyal Users
4193,2600,10,22,1,2,2,5,Lost
4217,861,7,29,2,2,2,6,Lost
4270,120,42,213,4,4,5,13,Champions
4463,350,8,25,3,2,2,7,Casual Users
5020,4327,6,12,1,1,1,3,Lost
5108,447,15,24,3,3,2,8,Loyal Users
5201,280,5,13,3,1,1,5,Casual Users
5221,3553,13,23,1,3,2,6,Casual Users
6241,47,10,76,5,2,4,11,Promising
6565,1861,5,5,1,1,1,3,Lost
6587,1837,7,8,1,2,1,4,Lost
6593,845,9,21,2,2,2,6,Lost
7027,4,64,133,5,5,4,14,Champions
7590,185,19,35,3,3,3,9,Loyal Users
7637,887,30,66,2,4,4,10,At Risk
7900,98,145,490,4,5,5,14,Champions
8070,162,5,10,4,1,1,6,Promising
8254,108,44,80,4,4,4,12,Champions
8397,150,26,65,4,4,4,12,Champions
8468,1000,10,27,2,2,2,6,Lost
8682,2600,5,17,1,1,2,4,Lost
8704,4779,7,7,1,2,1,4,Lost
8750,3411,35,49,1,4,3,8,At Risk
8777,149,5,6,4,1,1,6,Promising
9083,2293,5,7,1,1,1,3,Lost
9150,2702,6,24,1,1,2,4,Lost
9188,97,13,15,4,3,1,8,Loyal Users
9196,1,32,145,5,4,4,13,Champions
9379,3891,5,11,1,1,1,3,Lost
9635,2163,20,49,1,3,3,7,Casual Users
9693,250,20,27,3,3,2,8,Loyal Users
9837,141,22,43,4,4,3,11,Loyal Users
10005,101,48,112,4,5,4,13,Champions
10327,1411,16,43,1,3,3,7,Casual Users
10454,97,26,76,4,4,4,12,Champions
11387,417,24,91,3,4,4,11,Loyal Users
11861,854,8,20,2,2,2,6,Lost
12218,3402,14,18,1,3,2,6,Casual Users
12469,59,49,81,5,5,4,14,Champions
12570,995,6,7,2,1,1,4,Lost
12695,2080,17,77,1,3,4,8,Casual Users
12774,28,135,242,5,5,5,15,Champions
13223,9,102,148,5,5,5,15,Champions
13394,678,127,534,2,5,5,12,At Risk
113,162,9,14,4,2,1,7,Promising
237,2488,12,23,1,3,2,6,Casual Users
895,23,13,16,5,3,2,10,Loyal Users
1126,413,32,49,3,4,3,10,Loyal Users
1368,347,6,8,3,1,1,5,Casual Users
1421,3352,7,9,1,2,1,4,Lost
1492,23,18,26,5,3,2,10,Loyal Users
1543,248,14,21,3,3,2,8,Loyal Users
1556,514,50,135,2,5,4,11,At Risk
1941,259,10,78,3,2,4,9,Casual Users
2033,1549,9,18,1,2,2,5,Lost
2321,1011,38,49,2,4,3,9,At Risk
2539,56,17,61,5,3,3,11,Loyal Users
2648,107,19,70,4,3,4,11,Loyal Users
2858,10,26,103,5,4,4,13,Champions
3205,93,44,99,4,4,4,12,Champions
3438,2400,5,7,1,1,1,3,Lost
3461,10,82,331,5,5,5,15,Champions
3508,5040,5,12,1,1,1,3,Lost
3510,109,15,69,4,3,4,11,Loyal Users
3719,69,106,175,5,5,5,15,Champions
4470,213,8,9,3,2,1,6,Casual Users
4926,582,9,12,2,2,1,5,Lost
5154,155,50,200,4,5,5,14,Champions
5323,75,13,59,4,3,3,10,Loyal Users
5613,103,111,665,4,5,5,14,Champions
5710,1809,26,63,1,4,4,9,At Risk
5794,224,12,15,3,3,1,7,Loyal Users
5849,78,108,432,4,5,5,14,Champions
6129,412,13,92,3,3,4,10,Loyal Users
6372,14,31,135,5,4,4,13,Champions
6545,388,11,29,3,2,2,7,Casual Users
6758,23,120,800,5,5,5,15,Champions
6981,974,21,39,2,3,3,8,Casual Users
7553,107,48,86,4,5,4,13,Champions
7821,967,24,69,2,4,4,10,At Risk
8333,85,44,66,4,4,4,12,Champions
8388,12,28,193,5,4,5,14,Champions
8633,840,20,50,2,3,3,8,Casual Users
8795,118,58,100,4,5,4,13,Champions
8913,16,16,21,5,3,2,10,Loyal Users
9020,126,78,122,4,5,4,13,Champions
9122,37,51,234,5,5,5,15,Champions
9222,712,9,21,2,2,2,6,Lost
9375,2502,18,35,1,3,3,7,Casual Users
9480,82,84,251,4,5,5,14,Champions
9565,573,5,6,2,1,1,4,Lost
9688,3230,6,8,1,1,1,3,Lost
9800,478,14,23,2,3,2,7,Casual Users
10152,427,31,50,3,4,3,10,Loyal Users
10174,2,97,198,5,5,5,15,Champions
10233,834,5,5,2,1,1,4,Lost
10731,289,11,20,3,2,2,7,Casual Users
10886,2570,26,45,1,4,3,8,At Risk
11574,11,40,145,5,4,4,13,Champions
12133,79,23,78,4,4,4,12,Champions
12268,95,28,88,4,4,4,12,Champions
12411,1290,31,96,1,4,4,9,At Risk
12720,155,8,18,4,2,2,8,Promising
12805,2422,9,14,1,2,1,4,Lost
13020,1563,10,28,1,2,2,5,Lost
13334,367,20,60,3,3,3,9,Loyal Users
645,251,12,55,3,3,3,9,Loyal Users
795,33,32,134,5,4,4,13,Champions
1213,5,95,362,5,5,5,15,Champions
1419,2606,6,10,1,1,1,3,Lost
2552,5320,9,10,1,2,1,4,Lost
2899,102,34,123,4,4,4,12,Champions
3531,116,8,23,4,2,2,8,Promising
3974,34,87,182,5,5,5,15,Champions
3994,5286,6,27,1,1,2,4,Lost
4048,57,69,451,5,5,5,15,Champions
4082,2085,6,25,1,1,2,4,Lost
4216,1578,7,34,1,2,3,6,Lost
4554,122,61,232,4,5,5,14,Champions
4862,82,27,54,4,4,3,11,Loyal Users
5267,25,26,77,5,4,4,13,Champions
5350,1263,9,17,1,2,2,5,Lost
5415,188,20,72,3,3,4,10,Loyal Users
5733,1274,7,11,1,2,1,4,Lost
5850,560,6,16,2,1,2,5,Lost
6555,155,65,261,4,5,5,14,Champions
6702,13,67,221,5,5,5,15,Champions
6858,617,9,9,2,2,1,5,Lost
7452,103,48,84,4,5,4,13,Champions
7568,5331,5,6,1,1,1,3,Lost
7845,152,75,119,4,5,4,13,Champions
8018,548,35,50,2,4,3,9,At Risk
8295,11,8,31,5,2,2,9,Promising
8369,2690,16,33,1,3,3,7,Casual Users
8456,543,6,12,2,1,1,4,Lost
9146,2536,6,13,1,1,1,3,Lost
9214,2306,11,23,1,2,2,5,Lost
9750,168,8,16,3,2,2,7,Casual Users
9829,227,11,18,3,2,2,7,Casual Users
9911,796,40,110,2,4,4,10,At Risk
9954,436,38,44,3,4,3,10,Loyal Users
10087,245,5,12,3,1,1,5,Casual Users
10125,24,35,103,5,4,4,13,Champions
10127,126,35,88,4,4,4,12,Champions
10355,98,87,348,4,5,5,14,Champions
10432,10,91,270,5,5,5,15,Champions
10631,130,30,53,4,4,3,11,Loyal Users
11318,7,25,70,5,4,4,13,Champions
11720,341,26,118,3,4,4,11,Loyal Users
11938,4840,6,19,1,1,2,4,Lost
12154,217,53,153,3,5,5,13,Loyal Users
13337,130,6,23,4,1,2,7,Promising
13484,1595,6,8,1,1,1,3,Lost
24,865,23,69,2,4,4,10,At Risk
160,7,120,292,5,5,5,15,Champions
818,6,17,17,5,3,2,10,Loyal Users
893,235,19,40,3,3,3,9,Loyal Users
1071,10,126,278,5,5,5,15,Champions
1078,2046,6,6,1,1,1,3,Lost
1103,173,25,81,3,4,4,11,Loyal Users
1501,719,22,45,2,4,3,9,At Risk
1558,546,5,28,2,1,2,5,Lost
2689,112,8,11,4,2,1,7,Promising
3153,2658,6,9,1,1,1,3,Lost
3290,734,5,21,2,1,2,5,Lost
3337,692,6,6,2,1,1,4,Lost
3365,783,24,33,2,4,3,9,At Risk
3801,886,30,48,2,4,3,9,At Risk
3882,274,35,61,3,4,3,10,Loyal Users
3899,280,12,17,3,3,2,8,Loyal Users
4055,415,12,82,3,3,4,10,Loyal Users
4278,547,8,15,2,2,1,5,Lost
4413,1261,9,10,1,2,1,4,Lost
4819,126,41,100,4,4,4,12,Champions
4891,165,29,78,4,4,4,12,Champions
4915,135,20,94,4,3,4,11,Loyal Users
5027,16,46,91,5,5,4,14,Champions
5629,80,33,49,4,4,3,11,Loyal Users
5893,282,6,32,3,1,3,7,Casual Users
5958,121,37,117,4,4,4,12,Champions
6159,3529,8,9,1,2,1,4,Lost
6232,265,102,166,3,5,5,13,Loyal Users
6263,2,128,390,5,5,5,15,Champions
6486,179,60,432,3,5,5,13,Loyal Users
6749,85,49,99,4,5,4,13,Champions
7013,406,22,42,3,4,3,10,Loyal Users
7194,105,47,140,4,5,4,13,Champions
7338,2523,5,6,1,1,1,3,Lost
7698,425,12,14,3,3,1,7,Loyal Users
8033,443,8,17,3,2,2,7,Casual Users
8056,38,53,163,5,5,5,15,Champions
8074,113,9,46,4,2,3,9,Promising
8098,661,13,151,2,3,5,10,Casual Users
8125,38,111,323,5,5,5,15,Champions
8129,139,13,70,4,3,4,11,Loyal Users
8197,61,40,196,5,4,5,14,Champions
8459,124,116,572,4,5,5,14,Champions
8642,533,12,20,2,3,2,7,Casual Users
8881,182,160,531,3,5,5,13,Loyal Users
9479,116,17,38,4,3,3,10,Loyal Users
10490,1571,6,11,1,1,1,3,Lost
10812,833,25,151,2,4,5,11,At Risk
10960,653,8,30,2,2,2,6,Lost
11051,151,46,180,4,5,5,14,Champions
11266,30,45,113,5,4,4,13,Champions
11349,447,9,12,3,2,1,6,Casual Users
11535,7,104,326,5,5,5,15,Champions
11681,110,7,21,4,2,2,8,Promising
11688,40,92,140,5,5,4,14,Champions
12048,68,20,39,5,3,3,11,Loyal Users
12124,101,57,150,4,5,5,14,Champions
12283,566,13,37,2,3,3,8,Casual Users
12470,12,130,189,5,5,5,15,Champions
13149,129,33,95,4,4,4,12,Champions
13274,543,28,50,2,4,3,9,At Risk
70,1597,11,60,1,2,3,6,Lost
408,234,16,86,3,3,4,10,Loyal Users
921,603,6,7,2,1,1,4,Lost
1003,120,8,22,4,2,2,8,Promising
1454,2845,18,38,1,3,3,7,Casual Users
1479,3612,41,59,1,4,3,8,At Risk
1709,822,13,18,2,3,2,7,Casual Users
1897,48,9,16,5,2,2,9,Promising
2234,978,9,14,2,2,1,5,Lost
2260,499,7,9,2,2,1,5,Lost
2715,1063,10,45,2,2,3,7,Lost
2846,408,20,35,3,3,3,9,Loyal Users
3035,235,13,18,3,3,2,8,Loyal Users
3096,2570,15,32,1,3,3,7,Casual Users
3219,231,90,213,3,5,5,13,Loyal Users
3259,1895,8,8,1,2,1,4,Lost
3437,973,38,81,2,4,4,10,At Risk
3693,137,15,23,4,3,2,9,Loyal Users
3755,486,58,278,2,5,5,12,At Risk
3842,1688,20,59,1,3,3,7,Casual Users
3973,37,36,101,5,4,4,13,Champions
4099,1150,15,83,2,3,4,9,Casual Users
4400,350,11,17,3,2,2,7,Casual Users
4970,132,33,65,4,4,4,12,Champions
5128,2544,10,18,1,2,2,5,Lost
5177,41,81,493,5,5,5,15,Champions
5207,104,7,38,4,2,3,9,Promising
5273,5576,5,28,1,1,2,4,Lost
5762,1277,22,31,1,4,2,7,At Risk
5957,2685,12,23,1,3,2,6,Casual Users
6012,412,31,62,3,4,3,10,Loyal Users
6164,4617,70,151,1,5,5,11,At Risk
6287,900,10,30,2,2,2,6,Lost
6644,962,5,12,2,1,1,4,Lost
6923,112,11,29,4,2,2,8,Promising
6957,527,5,12,2,1,1,4,Lost
7049,2720,8,12,1,2,1,4,Lost
7332,1733,12,12,1,3,1,5,Casual Users
7511,134,24,169,4,4,5,13,Champions
7548,129,8,14,4,2,1,7,Promising
8219,3188,6,23,1,1,2,4,Lost
8613,120,42,116,4,4,4,12,Champions
8819,4658,6,10,1,1,1,3,Lost
9024,118,45,104,4,4,4,12,Champions
9043,4,143,353,5,5,5,15,Champions
9190,178,6,22,3,1,2,6,Casual Users
9227,862,28,46,2,4,3,9,At Risk
9580,116,43,110,4,4,4,12,Champions
9866,15,83,158,5,5,5,15,Champions
9929,596,5,14,2,1,1,4,Lost
10065,143,27,129,4,4,4,12,Champions
10750,1189,19,43,2,3,3,8,Casual Users
10753,360,28,242,3,4,5,12,Loyal Users
10938,1273,5,18,1,1,2,4,Lost
11008,34,6,6,5,1,1,7,Promising
11351,140,83,117,4,5,4,13,Champions
11386,112,44,60,4,4,3,11,Loyal Users
11772,281,21,85,3,3,4,10,Loyal Users
12156,2167,5,6,1,1,1,3,Lost
12266,97,13,123,4,3,4,11,Loyal Users
12394,1830,25,41,1,4,3,8,At Risk
12707,29,34,85,5,4,4,13,Champions
12856,1015,8,11,2,2,1,5,Lost
12902,142,33,244,4,4,5,13,Champions
12923,35,111,382,5,5,5,15,Champions
13502,133,11,17,4,2,2,8,Promising
13588,26,30,38,5,4,3,12,Loyal Users
62,101,62,164,4,5,5,14,Champions
121,1065,5,10,2,1,1,4,Lost
125,104,7,12,4,2,1,7,Promising
396,995,27,154,2,4,5,11,At Risk
730,978,7,29,2,2,2,6,Lost
1453,826,84,155,2,5,5,12,At Risk
1799,6,54,146,5,5,4,14,Champions
1907,101,17,30,4,3,2,9,Loyal Users
1912,262,34,38,3,4,3,10,Loyal Users
2075,106,103,194,4,5,5,14,Champions
2505,4861,9,28,1,2,2,5,Lost
2529,2585,7,10,1,2,1,4,Lost
2551,454,18,29,3,3,2,8,Loyal Users
3091,16,18,44,5,3,3,11,Loyal Users
3204,299,19,34,3,3,3,9,Loyal Users
3265,35,136,515,5,5,5,15,Champions
3267,432,32,38,3,4,3,10,Loyal Users
3514,2811,5,15,1,1,1,3,Lost
3560,998,19,50,2,3,3,8,Casual Users
3580,18,115,570,5,5,5,15,Champions
3678,120,93,158,4,5,5,14,Champions
3751,122,34,117,4,4,4,12,Champions
3906,276,16,30,3,3,2,8,Loyal Users
3909,851,7,22,2,2,2,6,Lost
4250,103,27,45,4,4,3,11,Loyal Users
4332,306,48,81,3,5,4,12,Loyal Users
4432,132,37,72,4,4,4,12,Champions
4654,87,19,35,4,3,3,10,Loyal Users
4767,418,11,33,3,2,3,8,Casual Users
4880,26,48,90,5,5,4,14,Champions
5143,2613,20,25,1,3,2,6,Casual Users
5434,842,5,11,2,1,1,4,Lost
5635,671,5,7,2,1,1,4,Lost
5904,6,25,98,5,4,4,13,Champions
6380,118,21,49,4,3,3,10,Loyal Users
6494,2287,8,19,1,2,2,5,Lost
6547,44,41,122,5,4,4,13,Champions
6823,169,13,14,3,3,1,7,Loyal Users
7263,8,33,35,5,4,3,12,Loyal Users
7652,1248,8,33,2,2,3,7,Lost
8118,1145,11,46,2,2,3,7,Lost
8331,425,15,37,3,3,3,9,Loyal Users
8483,7,16,37,5,3,3,11,Loyal Users
8508,12,66,115,5,5,4,14,Champions
8584,5,5,30,5,1,2,8,Promising
9310,463,32,83,3,4,4,11,Loyal Users
9510,388,16,45,3,3,3,9,Loyal Users
9595,1488,9,10,1,2,1,4,Lost
9899,284,8,11,3,2,1,6,Casual Users
9971,2950,5,10,1,1,1,3,Lost
10474,593,17,33,2,3,3,8,Casual Users
10641,441,27,53,3,4,3,10,Loyal Users
10696,31,28,118,5,4,4,13,Champions
10770,110,24,58,4,4,3,11,Loyal Users
11101,1715,6,10,1,1,1,3,Lost
11126,110,35,90,4,4,4,12,Champions
11495,525,12,33,2,3,3,8,Casual Users
11579,500,14,27,2,3,2,7,Casual Users
11620,296,20,34,3,3,3,9,Loyal Users
11820,378,18,41,3,3,3,9,Loyal Users
11867,163,7,22,4,2,2,8,Promising
12397,4662,5,6,1,1,1,3,Lost
12398,551,5,16,2,1,2,5,Lost
12492,4,82,223,5,5,5,15,Champions
13001,1124,17,33,2,3,3,8,Casual Users
13042,178,11,84,3,2,4,9,Casual Users
13338,1,126,193,5,5,5,15,Champions
156,62,35,135,5,4,4,13,Champions
351,1656,12,15,1,3,1,5,Casual Users
480,284,7,12,3,2,1,6,Casual Users
1592,611,9,19,2,2,2,6,Lost
1666,801,5,5,2,1,1,4,Lost
1853,79,49,389,4,5,5,14,Champions
2050,933,5,7,2,1,1,4,Lost
2812,3658,5,8,1,1,1,3,Lost
2878,2713,14,38,1,3,3,7,Casual Users
3391,74,50,97,4,5,4,13,Champions
3576,311,15,45,3,3,3,9,Loyal Users
3591,2556,7,11,1,2,1,4,Lost
4053,1325,6,54,1,1,3,5,Lost
4067,39,18,28,5,3,2,10,Loyal Users
4255,232,5,23,3,1,2,6,Casual Users
4471,91,10,77,4,2,4,10,Promising
4590,500,23,97,2,4,4,10,At Risk
4704,426,130,153,3,5,5,13,Loyal Users
4747,44,46,154,5,5,5,15,Champions
4938,4935,5,15,1,1,1,3,Lost
4998,70,35,106,4,4,4,12,Champions
5197,6,152,677,5,5,5,15,Champions
5259,964,5,5,2,1,1,4,Lost
5313,125,78,172,4,5,5,14,Champions
6173,417,6,25,3,1,2,6,Casual Users
6806,1572,10,15,1,2,1,4,Lost
6870,110,12,82,4,3,4,11,Loyal Users
6973,155,38,105,4,4,4,12,Champions
7060,2433,5,12,1,1,1,3,Lost
7121,229,39,113,3,4,4,11,Loyal Users
7201,28,12,25,5,3,2,10,Loyal Users
7512,4368,7,55,1,2,3,6,Lost
7569,464,22,27,3,4,2,9,Loyal Users
7700,1,49,151,5,5,5,15,Champions
8457,127,10,113,4,2,4,10,Promising
8540,187,55,254,3,5,5,13,Loyal Users
8725,421,41,119,3,4,4,11,Loyal Users
8745,592,26,44,2,4,3,9,At Risk
8808,3847,6,10,1,1,1,3,Lost
8810,1727,13,36,1,3,3,7,Casual Users
8875,3132,12,51,1,3,3,7,Casual Users
9281,122,8,11,4,2,1,7,Promising
9506,1691,9,18,1,2,2,5,Lost
9546,163,13,26,4,3,2,9,Loyal Users
10159,112,53,113,4,5,4,13,Champions
10279,267,10,136,3,2,4,9,Casual Users
10584,75,98,634,4,5,5,14,Champions
10955,1473,7,19,1,2,2,5,Lost
11303,269,82,401,3,5,5,13,Loyal Users
12369,112,9,12,4,2,1,7,Promising
12672,16,21,42,5,3,3,11,Loyal Users
12684,44,102,330,5,5,5,15,Champions
12814,426,21,51,3,3,3,9,Loyal Users
13171,141,13,25,4,3,2,9,Loyal Users
13185,9,41,92,5,4,4,13,Champions
13444,975,9,16,2,2,2,6,Lost
143,240,36,93,3,4,4,11,Loyal Users
219,893,5,35,2,1,3,6,Lost
697,221,26,212,3,4,5,12,Loyal Users
967,72,10,15,4,2,1,7,Promising
1083,1710,21,44,1,3,3,7,Casual Users
1099,852,5,17,2,1,2,5,Lost
1336,154,18,61,4,3,3,10,Loyal Users
1610,162,28,71,4,4,4,12,Champions
1679,377,39,75,3,4,4,11,Loyal Users
2207,371,30,67,3,4,4,11,Loyal Users
2408,163,19,114,4,3,4,11,Loyal Users
2820,1457,14,45,1,3,3,7,Casual Users
3106,525,11,22,2,2,2,6,Lost
3530,181,30,154,3,4,5,12,Loyal Users
3564,10,46,84,5,5,4,14,Champions
3828,15,38,95,5,4,4,13,Champions
4069,2558,5,19,1,1,2,4,Lost
4231,57,112,405,5,5,5,15,Champions
4686,3003,5,9,1,1,1,3,Lost
4705,1026,5,10,2,1,1,4,Lost
4708,413,38,55,3,4,3,10,Loyal Users
4951,1112,6,20,2,1,2,5,Lost
5196,1,8,10,5,2,1,8,Promising
5224,233,7,25,3,2,2,7,Casual Users
5253,3740,5,25,1,1,2,4,Lost
5479,416,6,37,3,1,3,7,Casual Users
5978,23,16,74,5,3,4,12,Loyal Users
6549,3092,11,31,1,2,2,5,Lost
6577,13,17,41,5,3,3,11,Loyal Users
6635,209,58,217,3,5,5,13,Loyal Users
6643,101,25,132,4,4,4,12,Champions
6851,451,7,12,3,2,1,6,Casual Users
7252,127,37,428,4,4,5,13,Champions
7294,534,11,12,2,2,1,5,Lost
7673,1363,14,55,1,3,3,7,Casual Users
7751,1671,6,7,1,1,1,3,Lost
8064,18,34,158,5,4,5,14,Champions
8505,1221,37,121,2,4,4,10,At Risk
9045,283,18,20,3,3,2,8,Loyal Users
9251,1240,5,8,2,1,1,4,Lost
9534,604,9,37,2,2,3,7,Lost
9682,10,19,34,5,3,3,11,Loyal Users
9830,3399,28,71,1,4,4,9,At Risk
9835,2611,8,9,1,2,1,4,Lost
10153,540,5,14,2,1,1,4,Lost
10320,60,81,379,5,5,5,15,Champions
10404,2,127,514,5,5,5,15,Champions
10444,273,5,7,3,1,1,5,Casual Users
10595,690,25,104,2,4,4,10,At Risk
10718,968,5,6,2,1,1,4,Lost
10752,17,5,11,5,1,1,7,Promising
10830,14,15,24,5,3,2,10,Loyal Users
10965,21,10,24,5,2,2,9,Promising
11012,352,52,82,3,5,4,12,Loyal Users
11019,812,6,7,2,1,1,4,Lost
11114,1976,6,98,1,1,4,6,Lost
11551,108,21,38,4,3,3,10,Loyal Users
11651,511,24,70,2,4,4,10,At Risk
11712,7,52,79,5,5,4,14,Champions
11866,1553,7,11,1,2,1,4,Lost
11987,101,22,44,4,4,3,11,Loyal Users
12052,161,27,49,4,4,3,11,Loyal Users
12953,2282,7,17,1,2,2,5,Lost
13043,293,15,42,3,3,3,9,Loyal Users
13252,108,20,52,4,3,3,10,Loyal Users
13425,1280,17,52,1,3,3,7,Casual Users
13436,987,64,100,2,5,4,11,At Risk
13580,1205,13,102,2,3,4,9,Casual Users
95,2321,5,8,1,1,1,3,Lost
411,15,47,259,5,5,5,15,Champions
477,3635,21,81,1,3,4,8,Casual Users
482,125,32,46,4,4,3,11,Loyal Users
740,208,37,186,3,4,5,12,Loyal Users
968,3136,7,14,1,2,1,4,Lost
1423,134,10,13,4,2,1,7,Promising
1687,2951,8,16,1,2,2,5,Lost
1740,657,12,27,2,3,2,7,Casual Users
1784,5360,7,16,1,2,2,5,Lost
2009,6029,5,15,1,1,1,3,Lost
2123,496,12,44,2,3,3,8,Casual Users
2133,19,142,284,5,5,5,15,Champions
2145,14,50,157,5,5,5,15,Champions
2217,1997,10,14,1,2,1,4,Lost
2359,33,10,21,5,2,2,9,Promising
2669,720,7,9,2,2,1,5,Lost
3241,113,33,61,4,4,3,11,Loyal Users
3868,420,19,69,3,3,4,10,Loyal Users
4063,105,9,18,4,2,2,8,Promising
4187,726,13,53,2,3,3,8,Casual Users
4493,109,103,579,4,5,5,14,Champions
4533,2246,10,23,1,2,2,5,Lost
4825,170,5,18,3,1,2,6,Casual Users
4887,223,57,137,3,5,4,12,Loyal Users
4913,123,12,22,4,3,2,9,Loyal Users
5045,39,25,124,5,4,4,13,Champions
5321,160,12,25,4,3,2,9,Loyal Users
5813,264,39,85,3,4,4,11,Loyal Users
5857,719,12,13,2,3,1,6,Casual Users
5872,863,7,12,2,2,1,5,Lost
5927,135,82,97,4,5,4,13,Champions
6000,116,54,250,4,5,5,14,Champions
6290,12,156,349,5,5,5,15,Champions
6843,265,84,103,3,5,4,12,Loyal Users
7163,2813,8,33,1,2,3,6,Lost
7318,259,9,45,3,2,3,8,Casual Users
7430,27,53,275,5,5,5,15,Champions
7826,271,20,79,3,3,4,10,Loyal Users
8794,698,6,6,2,1,1,4,Lost
9085,406,6,15,3,1,1,5,Casual Users
9263,407,5,9,3,1,1,5,Casual Users
9569,523,8,20,2,2,2,6,Lost
9676,137,18,33,4,3,3,10,Loyal Users
9684,311,16,45,3,3,3,9,Loyal Users
9774,134,106,699,4,5,5,14,Champions
10066,177,36,105,3,4,4,11,Loyal Users
10238,794,9,9,2,2,1,5,Lost
10375,106,61,109,4,5,4,13,Champions
10880,4837,7,17,1,2,2,5,Lost
10920,132,43,85,4,4,4,12,Champions
10993,107,41,52,4,4,3,11,Loyal Users
11077,141,103,235,4,5,5,14,Champions
11104,4018,6,6,1,1,1,3,Lost
11137,2,30,136,5,4,4,13,Champions
11582,5556,9,24,1,2,2,5,Lost
11653,1557,5,11,1,1,1,3,Lost
11843,422,13,39,3,3,3,9,Loyal Users
11898,190,10,13,3,2,1,6,Casual Users
11980,117,104,197,4,5,5,14,Champions
12497,68,21,37,5,3,3,11,Loyal Users
12610,796,5,41,2,1,3,6,Lost
12835,133,160,609,4,5,5,14,Champions
13035,154,13,26,4,3,2,9,Loyal Users
13131,10,30,55,5,4,3,12,Loyal Users
29,90,52,216,4,5,5,14,Champions
226,1093,30,54,2,4,3,9,At Risk
390,107,14,76,4,3,4,11,Loyal Users
651,39,35,121,5,4,4,13,Champions
741,435,11,19,3,2,2,7,Casual Users
789,3541,7,10,1,2,1,4,Lost
1038,2463,7,10,1,2,1,4,Lost
1439,38,99,283,5,5,5,15,Champions
1570,2305,5,11,1,1,1,3,Lost
2139,418,24,105,3,4,4,11,Loyal Users
2165,1432,7,16,1,2,2,5,Lost
2453,201,41,132,3,4,4,11,Loyal Users
2541,157,32,70,4,4,4,12,Champions
2860,151,61,137,4,5,4,13,Champions
2948,129,17,24,4,3,2,9,Loyal Users
3136,124,5,28,4,1,2,7,Promising
3288,207,13,37,3,3,3,9,Loyal Users
3848,301,13,39,3,3,3,9,Loyal Users
4499,182,79,258,3,5,5,13,Loyal Users
4563,975,5,10,2,1,1,4,Lost
5312,238,80,198,3,5,5,13,Loyal Users
5368,1696,5,17,1,1,2,4,Lost
5498,101,118,773,4,5,5,14,Champions
5672,306,22,30,3,4,2,9,Loyal Users
5888,604,47,189,2,5,5,12,At Risk
6632,887,35,106,2,4,4,10,At Risk
6919,18,119,242,5,5,5,15,Champions
7419,2393,19,97,1,3,4,8,Casual Users
7771,275,22,29,3,4,2,9,Loyal Users
8028,1809,16,35,1,3,3,7,Casual Users
8727,1595,10,42,1,2,3,6,Lost
8804,614,7,25,2,2,2,6,Lost
8817,101,45,83,4,4,4,12,Champions
8878,181,79,194,3,5,5,13,Loyal Users
9257,0,65,188,5,5,5,15,Champions
9367,739,15,30,2,3,2,7,Casual Users
9605,45,37,66,5,4,4,13,Champions
9949,385,64,115,3,5,4,12,Loyal Users
9975,566,8,13,2,2,1,5,Lost
10059,251,21,41,3,3,3,9,Loyal Users
10146,4987,10,27,1,2,2,5,Lost
10601,408,8,25,3,2,2,7,Casual Users
10603,431,7,14,3,2,1,6,Casual Users
10763,5525,7,7,1,2,1,4,Lost
10771,424,18,40,3,3,3,9,Loyal Users
11006,112,48,201,4,5,5,14,Champions
11384,67,50,106,5,5,4,14,Champions
11622,512,69,113,2,5,4,11,At Risk
12009,661,29,58,2,4,3,9,At Risk
12049,2688,5,50,1,1,3,5,Lost
12082,1086,6,18,2,1,2,5,Lost
12277,112,74,249,4,5,5,14,Champions
12454,1,22,83,5,4,4,13,Champions
12741,2598,12,30,1,3,2,6,Casual Users
13253,1224,8,22,2,2,2,6,Lost
464,510,33,142,2,4,4,10,At Risk
526,531,58,391,2,5,5,12,At Risk
528,141,77,261,4,5,5,14,Champions
558,965,10,12,2,2,1,5,Lost
1221,146,45,131,4,4,4,12,Champions
1289,4163,5,8,1,1,1,3,Lost
2125,230,12,34,3,3,3,9,Loyal Users
2291,256,15,24,3,3,2,8,Loyal Users
2749,144,31,84,4,4,4,12,Champions
2862,72,25,38,4,4,3,11,Loyal Users
2981,92,31,34,4,4,3,11,Loyal Users
3177,1,24,48,5,4,3,12,Loyal Users
3189,61,15,25,5,3,2,10,Loyal Users
3322,30,45,98,5,4,4,13,Champions
3845,408,7,8,3,2,1,6,Casual Users
3911,176,41,171,3,4,5,12,Loyal Users
4084,801,11,20,2,2,2,6,Lost
4098,175,72,269,3,5,5,13,Loyal Users
4841,3171,6,6,1,1,1,3,Lost
4878,1467,18,133,1,3,4,8,Casual Users
4945,2168,24,44,1,4,3,8,At Risk
5181,1171,18,135,2,3,4,9,Casual Users
5475,182,22,26,3,4,2,9,Loyal Users
5757,10,45,201,5,4,5,14,Champions
6236,440,9,25,3,2,2,7,Casual Users
6377,55,19,45,5,3,3,11,Loyal Users
6725,113,23,35,4,4,3,11,Loyal Users
6757,227,9,11,3,2,1,6,Casual Users
6875,4530,6,15,1,1,1,3,Lost
7336,375,9,15,3,2,1,6,Casual Users
7563,256,15,51,3,3,3,9,Loyal Users
7716,69,82,269,5,5,5,15,Champions
8436,23,42,82,5,4,4,13,Champions
8576,2812,6,18,1,1,2,4,Lost
8695,76,116,663,4,5,5,14,Champions
8752,633,19,46,2,3,3,8,Casual Users
9003,950,9,16,2,2,2,6,Lost
9063,423,57,90,3,5,4,12,Loyal Users
9137,101,13,217,4,3,5,12,Loyal Users
9183,294,10,26,3,2,2,7,Casual Users
9248,13,84,241,5,5,5,15,Champions
9531,111,6,7,4,1,1,6,Promising
9969,165,57,284,4,5,5,14,Champions
9970,67,79,362,5,5,5,15,Champions
10023,199,45,221,3,4,5,12,Loyal Users
10244,1731,7,8,1,2,1,4,Lost
10360,415,7,22,3,2,2,7,Casual Users
10629,30,20,79,5,3,4,12,Loyal Users
10818,139,12,20,4,3,2,9,Loyal Users
10848,24,74,498,5,5,5,15,Champions
11060,131,43,101,4,4,4,12,Champions
11167,3070,6,12,1,1,1,3,Lost
11176,121,67,287,4,5,5,14,Champions
11216,668,5,11,2,1,1,4,Lost
11329,564,6,7,2,1,1,4,Lost
11964,436,5,17,3,1,2,6,Casual Users
12180,1410,12,30,1,3,2,6,Casual Users
12208,270,64,147,3,5,5,13,Loyal Users
12215,1205,20,51,2,3,3,8,Casual Users
12784,460,19,36,3,3,3,9,Loyal Users
12858,22,13,19,5,3,2,10,Loyal Users
12876,330,25,58,3,4,3,10,Loyal Users
13058,575,37,214,2,4,5,11,At Risk
21,2174,13,19,1,3,2,6,Casual Users
214,705,12,22,2,3,2,7,Casual Users
653,444,10,21,3,2,2,7,Casual Users
710,84,126,764,4,5,5,14,Champions
1177,742,22,62,2,4,3,9,At Risk
1393,257,10,15,3,2,1,6,Casual Users
1409,129,86,335,4,5,5,14,Champions
1514,377,34,83,3,4,4,11,Loyal Users
1523,780,5,6,2,1,1,4,Lost
1578,3028,6,7,1,1,1,3,Lost
1587,90,27,53,4,4,3,11,Loyal Users
1801,4259,8,19,1,2,2,5,Lost
2074,9,121,263,5,5,5,15,Champions
2201,405,6,14,3,1,1,5,Casual Users
2636,126,59,63,4,5,4,13,Champions
2708,219,11,90,3,2,4,9,Casual Users
3064,443,35,51,3,4,3,10,Loyal Users
3253,1836,8,11,1,2,1,4,Lost
3599,987,7,13,2,2,1,5,Lost
3713,110,5,44,4,1,3,8,Promising
3847,1140,5,6,2,1,1,4,Lost
4051,136,34,106,4,4,4,12,Champions
4502,127,16,25,4,3,2,9,Loyal Users
4566,130,10,53,4,2,3,9,Promising
4678,422,7,10,3,2,1,6,Casual Users
4691,6,80,175,5,5,5,15,Champions
4792,1007,20,31,2,3,2,7,Casual Users
5161,1,9,41,5,2,3,10,Promising
5185,689,20,45,2,3,3,8,Casual Users
5290,1012,95,148,2,5,5,12,At Risk
5822,27,37,71,5,4,4,13,Champions
5830,620,31,96,2,4,4,10,At Risk
6368,26,63,251,5,5,5,15,Champions
6461,10,55,88,5,5,4,14,Champions
6483,16,55,365,5,5,5,15,Champions
6487,253,6,17,3,1,2,6,Casual Users
6845,162,35,92,4,4,4,12,Champions
7017,100,16,42,4,3,3,10,Loyal Users
7061,2804,59,84,1,5,4,10,At Risk
7276,252,6,7,3,1,1,5,Casual Users
7322,110,133,553,4,5,5,14,Champions
7358,193,31,92,3,4,4,11,Loyal Users
7405,75,44,64,4,4,4,12,Champions
7414,242,76,236,3,5,5,13,Loyal Users
7623,137,10,57,4,2,3,9,Promising
7675,28,62,129,5,5,4,14,Champions
7738,1810,5,8,1,1,1,3,Lost
7853,210,8,10,3,2,1,6,Casual Users
8026,4426,34,230,1,4,5,10,At Risk
8038,377,13,53,3,3,3,9,Loyal Users
8099,712,17,19,2,3,2,7,Casual Users
8188,691,9,17,2,2,2,6,Lost
9200,16,11,25,5,2,2,9,Promising
9449,2419,5,13,1,1,1,3,Lost
9587,242,120,355,3,5,5,13,Loyal Users
10296,4453,8,29,1,2,2,5,Lost
10441,704,32,49,2,4,3,9,At Risk
11065,3356,9,17,1,2,2,5,Lost
11084,845,5,5,2,1,1,4,Lost
11265,3031,5,7,1,1,1,3,Lost
11366,669,6,11,2,1,1,4,Lost
12101,2105,6,7,1,1,1,3,Lost
12280,31,9,9,5,2,1,8,Promising
12551,147,19,87,4,3,4,11,Loyal Users
12563,599,7,14,2,2,1,5,Lost
12739,1370,5,6,1,1,1,3,Lost
12938,2,21,187,5,3,5,13,Loyal Users
13079,3421,16,39,1,3,3,7,Casual Users
13196,102,52,121,4,5,4,13,Champions
13246,106,17,19,4,3,2,9,Loyal Users
13336,803,5,9,2,1,1,4,Lost
13358,3367,8,12,1,2,1,4,Lost
13559,846,19,60,2,3,3,8,Casual Users
323,1702,14,21,1,3,2,6,Casual Users
550,157,15,20,4,3,2,9,Loyal Users
1079,1,36,82,5,4,4,13,Champions
1153,114,12,21,4,3,2,9,Loyal Users
1283,3073,5,8,1,1,1,3,Lost
1327,97,14,18,4,3,2,9,Loyal Users
1345,3406,6,21,1,1,2,4,Lost
1465,1077,7,11,2,2,1,5,Lost
1548,18,13,22,5,3,2,10,Loyal Users
1552,11,99,276,5,5,5,15,Champions
1648,4292,5,7,1,1,1,3,Lost
1911,104,86,424,4,5,5,14,Champions
2116,147,19,102,4,3,4,11,Loyal Users
2250,1138,17,43,2,3,3,8,Casual Users
2544,899,11,20,2,2,2,6,Lost
2843,670,8,19,2,2,2,6,Lost
2868,2450,5,25,1,1,2,4,Lost
2922,424,50,114,3,5,4,12,Loyal Users
2955,828,9,16,2,2,2,6,Lost
3165,393,21,42,3,3,3,9,Loyal Users
3233,108,47,77,4,5,4,13,Champions
3246,1685,5,13,1,1,1,3,Lost
3303,2124,9,24,1,2,2,5,Lost
3716,121,27,59,4,4,3,11,Loyal Users
3872,52,104,134,5,5,4,14,Champions
3878,228,27,64,3,4,4,11,Loyal Users
4366,361,68,402,3,5,5,13,Loyal Users
4406,232,5,33,3,1,3,7,Casual Users
4972,281,9,18,3,2,2,7,Casual Users
5093,275,41,265,3,4,5,12,Loyal Users
5111,125,9,21,4,2,2,8,Promising
5723,550,9,22,2,2,2,6,Lost
6398,443,23,42,3,4,3,10,Loyal Users
7024,3652,13,50,1,3,3,7,Casual Users
7075,1760,13,41,1,3,3,7,Casual Users
7808,50,39,201,5,4,5,14,Champions
8060,44,130,169,5,5,5,15,Champions
8063,1389,15,24,1,3,2,6,Casual Users
8175,26,83,267,5,5,5,15,Champions
8494,86,16,94,4,3,4,11,Loyal Users
8545,997,23,44,2,4,3,9,At Risk
8555,583,10,12,2,2,1,5,Lost
8668,576,9,30,2,2,2,6,Lost
8676,1052,26,173,2,4,5,11,At Risk
8748,641,13,18,2,3,2,7,Casual Users
9089,1026,6,7,2,1,1,4,Lost
9407,16,96,374,5,5,5,15,Champions
9544,2529,6,7,1,1,1,3,Lost
9561,404,24,62,3,4,3,10,Loyal Users
9656,136,64,464,4,5,5,14,Champions
10113,48,18,28,5,3,2,10,Loyal Users
10545,520,234,731,2,5,5,12,At Risk
10652,415,21,114,3,3,4,10,Loyal Users
10852,1338,11,31,1,2,2,5,Lost
10997,79,50,83,4,5,4,13,Champions
11169,5689,5,9,1,1,1,3,Lost
11685,533,6,9,2,1,1,4,Lost
11770,101,52,476,4,5,5,14,Champions
12053,182,9,23,3,2,2,7,Casual Users
12058,11,10,108,5,2,4,11,Promising
12083,162,54,243,4,5,5,14,Champions
12396,138,10,21,4,2,2,8,Promising
12789,884,5,80,2,1,4,7,Lost
12844,47,48,151,5,5,5,15,Champions
335,1598,12,16,1,3,2,6,Casual Users
338,513,10,35,2,2,3,7,Lost
352,1658,8,37,1,2,3,6,Lost
492,293,53,80,3,5,4,12,Loyal Users
798,3116,5,10,1,1,1,3,Lost
866,433,48,356,3,5,5,13,Loyal Users
941,115,98,528,4,5,5,14,Champions
1179,2547,6,6,1,1,1,3,Lost
1239,869,26,41,2,4,3,9,At Risk
1337,291,9,27,3,2,2,7,Casual Users
2178,2228,10,28,1,2,2,5,Lost
2300,4,57,70,5,5,4,14,Champions
2426,123,9,18,4,2,2,8,Promising
2449,25,42,316,5,4,5,14,Champions
2870,101,50,146,4,5,4,13,Champions
2943,1988,6,11,1,1,1,3,Lost
3063,985,29,61,2,4,3,9,At Risk
3385,43,110,238,5,5,5,15,Champions
3459,5,65,111,5,5,4,14,Champions
3477,152,14,208,4,3,5,12,Loyal Users
3547,136,8,9,4,2,1,7,Promising
3775,252,9,16,3,2,2,7,Casual Users
3869,895,6,6,2,1,1,4,Lost
4117,2447,23,108,1,4,4,9,At Risk
4664,2555,6,13,1,1,1,3,Lost
5085,56,15,74,5,3,4,12,Loyal Users
5292,841,22,93,2,4,4,10,At Risk
5390,25,108,326,5,5,5,15,Champions
5416,135,17,25,4,3,2,9,Loyal Users
5601,412,21,165,3,3,5,11,Loyal Users
5637,946,11,22,2,2,2,6,Lost
5686,1234,10,37,2,2,3,7,Lost
6431,133,5,10,4,1,1,6,Promising
6507,26,29,102,5,4,4,13,Champions
6944,448,10,16,3,2,2,7,Casual Users
7036,101,31,126,4,4,4,12,Champions
7608,122,147,478,4,5,5,14,Champions
7630,683,14,94,2,3,4,9,Casual Users
8268,969,23,69,2,4,4,10,At Risk
8567,1301,8,13,1,2,1,4,Lost
9072,125,7,34,4,2,3,9,Promising
9285,88,80,111,4,5,4,13,Champions
9590,2085,6,78,1,1,4,6,Lost
10406,6,119,845,5,5,5,15,Champions
10450,1281,6,18,1,1,2,4,Lost
10542,29,56,113,5,5,4,14,Champions
10674,121,25,49,4,4,3,11,Loyal Users
10974,410,9,13,3,2,1,6,Casual Users
11040,2126,7,13,1,2,1,4,Lost
11319,834,14,46,2,3,3,8,Casual Users
11360,302,9,21,3,2,2,7,Casual Users
11383,331,19,76,3,3,4,10,Loyal Users
11791,2,30,118,5,4,4,13,Champions
11920,1834,12,34,1,3,3,7,Casual Users
12071,24,68,665,5,5,5,15,Champions
12130,992,7,25,2,2,2,6,Lost
12327,2787,7,7,1,2,1,4,Lost
12646,1283,7,19,1,2,2,5,Lost
12674,3640,7,8,1,2,1,4,Lost
12748,85,55,125,4,5,4,13,Champions
13174,2,151,491,5,5,5,15,Champions
13463,111,61,180,4,5,5,14,Champions
98,684,20,65,2,3,4,9,Casual Users
195,7,11,29,5,2,2,9,Promising
256,26,59,134,5,5,4,14,Champions
678,17,141,240,5,5,5,15,Champions
714,377,23,100,3,4,4,11,Loyal Users
911,44,60,82,5,5,4,14,Champions
933,720,6,38,2,1,3,6,Lost
1042,277,28,57,3,4,3,10,Loyal Users
1131,528,13,37,2,3,3,8,Casual Users
1140,280,16,22,3,3,2,8,Loyal Users
1185,1722,5,8,1,1,1,3,Lost
1257,37,28,38,5,4,3,12,Loyal Users
1308,2729,9,25,1,2,2,5,Lost
1348,345,32,102,3,4,4,11,Loyal Users
1364,330,34,54,3,4,3,10,Loyal Users
1450,156,26,65,4,4,4,12,Champions
1602,2276,7,29,1,2,2,5,Lost
1604,963,10,12,2,2,1,5,Lost
1936,4,185,506,5,5,5,15,Champions
2016,139,35,170,4,4,5,13,Champions
2100,889,12,61,2,3,3,8,Casual Users
2274,125,6,31,4,1,2,7,Promising
2330,1261,10,32,1,2,3,6,Lost
2615,2935,5,5,1,1,1,3,Lost
3094,135,19,76,4,3,4,11,Loyal Users
3275,105,43,90,4,4,4,12,Champions
3302,271,26,62,3,4,3,10,Loyal Users
3507,414,8,47,3,2,3,8,Casual Users
4275,834,6,14,2,1,1,4,Lost
4582,3,13,149,5,3,5,13,Loyal Users
4723,1421,7,17,1,2,2,5,Lost
4753,547,18,20,2,3,2,7,Casual Users
5007,112,13,24,4,3,2,9,Loyal Users
5714,4836,6,7,1,1,1,3,Lost
5810,219,5,19,3,1,2,6,Casual Users
6109,26,39,347,5,4,5,14,Champions
6229,93,92,549,4,5,5,14,Champions
6271,175,38,83,3,4,4,11,Loyal Users
6281,137,58,96,4,5,4,13,Champions
6569,956,5,8,2,1,1,4,Lost
6633,802,8,10,2,2,1,5,Lost
6922,2204,10,10,1,2,1,4,Lost
7115,3,91,205,5,5,5,15,Champions
7219,289,66,136,3,5,4,12,Loyal Users
7610,44,22,26,5,4,2,11,Loyal Users
7889,974,16,29,2,3,2,7,Casual Users
7936,1382,15,188,1,3,5,9,Casual Users
7988,131,33,99,4,4,4,12,Champions
8139,3964,14,59,1,3,3,7,Casual Users
8230,24,46,215,5,5,5,15,Champions
8361,528,8,9,2,2,1,5,Lost
8435,428,16,35,3,3,3,9,Loyal Users
8634,4853,17,35,1,3,3,7,Casual Users
9064,93,93,144,4,5,4,13,Champions
9219,30,110,215,5,5,5,15,Champions
9472,263,71,108,3,5,4,12,Loyal Users
9530,5026,20,31,1,3,2,6,Casual Users
9646,1649,11,11,1,2,1,4,Lost
10193,4214,5,7,1,1,1,3,Lost
10214,442,14,84,3,3,4,10,Loyal Users
10714,505,17,22,2,3,2,7,Casual Users
10916,2,86,295,5,5,5,15,Champions
10989,818,18,38,2,3,3,8,Casual Users
11015,1303,9,31,1,2,2,5,Lost
11079,295,16,27,3,3,2,8,Loyal Users
11140,73,22,99,4,4,4,12,Champions
11154,3886,5,6,1,1,1,3,Lost
11433,13,55,128,5,5,4,14,Champions
11465,704,9,36,2,2,3,7,Lost
11510,118,26,37,4,4,3,11,Loyal Users
11872,697,15,30,2,3,2,7,Casual Users
11976,75,16,23,4,3,2,9,Loyal Users
12217,4167,12,40,1,3,3,7,Casual Users
12816,835,17,73,2,3,4,9,Casual Users
12843,5284,5,6,1,1,1,3,Lost
12847,235,13,48,3,3,3,9,Loyal Users
287,1986,5,6,1,1,1,3,Lost
345,96,51,169,4,5,5,14,Champions
490,69,152,311,5,5,5,15,Champions
595,368,10,40,3,2,3,8,Casual Users
1168,111,144,248,4,5,5,14,Champions
1188,417,39,103,3,4,4,11,Loyal Users
1524,208,5,8,3,1,1,5,Casual Users
1792,123,132,226,4,5,5,14,Champions
1832,3492,22,41,1,4,3,8,At Risk
2130,113,6,13,4,1,1,6,Promising
2285,107,19,65,4,3,4,11,Loyal Users
2435,168,9,44,3,2,3,8,Casual Users
2573,4025,5,7,1,1,1,3,Lost
3466,1409,6,7,1,1,1,3,Lost
3627,2216,6,8,1,1,1,3,Lost
3820,1571,8,10,1,2,1,4,Lost
3954,76,54,134,4,5,4,13,Champions
4342,855,17,20,2,3,2,7,Casual Users
4501,1197,9,23,2,2,2,6,Lost
4699,562,12,17,2,3,2,7,Casual Users
4735,1426,20,41,1,3,3,7,Casual Users
4791,17,23,37,5,4,3,12,Loyal Users
4869,424,25,125,3,4,4,11,Loyal Users
4908,288,5,11,3,1,1,5,Casual Users
4965,130,49,82,4,5,4,13,Champions
5126,419,22,32,3,4,3,10,Loyal Users
5241,16,45,199,5,4,5,14,Champions
5352,3275,8,14,1,2,1,4,Lost
5779,4,103,368,5,5,5,15,Champions
5784,403,11,50,3,2,3,8,Casual Users
5812,15,26,40,5,4,3,12,Loyal Users
5974,1568,10,14,1,2,1,4,Lost
6292,8,34,145,5,4,4,13,Champions
6364,2920,22,40,1,4,3,8,At Risk
6782,23,135,394,5,5,5,15,Champions
6950,566,5,13,2,1,1,4,Lost
7175,214,39,99,3,4,4,11,Loyal Users
7195,104,60,315,4,5,5,14,Champions
7326,1454,6,20,1,1,2,4,Lost
8182,271,31,36,3,4,3,10,Loyal Users
8266,306,20,101,3,3,4,10,Loyal Users
8488,882,34,41,2,4,3,9,At Risk
8512,258,12,46,3,3,3,9,Loyal Users
8571,3125,11,43,1,2,3,6,Lost
8677,1819,5,11,1,1,1,3,Lost
8734,228,21,84,3,3,4,10,Loyal Users
8823,153,5,7,4,1,1,6,Promising
8889,109,103,487,4,5,5,14,Champions
9054,421,48,168,3,5,5,13,Loyal Users
9135,30,119,412,5,5,5,15,Champions
9179,105,10,54,4,2,3,9,Promising
9210,264,6,14,3,1,1,5,Casual Users
9225,667,11,27,2,2,2,6,Lost
9464,852,21,100,2,3,4,9,Casual Users
9632,78,21,91,4,3,4,11,Loyal Users
10585,308,13,28,3,3,2,8,Loyal Users
10712,933,10,53,2,2,3,7,Lost
10825,2842,12,29,1,3,2,6,Casual Users
11299,257,85,121,3,5,4,12,Loyal Users
11427,65,41,114,5,4,4,13,Champions
11819,694,11,33,2,2,3,7,Lost
11826,425,11,13,3,2,1,6,Casual Users
12811,549,6,15,2,1,1,4,Lost
12872,3599,5,7,1,1,1,3,Lost
12907,78,16,77,4,3,4,11,Loyal Users
13245,4517,5,34,1,1,3,5,Lost
752,43,8,12,5,2,1,8,Promising
767,68,13,34,5,3,3,11,Loyal Users
790,15,97,193,5,5,5,15,Champions
828,2012,12,29,1,3,2,6,Casual Users
1173,589,9,50,2,2,3,7,Lost
1593,600,37,85,2,4,4,10,At Risk
1631,25,52,68,5,5,4,14,Champions
1637,108,11,18,4,2,2,8,Promising
1767,852,15,48,2,3,3,8,Casual Users
1782,1053,7,9,2,2,1,5,Lost
1920,503,26,112,2,4,4,10,At Risk
2216,104,119,562,4,5,5,14,Champions
2314,213,6,9,3,1,1,5,Casual Users
2327,1983,8,27,1,2,2,5,Lost
2472,12,91,476,5,5,5,15,Champions
2533,54,19,39,5,3,3,11,Loyal Users
2744,616,5,5,2,1,1,4,Lost
3004,992,9,11,2,2,1,5,Lost
3255,123,6,48,4,1,3,8,Promising
3307,2150,6,6,1,1,1,3,Lost
3569,211,29,57,3,4,3,10,Loyal Users
3731,234,21,78,3,3,4,10,Loyal Users
3767,1022,18,41,2,3,3,8,Casual Users
3877,3743,9,12,1,2,1,4,Lost
4385,120,41,53,4,4,3,11,Loyal Users
4535,65,21,24,5,3,2,10,Loyal Users
4553,379,6,8,3,1,1,5,Casual Users
4619,27,105,401,5,5,5,15,Champions
4696,42,57,106,5,5,4,14,Champions
4815,1981,10,27,1,2,2,5,Lost
5340,2190,5,12,1,1,1,3,Lost
5458,625,5,5,2,1,1,4,Lost
5567,15,51,88,5,5,4,14,Champions
6158,1841,22,111,1,4,4,9,At Risk
6554,236,44,91,3,4,4,11,Loyal Users
6601,679,5,6,2,1,1,4,Lost
6731,1267,11,27,1,2,2,5,Lost
6815,304,26,43,3,4,3,10,Loyal Users
6969,235,103,415,3,5,5,13,Loyal Users
6979,10,6,33,5,1,3,9,Promising
6987,408,63,99,3,5,4,12,Loyal Users
7345,1308,26,98,1,4,4,9,At Risk
8031,284,17,45,3,3,3,9,Loyal Users
8041,2728,5,38,1,1,3,5,Lost
8636,1525,10,13,1,2,1,4,Lost
8687,234,33,63,3,4,4,11,Loyal Users
8768,394,7,15,3,2,1,6,Casual Users
8926,610,7,19,2,2,2,6,Lost
9194,673,5,6,2,1,1,4,Lost
9215,625,5,5,2,1,1,4,Lost
9337,1059,11,31,2,2,2,6,Lost
9408,383,8,17,3,2,2,7,Casual Users
9520,1116,15,26,2,3,2,7,Casual Users
9809,533,24,37,2,4,3,9,At Risk
9815,292,5,6,3,1,1,5,Casual Users
9917,4,16,18,5,3,2,10,Loyal Users
10069,32,105,215,5,5,5,15,Champions
10329,149,31,93,4,4,4,12,Champions
10384,848,12,14,2,3,1,6,Casual Users
10985,409,12,38,3,3,3,9,Loyal Users
11699,671,14,23,2,3,2,7,Casual Users
11783,10,106,375,5,5,5,15,Champions
11910,281,8,19,3,2,2,7,Casual Users
11952,77,41,81,4,4,4,12,Champions
12010,4986,16,16,1,3,2,6,Casual Users
12308,217,49,264,3,5,5,13,Loyal Users
12324,203,28,83,3,4,4,11,Loyal Users
12380,20,46,78,5,5,4,14,Champions
12669,5,11,47,5,2,3,10,Promising
12734,33,5,21,5,1,2,8,Promising
12764,107,22,46,4,4,3,11,Loyal Users
12800,285,17,29,3,3,2,8,Loyal Users
12969,739,12,18,2,3,2,7,Casual Users
13272,388,46,123,3,5,4,12,Loyal Users
13570,3247,7,50,1,2,3,6,Lost
13572,726,55,70,2,5,4,11,At Risk
809,406,7,14,3,2,1,6,Casual Users
863,12,128,187,5,5,5,15,Champions
990,413,16,32,3,3,3,9,Loyal Users
1053,656,16,61,2,3,3,8,Casual Users
1150,317,6,9,3,1,1,5,Casual Users
1203,148,25,88,4,4,4,12,Champions
1284,447,67,242,3,5,5,13,Loyal Users
1319,10,141,272,5,5,5,15,Champions
1562,278,15,34,3,3,3,9,Loyal Users
1712,230,6,23,3,1,2,6,Casual Users
1844,126,30,193,4,4,5,13,Champions
1995,40,9,20,5,2,2,9,Promising
2132,95,22,63,4,4,4,12,Champions
2352,517,28,35,2,4,3,9,At Risk
2389,126,68,173,4,5,5,14,Champions
3009,1492,6,17,1,1,2,4,Lost
3077,1226,7,35,2,2,3,7,Lost
3079,112,17,19,4,3,2,9,Loyal Users
3384,3671,8,20,1,2,2,5,Lost
3521,350,41,113,3,4,4,11,Loyal Users
3641,1157,35,49,2,4,3,9,At Risk
3802,265,14,44,3,3,3,9,Loyal Users
3945,859,5,24,2,1,2,5,Lost
3979,576,11,65,2,2,4,8,Lost
4005,53,29,56,5,4,3,12,Loyal Users
4072,435,10,22,3,2,2,7,Casual Users
4114,415,6,24,3,1,2,6,Casual Users
4392,230,12,34,3,3,3,9,Loyal Users
4649,13,15,58,5,3,3,11,Loyal Users
5240,156,14,61,4,3,3,10,Loyal Users
5384,254,29,184,3,4,5,12,Loyal Users
5454,1742,8,10,1,2,1,4,Lost
6625,1266,8,10,1,2,1,4,Lost
6796,56,42,56,5,4,3,12,Loyal Users
7067,688,23,32,2,4,3,9,At Risk
7394,568,5,7,2,1,1,4,Lost
7395,58,66,123,5,5,4,14,Champions
7478,139,123,481,4,5,5,14,Champions
7547,11,67,161,5,5,5,15,Champions
7719,298,44,128,3,4,4,11,Loyal Users
7871,540,56,106,2,5,4,11,At Risk
8149,70,32,94,4,4,4,12,Champions
8310,165,42,137,4,4,4,12,Champions
8448,96,9,17,4,2,2,8,Promising
8732,1103,8,23,2,2,2,6,Lost
8778,1371,5,15,1,1,1,3,Lost
8854,2106,5,10,1,1,1,3,Lost
8858,0,40,187,5,4,5,14,Champions
8873,418,19,50,3,3,3,9,Loyal Users
9319,106,36,162,4,4,5,13,Champions
9554,120,7,24,4,2,2,8,Promising
9556,1190,5,17,2,1,2,5,Lost
9791,44,141,548,5,5,5,15,Champions
9892,841,19,27,2,3,2,7,Casual Users
10139,137,19,25,4,3,2,9,Loyal Users
10401,1017,40,174,2,4,5,11,At Risk
10661,305,13,18,3,3,2,8,Loyal Users
10676,2637,6,16,1,1,2,4,Lost
11000,836,5,9,2,1,1,4,Lost
11158,379,5,18,3,1,2,6,Casual Users
11663,582,5,7,2,1,1,4,Lost
11803,2829,6,14,1,1,1,3,Lost
11806,1160,9,25,2,2,2,6,Lost
11830,207,15,59,3,3,3,9,Loyal Users
11848,2,6,45,5,1,3,9,Promising
12017,505,17,27,2,3,2,7,Casual Users
12033,11,41,75,5,4,4,13,Champions
12443,0,12,48,5,3,3,11,Loyal Users
12510,1557,13,204,1,3,5,9,Casual Users
12517,46,17,122,5,3,4,12,Loyal Users
12557,53,58,91,5,5,4,14,Champions
12730,113,65,284,4,5,5,14,Champions
12769,126,5,12,4,1,1,6,Promising
12976,834,42,60,2,4,3,9,At Risk
13018,24,41,96,5,4,4,13,Champions
13141,645,11,26,2,2,2,6,Lost
13476,152,8,38,4,2,3,9,Promising
13492,171,17,34,3,3,3,9,Loyal Users
13537,126,18,119,4,3,4,11,Loyal Users
32,63,31,37,5,4,3,12,Loyal Users
60,2686,5,5,1,1,1,3,Lost
90,31,59,62,5,5,3,13,Loyal Users
371,154,72,141,4,5,4,13,Champions
622,17,57,111,5,5,4,14,Champions
1014,135,30,63,4,4,4,12,Champions
1115,563,96,377,2,5,5,12,At Risk
1931,78,51,249,4,5,5,14,Champions
1937,186,29,66,3,4,4,11,Loyal Users
2098,9,72,185,5,5,5,15,Champions
2152,2526,12,47,1,3,3,7,Casual Users
2450,262,71,208,3,5,5,13,Loyal Users
2927,279,57,170,3,5,5,13,Loyal Users
2960,52,7,14,5,2,1,8,Promising
3081,1043,18,41,2,3,3,8,Casual Users
3237,4,26,135,5,4,4,13,Champions
3525,3,6,22,5,1,2,8,Promising
3553,95,33,69,4,4,4,12,Champions
3684,2093,12,47,1,3,3,7,Casual Users
3738,113,27,166,4,4,5,13,Champions
3746,2040,8,11,1,2,1,4,Lost
3804,0,124,447,5,5,5,15,Champions
4050,220,17,30,3,3,2,8,Loyal Users
4205,357,6,31,3,1,2,6,Casual Users
4241,662,6,48,2,1,3,6,Lost
4835,866,10,21,2,2,2,6,Lost
5091,910,16,32,2,3,3,8,Casual Users
5202,135,15,157,4,3,5,12,Loyal Users
5310,284,11,21,3,2,2,7,Casual Users
5429,1340,6,26,1,1,2,4,Lost
5773,578,16,81,2,3,4,9,Casual Users
6259,413,5,17,3,1,2,6,Casual Users
6409,570,6,7,2,1,1,4,Lost
6417,340,15,42,3,3,3,9,Loyal Users
6586,210,18,40,3,3,3,9,Loyal Users
6648,102,30,129,4,4,4,12,Champions
6698,32,53,257,5,5,5,15,Champions
6753,131,6,34,4,1,3,8,Promising
6761,330,22,34,3,4,3,10,Loyal Users
6808,69,92,270,5,5,5,15,Champions
7282,2439,13,21,1,3,2,6,Casual Users
7314,35,26,90,5,4,4,13,Champions
7491,2603,5,13,1,1,1,3,Lost
7525,2121,5,25,1,1,2,4,Lost
7776,39,42,171,5,4,5,14,Champions
8236,265,36,153,3,4,5,12,Loyal Users
8341,882,9,13,2,2,1,5,Lost
8386,25,69,127,5,5,4,14,Champions
8499,1104,8,12,2,2,1,5,Lost
8669,377,118,498,3,5,5,13,Loyal Users
8856,3521,16,61,1,3,3,7,Casual Users
8922,1145,9,90,2,2,4,8,Lost
9134,998,84,326,2,5,5,12,At Risk
9535,857,30,78,2,4,4,10,At Risk
9555,1567,12,15,1,3,1,5,Casual Users
9705,1031,6,10,2,1,1,4,Lost
9747,659,6,8,2,1,1,4,Lost
9786,156,30,262,4,4,5,13,Champions
10097,126,65,100,4,5,4,13,Champions
10118,2688,6,8,1,1,1,3,Lost
10164,1931,12,81,1,3,4,8,Casual Users
10253,540,13,25,2,3,2,7,Casual Users
10622,1093,5,12,2,1,1,4,Lost
10699,1574,8,26,1,2,2,5,Lost
10704,162,47,119,4,5,4,13,Champions
10832,106,97,186,4,5,5,14,Champions
11161,1836,8,22,1,2,2,5,Lost
11290,379,6,12,3,1,1,5,Casual Users
11380,129,53,115,4,5,4,13,Champions
11501,10,32,105,5,4,4,13,Champions
11515,1979,9,29,1,2,2,5,Lost
11516,232,17,27,3,3,2,8,Loyal Users
11563,31,106,164,5,5,5,15,Champions
11833,97,7,16,4,2,2,8,Promising
12005,30,41,223,5,4,5,14,Champions
12426,125,8,88,4,2,4,10,Promising
12618,2957,8,13,1,2,1,4,Lost
12699,93,32,145,4,4,4,12,Champions
12753,68,44,171,5,4,5,14,Champions
12781,250,29,114,3,4,4,11,Loyal Users
12810,256,26,173,3,4,5,12,Loyal Users
13033,466,6,9,3,1,1,5,Casual Users
13072,348,5,8,3,1,1,5,Casual Users
13162,129,16,51,4,3,3,10,Loyal Users
13548,569,6,8,2,1,1,4,Lost
75,2124,5,63,1,1,4,6,Lost
382,1206,5,6,2,1,1,4,Lost
469,2,11,51,5,2,3,10,Promising
621,34,88,138,5,5,4,14,Champions
630,559,7,9,2,2,1,5,Lost
786,22,103,306,5,5,5,15,Champions
1027,95,39,88,4,4,4,12,Champions
1282,166,13,51,3,3,3,9,Loyal Users
1919,291,50,225,3,5,5,13,Loyal Users
2088,539,20,29,2,3,2,7,Casual Users
2195,569,15,25,2,3,2,7,Casual Users
2441,142,52,96,4,5,4,13,Champions
2491,4221,9,21,1,2,2,5,Lost
3268,1667,9,13,1,2,1,4,Lost
3311,1694,6,16,1,1,2,4,Lost
3896,2294,6,7,1,1,1,3,Lost
3953,4123,8,15,1,2,1,4,Lost
4827,30,59,199,5,5,5,15,Champions
4853,671,22,51,2,4,3,9,At Risk
5508,16,11,19,5,2,2,9,Promising
5783,628,14,122,2,3,4,9,Casual Users
5855,135,22,227,4,4,5,13,Champions
5894,47,130,706,5,5,5,15,Champions
6046,11,153,305,5,5,5,15,Champions
6270,2704,5,9,1,1,1,3,Lost
6783,5993,7,12,1,2,1,4,Lost
6817,2963,12,127,1,3,4,8,Casual Users
6909,3,82,216,5,5,5,15,Champions
7010,260,10,16,3,2,2,7,Casual Users
7848,1011,7,12,2,2,1,5,Lost
7851,1360,7,11,1,2,1,4,Lost
7878,237,20,48,3,3,3,9,Loyal Users
8227,428,47,98,3,5,4,12,Loyal Users
8307,546,10,41,2,2,3,7,Lost
8376,54,221,665,5,5,5,15,Champions
8741,130,9,22,4,2,2,8,Promising
8814,7,12,15,5,3,1,9,Loyal Users
9952,15,10,26,5,2,2,9,Promising
10178,2118,7,9,1,2,1,4,Lost
10284,441,30,238,3,4,5,12,Loyal Users
10592,7,178,401,5,5,5,15,Champions
10729,542,7,10,2,2,1,5,Lost
10805,130,9,16,4,2,2,8,Promising
11017,694,19,113,2,3,4,9,Casual Users
11046,2123,10,25,1,2,2,5,Lost
11890,526,5,34,2,1,3,6,Lost
11970,164,23,50,4,4,3,11,Loyal Users
12099,130,42,112,4,4,4,12,Champions
12792,104,59,160,4,5,5,14,Champions
13184,146,51,89,4,5,4,13,Champions
13270,115,11,17,4,2,2,8,Promising
13310,433,13,25,3,3,2,8,Loyal Users
13446,115,25,32,4,4,3,11,Loyal Users
13522,1018,23,71,2,4,4,10,At Risk
203,543,6,13,2,1,1,4,Lost
221,17,45,183,5,4,5,14,Champions
265,2262,10,24,1,2,2,5,Lost
457,104,28,104,4,4,4,12,Champions
640,93,20,81,4,3,4,11,Loyal Users
662,1235,7,9,2,2,1,5,Lost
782,151,145,209,4,5,5,14,Champions
835,1658,5,7,1,1,1,3,Lost
1237,347,18,48,3,3,3,9,Loyal Users
1515,2114,9,14,1,2,1,4,Lost
1668,2559,5,7,1,1,1,3,Lost
1895,3002,28,205,1,4,5,10,At Risk
1906,103,38,184,4,4,5,13,Champions
2317,832,60,439,2,5,5,12,At Risk
2421,1,12,65,5,3,4,12,Loyal Users
2460,24,14,43,5,3,3,11,Loyal Users
2508,832,19,57,2,3,3,8,Casual Users
2530,735,15,20,2,3,2,7,Casual Users
2634,39,53,59,5,5,3,13,Loyal Users
2806,101,49,62,4,5,3,12,Loyal Users
3082,512,50,90,2,5,4,11,At Risk
3396,569,8,73,2,2,4,8,Lost
3493,917,14,117,2,3,4,9,Casual Users
3540,437,6,14,3,1,1,5,Casual Users
3781,803,6,11,2,1,1,4,Lost
3788,2742,29,44,1,4,3,8,At Risk
4339,2578,7,28,1,2,2,5,Lost
5175,123,5,23,4,1,2,7,Promising
5184,248,32,105,3,4,4,11,Loyal Users
5279,290,37,168,3,4,5,12,Loyal Users
5395,78,29,47,4,4,3,11,Loyal Users
5483,1398,16,28,1,3,2,6,Casual Users
5502,864,32,63,2,4,4,10,At Risk
6101,13,114,708,5,5,5,15,Champions
6183,17,50,88,5,5,4,14,Champions
6356,42,114,295,5,5,5,15,Champions
6383,272,12,77,3,3,4,10,Loyal Users
6585,7,17,32,5,3,3,11,Loyal Users
6834,143,30,90,4,4,4,12,Champions
6968,405,20,109,3,3,4,10,Loyal Users
6983,105,26,41,4,4,3,11,Loyal Users
7453,46,67,265,5,5,5,15,Champions
7687,16,34,76,5,4,4,13,Champions
7864,44,76,512,5,5,5,15,Champions
8100,2375,9,11,1,2,1,4,Lost
8487,2685,5,6,1,1,1,3,Lost
8525,1973,13,23,1,3,2,6,Casual Users
8735,706,5,8,2,1,1,4,Lost
9246,3094,18,35,1,3,3,7,Casual Users
9542,31,14,34,5,3,3,11,Loyal Users
9802,699,39,99,2,4,4,10,At Risk
9881,1498,14,36,1,3,3,7,Casual Users
10030,2762,9,15,1,2,1,4,Lost
10314,4036,11,32,1,2,3,6,Lost
10504,688,12,34,2,3,3,8,Casual Users
10568,435,14,82,3,3,4,10,Loyal Users
10616,735,6,7,2,1,1,4,Lost
10844,103,37,80,4,4,4,12,Champions
11277,93,18,28,4,3,2,9,Loyal Users
11480,164,110,903,4,5,5,14,Champions
11505,412,6,7,3,1,1,5,Casual Users
11881,3283,7,17,1,2,2,5,Lost
11983,1973,8,16,1,2,2,5,Lost
12247,332,53,390,3,5,5,13,Loyal Users
12294,141,8,12,4,2,1,7,Promising
12899,1143,15,35,2,3,3,8,Casual Users
12977,147,17,73,4,3,4,11,Loyal Users
12990,2487,9,17,1,2,2,5,Lost
13013,10,88,226,5,5,5,15,Champions
13142,91,93,423,4,5,5,14,Champions
13164,5,92,185,5,5,5,15,Champions
13181,4266,13,96,1,3,4,8,Casual Users
13201,9,69,181,5,5,5,15,Champions
13437,465,27,74,3,4,4,11,Loyal Users
141,140,55,249,4,5,5,14,Champions
151,2641,18,25,1,3,2,6,Casual Users
341,447,6,15,3,1,1,5,Casual Users
414,129,17,27,4,3,2,9,Loyal Users
433,266,45,107,3,4,4,11,Loyal Users
608,690,14,15,2,3,1,6,Casual Users
712,723,7,9,2,2,1,5,Lost
724,52,46,158,5,5,5,15,Champions
859,840,16,82,2,3,4,9,Casual Users
899,137,39,69,4,4,4,12,Champions
1471,93,50,127,4,5,4,13,Champions
1532,382,14,44,3,3,3,9,Loyal Users
1579,132,6,16,4,1,2,7,Promising
1915,1258,14,14,1,3,1,5,Casual Users
2061,393,26,39,3,4,3,10,Loyal Users
2154,8,161,442,5,5,5,15,Champions
2160,208,75,363,3,5,5,13,Loyal Users
2432,147,18,39,4,3,3,10,Loyal Users
2594,840,15,81,2,3,4,9,Casual Users
3338,268,9,20,3,2,2,7,Casual Users
3992,614,15,36,2,3,3,8,Casual Users
4170,1209,10,27,2,2,2,6,Lost
4306,1469,12,26,1,3,2,6,Casual Users
4410,1000,5,12,2,1,1,4,Lost
4516,35,7,23,5,2,2,9,Promising
4558,2328,8,11,1,2,1,4,Lost
4746,257,17,113,3,3,4,10,Loyal Users
5046,498,11,32,2,2,3,7,Lost
5068,3,56,114,5,5,4,14,Champions
5464,419,7,18,3,2,2,7,Casual Users
6048,119,19,44,4,3,3,10,Loyal Users
6274,174,35,77,3,4,4,11,Loyal Users
6511,883,13,16,2,3,2,7,Casual Users
6791,882,7,12,2,2,1,5,Lost
6903,1282,30,61,1,4,3,8,At Risk
7003,3398,6,20,1,1,2,4,Lost
7079,122,55,249,4,5,5,14,Champions
7542,1,103,204,5,5,5,15,Champions
8291,987,14,28,2,3,2,7,Casual Users
8314,495,7,34,2,2,3,7,Lost
8349,600,7,44,2,2,3,7,Lost
8463,23,53,183,5,5,5,15,Champions
8541,120,29,79,4,4,4,12,Champions
8837,2520,11,21,1,2,2,5,Lost
8988,141,87,748,4,5,5,14,Champions
9339,394,40,67,3,4,4,11,Loyal Users
9557,157,19,35,4,3,3,10,Loyal Users
10041,1392,5,10,1,1,1,3,Lost
10239,1428,14,37,1,3,3,7,Casual Users
10332,1855,39,137,1,4,4,9,At Risk
10577,111,67,196,4,5,5,14,Champions
10608,62,77,558,5,5,5,15,Champions
10692,25,37,94,5,4,4,13,Champions
11055,69,32,181,5,4,5,14,Champions
11220,126,13,30,4,3,2,9,Loyal Users
11726,1136,6,6,2,1,1,4,Lost
11870,12,22,39,5,4,3,12,Loyal Users
12642,262,15,50,3,3,3,9,Loyal Users
12681,3972,8,8,1,2,1,4,Lost
12718,5,55,127,5,5,4,14,Champions
13156,193,17,21,3,3,2,8,Loyal Users
13266,40,111,722,5,5,5,15,Champions
13294,113,13,26,4,3,2,9,Loyal Users
13385,2246,5,6,1,1,1,3,Lost
13503,1265,12,49,1,3,3,7,Casual Users
13532,301,25,71,3,4,4,11,Loyal Users
13550,5,154,368,5,5,5,15,Champions
334,445,44,64,3,4,4,11,Loyal Users
592,871,18,56,2,3,3,8,Casual Users
751,146,14,18,4,3,2,9,Loyal Users
801,144,11,14,4,2,1,7,Promising
943,284,76,154,3,5,5,13,Loyal Users
953,275,32,83,3,4,4,11,Loyal Users
978,2501,13,16,1,3,2,6,Casual Users
1023,130,115,295,4,5,5,14,Champions
1043,77,56,74,4,5,4,13,Champions
1440,1,57,237,5,5,5,15,Champions
1547,942,8,10,2,2,1,5,Lost
1577,1386,5,6,1,1,1,3,Lost
1909,117,26,80,4,4,4,12,Champions
2592,2704,12,15,1,3,1,5,Casual Users
2670,1329,5,9,1,1,1,3,Lost
3143,570,6,6,2,1,1,4,Lost
3494,118,14,87,4,3,4,11,Loyal Users
3532,5253,9,19,1,2,2,5,Lost
3565,307,103,358,3,5,5,13,Loyal Users
3915,2120,9,11,1,2,1,4,Lost
4077,25,48,212,5,5,5,15,Champions
4081,434,11,109,3,2,4,9,Casual Users
4189,90,94,376,4,5,5,14,Champions
4675,10,10,58,5,2,3,10,Promising
4834,44,58,206,5,5,5,15,Champions
4868,909,15,41,2,3,3,8,Casual Users
5005,111,51,440,4,5,5,14,Champions
5116,92,5,7,4,1,1,6,Promising
5438,1848,7,14,1,2,1,4,Lost
5534,293,12,21,3,3,2,8,Loyal Users
5583,726,58,186,2,5,5,12,At Risk
5650,1811,7,16,1,2,2,5,Lost
5747,11,30,42,5,4,3,12,Loyal Users
6021,85,6,9,4,1,1,6,Promising
6079,2529,6,9,1,1,1,3,Lost
6296,6,44,75,5,4,4,13,Champions
6341,456,21,39,3,3,3,9,Loyal Users
6736,35,9,25,5,2,2,9,Promising
6894,58,11,20,5,2,2,9,Promising
7337,0,27,138,5,4,4,13,Champions
8084,142,15,18,4,3,2,9,Loyal Users
8157,1134,7,8,2,2,1,5,Lost
8171,85,38,117,4,4,4,12,Champions
8553,64,91,422,5,5,5,15,Champions
8600,306,31,76,3,4,4,11,Loyal Users
8609,92,79,243,4,5,5,14,Champions
8978,375,11,11,3,2,1,6,Casual Users
9552,5,5,5,5,1,1,7,Promising
9679,282,21,210,3,3,5,11,Loyal Users
9928,495,47,335,2,5,5,12,At Risk
9960,110,20,112,4,3,4,11,Loyal Users
10646,64,72,108,5,5,4,14,Champions
10777,149,49,476,4,5,5,14,Champions
11236,339,46,342,3,5,5,13,Loyal Users
11293,205,58,188,3,5,5,13,Loyal Users
11464,11,154,433,5,5,5,15,Champions
11538,951,7,10,2,2,1,5,Lost
11958,5538,10,15,1,2,1,4,Lost
12272,416,26,115,3,4,4,11,Loyal Users
12455,11,39,134,5,4,4,13,Champions
12634,249,20,38,3,3,3,9,Loyal Users
13055,4820,6,9,1,1,1,3,Lost
13167,2060,5,5,1,1,1,3,Lost
13211,134,13,22,4,3,2,9,Loyal Users
13212,120,36,89,4,4,4,12,Champions
13567,552,7,7,2,2,1,5,Lost
145,288,32,99,3,4,4,11,Loyal Users
200,162,26,48,4,4,3,11,Loyal Users
272,1023,18,37,2,3,3,8,Casual Users
376,141,19,31,4,3,2,9,Loyal Users
488,2604,5,15,1,1,1,3,Lost
515,4,15,87,5,3,4,12,Loyal Users
680,1790,7,12,1,2,1,4,Lost
735,36,122,163,5,5,5,15,Champions
1383,62,44,197,5,4,5,14,Champions
1511,444,6,24,3,1,2,6,Casual Users
1622,1245,50,151,2,5,5,12,At Risk
1707,31,77,238,5,5,5,15,Champions
2043,271,5,36,3,1,3,7,Casual Users
2372,276,18,81,3,3,4,10,Loyal Users
2503,2258,9,10,1,2,1,4,Lost
2550,920,9,37,2,2,3,7,Lost
2562,80,23,34,4,4,3,11,Loyal Users
2660,230,19,37,3,3,3,9,Loyal Users
2710,544,21,132,2,3,4,9,Casual Users
2747,367,16,87,3,3,4,10,Loyal Users
2978,304,23,43,3,4,3,10,Loyal Users
3041,44,94,182,5,5,5,15,Champions
3487,9,43,85,5,4,4,13,Champions
3594,3571,7,42,1,2,3,6,Lost
3614,68,7,13,5,2,1,8,Promising
3722,2811,6,6,1,1,1,3,Lost
4287,3964,6,11,1,1,1,3,Lost
4309,8,113,374,5,5,5,15,Champions
4358,132,12,67,4,3,4,11,Loyal Users
4458,417,17,56,3,3,3,9,Loyal Users
4963,625,5,24,2,1,2,5,Lost
4975,262,55,333,3,5,5,13,Loyal Users
4990,415,8,23,3,2,2,7,Casual Users
5017,2,6,9,5,1,1,7,Promising
5248,342,13,87,3,3,4,10,Loyal Users
5484,138,51,119,4,5,4,13,Champions
5623,1291,6,27,1,1,2,4,Lost
5739,4389,7,9,1,2,1,4,Lost
5910,2950,16,70,1,3,4,8,Casual Users
5928,1283,7,14,1,2,1,4,Lost
6682,250,30,117,3,4,4,11,Loyal Users
6844,166,28,68,3,4,4,11,Loyal Users
7126,94,6,10,4,1,1,6,Promising
7207,145,38,268,4,4,5,13,Champions
7413,363,11,45,3,2,3,8,Casual Users
7544,258,20,89,3,3,4,10,Loyal Users
7593,125,17,45,4,3,3,10,Loyal Users
7828,286,15,125,3,3,4,10,Loyal Users
8021,257,9,20,3,2,2,7,Casual Users
8162,1695,26,67,1,4,4,9,At Risk
8215,65,59,174,5,5,5,15,Champions
8305,79,16,25,4,3,2,9,Loyal Users
8631,353,6,48,3,1,3,7,Casual Users
8670,2203,5,12,1,1,1,3,Lost
8684,166,10,16,3,2,2,7,Casual Users
8685,119,5,7,4,1,1,6,Promising
9170,3,6,12,5,1,1,7,Promising
9362,90,11,21,4,2,2,8,Promising
9487,1989,6,37,1,1,3,5,Lost
9497,2954,13,60,1,3,3,7,Casual Users
9572,2678,7,22,1,2,2,5,Lost
9581,1376,5,13,1,1,1,3,Lost
9617,419,48,227,3,5,5,13,Loyal Users
9633,419,7,11,3,2,1,6,Casual Users
9761,259,14,16,3,3,2,8,Loyal Users
10126,62,12,50,5,3,3,11,Loyal Users
10519,1382,16,35,1,3,3,7,Casual Users
10593,3933,7,40,1,2,3,6,Lost
10790,79,67,246,4,5,5,14,Champions
11313,681,10,26,2,2,2,6,Lost
11337,889,13,32,2,3,3,8,Casual Users
11439,14,16,48,5,3,3,11,Loyal Users
11565,782,14,42,2,3,3,8,Casual Users
11751,598,22,81,2,4,4,10,At Risk
12096,107,6,20,4,1,2,7,Promising
12263,275,137,382,3,5,5,13,Loyal Users
12403,32,61,127,5,5,4,14,Champions
12499,1576,6,8,1,1,1,3,Lost
13227,401,22,24,3,4,2,9,Loyal Users
13332,992,13,31,2,3,2,7,Casual Users
13383,126,61,134,4,5,4,13,Champions
56,3980,6,7,1,1,1,3,Lost
109,172,10,15,3,2,1,6,Casual Users
254,4245,6,6,1,1,1,3,Lost
378,30,38,178,5,4,5,14,Champions
487,406,15,87,3,3,4,10,Loyal Users
639,849,23,36,2,4,3,9,At Risk
940,5,24,25,5,4,2,11,Loyal Users
1040,1907,7,18,1,2,2,5,Lost
1617,3594,20,102,1,3,4,8,Casual Users
1726,116,11,29,4,2,2,8,Promising
1883,78,16,41,4,3,3,10,Loyal Users
1980,122,11,28,4,2,2,8,Promising
2093,3793,6,16,1,1,2,4,Lost
2283,96,7,8,4,2,1,7,Promising
2510,0,39,55,5,4,3,12,Loyal Users
2604,2704,5,7,1,1,1,3,Lost
2795,104,5,19,4,1,2,7,Promising
3247,634,5,10,2,1,1,4,Lost
4003,702,11,25,2,2,2,6,Lost
4139,172,26,77,3,4,4,11,Loyal Users
4411,258,45,124,3,4,4,11,Loyal Users
4527,271,43,72,3,4,4,11,Loyal Users
4540,97,74,109,4,5,4,13,Champions
4584,1602,5,8,1,1,1,3,Lost
4750,410,9,21,3,2,2,7,Casual Users
4922,111,18,23,4,3,2,9,Loyal Users
5051,1439,13,93,1,3,4,8,Casual Users
5406,1362,13,17,1,3,2,6,Casual Users
5550,33,23,181,5,4,5,14,Champions
5889,406,52,100,3,5,4,12,Loyal Users
6228,823,8,18,2,2,2,6,Lost
6253,125,21,43,4,3,3,10,Loyal Users
6441,413,24,137,3,4,4,11,Loyal Users
6651,195,10,30,3,2,2,7,Casual Users
6684,21,7,12,5,2,1,8,Promising
7663,857,17,47,2,3,3,8,Casual Users
7702,117,34,113,4,4,4,12,Champions
7717,103,15,17,4,3,2,9,Loyal Users
8630,2094,5,34,1,1,3,5,Lost
8929,515,15,140,2,3,4,9,Casual Users
9260,119,15,38,4,3,3,10,Loyal Users
9672,547,29,146,2,4,4,10,At Risk
9905,406,92,403,3,5,5,13,Loyal Users
9918,74,44,131,4,4,4,12,Champions
10055,331,6,34,3,1,3,7,Casual Users
10226,15,52,159,5,5,5,15,Champions
10971,65,48,182,5,5,5,15,Champions
11009,471,45,80,2,4,4,10,At Risk
11270,2675,5,9,1,1,1,3,Lost
11285,525,15,60,2,3,3,8,Casual Users
11323,91,35,73,4,4,4,12,Champions
11454,93,146,312,4,5,5,14,Champions
11533,103,36,122,4,4,4,12,Champions
12668,23,61,122,5,5,4,14,Champions
12794,140,58,181,4,5,5,14,Champions
12939,431,36,66,3,4,4,11,Loyal Users
13068,19,62,105,5,5,4,14,Champions
13143,148,38,103,4,4,4,12,Champions
13165,232,35,111,3,4,4,11,Loyal Users
13323,256,5,16,3,1,2,6,Casual Users
13352,439,8,16,3,2,2,7,Casual Users
13410,778,6,17,2,1,2,5,Lost
13448,11,41,130,5,4,4,13,Champions
213,565,104,170,2,5,5,12,At Risk
228,324,38,80,3,4,4,11,Loyal Users
478,1137,23,47,2,4,3,9,At Risk
534,1819,11,15,1,2,1,4,Lost
655,5,53,203,5,5,5,15,Champions
997,424,35,62,3,4,3,10,Loyal Users
1149,125,6,7,4,1,1,6,Promising
1446,3297,5,5,1,1,1,3,Lost
1585,163,44,67,4,4,4,12,Champions
1623,30,24,43,5,4,3,12,Loyal Users
1686,857,19,26,2,3,2,7,Casual Users
1854,16,143,512,5,5,5,15,Champions
2233,1004,17,40,2,3,3,8,Casual Users
2253,30,46,233,5,5,5,15,Champions
2427,93,73,243,4,5,5,14,Champions
2506,1385,7,26,1,2,2,5,Lost
2765,582,11,16,2,2,2,6,Lost
3019,38,80,517,5,5,5,15,Champions
3603,19,23,49,5,4,3,12,Loyal Users
3879,443,14,77,3,3,4,10,Loyal Users
3957,5278,9,17,1,2,2,5,Lost
4298,24,44,63,5,4,4,13,Champions
4492,9,159,658,5,5,5,15,Champions
4551,190,37,136,3,4,4,11,Loyal Users
5104,447,5,7,3,1,1,5,Casual Users
5528,424,44,171,3,4,5,12,Loyal Users
5604,5,29,55,5,4,3,12,Loyal Users
5671,3014,12,37,1,3,3,7,Casual Users
5842,988,10,14,2,2,1,5,Lost
5952,141,23,39,4,4,3,11,Loyal Users
6062,728,23,85,2,4,4,10,At Risk
6121,438,56,98,3,5,4,12,Loyal Users
6321,15,50,235,5,5,5,15,Champions
6349,0,125,367,5,5,5,15,Champions
6838,851,5,9,2,1,1,4,Lost
7071,171,39,142,3,4,4,11,Loyal Users
7089,265,45,89,3,4,4,11,Loyal Users
7619,297,11,58,3,2,3,8,Casual Users
7697,847,34,59,2,4,3,9,At Risk
8240,142,22,34,4,4,3,11,Loyal Users
8277,150,50,185,4,5,5,14,Champions
8816,220,5,9,3,1,1,5,Casual Users
8841,212,28,223,3,4,5,12,Loyal Users
9042,499,21,23,2,3,2,7,Casual Users
9093,110,56,219,4,5,5,14,Champions
9412,2973,5,7,1,1,1,3,Lost
9720,2,17,34,5,3,3,11,Loyal Users
9965,1709,9,21,1,2,2,5,Lost
10188,23,8,14,5,2,1,8,Promising
10231,3223,7,8,1,2,1,4,Lost
10370,45,24,189,5,4,5,14,Champions
10466,153,32,170,4,4,5,13,Champions
10508,149,30,44,4,4,3,11,Loyal Users
10865,412,66,225,3,5,5,13,Loyal Users
11003,226,32,100,3,4,4,11,Loyal Users
11071,411,95,218,3,5,5,13,Loyal Users
11102,187,52,221,3,5,5,13,Loyal Users
11244,187,37,163,3,4,5,12,Loyal Users
11245,241,57,89,3,5,4,12,Loyal Users
11413,956,7,12,2,2,1,5,Lost
11521,1082,6,23,2,1,2,5,Lost
11595,145,43,70,4,4,4,12,Champions
11814,683,13,15,2,3,1,6,Casual Users
11834,4281,5,26,1,1,2,4,Lost
11859,706,70,155,2,5,5,12,At Risk
12128,5851,13,35,1,3,3,7,Casual Users
12129,5513,5,66,1,1,4,6,Lost
12157,232,41,87,3,4,4,11,Loyal Users
12209,2006,5,6,1,1,1,3,Lost
12389,115,58,71,4,5,4,13,Champions
12458,901,19,74,2,3,4,9,Casual Users
12657,50,38,108,5,4,4,13,Champions
13490,324,122,301,3,5,5,13,Loyal Users
303,691,15,54,2,3,3,8,Casual Users
426,342,53,174,3,5,5,13,Loyal Users
574,835,11,35,2,2,3,7,Lost
718,43,74,151,5,5,5,15,Champions
749,52,8,29,5,2,2,9,Promising
1105,2136,6,51,1,1,3,5,Lost
1120,49,139,280,5,5,5,15,Champions
1281,822,9,42,2,2,3,7,Lost
1408,542,10,23,2,2,2,6,Lost
1474,63,116,158,5,5,5,15,Champions
1554,1365,25,61,1,4,3,8,At Risk
1842,531,6,15,2,1,1,4,Lost
2390,43,24,38,5,4,3,12,Loyal Users
2816,4,15,34,5,3,3,11,Loyal Users
3230,4846,22,43,1,4,3,8,At Risk
3432,108,39,75,4,4,4,12,Champions
3559,113,25,41,4,4,3,11,Loyal Users
3748,4077,5,11,1,1,1,3,Lost
3995,903,28,29,2,4,2,8,At Risk
4049,90,83,187,4,5,5,14,Champions
4284,1869,6,16,1,1,2,4,Lost
4802,103,38,188,4,4,5,13,Champions
4942,74,18,46,4,3,3,10,Loyal Users
4954,4886,8,14,1,2,1,4,Lost
5012,165,17,97,4,3,4,11,Loyal Users
5587,350,14,22,3,3,2,8,Loyal Users
5881,302,11,133,3,2,4,9,Casual Users
6226,149,32,261,4,4,5,13,Champions
6497,140,43,88,4,4,4,12,Champions
6566,131,21,24,4,3,2,9,Loyal Users
6872,1009,7,10,2,2,1,5,Lost
6920,146,38,174,4,4,5,13,Champions
7149,3125,7,33,1,2,3,6,Lost
7273,270,19,45,3,3,3,9,Loyal Users
7357,726,8,13,2,2,1,5,Lost
7622,834,13,34,2,3,3,8,Casual Users
7659,26,8,29,5,2,2,9,Promising
7677,298,9,14,3,2,1,6,Casual Users
7992,3831,9,11,1,2,1,4,Lost
8136,517,9,12,2,2,1,5,Lost
8192,680,62,149,2,5,5,12,At Risk
8245,112,6,11,4,1,1,6,Promising
8285,4001,11,34,1,2,3,6,Lost
8357,88,35,117,4,4,4,12,Champions
8472,981,6,13,2,1,1,4,Lost
8711,2,147,247,5,5,5,15,Champions
9159,112,103,354,4,5,5,14,Champions
9245,268,37,104,3,4,4,11,Loyal Users
9284,143,54,311,4,5,5,14,Champions
9584,581,6,11,2,1,1,4,Lost
9591,1275,30,61,1,4,3,8,At Risk
10050,144,8,50,4,2,3,9,Promising
10198,116,7,44,4,2,3,9,Promising
10221,798,11,68,2,2,4,8,Lost
10245,673,27,47,2,4,3,9,At Risk
10322,152,87,198,4,5,5,14,Champions
10621,5,89,175,5,5,5,15,Champions
10756,1149,11,14,2,2,1,5,Lost
11042,715,5,7,2,1,1,4,Lost
11525,431,9,9,3,2,1,6,Casual Users
11913,1979,12,66,1,3,4,8,Casual Users
12427,1234,20,28,2,3,2,7,Casual Users
12501,405,30,134,3,4,4,11,Loyal Users
12623,84,19,89,4,3,4,11,Loyal Users
12721,294,9,10,3,2,1,6,Casual Users
13209,36,53,252,5,5,5,15,Champions
13263,26,22,76,5,4,4,13,Champions
13309,3727,5,17,1,1,2,4,Lost
13421,2416,7,35,1,2,3,6,Lost
13534,34,12,26,5,3,2,10,Loyal Users
170,301,33,68,3,4,4,11,Loyal Users
354,1849,5,7,1,1,1,3,Lost
702,24,11,18,5,2,2,9,Promising
708,297,5,9,3,1,1,5,Casual Users
807,709,5,6,2,1,1,4,Lost
1162,0,54,187,5,5,5,15,Champions
1196,256,17,29,3,3,2,8,Loyal Users
1268,1008,9,17,2,2,2,6,Lost
1544,1235,6,10,2,1,1,4,Lost
1953,392,18,32,3,3,3,9,Loyal Users
2367,278,95,203,3,5,5,13,Loyal Users
2373,1541,15,59,1,3,3,7,Casual Users
2893,379,90,534,3,5,5,13,Loyal Users
3335,4564,5,6,1,1,1,3,Lost
3812,527,21,123,2,3,4,9,Casual Users
3977,641,19,46,2,3,3,8,Casual Users
4147,1,71,534,5,5,5,15,Champions
4300,19,36,52,5,4,3,12,Loyal Users
4548,1140,23,38,2,4,3,9,At Risk
4616,4365,31,79,1,4,4,9,At Risk
4634,386,35,60,3,4,3,10,Loyal Users
4657,79,190,386,4,5,5,14,Champions
4755,2141,7,19,1,2,2,5,Lost
4971,685,22,63,2,4,4,10,At Risk
5135,117,198,404,4,5,5,14,Champions
5229,2693,6,77,1,1,4,6,Lost
5263,31,21,33,5,3,3,11,Loyal Users
5687,102,63,96,4,5,4,13,Champions
5729,967,11,26,2,2,2,6,Lost
5821,23,66,81,5,5,4,14,Champions
5963,1166,5,5,2,1,1,4,Lost
6609,246,9,59,3,2,3,8,Casual Users
6708,32,112,199,5,5,5,15,Champions
6723,167,7,34,3,2,3,8,Casual Users
6928,961,10,12,2,2,1,5,Lost
7077,2,53,293,5,5,5,15,Champions
7373,4997,5,10,1,1,1,3,Lost
7495,11,63,231,5,5,5,15,Champions
7521,35,21,26,5,3,2,10,Loyal Users
8301,1394,5,10,1,1,1,3,Lost
8346,105,112,298,4,5,5,14,Champions
9022,3098,6,26,1,1,2,4,Lost
9956,101,9,30,4,2,2,8,Promising
10555,85,49,145,4,5,4,13,Champions
10564,6,77,176,5,5,5,15,Champions
10931,30,12,38,5,3,3,11,Loyal Users
11087,882,14,16,2,3,2,7,Casual Users
11173,1913,8,45,1,2,3,6,Lost
11294,6,21,51,5,3,3,11,Loyal Users
11429,1741,5,16,1,1,2,4,Lost
11619,101,41,342,4,4,5,13,Champions
11977,473,11,12,2,2,1,5,Lost
12254,954,8,26,2,2,2,6,Lost
12483,705,7,11,2,2,1,5,Lost
12636,6,53,226,5,5,5,15,Champions
12930,4960,5,10,1,1,1,3,Lost
13002,2972,47,112,1,5,4,10,At Risk
13402,419,29,64,3,4,4,11,Loyal Users
13578,349,8,20,3,2,2,7,Casual Users
304,118,94,376,4,5,5,14,Champions
536,346,29,73,3,4,4,11,Loyal Users
611,233,16,45,3,3,3,9,Loyal Users
612,2466,7,11,1,2,1,4,Lost
668,1843,5,9,1,1,1,3,Lost
783,128,8,25,4,2,2,8,Promising
1758,3445,8,24,1,2,2,5,Lost
1813,444,12,97,3,3,4,10,Loyal Users
1830,255,153,399,3,5,5,13,Loyal Users
2146,11,75,235,5,5,5,15,Champions
2527,4873,7,20,1,2,2,5,Lost
2908,1697,8,17,1,2,2,5,Lost
2936,479,7,34,2,2,3,7,Lost
2977,887,19,30,2,3,2,7,Casual Users
2990,214,17,55,3,3,3,9,Loyal Users
3342,304,39,64,3,4,4,11,Loyal Users
3424,709,9,18,2,2,2,6,Lost
3544,1997,5,19,1,1,2,4,Lost
3892,23,89,456,5,5,5,15,Champions
4283,447,16,27,3,3,2,8,Loyal Users
4449,1813,8,12,1,2,1,4,Lost
4462,136,6,19,4,1,2,7,Promising
4785,823,8,12,2,2,1,5,Lost
4789,1846,13,70,1,3,4,8,Casual Users
4801,111,44,237,4,4,5,13,Champions
4861,3,71,156,5,5,5,15,Champions
5226,982,7,18,2,2,2,6,Lost
5358,42,82,397,5,5,5,15,Champions
5399,77,133,904,4,5,5,14,Champions
5951,111,46,327,4,5,5,14,Champions
6041,267,32,65,3,4,4,11,Loyal Users
6044,300,41,58,3,4,3,10,Loyal Users
6298,414,71,81,3,5,4,12,Loyal Users
7185,274,9,25,3,2,2,7,Casual Users
7403,1256,25,70,2,4,4,10,At Risk
7421,4472,12,19,1,3,2,6,Casual Users
7695,26,55,94,5,5,4,14,Champions
7939,2047,5,8,1,1,1,3,Lost
7942,442,20,30,3,3,2,8,Loyal Users
7996,2297,7,11,1,2,1,4,Lost
8332,425,12,25,3,3,2,8,Loyal Users
8493,769,29,124,2,4,4,10,At Risk
8659,195,7,7,3,2,1,6,Casual Users
8772,2433,10,22,1,2,2,5,Lost
8953,286,63,118,3,5,4,12,Loyal Users
9000,153,16,124,4,3,4,11,Loyal Users
9148,3279,5,13,1,1,1,3,Lost
10148,856,12,51,2,3,3,8,Casual Users
10299,119,14,28,4,3,2,9,Loyal Users
10413,117,30,108,4,4,4,12,Champions
10428,179,14,43,3,3,3,9,Loyal Users
10575,248,18,116,3,3,4,10,Loyal Users
10891,91,98,184,4,5,5,14,Champions
11044,113,8,31,4,2,2,8,Promising
11086,1315,5,10,1,1,1,3,Lost
11339,270,5,5,3,1,1,5,Casual Users
11457,31,62,141,5,5,4,14,Champions
11575,102,66,158,4,5,5,14,Champions
11727,3813,6,23,1,1,2,4,Lost
11896,59,28,83,5,4,4,13,Champions
12043,523,33,245,2,4,5,11,At Risk
12405,74,25,60,4,4,3,11,Loyal Users
12685,39,15,19,5,3,2,10,Loyal Users
12851,167,65,137,3,5,4,12,Loyal Users
13006,7,129,516,5,5,5,15,Champions
13176,3006,7,19,1,2,2,5,Lost
13205,592,20,73,2,3,4,9,Casual Users
13376,1818,7,61,1,2,3,6,Lost
13411,0,259,665,5,5,5,15,Champions
13434,4763,11,21,1,2,2,5,Lost
13506,10,35,298,5,4,5,14,Champions
105,1540,8,16,1,2,2,5,Lost
298,4045,5,15,1,1,1,3,Lost
370,1536,10,20,1,2,2,5,Lost
753,11,37,85,5,4,4,13,Champions
865,41,16,38,5,3,3,11,Loyal Users
913,715,6,65,2,1,4,7,Lost
1553,435,15,26,3,3,2,8,Loyal Users
1744,3390,15,100,1,3,4,8,Casual Users
2103,426,31,55,3,4,3,10,Loyal Users
2151,951,28,185,2,4,5,11,At Risk
2280,296,101,372,3,5,5,13,Loyal Users
2430,726,11,58,2,2,3,7,Lost
2518,171,25,92,3,4,4,11,Loyal Users
2693,80,92,287,4,5,5,14,Champions
2707,18,53,260,5,5,5,15,Champions
3203,0,33,72,5,4,4,13,Champions
3472,90,25,42,4,4,3,11,Loyal Users
4257,233,25,39,3,4,3,10,Loyal Users
4269,92,9,47,4,2,3,9,Promising
4350,37,112,222,5,5,5,15,Champions
4407,110,27,109,4,4,4,12,Champions
5430,1043,22,83,2,4,4,10,At Risk
5570,14,30,91,5,4,4,13,Champions
5698,116,59,197,4,5,5,14,Champions
5804,416,11,34,3,2,3,8,Casual Users
6008,718,42,131,2,4,4,10,At Risk
6070,186,7,7,3,2,1,6,Casual Users
6439,113,18,34,4,3,3,10,Loyal Users
6455,4,6,12,5,1,1,7,Promising
6468,476,46,93,2,5,4,11,At Risk
7094,112,12,17,4,3,2,9,Loyal Users
7300,36,53,261,5,5,5,15,Champions
7339,1983,8,21,1,2,2,5,Lost
7407,421,5,5,3,1,1,5,Casual Users
7412,136,14,19,4,3,2,9,Loyal Users
7529,263,12,34,3,3,3,9,Loyal Users
7588,243,8,13,3,2,1,6,Casual Users
7783,258,18,103,3,3,4,10,Loyal Users
7997,2104,6,12,1,1,1,3,Lost
8164,4005,6,6,1,1,1,3,Lost
8286,550,19,48,2,3,3,8,Casual Users
8404,391,43,65,3,4,4,11,Loyal Users
8724,1839,18,54,1,3,3,7,Casual Users
9177,1417,10,12,1,2,1,4,Lost
9658,44,102,462,5,5,5,15,Champions
9662,491,13,14,2,3,1,6,Casual Users
9681,385,13,29,3,3,2,8,Loyal Users
10157,115,65,214,4,5,5,14,Champions
10203,810,16,22,2,3,2,7,Casual Users
10229,10,49,132,5,5,4,14,Champions
10588,121,13,21,4,3,2,9,Loyal Users
10591,50,83,283,5,5,5,15,Champions
10705,11,109,633,5,5,5,15,Champions
10951,611,5,5,2,1,1,4,Lost
11147,3,27,90,5,4,4,13,Champions
11186,109,141,662,4,5,5,14,Champions
11542,87,12,21,4,3,2,9,Loyal Users
11556,184,8,134,3,2,4,9,Casual Users
11570,107,27,168,4,4,5,13,Champions
11696,381,102,440,3,5,5,13,Loyal Users
11739,549,14,24,2,3,2,7,Casual Users
11842,128,27,43,4,4,3,11,Loyal Users
11989,125,13,47,4,3,3,10,Loyal Users
12001,7,5,9,5,1,1,7,Promising
12094,263,5,7,3,1,1,5,Casual Users
12204,683,5,5,2,1,1,4,Lost
12211,31,64,239,5,5,5,15,Champions
12514,286,20,25,3,3,2,8,Loyal Users
12643,410,39,130,3,4,4,11,Loyal Users
12883,131,28,60,4,4,3,11,Loyal Users
12900,2147,7,18,1,2,2,5,Lost
13325,168,19,137,3,3,4,10,Loyal Users
13359,2710,5,24,1,1,2,4,Lost
58,2189,5,12,1,1,1,3,Lost
188,2570,12,16,1,3,2,6,Casual Users
726,753,27,107,2,4,4,10,At Risk
837,547,5,36,2,1,3,6,Lost
1370,702,6,11,2,1,1,4,Lost
1573,4092,10,26,1,2,2,5,Lost
1880,15,46,159,5,5,5,15,Champions
2126,2011,6,6,1,1,1,3,Lost
2293,9,8,58,5,2,3,10,Promising
2332,37,97,257,5,5,5,15,Champions
2347,1,25,56,5,4,3,12,Loyal Users
2400,995,7,9,2,2,1,5,Lost
2632,2704,17,40,1,3,3,7,Casual Users
2916,2978,5,7,1,1,1,3,Lost
3145,289,6,11,3,1,1,5,Casual Users
3362,4532,5,10,1,1,1,3,Lost
3672,7,32,70,5,4,4,13,Champions
3736,273,36,84,3,4,4,11,Loyal Users
3747,4249,19,71,1,3,4,8,Casual Users
3780,2319,5,7,1,1,1,3,Lost
3849,1629,18,32,1,3,3,7,Casual Users
4316,2721,10,29,1,2,2,5,Lost
4328,1443,7,15,1,2,1,4,Lost
4360,424,12,64,3,3,4,10,Loyal Users
4362,2280,16,64,1,3,4,8,Casual Users
4378,142,7,19,4,2,2,8,Promising
4541,1737,5,7,1,1,1,3,Lost
4611,244,5,7,3,1,1,5,Casual Users
5236,11,57,306,5,5,5,15,Champions
5349,424,21,61,3,3,3,9,Loyal Users
5525,96,51,112,4,5,4,13,Champions
5666,29,79,218,5,5,5,15,Champions
5719,3,10,107,5,2,4,11,Promising
5805,1263,6,28,1,1,2,4,Lost
5980,426,22,36,3,4,3,10,Loyal Users
6038,929,7,7,2,2,1,5,Lost
6073,916,21,33,2,3,3,8,Casual Users
6451,50,15,20,5,3,2,10,Loyal Users
6453,2147,5,23,1,1,2,4,Lost
6662,389,14,23,3,3,2,8,Loyal Users
6733,487,28,204,2,4,5,11,At Risk
6742,2484,11,11,1,2,1,4,Lost
6743,1112,5,7,2,1,1,4,Lost
6814,141,7,15,4,2,1,7,Promising
6881,482,8,25,2,2,2,6,Lost
6986,1025,9,37,2,2,3,7,Lost
7277,36,28,53,5,4,3,12,Loyal Users
7654,27,76,311,5,5,5,15,Champions
7712,150,14,83,4,3,4,11,Loyal Users
8364,159,9,15,4,2,1,7,Promising
8515,152,42,68,4,4,4,12,Champions
8623,91,41,82,4,4,4,12,Champions
8933,273,17,40,3,3,3,9,Loyal Users
8983,187,25,265,3,4,5,12,Loyal Users
9011,651,32,214,2,4,5,11,At Risk
9030,3038,6,9,1,1,1,3,Lost
9593,981,17,85,2,3,4,9,Casual Users
9785,65,42,63,5,4,4,13,Champions
10357,118,11,62,4,2,3,9,Promising
10389,267,18,29,3,3,2,8,Loyal Users
10630,347,9,21,3,2,2,7,Casual Users
11348,1643,42,152,1,4,5,10,At Risk
11540,1145,14,22,2,3,2,7,Casual Users
11684,137,57,79,4,5,4,13,Champions
11730,2341,56,119,1,5,4,10,At Risk
11846,929,9,44,2,2,3,7,Lost
11886,1399,7,11,1,2,1,4,Lost
12342,106,26,38,4,4,3,11,Loyal Users
12588,251,30,64,3,4,4,11,Loyal Users
12594,1,21,118,5,3,4,12,Loyal Users
12683,289,40,77,3,4,4,11,Loyal Users
12752,269,5,6,3,1,1,5,Casual Users
13150,288,9,10,3,2,1,6,Casual Users
13278,1909,6,9,1,1,1,3,Lost
13495,1704,18,55,1,3,3,7,Casual Users
11,701,5,5,2,1,1,4,Lost
33,1251,8,22,2,2,2,6,Lost
204,340,9,118,3,2,4,9,Casual Users
421,243,71,170,3,5,5,13,Loyal Users
575,81,11,14,4,2,1,7,Promising
781,118,45,170,4,4,5,13,Champions
872,7,49,65,5,5,4,14,Champions
888,0,31,159,5,4,5,14,Champions
1024,167,25,56,3,4,3,10,Loyal Users
1152,2605,7,12,1,2,1,4,Lost
1482,2007,32,192,1,4,5,10,At Risk
1794,371,5,27,3,1,2,6,Casual Users
1852,11,74,160,5,5,5,15,Champions
1859,13,63,162,5,5,5,15,Champions
2058,4546,8,28,1,2,2,5,Lost
2121,1170,9,30,2,2,2,6,Lost
3109,734,29,102,2,4,4,10,At Risk
3367,2565,11,17,1,2,2,5,Lost
3400,8,39,129,5,4,4,13,Champions
3428,136,5,12,4,1,1,6,Promising
3550,45,20,107,5,3,4,12,Loyal Users
3735,3721,7,10,1,2,1,4,Lost
3965,1164,16,22,2,3,2,7,Casual Users
4004,972,17,30,2,3,2,7,Casual Users
4188,131,10,13,4,2,1,7,Promising
4213,1236,24,63,2,4,4,10,At Risk
4268,103,11,26,4,2,2,8,Promising
4486,279,33,48,3,4,3,10,Loyal Users
4706,1555,17,106,1,3,4,8,Casual Users
4764,1873,13,131,1,3,4,8,Casual Users
5244,2418,7,12,1,2,1,4,Lost
5272,271,25,66,3,4,4,11,Loyal Users
5299,1110,5,8,2,1,1,4,Lost
5332,23,82,639,5,5,5,15,Champions
6132,2876,6,6,1,1,1,3,Lost
6305,5601,9,12,1,2,1,4,Lost
6324,247,5,11,3,1,1,5,Casual Users
6420,566,13,48,2,3,3,8,Casual Users
6683,0,123,574,5,5,5,15,Champions
7205,16,27,85,5,4,4,13,Champions
7312,434,26,69,3,4,4,11,Loyal Users
7386,347,13,135,3,3,4,10,Loyal Users
7830,4,145,708,5,5,5,15,Champions
8179,4125,19,134,1,3,4,8,Casual Users
8187,239,44,164,3,4,5,12,Loyal Users
8470,9,57,190,5,5,5,15,Champions
8560,1994,5,24,1,1,2,4,Lost
8639,3531,8,24,1,2,2,5,Lost
8850,865,16,174,2,3,5,10,Casual Users
8863,452,7,53,3,2,3,8,Casual Users
8869,10,43,73,5,4,4,13,Champions
8949,87,8,17,4,2,2,8,Promising
9044,11,85,124,5,5,4,14,Champions
9331,134,27,31,4,4,2,10,Loyal Users
9560,1696,10,13,1,2,1,4,Lost
9762,95,78,122,4,5,4,13,Champions
9891,91,40,130,4,4,4,12,Champions
10418,275,9,23,3,2,2,7,Casual Users
10784,17,79,489,5,5,5,15,Champions
10967,4,145,601,5,5,5,15,Champions
11440,124,47,141,4,5,4,13,Champions
11463,0,36,147,5,4,5,14,Champions
11621,1904,8,8,1,2,1,4,Lost
11728,1520,5,5,1,1,1,3,Lost
12484,585,6,13,2,1,1,4,Lost
12507,23,103,446,5,5,5,15,Champions
12647,4371,5,16,1,1,2,4,Lost
12740,2661,6,10,1,1,1,3,Lost
12807,988,8,15,2,2,1,5,Lost
12878,145,24,51,4,4,3,11,Loyal Users
12952,6,94,254,5,5,5,15,Champions
13032,802,18,52,2,3,3,8,Casual Users
13075,10,35,40,5,4,3,12,Loyal Users
83,593,5,8,2,1,1,4,Lost
110,4627,27,45,1,4,3,8,At Risk
150,213,72,181,3,5,5,13,Loyal Users
369,9,19,43,5,3,3,11,Loyal Users
413,1271,10,11,1,2,1,4,Lost
508,4428,6,14,1,1,1,3,Lost
541,402,8,12,3,2,1,6,Casual Users
825,423,43,74,3,4,4,11,Loyal Users
1033,4,107,334,5,5,5,15,Champions
1129,251,26,51,3,4,3,10,Loyal Users
1821,1307,6,13,1,1,1,3,Lost
1860,137,9,12,4,2,1,7,Promising
2039,1019,17,23,2,3,2,7,Casual Users
2953,1673,12,20,1,3,2,6,Casual Users
3178,11,10,18,5,2,2,9,Promising
3223,1,101,225,5,5,5,15,Champions
3380,272,50,147,3,5,5,13,Loyal Users
3418,136,42,63,4,4,4,12,Champions
3642,144,23,102,4,4,4,12,Champions
3903,912,17,70,2,3,4,9,Casual Users
4031,391,12,28,3,3,2,8,Loyal Users
4131,995,6,7,2,1,1,4,Lost
4266,271,36,143,3,4,4,11,Loyal Users
4479,2245,5,23,1,1,2,4,Lost
4488,113,36,79,4,4,4,12,Champions
4728,114,51,281,4,5,5,14,Champions
5439,1832,13,46,1,3,3,7,Casual Users
5654,301,21,22,3,3,2,8,Loyal Users
5815,146,17,136,4,3,4,11,Loyal Users
5955,1291,10,12,1,2,1,4,Lost
6186,93,25,92,4,4,4,12,Champions
6202,699,6,6,2,1,1,4,Lost
6589,718,8,16,2,2,2,6,Lost
6945,431,24,50,3,4,3,10,Loyal Users
7113,92,25,92,4,4,4,12,Champions
7631,406,48,62,3,5,3,11,Loyal Users
7801,2687,15,58,1,3,3,7,Casual Users
8020,1233,9,59,2,2,3,7,Lost
8071,101,19,49,4,3,3,10,Loyal Users
8371,78,155,1158,4,5,5,14,Champions
8547,820,7,16,2,2,2,6,Lost
8729,21,88,110,5,5,4,14,Champions
8758,39,24,41,5,4,3,12,Loyal Users
8853,87,74,159,4,5,5,14,Champions
9075,27,33,52,5,4,3,12,Loyal Users
9314,107,7,20,4,2,2,8,Promising
9718,38,16,23,5,3,2,10,Loyal Users
9724,387,9,14,3,2,1,6,Casual Users
10301,1065,9,30,2,2,2,6,Lost
10372,1699,24,78,1,4,4,9,At Risk
10419,701,13,15,2,3,1,6,Casual Users
10521,2671,13,33,1,3,3,7,Casual Users
10576,1595,10,19,1,2,2,5,Lost
11185,117,16,44,4,3,3,10,Loyal Users
11195,321,12,49,3,3,3,9,Loyal Users
11217,439,16,64,3,3,4,10,Loyal Users
11275,1475,8,13,1,2,1,4,Lost
11503,850,5,11,2,1,1,4,Lost
11524,293,5,5,3,1,1,5,Casual Users
11596,3880,44,214,1,4,5,10,At Risk
11647,43,109,717,5,5,5,15,Champions
11721,7,40,55,5,4,3,12,Loyal Users
12016,1084,5,19,2,1,2,5,Lost
12060,965,17,28,2,3,2,7,Casual Users
12658,168,22,173,3,4,5,12,Loyal Users
12920,317,5,19,3,1,2,6,Casual Users
12975,2698,5,35,1,1,3,5,Lost
13107,3383,7,7,1,2,1,4,Lost
13138,1837,21,23,1,3,2,6,Casual Users
68,1508,8,8,1,2,1,4,Lost
71,135,18,71,4,3,4,11,Loyal Users
106,817,7,16,2,2,2,6,Lost
260,111,7,13,4,2,1,7,Promising
567,155,14,164,4,3,5,12,Loyal Users
1472,237,23,45,3,4,3,10,Loyal Users
1730,93,65,245,4,5,5,14,Champions
2001,109,72,176,4,5,5,14,Champions
2221,438,40,94,3,4,4,11,Loyal Users
2307,557,9,30,2,2,2,6,Lost
2360,1395,5,11,1,1,1,3,Lost
2459,1671,6,11,1,1,1,3,Lost
2474,98,20,83,4,3,4,11,Loyal Users
2917,222,30,196,3,4,5,12,Loyal Users
3238,1871,11,14,1,2,1,4,Lost
3347,930,5,13,2,1,1,4,Lost
3358,97,9,22,4,2,2,8,Promising
3873,109,86,233,4,5,5,14,Champions
4096,856,10,12,2,2,1,5,Lost
4152,91,80,178,4,5,5,14,Champions
5070,323,13,26,3,3,2,8,Loyal Users
5674,738,11,125,2,2,4,8,Lost
5732,305,18,37,3,3,3,9,Loyal Users
5766,450,9,23,3,2,2,7,Casual Users
5939,6,99,117,5,5,4,14,Champions
6023,1416,7,14,1,2,1,4,Lost
6094,314,12,17,3,3,2,8,Loyal Users
6242,4072,7,15,1,2,1,4,Lost
6580,2906,5,14,1,1,1,3,Lost
6785,1,11,64,5,2,4,11,Promising
7369,12,73,201,5,5,5,15,Champions
7598,1,163,742,5,5,5,15,Champions
7913,1602,27,44,1,4,3,8,At Risk
7950,409,16,37,3,3,3,9,Loyal Users
7960,135,137,257,4,5,5,14,Champions
7977,282,16,147,3,3,5,11,Loyal Users
8898,813,8,21,2,2,2,6,Lost
8956,242,19,28,3,3,2,8,Loyal Users
9007,977,10,11,2,2,1,5,Lost
9421,21,20,26,5,3,2,10,Loyal Users
9422,140,31,51,4,4,3,11,Loyal Users
9594,82,40,57,4,4,3,11,Loyal Users
9683,146,65,101,4,5,4,13,Champions
9838,101,10,83,4,2,4,10,Promising
10051,1998,5,8,1,1,1,3,Lost
10182,79,76,214,4,5,5,14,Champions
10478,213,11,46,3,2,3,8,Casual Users
10644,2097,7,17,1,2,2,5,Lost
10717,234,30,46,3,4,3,10,Loyal Users
11312,257,25,89,3,4,4,11,Loyal Users
11481,1097,31,54,2,4,3,9,At Risk
11680,3904,16,16,1,3,2,6,Casual Users
11738,3223,9,27,1,2,2,5,Lost
12061,2907,5,9,1,1,1,3,Lost
12220,2848,6,13,1,1,1,3,Lost
12222,12,102,616,5,5,5,15,Champions
12274,130,97,318,4,5,5,14,Champions
12275,183,11,37,3,2,3,8,Casual Users
12333,139,56,166,4,5,5,14,Champions
12387,234,21,82,3,3,4,10,Loyal Users
12528,104,35,75,4,4,4,12,Champions
12653,2,102,308,5,5,5,15,Champions
12726,1512,45,79,1,4,4,9,At Risk
12826,1083,9,22,2,2,2,6,Lost
12886,3163,19,37,1,3,3,7,Casual Users
13538,445,33,74,3,4,4,11,Loyal Users
525,1010,10,13,2,2,1,5,Lost
561,884,11,23,2,2,2,6,Lost
1241,26,21,69,5,3,4,12,Loyal Users
2028,429,11,41,3,2,3,8,Casual Users
2353,186,7,11,3,2,1,6,Casual Users
2379,0,23,32,5,4,3,12,Loyal Users
2486,410,27,35,3,4,3,10,Loyal Users
2767,574,20,85,2,3,4,9,Casual Users
2931,1016,6,7,2,1,1,4,Lost
3409,3583,11,15,1,2,1,4,Lost
3630,490,11,47,2,2,3,7,Lost
4021,1011,16,18,2,3,2,7,Casual Users
4183,1039,10,22,2,2,2,6,Lost
4201,1916,8,27,1,2,2,5,Lost
4372,2,40,256,5,4,5,14,Champions
5607,158,70,151,4,5,5,14,Champions
5846,245,11,64,3,2,4,9,Casual Users
6022,332,5,10,3,1,1,5,Casual Users
6119,2005,6,13,1,1,1,3,Lost
6191,3,35,72,5,4,4,13,Champions
6258,43,36,74,5,4,4,13,Champions
6317,138,20,79,4,3,4,11,Loyal Users
6444,26,27,176,5,4,5,14,Champions
6636,544,11,29,2,2,2,6,Lost
6674,145,11,63,4,2,4,10,Promising
6679,91,76,313,4,5,5,14,Champions
7063,100,62,92,4,5,4,13,Champions
7381,291,6,17,3,1,2,6,Casual Users
7445,8,141,202,5,5,5,15,Champions
8213,9,99,271,5,5,5,15,Champions
8506,393,40,188,3,4,5,12,Loyal Users
8736,584,7,33,2,2,3,7,Lost
8757,278,32,53,3,4,3,10,Loyal Users
9586,658,6,25,2,1,2,5,Lost
9910,713,11,20,2,2,2,6,Lost
9972,522,8,12,2,2,1,5,Lost
10042,288,9,21,3,2,2,7,Casual Users
10089,1453,6,8,1,1,1,3,Lost
10270,3406,15,50,1,3,3,7,Casual Users
10273,15,24,103,5,4,4,13,Champions
10492,811,5,18,2,1,2,5,Lost
10499,2045,13,32,1,3,3,7,Casual Users
10596,984,10,13,2,2,1,5,Lost
10759,192,41,85,3,4,4,11,Loyal Users
10775,444,6,37,3,1,3,7,Casual Users
10922,256,53,101,3,5,4,12,Loyal Users
10952,125,5,9,4,1,1,6,Promising
11634,1848,9,16,1,2,2,5,Lost
11731,273,26,38,3,4,3,10,Loyal Users
11790,219,19,78,3,3,4,10,Loyal Users
11802,565,7,12,2,2,1,5,Lost
12145,61,172,709,5,5,5,15,Champions
12486,409,5,14,3,1,1,5,Casual Users
12833,110,80,567,4,5,5,14,Champions
12906,1695,19,28,1,3,2,6,Casual Users
13110,221,16,46,3,3,3,9,Loyal Users
13137,2568,12,14,1,3,1,5,Casual Users
13307,1239,13,30,2,3,2,7,Casual Users
13353,713,6,8,2,1,1,4,Lost
13467,3586,6,21,1,1,2,4,Lost
116,5,97,202,5,5,5,15,Champions
147,4,35,92,5,4,4,13,Champions
910,92,50,69,4,5,4,13,Champions
1080,879,11,35,2,2,3,7,Lost
1224,2775,7,8,1,2,1,4,Lost
1797,183,18,24,3,3,2,8,Loyal Users
1972,399,8,24,3,2,2,7,Casual Users
2024,1128,22,60,2,4,3,9,At Risk
2263,694,25,43,2,4,3,9,At Risk
2894,68,48,152,5,5,5,15,Champions
3604,5,35,67,5,4,4,13,Champions
3680,2136,9,20,1,2,2,5,Lost
4242,758,13,23,2,3,2,7,Casual Users
4371,58,71,326,5,5,5,15,Champions
4375,2811,27,188,1,4,5,10,At Risk
4575,3077,6,12,1,1,1,3,Lost
4949,4,31,80,5,4,4,13,Champions
5021,447,23,114,3,4,4,11,Loyal Users
5026,961,11,33,2,2,3,7,Lost
5098,792,73,162,2,5,5,12,At Risk
5379,301,82,160,3,5,5,13,Loyal Users
5782,107,19,29,4,3,2,9,Loyal Users
5858,8,30,100,5,4,4,13,Champions
5935,531,49,202,2,5,5,12,At Risk
6036,1695,33,72,1,4,4,9,At Risk
6310,27,56,129,5,5,4,14,Champions
6458,1484,28,120,1,4,4,9,At Risk
6830,4278,9,23,1,2,2,5,Lost
6862,1122,5,14,2,1,1,4,Lost
6915,306,60,167,3,5,5,13,Loyal Users
7021,1428,23,74,1,4,4,9,At Risk
7329,247,19,38,3,3,3,9,Loyal Users
7518,1476,5,102,1,1,4,6,Lost
7591,745,10,79,2,2,4,8,Lost
7671,1427,10,16,1,2,2,5,Lost
8017,1418,15,40,1,3,3,7,Casual Users
8052,13,27,137,5,4,4,13,Champions
8387,135,27,114,4,4,4,12,Champions
8934,140,17,57,4,3,3,10,Loyal Users
9289,374,17,31,3,3,2,8,Loyal Users
9708,79,31,137,4,4,4,12,Champions
9729,439,77,113,3,5,4,12,Loyal Users
9961,841,40,141,2,4,4,10,At Risk
9976,585,30,91,2,4,4,10,At Risk
10151,1560,6,13,1,1,1,3,Lost
10196,1375,13,18,1,3,2,6,Casual Users
10543,76,10,78,4,2,4,10,Promising
10552,277,42,68,3,4,4,11,Loyal Users
10874,143,64,326,4,5,5,14,Champions
10981,55,122,314,5,5,5,15,Champions
10987,735,6,6,2,1,1,4,Lost
11786,85,52,259,4,5,5,14,Champions
11949,527,37,186,2,4,5,11,At Risk
11957,212,40,73,3,4,4,11,Loyal Users
11968,157,9,20,4,2,2,8,Promising
12047,204,100,557,3,5,5,13,Loyal Users
12202,130,10,18,4,2,2,8,Promising
12352,1137,5,15,2,1,1,4,Lost
12465,45,84,149,5,5,5,15,Champions
12693,35,23,57,5,4,3,12,Loyal Users
12866,108,22,138,4,4,4,12,Champions
13217,991,28,165,2,4,5,11,At Risk
13393,1660,5,7,1,1,1,3,Lost
13395,29,29,208,5,4,5,14,Champions
13519,283,8,19,3,2,2,7,Casual Users
13540,3,76,412,5,5,5,15,Champions
14,22,99,314,5,5,5,15,Champions
198,4515,8,11,1,2,1,4,Lost
317,9,76,279,5,5,5,15,Champions
546,833,5,5,2,1,1,4,Lost
600,142,44,79,4,4,4,12,Champions
638,756,16,68,2,3,4,9,Casual Users
805,124,115,318,4,5,5,14,Champions
1228,36,102,613,5,5,5,15,Champions
1430,5620,5,5,1,1,1,3,Lost
1672,1520,6,7,1,1,1,3,Lost
1680,1219,7,7,2,2,1,5,Lost
2084,0,21,102,5,3,4,12,Loyal Users
2101,16,14,22,5,3,2,10,Loyal Users
2478,0,9,13,5,2,1,8,Promising
2714,15,56,137,5,5,4,14,Champions
2934,2410,13,53,1,3,3,7,Casual Users
2946,679,11,43,2,2,3,7,Lost
3078,681,10,54,2,2,3,7,Lost
3187,671,5,9,2,1,1,4,Lost
3442,630,7,14,2,2,1,5,Lost
3455,221,5,11,3,1,1,5,Casual Users
3460,2904,6,8,1,1,1,3,Lost
3533,83,16,49,4,3,3,10,Loyal Users
3808,993,73,189,2,5,5,12,At Risk
3829,1701,24,26,1,4,2,7,At Risk
3924,242,5,6,3,1,1,5,Casual Users
3928,116,135,244,4,5,5,14,Champions
4089,21,63,304,5,5,5,15,Champions
4609,4399,9,9,1,2,1,4,Lost
4685,148,18,27,4,3,2,9,Loyal Users
4895,369,18,55,3,3,3,9,Loyal Users
5232,833,5,11,2,1,1,4,Lost
5394,125,9,49,4,2,3,9,Promising
5486,360,44,183,3,4,5,12,Loyal Users
5726,427,15,104,3,3,4,10,Loyal Users
5807,69,43,127,5,4,4,13,Champions
5902,109,7,10,4,2,1,7,Promising
6750,3,76,130,5,5,4,14,Champions
6912,2427,11,16,1,2,2,5,Lost
7153,7,31,96,5,4,4,13,Champions
7287,15,62,166,5,5,5,15,Champions
7295,733,8,12,2,2,1,5,Lost
7371,1807,52,277,1,5,5,11,At Risk
7474,410,19,56,3,3,3,9,Loyal Users
7746,7,112,669,5,5,5,15,Champions
7915,1754,64,195,1,5,5,11,At Risk
8497,50,35,64,5,4,4,13,Champions
8538,322,5,11,3,1,1,5,Casual Users
8968,443,18,63,3,3,4,10,Loyal Users
8994,544,34,274,2,4,5,11,At Risk
9484,239,10,19,3,2,2,7,Casual Users
9577,34,84,243,5,5,5,15,Champions
9579,410,6,11,3,1,1,5,Casual Users
9710,438,24,46,3,4,3,10,Loyal Users
9770,2,78,501,5,5,5,15,Champions
10158,12,75,139,5,5,4,14,Champions
10258,175,12,18,3,3,2,8,Loyal Users
10280,607,58,174,2,5,5,12,At Risk
10516,16,58,80,5,5,4,14,Champions
11403,5,34,88,5,4,4,13,Champions
11451,462,13,27,3,3,2,8,Loyal Users
11671,30,48,243,5,5,5,15,Champions
11768,23,92,515,5,5,5,15,Champions
11889,83,80,118,4,5,4,13,Champions
11961,1124,6,8,2,1,1,4,Lost
12338,539,28,39,2,4,3,9,At Risk
13373,1393,5,5,1,1,1,3,Lost
13585,134,108,145,4,5,4,13,Champions
344,2437,13,33,1,3,3,7,Casual Users
349,2127,18,48,1,3,3,7,Casual Users
424,47,69,413,5,5,5,15,Champions
657,1398,7,21,1,2,2,5,Lost
975,139,27,104,4,4,4,12,Champions
1184,1127,6,13,2,1,1,4,Lost
1285,2056,7,7,1,2,1,4,Lost
1658,483,6,21,2,1,2,5,Lost
1693,726,6,33,2,1,3,6,Lost
1728,11,89,319,5,5,5,15,Champions
2264,151,5,42,4,1,3,8,Promising
2303,618,12,46,2,3,3,8,Casual Users
2388,26,52,171,5,5,5,15,Champions
2773,408,61,367,3,5,5,13,Loyal Users
3378,131,57,178,4,5,5,14,Champions
3623,301,6,8,3,1,1,5,Casual Users
3883,1235,18,56,2,3,3,8,Casual Users
4165,2397,6,13,1,1,1,3,Lost
4514,331,25,57,3,4,3,10,Loyal Users
4597,2781,6,7,1,1,1,3,Lost
4737,392,21,47,3,3,3,9,Loyal Users
4745,50,105,236,5,5,5,15,Champions
4800,127,44,186,4,4,5,13,Champions
4984,1413,22,41,1,4,3,8,At Risk
5011,71,36,168,4,4,5,13,Champions
5351,546,12,21,2,3,2,7,Casual Users
6007,2010,11,17,1,2,2,5,Lost
6238,5,47,64,5,5,4,14,Champions
6475,3177,6,16,1,1,2,4,Lost
6492,58,18,46,5,3,3,11,Loyal Users
6661,485,44,320,2,4,5,11,At Risk
7091,115,40,227,4,4,5,13,Champions
7235,7,90,181,5,5,5,15,Champions
7298,943,5,27,2,1,2,5,Lost
7307,432,23,47,3,4,3,10,Loyal Users
7439,55,47,131,5,5,4,14,Champions
7458,32,82,139,5,5,4,14,Champions
7586,852,8,15,2,2,1,5,Lost
7807,140,19,43,4,3,3,10,Loyal Users
7969,5527,6,15,1,1,1,3,Lost
8586,523,14,17,2,3,2,7,Casual Users
8775,1690,5,15,1,1,1,3,Lost
8963,2290,6,7,1,1,1,3,Lost
9163,117,15,63,4,3,4,11,Loyal Users
9212,1787,13,78,1,3,4,8,Casual Users
9218,533,12,36,2,3,3,8,Casual Users
9223,86,73,144,4,5,4,13,Champions
9585,326,59,125,3,5,4,12,Loyal Users
9746,54,11,14,5,2,1,8,Promising
9777,132,39,66,4,4,4,12,Champions
10031,4,19,45,5,3,3,11,Loyal Users
10548,1482,6,7,1,1,1,3,Lost
10645,79,13,58,4,3,3,10,Loyal Users
10707,999,5,9,2,1,1,4,Lost
11231,23,11,15,5,2,1,8,Promising
11381,575,11,73,2,2,4,8,Lost
11395,891,12,13,2,3,1,6,Casual Users
11425,88,57,125,4,5,4,13,Champions
11474,3471,88,147,1,5,5,11,At Risk
11526,234,17,35,3,3,3,9,Loyal Users
11591,105,16,84,4,3,4,11,Loyal Users
11799,1803,5,27,1,1,2,4,Lost
11887,460,6,14,3,1,1,5,Casual Users
11934,674,6,12,2,1,1,4,Lost
11944,1523,6,11,1,1,1,3,Lost
11974,91,46,61,4,5,3,12,Loyal Users
12040,272,24,40,3,4,3,10,Loyal Users
12070,22,250,822,5,5,5,15,Champions
12253,578,6,11,2,1,1,4,Lost
12604,86,21,30,4,3,2,9,Loyal Users
12803,514,5,10,2,1,1,4,Lost
12999,5410,9,13,1,2,1,4,Lost
13039,319,143,547,3,5,5,13,Loyal Users
13089,130,61,109,4,5,4,13,Champions
13147,2447,8,10,1,2,1,4,Lost
13231,2372,17,63,1,3,4,8,Casual Users
13254,4816,9,32,1,2,3,6,Lost
13296,1115,5,9,2,1,1,4,Lost
13324,409,7,58,3,2,3,8,Casual Users
13464,111,80,104,4,5,4,13,Champions
13501,2998,8,48,1,2,3,6,Lost
13535,17,27,77,5,4,4,13,Champions
123,1547,5,5,1,1,1,3,Lost
342,685,50,140,2,5,4,11,At Risk
373,1750,6,11,1,1,1,3,Lost
379,752,9,16,2,2,2,6,Lost
454,1175,7,16,2,2,2,6,Lost
832,566,11,15,2,2,1,5,Lost
965,409,5,10,3,1,1,5,Casual Users
971,226,69,400,3,5,5,13,Loyal Users
1018,113,26,58,4,4,3,11,Loyal Users
1264,23,10,24,5,2,2,9,Promising
1448,1810,7,16,1,2,2,5,Lost
1629,1417,9,38,1,2,3,6,Lost
1678,87,30,202,4,4,5,13,Champions
1753,153,10,22,4,2,2,8,Promising
1958,80,10,13,4,2,1,7,Promising
1992,81,103,475,4,5,5,14,Champions
2179,1256,6,6,2,1,1,4,Lost
2411,255,18,73,3,3,4,10,Loyal Users
2476,498,14,31,2,3,2,7,Casual Users
3100,850,6,22,2,1,2,5,Lost
3191,12,138,671,5,5,5,15,Champions
3360,2369,18,32,1,3,3,7,Casual Users
3643,25,16,50,5,3,3,11,Loyal Users
3770,5,107,557,5,5,5,15,Champions
3785,1264,9,14,1,2,1,4,Lost
4056,140,55,411,4,5,5,14,Champions
4175,693,55,144,2,5,4,11,At Risk
4468,456,20,36,3,3,3,9,Loyal Users
4813,2537,7,13,1,2,1,4,Lost
4980,859,24,74,2,4,4,10,At Risk
5277,151,30,191,4,4,5,13,Champions
5297,505,55,275,2,5,5,12,At Risk
5712,102,29,75,4,4,4,12,Champions
5944,920,7,14,2,2,1,5,Lost
6192,849,47,208,2,5,5,12,At Risk
6260,16,55,140,5,5,4,14,Champions
6338,13,114,415,5,5,5,15,Champions
6666,2743,5,5,1,1,1,3,Lost
6697,139,59,123,4,5,4,13,Champions
6955,690,9,23,2,2,2,6,Lost
7050,518,8,13,2,2,1,5,Lost
7450,240,25,63,3,4,4,11,Loyal Users
7708,10,41,108,5,4,4,13,Champions
7929,507,6,6,2,1,1,4,Lost
8035,7,126,417,5,5,5,15,Champions
8156,7,5,19,5,1,2,8,Promising
8370,32,152,285,5,5,5,15,Champions
8797,2258,7,18,1,2,2,5,Lost
8938,77,41,115,4,4,4,12,Champions
9377,429,24,58,3,4,3,10,Loyal Users
9740,1855,7,25,1,2,2,5,Lost
9810,46,88,196,5,5,5,15,Champions
10173,2250,12,55,1,3,3,7,Casual Users
10222,175,17,29,3,3,2,8,Loyal Users
10277,75,32,106,4,4,4,12,Champions
10460,286,35,100,3,4,4,11,Loyal Users
10658,115,6,7,4,1,1,6,Promising
10713,462,6,9,3,1,1,5,Casual Users
10738,79,59,82,4,5,4,13,Champions
11109,265,6,9,3,1,1,5,Casual Users
11398,1788,5,13,1,1,1,3,Lost
11460,15,84,181,5,5,5,15,Champions
11466,96,70,288,4,5,5,14,Champions
11733,533,9,46,2,2,3,7,Lost
11746,2,120,314,5,5,5,15,Champions
11907,233,37,125,3,4,4,11,Loyal Users
12361,510,36,133,2,4,4,10,At Risk
12456,981,5,7,2,1,1,4,Lost
12616,560,7,9,2,2,1,5,Lost
13127,137,107,410,4,5,5,14,Champions
13386,2684,5,12,1,1,1,3,Lost
13512,88,21,38,4,3,3,10,Loyal Users
158,447,15,64,3,3,4,10,Loyal Users
199,3138,13,14,1,3,1,5,Casual Users
242,517,20,41,2,3,3,8,Casual Users
270,181,9,20,3,2,2,7,Casual Users
284,172,35,80,3,4,4,11,Loyal Users
690,13,199,601,5,5,5,15,Champions
1086,2847,12,40,1,3,3,7,Casual Users
1563,2988,5,11,1,1,1,3,Lost
1684,2087,9,12,1,2,1,4,Lost
1983,1232,8,11,2,2,1,5,Lost
2049,834,14,88,2,3,4,9,Casual Users
2065,73,10,12,4,2,1,7,Promising
2222,225,13,15,3,3,1,7,Loyal Users
2416,4,100,201,5,5,5,15,Champions
2538,303,18,46,3,3,3,9,Loyal Users
2709,1538,15,75,1,3,4,8,Casual Users
3250,1258,19,101,1,3,4,8,Casual Users
3535,77,142,280,4,5,5,14,Champions
3665,1858,11,48,1,2,3,6,Lost
3822,67,52,85,5,5,4,14,Champions
4417,106,27,43,4,4,3,11,Loyal Users
4434,813,27,133,2,4,4,10,At Risk
4640,9,35,171,5,4,5,14,Champions
4710,549,9,9,2,2,1,5,Lost
4863,122,11,23,4,2,2,8,Promising
5081,664,12,39,2,3,3,8,Casual Users
5118,1098,5,6,2,1,1,4,Lost
5159,1663,6,11,1,1,1,3,Lost
5205,350,6,8,3,1,1,5,Casual Users
5295,133,10,19,4,2,2,8,Promising
5377,41,12,14,5,3,1,9,Loyal Users
5414,1563,30,64,1,4,4,9,At Risk
5491,109,26,51,4,4,3,11,Loyal Users
5519,195,47,75,3,5,4,12,Loyal Users
6054,2133,8,11,1,2,1,4,Lost
6114,962,13,75,2,3,4,9,Casual Users
6174,283,18,24,3,3,2,8,Loyal Users
6286,2390,55,385,1,5,5,11,At Risk
6489,106,38,58,4,4,3,11,Loyal Users
6556,85,75,136,4,5,4,13,Champions
6971,88,14,42,4,3,3,10,Loyal Users
7243,119,7,10,4,2,1,7,Promising
7308,19,33,146,5,4,4,13,Champions
7315,761,15,44,2,3,3,8,Casual Users
7557,304,27,36,3,4,3,10,Loyal Users
7820,30,16,55,5,3,3,11,Loyal Users
7839,154,20,24,4,3,2,9,Loyal Users
7844,4319,6,8,1,1,1,3,Lost
8045,147,37,130,4,4,4,12,Champions
8059,28,9,27,5,2,2,9,Promising
8142,79,22,28,4,4,2,10,Loyal Users
8617,802,8,140,2,2,4,8,Lost
8714,152,35,202,4,4,5,13,Champions
9025,1838,6,8,1,1,1,3,Lost
9160,540,7,14,2,2,1,5,Lost
9308,20,305,503,5,5,5,15,Champions
9485,5437,15,37,1,3,3,7,Casual Users
9661,26,48,204,5,5,5,15,Champions
9797,2241,6,13,1,1,1,3,Lost
9849,427,8,22,3,2,2,7,Casual Users
10659,468,29,92,3,4,4,11,Loyal Users
10672,103,15,44,4,3,3,10,Loyal Users
10679,1416,34,136,1,4,4,9,At Risk
10773,21,37,130,5,4,4,13,Champions
10992,1411,6,27,1,1,2,4,Lost
11336,272,11,32,3,2,3,8,Casual Users
11379,95,18,63,4,3,4,11,Loyal Users
11612,2433,6,16,1,1,2,4,Lost
11930,387,53,131,3,5,4,12,Loyal Users
12091,94,38,51,4,4,3,11,Loyal Users
12552,92,89,155,4,5,5,14,Champions
12788,185,18,39,3,3,3,9,Loyal Users
12897,487,52,127,2,5,4,11,At Risk
13019,696,7,7,2,2,1,5,Lost
13021,426,16,27,3,3,2,8,Loyal Users
13197,965,56,149,2,5,5,12,At Risk
13258,344,72,184,3,5,5,13,Loyal Users
13455,1350,7,21,1,2,2,5,Lost
13560,7,46,89,5,5,4,14,Champions
135,149,6,7,4,1,1,6,Promising
248,402,14,48,3,3,3,9,Loyal Users
499,540,22,81,2,4,4,10,At Risk
522,2077,5,26,1,1,2,4,Lost
902,566,10,43,2,2,3,7,Lost
1095,959,15,38,2,3,3,8,Casual Users
1106,1,104,539,5,5,5,15,Champions
1567,401,92,276,3,5,5,13,Loyal Users
1606,212,30,105,3,4,4,11,Loyal Users
1788,126,20,35,4,3,3,10,Loyal Users
2319,408,5,41,3,1,3,7,Casual Users
2611,998,5,6,2,1,1,4,Lost
2617,3402,8,24,1,2,2,5,Lost
2731,138,10,66,4,2,4,10,Promising
2762,14,133,373,5,5,5,15,Champions
2890,130,9,25,4,2,2,8,Promising
3142,976,20,88,2,3,4,9,Casual Users
3146,345,9,68,3,2,4,9,Casual Users
3355,3848,7,10,1,2,1,4,Lost
3558,79,50,132,4,5,4,13,Champions
3881,5012,5,7,1,1,1,3,Lost
3914,3530,5,5,1,1,1,3,Lost
3946,23,64,270,5,5,5,15,Champions
3948,468,9,29,3,2,2,7,Casual Users
4057,16,12,29,5,3,2,10,Loyal Users
4116,481,9,9,2,2,1,5,Lost
4302,131,43,82,4,4,4,12,Champions
4769,1275,8,33,1,2,3,6,Lost
4934,371,5,8,3,1,1,5,Casual Users
5293,78,12,31,4,3,2,9,Loyal Users
5634,432,9,15,3,2,1,6,Casual Users
5793,270,64,118,3,5,4,12,Loyal Users
5986,0,32,92,5,4,4,13,Champions
6220,118,56,193,4,5,5,14,Champions
6251,80,72,174,4,5,5,14,Champions
6802,33,25,39,5,4,3,12,Loyal Users
7085,434,5,8,3,1,1,5,Casual Users
7154,3328,7,21,1,2,2,5,Lost
7256,405,31,88,3,4,4,11,Loyal Users
7582,393,85,302,3,5,5,13,Loyal Users
7585,2,10,30,5,2,2,9,Promising
7772,6,116,306,5,5,5,15,Champions
7882,3754,5,21,1,1,2,4,Lost
8195,3279,12,53,1,3,3,7,Casual Users
8403,977,8,14,2,2,1,5,Lost
8575,282,5,8,3,1,1,5,Casual Users
8813,1929,48,174,1,5,5,11,At Risk
9149,25,58,278,5,5,5,15,Champions
9243,420,30,57,3,4,3,10,Loyal Users
9356,1,91,532,5,5,5,15,Champions
9392,737,17,42,2,3,3,8,Casual Users
9823,532,20,29,2,3,2,7,Casual Users
10321,9,28,202,5,4,5,14,Champions
10335,710,34,185,2,4,5,11,At Risk
10455,7,8,19,5,2,2,9,Promising
10649,2614,11,40,1,2,3,6,Lost
10695,2,95,672,5,5,5,15,Champions
10969,444,6,24,3,1,2,6,Casual Users
11053,6,92,412,5,5,5,15,Champions
11203,1141,9,18,2,2,2,6,Lost
11261,1834,6,12,1,1,1,3,Lost
11325,116,43,59,4,4,3,11,Loyal Users
11629,88,56,171,4,5,5,14,Champions
11657,130,67,215,4,5,5,14,Champions
11877,1292,6,22,1,1,2,4,Lost
11879,1674,7,10,1,2,1,4,Lost
11914,57,34,128,5,4,4,13,Champions
12345,150,12,17,4,3,2,9,Loyal Users
13304,398,22,79,3,4,4,11,Loyal Users
13361,231,61,252,3,5,5,13,Loyal Users
13491,869,10,20,2,2,2,6,Lost
13536,70,55,181,4,5,5,14,Champions
13587,822,12,27,2,3,2,7,Casual Users
42,1427,6,11,1,1,1,3,Lost
119,2873,7,11,1,2,1,4,Lost
337,1300,11,105,1,2,4,7,Lost
466,66,62,200,5,5,5,15,Champions
506,134,39,86,4,4,4,12,Champions
566,261,43,87,3,4,4,11,Loyal Users
909,430,10,19,3,2,2,7,Casual Users
1141,172,10,72,3,2,4,9,Casual Users
1312,951,11,49,2,2,3,7,Lost
1433,142,31,35,4,4,3,11,Loyal Users
1437,1430,6,6,1,1,1,3,Lost
1566,366,56,89,3,5,4,12,Loyal Users
1954,463,7,10,3,2,1,6,Casual Users
2005,191,39,145,3,4,4,11,Loyal Users
2124,1948,5,26,1,1,2,4,Lost
2308,209,5,22,3,1,2,6,Casual Users
2334,1330,18,45,1,3,3,7,Casual Users
2415,823,34,158,2,4,5,11,At Risk
2493,1563,7,8,1,2,1,4,Lost
3103,270,30,116,3,4,4,11,Loyal Users
3113,584,11,13,2,2,1,5,Lost
3160,48,120,198,5,5,5,15,Champions
3286,111,75,135,4,5,4,13,Champions
3448,1821,6,9,1,1,1,3,Lost
4509,443,14,27,3,3,2,8,Loyal Users
5060,595,6,12,2,1,1,4,Lost
5141,875,51,212,2,5,5,12,At Risk
5168,80,30,113,4,4,4,12,Champions
5569,421,9,28,3,2,2,7,Casual Users
5991,315,18,56,3,3,3,9,Loyal Users
6395,1041,76,129,2,5,4,11,At Risk
6575,31,53,253,5,5,5,15,Champions
6805,228,22,96,3,4,4,11,Loyal Users
6889,718,13,35,2,3,3,8,Casual Users
6982,1,97,753,5,5,5,15,Champions
7016,419,23,50,3,4,3,10,Loyal Users
7134,15,37,94,5,4,4,13,Champions
7471,845,12,30,2,3,2,7,Casual Users
7502,134,19,60,4,3,3,10,Loyal Users
7514,4140,22,96,1,4,4,9,At Risk
7959,7,41,81,5,4,4,13,Champions
8726,884,22,38,2,4,3,9,At Risk
9549,1930,11,25,1,2,2,5,Lost
9744,29,86,600,5,5,5,15,Champions
9772,965,16,49,2,3,3,8,Casual Users
9803,72,18,73,4,3,4,11,Loyal Users
9818,266,9,69,3,2,4,9,Casual Users
9826,164,5,6,4,1,1,6,Promising
9876,139,18,33,4,3,3,10,Loyal Users
9920,208,39,175,3,4,5,12,Loyal Users
10039,449,6,16,3,1,2,6,Casual Users
10047,1450,6,6,1,1,1,3,Lost
10123,1,46,335,5,5,5,15,Champions
10337,18,30,40,5,4,3,12,Loyal Users
10609,46,64,238,5,5,5,15,Champions
10816,57,139,493,5,5,5,15,Champions
10884,1407,8,41,1,2,3,6,Lost
11083,699,9,13,2,2,1,5,Lost
11097,25,33,308,5,4,5,14,Champions
11798,1491,8,8,1,2,1,4,Lost
11857,44,44,151,5,4,5,14,Champions
11924,17,10,12,5,2,1,8,Promising
12038,3669,9,13,1,2,1,4,Lost
12377,420,9,18,3,2,2,7,Casual Users
12619,1097,7,35,2,2,3,7,Lost
13335,336,8,34,3,2,3,8,Casual Users
2,162,37,68,4,4,4,12,Champions
79,188,25,80,3,4,4,11,Loyal Users
201,98,212,766,4,5,5,14,Champions
765,4568,6,7,1,1,1,3,Lost
778,29,24,38,5,4,3,12,Loyal Users
803,117,37,143,4,4,4,12,Champions
892,837,7,25,2,2,2,6,Lost
1262,1064,32,68,2,4,4,10,At Risk
1328,459,11,35,3,2,3,8,Casual Users
1572,33,39,146,5,4,4,13,Champions
1817,3408,7,20,1,2,2,5,Lost
2162,32,17,31,5,3,2,10,Loyal Users
2266,28,63,88,5,5,4,14,Champions
2897,598,11,12,2,2,1,5,Lost
2944,239,60,134,3,5,4,12,Loyal Users
3366,1576,24,60,1,4,3,8,At Risk
3447,5035,5,18,1,1,2,4,Lost
3556,704,24,144,2,4,4,10,At Risk
4261,27,148,422,5,5,5,15,Champions
4856,126,6,11,4,1,1,6,Promising
4871,244,62,143,3,5,4,12,Loyal Users
4901,82,33,76,4,4,4,12,Champions
4906,157,9,27,4,2,2,8,Promising
4920,0,74,389,5,5,5,15,Champions
4960,108,9,22,4,2,2,8,Promising
5079,162,25,31,4,4,2,10,Loyal Users
5239,108,51,230,4,5,5,14,Champions
5703,40,22,34,5,4,3,12,Loyal Users
5820,1228,19,53,2,3,3,8,Casual Users
6037,920,10,10,2,2,1,5,Lost
6196,729,5,20,2,1,2,5,Lost
6246,1236,48,183,2,5,5,12,At Risk
6371,502,10,105,2,2,4,8,Lost
6519,1840,6,11,1,1,1,3,Lost
6533,812,6,6,2,1,1,4,Lost
6603,88,97,243,4,5,5,14,Champions
6868,3131,9,21,1,2,2,5,Lost
6883,544,9,19,2,2,2,6,Lost
7007,251,43,230,3,4,5,12,Loyal Users
7064,26,6,10,5,1,1,7,Promising
7179,165,10,41,4,2,3,9,Promising
8089,2728,6,13,1,1,1,3,Lost
8906,722,8,48,2,2,3,7,Lost
8944,4065,38,68,1,4,4,9,At Risk
9104,145,13,39,4,3,3,10,Loyal Users
9388,5737,6,21,1,1,2,4,Lost
9398,113,17,38,4,3,3,10,Loyal Users
9490,524,19,26,2,3,2,7,Casual Users
9796,17,6,16,5,1,2,8,Promising
10021,1788,7,29,1,2,2,5,Lost
10256,92,34,110,4,4,4,12,Champions
10919,42,12,79,5,3,4,12,Loyal Users
11112,827,5,13,2,1,1,4,Lost
11233,4089,16,44,1,3,3,7,Casual Users
11559,655,16,30,2,3,2,7,Casual Users
11593,1291,6,9,1,1,1,3,Lost
11668,57,120,222,5,5,5,15,Champions
11678,143,26,182,4,4,5,13,Champions
11812,77,45,132,4,4,4,12,Champions
11999,179,44,59,3,4,3,10,Loyal Users
12289,961,15,170,2,3,5,10,Casual Users
12584,474,30,94,2,4,4,10,At Risk
12673,23,16,49,5,3,3,11,Loyal Users
12747,2921,17,23,1,3,2,6,Casual Users
13005,437,6,14,3,1,1,5,Casual Users
13031,1065,21,41,2,3,3,8,Casual Users
13293,1813,9,16,1,2,2,5,Lost
131,42,73,374,5,5,5,15,Champions
149,694,12,21,2,3,2,7,Casual Users
276,271,41,92,3,4,4,11,Loyal Users
962,3233,6,13,1,1,1,3,Lost
1070,408,14,50,3,3,3,9,Loyal Users
1761,1990,14,68,1,3,4,8,Casual Users
1935,2,18,86,5,3,4,12,Loyal Users
1984,23,21,47,5,3,3,11,Loyal Users
2166,14,11,21,5,2,2,9,Promising
2302,91,100,206,4,5,5,14,Champions
2419,4,6,6,5,1,1,7,Promising
2605,271,5,5,3,1,1,5,Casual Users
2624,873,50,105,2,5,4,11,At Risk
2974,128,81,259,4,5,5,14,Champions
3107,105,20,60,4,3,3,10,Loyal Users
3130,994,7,42,2,2,3,7,Lost
3274,55,11,14,5,2,1,8,Promising
3536,270,28,106,3,4,4,11,Loyal Users
3917,121,114,477,4,5,5,14,Champions
3942,27,62,231,5,5,5,15,Champions
3968,1208,9,19,2,2,2,6,Lost
3988,29,60,134,5,5,4,14,Champions
4065,33,7,30,5,2,2,9,Promising
4532,475,5,6,2,1,1,4,Lost
4665,846,7,16,2,2,2,6,Lost
4771,293,8,17,3,2,2,7,Casual Users
4833,114,5,6,4,1,1,6,Promising
4883,418,8,13,3,2,1,6,Casual Users
5195,30,38,431,5,4,5,14,Champions
5199,595,14,40,2,3,3,8,Casual Users
5228,873,19,42,2,3,3,8,Casual Users
5314,1533,8,44,1,2,3,6,Lost
5512,1310,5,26,1,1,2,4,Lost
5734,92,14,162,4,3,5,12,Loyal Users
5746,1474,7,17,1,2,2,5,Lost
5977,423,5,7,3,1,1,5,Casual Users
6316,628,7,42,2,2,3,7,Lost
6330,222,6,13,3,1,1,5,Casual Users
6450,466,19,32,3,3,3,9,Loyal Users
6502,38,180,642,5,5,5,15,Champions
6516,0,113,409,5,5,5,15,Champions
7313,575,12,34,2,3,3,8,Casual Users
7435,2,68,141,5,5,4,14,Champions
7625,124,72,112,4,5,4,13,Champions
7670,423,30,36,3,4,3,10,Loyal Users
7918,107,32,95,4,4,4,12,Champions
8050,15,50,361,5,5,5,15,Champions
8168,5204,6,9,1,1,1,3,Lost
8253,27,10,24,5,2,2,9,Promising
8316,0,53,69,5,5,4,14,Champions
8343,828,9,25,2,2,2,6,Lost
8444,3560,19,48,1,3,3,7,Casual Users
9026,84,53,78,4,5,4,13,Champions
9180,280,5,9,3,1,1,5,Casual Users
9261,267,14,31,3,3,2,8,Loyal Users
9430,2014,8,11,1,2,1,4,Lost
9651,1536,6,33,1,1,3,5,Lost
9665,453,8,12,3,2,1,6,Casual Users
9922,105,14,41,4,3,3,10,Loyal Users
10102,157,12,88,4,3,4,11,Loyal Users
10274,148,10,38,4,2,3,9,Promising
10353,1178,5,12,2,1,1,4,Lost
10379,218,24,32,3,4,3,10,Loyal Users
10491,159,58,315,4,5,5,14,Champions
10741,65,6,21,5,1,2,8,Promising
10749,1499,8,45,1,2,3,6,Lost
10888,4,33,146,5,4,4,13,Champions
11599,3260,9,24,1,2,2,5,Lost
12239,2011,6,6,1,1,1,3,Lost
12572,213,97,402,3,5,5,13,Loyal Users
12891,27,10,17,5,2,2,9,Promising
12911,225,33,136,3,4,4,11,Loyal Users
12924,365,49,308,3,5,5,13,Loyal Users
12984,4393,6,6,1,1,1,3,Lost
13056,728,9,11,2,2,1,5,Lost
365,2288,25,55,1,4,3,8,At Risk
773,327,12,33,3,3,3,9,Loyal Users
820,5,6,6,5,1,1,7,Promising
999,3817,5,8,1,1,1,3,Lost
1092,73,60,74,4,5,4,13,Champions
1316,571,10,10,2,2,1,5,Lost
1557,521,19,25,2,3,2,7,Casual Users
1691,51,5,71,5,1,4,10,Promising
1763,1241,9,18,2,2,2,6,Lost
1839,16,111,662,5,5,5,15,Champions
2115,2,113,195,5,5,5,15,Champions
2548,1552,13,41,1,3,3,7,Casual Users
2593,964,80,238,2,5,5,12,At Risk
2825,338,14,21,3,3,2,8,Loyal Users
2938,251,53,78,3,5,4,12,Loyal Users
3344,3242,10,15,1,2,1,4,Lost
3737,599,8,23,2,2,2,6,Lost
3880,253,44,197,3,4,5,12,Loyal Users
3921,23,20,59,5,3,3,11,Loyal Users
3984,523,32,35,2,4,3,9,At Risk
4112,834,24,37,2,4,3,9,At Risk
4194,1448,8,17,1,2,2,5,Lost
4886,285,26,68,3,4,4,11,Loyal Users
5115,1164,5,5,2,1,1,4,Lost
5487,55,45,99,5,4,4,13,Champions
6049,3903,5,56,1,1,3,5,Lost
6208,2414,5,12,1,1,1,3,Lost
6355,81,118,423,4,5,5,14,Champions
6404,6147,24,24,1,4,2,7,At Risk
6415,339,52,104,3,5,4,12,Loyal Users
6474,1218,13,21,2,3,2,7,Casual Users
6530,1735,5,9,1,1,1,3,Lost
6681,2272,22,38,1,4,3,8,At Risk
6860,2401,14,84,1,3,4,8,Casual Users
6926,0,73,173,5,5,5,15,Champions
6967,913,38,112,2,4,4,10,At Risk
7045,4,71,118,5,5,4,14,Champions
7047,233,10,19,3,2,2,7,Casual Users
7056,278,25,81,3,4,4,11,Loyal Users
7111,52,76,191,5,5,5,15,Champions
7167,114,35,188,4,4,5,13,Champions
7172,400,10,17,3,2,2,7,Casual Users
7189,87,47,309,4,5,5,14,Champions
7288,116,19,64,4,3,4,11,Loyal Users
7457,318,7,8,3,2,1,6,Casual Users
7469,516,10,17,2,2,2,6,Lost
7575,252,37,58,3,4,3,10,Loyal Users
7752,109,59,425,4,5,5,14,Champions
7916,64,14,43,5,3,3,11,Loyal Users
8535,1417,6,13,1,1,1,3,Lost
8554,151,55,82,4,5,4,13,Champions
8582,12,87,296,5,5,5,15,Champions
8763,570,14,17,2,3,2,7,Casual Users
8964,341,59,84,3,5,4,12,Loyal Users
8991,2556,39,113,1,4,4,9,At Risk
9049,13,99,269,5,5,5,15,Champions
9136,292,45,110,3,4,4,11,Loyal Users
9184,103,45,87,4,4,4,12,Champions
9424,158,51,86,4,5,4,13,Champions
9986,97,6,6,4,1,1,6,Promising
10856,691,6,31,2,1,2,5,Lost
10924,441,71,330,3,5,5,13,Loyal Users
11355,151,9,22,4,2,2,8,Promising
11966,5675,5,5,1,1,1,3,Lost
12144,275,27,44,3,4,3,10,Loyal Users
12412,0,66,189,5,5,5,15,Champions
12547,2651,24,58,1,4,3,8,At Risk
12967,107,79,127,4,5,4,13,Champions
13382,396,24,113,3,4,4,11,Loyal Users
294,3880,7,19,1,2,2,5,Lost
357,260,30,75,3,4,4,11,Loyal Users
529,29,110,244,5,5,5,15,Champions
905,24,122,573,5,5,5,15,Champions
1004,79,67,246,4,5,5,14,Champions
1187,844,22,24,2,4,2,8,At Risk
1612,835,6,22,2,1,2,5,Lost
1819,60,17,38,5,3,3,11,Loyal Users
1964,419,7,7,3,2,1,6,Casual Users
2000,983,6,24,2,1,2,5,Lost
2144,1410,15,19,1,3,2,6,Casual Users
2276,312,23,62,3,4,3,10,Loyal Users
3732,1271,8,9,1,2,1,4,Lost
3950,122,46,101,4,5,4,13,Champions
4046,2225,6,10,1,1,1,3,Lost
4414,101,41,92,4,4,4,12,Champions
4622,521,30,83,2,4,4,10,At Risk
4702,55,8,9,5,2,1,8,Promising
4783,3,29,51,5,4,3,12,Loyal Users
4836,1158,12,25,2,3,2,7,Casual Users
5215,139,10,64,4,2,4,10,Promising
5617,153,22,34,4,4,3,11,Loyal Users
5643,2320,8,61,1,2,3,6,Lost
5644,236,89,405,3,5,5,13,Loyal Users
5700,40,12,26,5,3,2,10,Loyal Users
5878,101,14,298,4,3,5,12,Loyal Users
5987,958,11,28,2,2,2,6,Lost
6016,1370,6,8,1,1,1,3,Lost
6180,660,5,38,2,1,3,6,Lost
6596,176,13,61,3,3,3,9,Loyal Users
6688,377,11,18,3,2,2,7,Casual Users
6777,1758,7,9,1,2,1,4,Lost
6842,14,143,663,5,5,5,15,Champions
6952,4806,6,65,1,1,4,6,Lost
7356,727,12,15,2,3,1,6,Casual Users
7374,7,110,430,5,5,5,15,Champions
7496,290,6,11,3,1,1,5,Casual Users
7577,89,51,123,4,5,4,13,Champions
7668,287,49,174,3,5,5,13,Loyal Users
7678,443,41,198,3,4,5,12,Loyal Users
7778,142,28,51,4,4,3,11,Loyal Users
7782,49,96,711,5,5,5,15,Champions
8097,1992,16,22,1,3,2,6,Casual Users
8489,36,9,24,5,2,2,9,Promising
8781,46,26,85,5,4,4,13,Champions
8806,993,10,51,2,2,3,7,Lost
8942,43,69,475,5,5,5,15,Champions
9171,822,8,25,2,2,2,6,Lost
9228,1368,27,36,1,4,3,8,At Risk
9504,1975,5,23,1,1,2,4,Lost
9541,53,8,60,5,2,3,10,Promising
9999,165,19,109,4,3,4,11,Loyal Users
10048,359,6,15,3,1,1,5,Casual Users
10204,4431,5,5,1,1,1,3,Lost
10250,1261,5,6,1,1,1,3,Lost
10298,455,32,55,3,4,3,10,Loyal Users
10523,208,8,60,3,2,3,8,Casual Users
10537,1142,5,10,2,1,1,4,Lost
10590,531,6,25,2,1,2,5,Lost
10999,2705,5,11,1,1,1,3,Lost
11338,1306,10,10,1,2,1,4,Lost
11392,2120,5,6,1,1,1,3,Lost
11530,1017,10,10,2,2,1,5,Lost
11737,513,40,51,2,4,3,9,At Risk
12089,1782,8,13,1,2,1,4,Lost
12183,2630,11,24,1,2,2,5,Lost
12200,118,70,444,4,5,5,14,Champions
12221,184,58,79,3,5,4,12,Loyal Users
12477,417,100,134,3,5,4,12,Loyal Users
12521,3496,5,8,1,1,1,3,Lost
12554,31,87,394,5,5,5,15,Champions
12603,178,23,76,3,4,4,11,Loyal Users
12635,174,8,20,3,2,2,7,Casual Users
12932,121,42,108,4,4,4,12,Champions
13158,1318,18,41,1,3,3,7,Casual Users
13299,664,32,76,2,4,4,10,At Risk
118,296,9,59,3,2,3,8,Casual Users
573,2155,8,10,1,2,1,4,Lost
722,287,30,96,3,4,4,11,Loyal Users
1112,985,97,360,2,5,5,12,At Risk
1373,1,50,168,5,5,5,15,Champions
1390,20,15,18,5,3,2,10,Loyal Users
1449,1166,12,40,2,3,3,8,Casual Users
1503,152,33,147,4,4,5,13,Champions
1508,3713,6,6,1,1,1,3,Lost
1571,399,9,10,3,2,1,6,Casual Users
1652,409,6,12,3,1,1,5,Casual Users
1885,174,32,78,3,4,4,11,Loyal Users
1981,4012,15,21,1,3,2,6,Casual Users
2010,4285,10,22,1,2,2,5,Lost
2348,2705,8,15,1,2,1,4,Lost
2642,1097,8,22,2,2,2,6,Lost
2925,114,21,27,4,3,2,9,Loyal Users
3186,2649,12,12,1,3,1,5,Casual Users
3224,126,79,179,4,5,5,14,Champions
3321,25,95,238,5,5,5,15,Champions
3329,240,27,54,3,4,3,10,Loyal Users
3617,21,76,176,5,5,5,15,Champions
4128,1032,15,45,2,3,3,8,Casual Users
4236,96,6,8,4,1,1,6,Promising
4422,522,12,20,2,3,2,7,Casual Users
4671,12,40,100,5,4,4,13,Champions
4679,3697,9,25,1,2,2,5,Lost
4724,140,15,27,4,3,2,9,Loyal Users
4817,112,41,86,4,4,4,12,Champions
4854,273,25,45,3,4,3,10,Loyal Users
4872,618,15,40,2,3,3,8,Casual Users
4903,270,9,23,3,2,2,7,Casual Users
4953,150,17,32,4,3,3,10,Loyal Users
5078,119,12,29,4,3,2,9,Loyal Users
5145,161,24,44,4,4,3,11,Loyal Users
5208,1120,12,46,2,3,3,8,Casual Users
5493,710,7,12,2,2,1,5,Lost
5535,4,98,403,5,5,5,15,Champions
5648,743,6,14,2,1,1,4,Lost
5873,1901,5,25,1,1,2,4,Lost
6013,60,73,95,5,5,4,14,Champions
6269,115,158,568,4,5,5,14,Champions
6412,140,24,47,4,4,3,11,Loyal Users
6645,247,12,17,3,3,2,8,Loyal Users
6675,26,135,313,5,5,5,15,Champions
6701,277,7,9,3,2,1,6,Casual Users
7025,300,7,18,3,2,2,7,Casual Users
7658,261,16,27,3,3,2,8,Loyal Users
7734,153,12,42,4,3,3,10,Loyal Users
7809,408,24,36,3,4,3,10,Loyal Users
7965,174,10,12,3,2,1,6,Casual Users
8103,35,63,133,5,5,4,14,Champions
8972,665,22,56,2,4,3,9,At Risk
9010,962,25,40,2,4,3,9,At Risk
9100,69,82,133,5,5,4,14,Champions
9102,6,105,188,5,5,5,15,Champions
9663,450,30,55,3,4,3,10,Loyal Users
10160,263,26,160,3,4,5,12,Loyal Users
10175,33,73,278,5,5,5,15,Champions
10185,22,163,341,5,5,5,15,Champions
10386,272,12,29,3,3,2,8,Loyal Users
10821,365,7,55,3,2,3,8,Casual Users
10843,95,52,166,4,5,5,14,Champions
10892,5,61,159,5,5,5,15,Champions
11075,8,75,315,5,5,5,15,Champions
11345,407,31,118,3,4,4,11,Loyal Users
11756,523,15,30,2,3,2,7,Casual Users
11955,60,27,83,5,4,4,13,Champions
12194,12,33,85,5,4,4,13,Champions
12416,841,5,6,2,1,1,4,Lost
12503,73,113,304,4,5,5,14,Champions
12735,71,69,262,4,5,5,14,Champions
12985,1051,37,72,2,4,4,10,At Risk
13280,43,138,388,5,5,5,15,Champions
13541,522,10,22,2,2,2,6,Lost
124,140,13,43,4,3,3,10,Loyal Users
281,30,18,44,5,3,3,11,Loyal Users
571,1569,6,11,1,1,1,3,Lost
1011,1700,16,47,1,3,3,7,Casual Users
1193,110,72,254,4,5,5,14,Champions
1366,1026,8,50,2,2,3,7,Lost
1428,118,17,32,4,3,3,10,Loyal Users
1986,730,20,55,2,3,3,8,Casual Users
2073,487,16,25,2,3,2,7,Casual Users
2137,463,9,16,3,2,2,7,Casual Users
2661,2495,20,87,1,3,4,8,Casual Users
3174,655,14,35,2,3,3,8,Casual Users
3289,416,10,12,3,2,1,6,Casual Users
3348,780,29,123,2,4,4,10,At Risk
3483,365,5,18,3,1,2,6,Casual Users
3503,163,5,15,4,1,1,6,Promising
3585,1304,6,6,1,1,1,3,Lost
3951,256,13,49,3,3,3,9,Loyal Users
4060,650,5,11,2,1,1,4,Lost
4129,54,10,109,5,2,4,11,Promising
4146,12,176,294,5,5,5,15,Champions
4388,1222,9,18,2,2,2,6,Lost
4556,864,5,28,2,1,2,5,Lost
4580,672,12,20,2,3,2,7,Casual Users
4911,74,7,19,4,2,2,8,Promising
5270,52,60,430,5,5,5,15,Champions
6151,335,19,24,3,3,2,8,Loyal Users
6210,81,41,174,4,4,5,13,Champions
6652,1850,8,25,1,2,2,5,Lost
6715,56,122,305,5,5,5,15,Champions
6800,102,70,589,4,5,5,14,Champions
7813,1982,9,41,1,2,3,6,Lost
7835,145,29,178,4,4,5,13,Champions
7863,59,21,49,5,3,3,11,Loyal Users
8076,275,12,103,3,3,4,10,Loyal Users
8890,122,132,488,4,5,5,14,Champions
8891,968,11,40,2,2,3,7,Lost
9017,2095,77,430,1,5,5,11,At Risk
9115,52,90,222,5,5,5,15,Champions
9167,90,7,17,4,2,2,8,Promising
9220,1159,10,81,2,2,4,8,Lost
9856,46,9,34,5,2,3,10,Promising
9863,1553,20,81,1,3,4,8,Casual Users
9916,196,44,85,3,4,4,11,Loyal Users
9990,12,75,242,5,5,5,15,Champions
10598,7,7,56,5,2,3,10,Promising
10694,61,47,62,5,5,3,13,Loyal Users
10778,72,65,90,4,5,4,13,Champions
10883,75,58,310,4,5,5,14,Champions
11099,231,29,135,3,4,4,11,Loyal Users
11555,774,8,114,2,2,4,8,Lost
11614,673,12,20,2,3,2,7,Casual Users
11705,48,83,101,5,5,4,14,Champions
11769,105,35,137,4,4,4,12,Champions
11853,146,8,13,4,2,1,7,Promising
11916,1871,8,9,1,2,1,4,Lost
12135,384,5,17,3,1,2,6,Casual Users
12498,575,7,11,2,2,1,5,Lost
12860,2,106,252,5,5,5,15,Champions
13259,551,14,46,2,3,3,8,Casual Users
1402,1,21,40,5,3,3,11,Loyal Users
1879,81,22,43,4,4,3,11,Loyal Users
2406,3976,32,60,1,4,3,8,At Risk
2461,129,113,510,4,5,5,14,Champions
2557,662,23,37,2,4,3,9,At Risk
2792,21,69,151,5,5,5,15,Champions
2818,1673,14,31,1,3,2,6,Casual Users
2883,31,93,246,5,5,5,15,Champions
3110,0,36,99,5,4,4,13,Champions
3225,381,7,12,3,2,1,6,Casual Users
3295,167,29,92,3,4,4,11,Loyal Users
3299,515,10,36,2,2,3,7,Lost
3315,503,8,24,2,2,2,6,Lost
3520,1410,20,83,1,3,4,8,Casual Users
3733,694,8,37,2,2,3,7,Lost
3768,347,21,39,3,3,3,9,Loyal Users
3960,289,5,6,3,1,1,5,Casual Users
4095,2936,18,42,1,3,3,7,Casual Users
4628,408,7,55,3,2,3,8,Casual Users
4955,423,27,86,3,4,4,11,Loyal Users
4988,236,25,134,3,4,4,11,Loyal Users
5209,139,38,39,4,4,3,11,Loyal Users
5459,124,67,126,4,5,4,13,Champions
5584,114,56,439,4,5,5,14,Champions
6250,1988,6,6,1,1,1,3,Lost
6297,1854,6,10,1,1,1,3,Lost
6614,3283,8,10,1,2,1,4,Lost
6704,1415,14,16,1,3,2,6,Casual Users
7162,24,26,43,5,4,3,12,Loyal Users
7415,74,78,230,4,5,5,14,Champions
7636,846,24,93,2,4,4,10,At Risk
8833,240,8,8,3,2,1,6,Casual Users
9080,114,48,198,4,5,5,14,Champions
9428,708,14,20,2,3,2,7,Casual Users
9644,679,36,68,2,4,4,10,At Risk
9808,15,51,141,5,5,4,14,Champions
9912,90,57,87,4,5,4,13,Champions
10436,203,81,794,3,5,5,13,Loyal Users
10547,126,27,60,4,4,3,11,Loyal Users
10804,279,10,25,3,2,2,7,Casual Users
11331,962,30,129,2,4,4,10,At Risk
11448,1421,6,16,1,1,2,4,Lost
11695,75,59,255,4,5,5,14,Champions
11787,716,18,72,2,3,4,9,Casual Users
11789,139,7,32,4,2,3,9,Promising
11795,412,7,23,3,2,2,7,Casual Users
11993,16,20,86,5,3,4,12,Loyal Users
12019,665,7,11,2,2,1,5,Lost
12151,674,38,238,2,4,5,11,At Risk
12820,68,10,42,5,2,3,10,Promising
12908,4976,13,86,1,3,4,8,Casual Users
13144,985,6,8,2,1,1,4,Lost
13520,2746,44,275,1,4,5,10,At Risk
13555,35,63,325,5,5,5,15,Champions
13566,1,12,37,5,3,3,11,Loyal Users
30,164,10,21,4,2,2,8,Promising
99,264,41,135,3,4,4,11,Loyal Users
942,533,11,25,2,2,2,6,Lost
985,409,42,68,3,4,4,11,Loyal Users
1702,2850,5,6,1,1,1,3,Lost
1805,405,29,79,3,4,4,11,Loyal Users
2011,204,54,125,3,5,4,12,Loyal Users
2243,36,46,182,5,5,5,15,Champions
2869,31,159,630,5,5,5,15,Champions
3005,147,14,48,4,3,3,10,Loyal Users
3048,3425,10,13,1,2,1,4,Lost
3372,130,14,36,4,3,3,10,Loyal Users
3515,17,74,102,5,5,4,14,Champions
3578,3671,8,8,1,2,1,4,Lost
3989,1246,6,10,2,1,1,4,Lost
4141,30,31,92,5,4,4,13,Champions
4218,35,106,182,5,5,5,15,Champions
4636,117,6,7,4,1,1,6,Promising
4860,496,31,99,2,4,4,10,At Risk
5233,1239,5,9,2,1,1,4,Lost
5268,39,73,243,5,5,5,15,Champions
5294,1171,9,39,2,2,3,7,Lost
5533,428,17,47,3,3,3,9,Loyal Users
5646,72,27,170,4,4,5,13,Champions
5906,1,104,180,5,5,5,15,Champions
5973,88,19,210,4,3,5,12,Loyal Users
6111,118,66,115,4,5,4,13,Champions
6123,78,22,44,4,4,3,11,Loyal Users
6130,262,6,48,3,1,3,7,Casual Users
6148,140,20,87,4,3,4,11,Loyal Users
6399,53,59,426,5,5,5,15,Champions
7015,256,57,121,3,5,4,12,Loyal Users
7018,1796,5,26,1,1,2,4,Lost
7082,4,93,397,5,5,5,15,Champions
7643,672,8,18,2,2,2,6,Lost
7983,837,16,21,2,3,2,7,Casual Users
8380,207,21,75,3,3,4,10,Loyal Users
8539,599,6,49,2,1,3,6,Lost
8908,376,15,21,3,3,2,8,Loyal Users
8981,546,14,23,2,3,2,7,Casual Users
9032,268,6,22,3,1,2,6,Casual Users
9185,4601,5,17,1,1,2,4,Lost
9232,759,50,123,2,5,4,11,At Risk
9400,1140,10,25,2,2,2,6,Lost
9996,240,68,111,3,5,4,12,Loyal Users
10219,5332,6,6,1,1,1,3,Lost
10305,5581,5,7,1,1,1,3,Lost
10429,23,174,334,5,5,5,15,Champions
11063,13,11,55,5,2,3,10,Promising
11172,233,10,10,3,2,1,6,Casual Users
11219,51,11,28,5,2,2,9,Promising
11322,418,13,35,3,3,3,9,Loyal Users
11365,269,9,10,3,2,1,6,Casual Users
11600,1911,7,8,1,2,1,4,Lost
11902,123,12,48,4,3,3,10,Loyal Users
12185,482,9,15,2,2,1,5,Lost
12233,1967,6,9,1,1,1,3,Lost
12317,1533,6,24,1,1,2,4,Lost
12386,365,65,136,3,5,4,12,Loyal Users
12590,58,37,106,5,4,4,13,Champions
12798,1150,5,13,2,1,1,4,Lost
12869,1267,5,10,1,1,1,3,Lost
13400,805,11,17,2,2,2,6,Lost
184,266,107,186,3,5,5,13,Loyal Users
302,1854,23,73,1,4,4,9,At Risk
313,1458,25,42,1,4,3,8,At Risk
652,130,53,150,4,5,5,14,Champions
815,13,37,63,5,4,4,13,Champions
901,1179,126,150,2,5,5,12,At Risk
1090,29,23,41,5,4,3,12,Loyal Users
1202,421,40,69,3,4,4,11,Loyal Users
1371,99,90,150,4,5,5,14,Champions
1445,698,9,40,2,2,3,7,Lost
1836,160,11,72,4,2,4,10,Promising
2361,559,11,13,2,2,1,5,Lost
2446,9,8,23,5,2,2,9,Promising
2543,430,24,35,3,4,3,10,Loyal Users
2566,272,7,10,3,2,1,6,Casual Users
2696,143,28,44,4,4,3,11,Loyal Users
2766,133,10,16,4,2,2,8,Promising
3033,757,13,16,2,3,2,7,Casual Users
3214,1825,5,9,1,1,1,3,Lost
3248,581,19,48,2,3,3,8,Casual Users
3895,662,16,39,2,3,3,8,Casual Users
3961,2251,13,113,1,3,4,8,Casual Users
4064,13,24,124,5,4,4,13,Champions
4289,2142,8,20,1,2,2,5,Lost
4335,7,113,219,5,5,5,15,Champions
4346,111,28,198,4,4,5,13,Champions
4850,2891,14,55,1,3,3,7,Casual Users
4978,1638,18,30,1,3,2,6,Casual Users
4996,436,24,32,3,4,3,10,Loyal Users
5163,136,25,59,4,4,3,11,Loyal Users
5326,5317,6,6,1,1,1,3,Lost
5364,156,28,103,4,4,4,12,Champions
5859,7,5,40,5,1,3,9,Promising
6627,114,57,222,4,5,5,14,Champions
8077,1,36,132,5,4,4,13,Champions
8114,2113,10,41,1,2,3,6,Lost
8224,694,6,8,2,1,1,4,Lost
8320,2905,7,9,1,2,1,4,Lost
8476,135,19,36,4,3,3,10,Loyal Users
8739,110,9,13,4,2,1,7,Promising
8812,164,46,120,4,5,4,13,Champions
8905,864,9,14,2,2,1,5,Lost
9112,112,15,42,4,3,3,10,Loyal Users
9143,272,16,89,3,3,4,10,Loyal Users
9365,450,5,7,3,1,1,5,Casual Users
9380,543,13,66,2,3,4,9,Casual Users
9503,282,19,33,3,3,3,9,Loyal Users
9608,955,14,71,2,3,4,9,Casual Users
9636,583,10,29,2,2,2,6,Lost
9773,37,6,50,5,1,3,9,Promising
9984,88,71,127,4,5,4,13,Champions
10373,2403,7,13,1,2,1,4,Lost
10655,70,47,106,4,5,4,13,Champions
10670,24,44,151,5,4,5,14,Champions
10688,2242,5,18,1,1,2,4,Lost
10689,60,139,270,5,5,5,15,Champions
10702,96,28,135,4,4,4,12,Champions
10726,1433,13,31,1,3,2,6,Casual Users
10819,1424,10,10,1,2,1,4,Lost
11021,573,16,16,2,3,2,7,Casual Users
11160,721,11,16,2,2,2,6,Lost
11302,1264,8,31,1,2,2,5,Lost
11963,1303,10,26,1,2,2,5,Lost
12142,125,16,28,4,3,2,9,Loyal Users
12181,6,28,75,5,4,4,13,Champions
12223,412,12,23,3,3,2,8,Loyal Users
12312,14,182,547,5,5,5,15,Champions
12372,147,20,123,4,3,4,11,Loyal Users
12468,39,7,12,5,2,1,8,Promising
12848,2555,9,27,1,2,2,5,Lost
12945,70,81,328,4,5,5,14,Champions
13023,1927,18,48,1,3,3,7,Casual Users
13037,649,9,36,2,2,3,7,Lost
13202,224,5,35,3,1,3,7,Casual Users
13573,1004,10,114,2,2,4,8,Lost
66,161,12,17,4,3,2,9,Loyal Users
405,1046,6,8,2,1,1,4,Lost
557,1504,8,13,1,2,1,4,Lost
682,123,29,75,4,4,4,12,Champions
700,867,6,7,2,1,1,4,Lost
915,67,31,93,5,4,4,13,Champions
1012,157,41,162,4,4,5,13,Champions
1568,112,38,130,4,4,4,12,Champions
1764,2587,5,27,1,1,2,4,Lost
2465,610,17,28,2,3,2,7,Casual Users
2591,693,6,37,2,1,3,6,Lost
3176,86,67,164,4,5,5,14,Champions
3371,999,9,25,2,2,2,6,Lost
3491,1140,15,16,2,3,2,7,Casual Users
3758,3583,10,16,1,2,2,5,Lost
4029,1215,18,28,2,3,2,7,Casual Users
4079,409,14,25,3,3,2,8,Loyal Users
4085,516,16,26,2,3,2,7,Casual Users
4555,275,7,17,3,2,2,7,Casual Users
4730,13,95,308,5,5,5,15,Champions
4748,27,80,220,5,5,5,15,Champions
5041,653,9,64,2,2,4,8,Lost
5164,382,73,338,3,5,5,13,Loyal Users
5256,367,26,35,3,4,3,10,Loyal Users
5537,124,33,84,4,4,4,12,Champions
5865,9,123,548,5,5,5,15,Champions
6074,68,62,155,5,5,5,15,Champions
6611,424,33,137,3,4,4,11,Loyal Users
6727,1249,20,83,2,3,4,9,Casual Users
6888,695,7,14,2,2,1,5,Lost
7137,1302,19,37,1,3,3,7,Casual Users
7410,74,15,28,4,3,2,9,Loyal Users
7464,3,112,235,5,5,5,15,Champions
7579,418,5,7,3,1,1,5,Casual Users
7922,35,33,64,5,4,4,13,Champions
7964,18,76,271,5,5,5,15,Champions
8000,92,17,82,4,3,4,11,Loyal Users
8585,245,10,20,3,2,2,7,Casual Users
8765,28,10,111,5,2,4,11,Promising
9151,144,6,20,4,1,2,7,Promising
9266,165,10,14,4,2,1,7,Promising
9616,124,10,34,4,2,3,9,Promising
9618,91,6,14,4,1,1,6,Promising
9694,10,36,64,5,4,4,13,Champions
10307,80,105,375,4,5,5,14,Champions
10328,568,5,19,2,1,2,5,Lost
10842,3654,5,6,1,1,1,3,Lost
10890,79,58,117,4,5,4,13,Champions
11583,3072,5,5,1,1,1,3,Lost
11704,1423,8,11,1,2,1,4,Lost
11723,291,7,40,3,2,3,8,Casual Users
11837,28,57,175,5,5,5,15,Champions
12524,70,140,670,4,5,5,14,Champions
12649,119,17,67,4,3,4,11,Loyal Users
12809,382,6,10,3,1,1,5,Casual Users
13308,94,41,128,4,4,4,12,Champions
13565,23,72,334,5,5,5,15,Champions
13576,15,107,293,5,5,5,15,Champions
13582,2547,28,53,1,4,3,8,At Risk
46,2433,7,14,1,2,1,4,Lost
67,3916,5,23,1,1,2,4,Lost
186,843,6,11,2,1,1,4,Lost
275,18,48,87,5,5,4,14,Champions
282,2289,5,8,1,1,1,3,Lost
605,15,51,292,5,5,5,15,Champions
802,852,15,42,2,3,3,8,Casual Users
1101,1516,7,29,1,2,2,5,Lost
1376,995,24,29,2,4,2,8,At Risk
1976,1412,12,26,1,3,2,6,Casual Users
2325,644,10,41,2,2,3,7,Lost
2341,200,27,115,3,4,4,11,Loyal Users
2504,8,50,95,5,5,4,14,Champions
2813,2728,15,70,1,3,4,8,Casual Users
2949,64,18,33,5,3,3,11,Loyal Users
2995,5001,6,6,1,1,1,3,Lost
3021,382,10,27,3,2,2,7,Casual Users
3312,595,5,24,2,1,2,5,Lost
4711,209,14,20,3,3,2,8,Loyal Users
4719,26,39,51,5,4,3,12,Loyal Users
4776,3147,6,11,1,1,1,3,Lost
4974,388,17,23,3,3,2,8,Loyal Users
5242,136,15,25,4,3,2,9,Loyal Users
5318,2592,11,17,1,2,2,5,Lost
5456,3267,5,9,1,1,1,3,Lost
5514,2107,5,13,1,1,1,3,Lost
5882,1129,5,8,2,1,1,4,Lost
6169,3169,18,37,1,3,3,7,Casual Users
7448,389,14,28,3,3,2,8,Loyal Users
7829,781,16,101,2,3,4,9,Casual Users
7946,156,5,35,4,1,3,8,Promising
8542,1426,8,11,1,2,1,4,Lost
8733,4151,5,5,1,1,1,3,Lost
8859,81,28,48,4,4,3,11,Loyal Users
9068,703,18,57,2,3,3,8,Casual Users
9496,27,76,712,5,5,5,15,Champions
9563,2544,16,42,1,3,3,7,Casual Users
9609,199,38,70,3,4,4,11,Loyal Users
9667,121,68,211,4,5,5,14,Champions
9889,80,5,6,4,1,1,6,Promising
9924,3132,10,11,1,2,1,4,Lost
10060,735,148,476,2,5,5,12,At Risk
10179,297,5,18,3,1,2,6,Casual Users
10278,110,6,54,4,1,3,8,Promising
10387,40,81,403,5,5,5,15,Champions
10628,207,8,14,3,2,1,6,Casual Users
10744,285,19,93,3,3,4,10,Loyal Users
10793,780,5,17,2,1,2,5,Lost
10814,2272,14,27,1,3,2,6,Casual Users
10908,3837,33,164,1,4,5,10,At Risk
10944,552,23,48,2,4,3,9,At Risk
10959,10,8,40,5,2,3,10,Promising
10970,1835,20,43,1,3,3,7,Casual Users
11052,3261,8,61,1,2,3,6,Lost
11131,2275,10,11,1,2,1,4,Lost
11687,585,24,27,2,4,2,8,At Risk
11702,577,17,20,2,3,2,7,Casual Users
11891,1689,10,18,1,2,2,5,Lost
11972,92,41,133,4,4,4,12,Champions
12020,137,47,95,4,5,4,13,Champions
12256,31,134,791,5,5,5,15,Champions
12490,32,51,347,5,5,5,15,Champions
12898,1649,5,6,1,1,1,3,Lost
13130,48,39,143,5,4,4,13,Champions
13269,321,5,7,3,1,1,5,Casual Users
13273,3551,7,8,1,2,1,4,Lost
13315,111,37,62,4,4,3,11,Loyal Users
311,62,86,160,5,5,5,15,Champions
535,161,5,13,4,1,1,6,Promising
873,2018,24,94,1,4,4,9,At Risk
894,1094,8,13,2,2,1,5,Lost
1534,364,48,148,3,5,5,13,Loyal Users
1851,42,178,1015,5,5,5,15,Champions
1870,415,5,8,3,1,1,5,Casual Users
1940,165,8,31,4,2,2,8,Promising
2008,17,66,638,5,5,5,15,Champions
2248,105,10,11,4,2,1,7,Promising
2586,410,6,19,3,1,2,6,Casual Users
2997,421,19,24,3,3,2,8,Loyal Users
3159,3442,5,22,1,1,2,4,Lost
3194,1454,10,55,1,2,3,6,Lost
3887,1,61,169,5,5,5,15,Champions
3939,1873,6,12,1,1,1,3,Lost
4039,238,13,31,3,3,2,8,Loyal Users
4341,529,5,9,2,1,1,4,Lost
4659,13,79,253,5,5,5,15,Champions
4810,126,22,459,4,4,5,13,Champions
4904,402,5,5,3,1,1,5,Casual Users
5009,56,126,999,5,5,5,15,Champions
5139,4017,36,335,1,4,5,10,At Risk
5198,71,41,144,4,4,4,12,Champions
5413,1127,6,11,2,1,1,4,Lost
5707,116,45,256,4,4,5,13,Champions
6423,560,17,49,2,3,3,8,Casual Users
7592,736,29,70,2,4,4,10,At Risk
7756,244,16,23,3,3,2,8,Loyal Users
7777,424,7,18,3,2,2,7,Casual Users
7834,179,23,78,3,4,4,11,Loyal Users
7893,21,119,470,5,5,5,15,Champions
7991,197,33,76,3,4,4,11,Loyal Users
8167,141,8,18,4,2,2,8,Promising
8377,20,127,449,5,5,5,15,Champions
8737,2058,5,16,1,1,2,4,Lost
9062,3,32,91,5,4,4,13,Champions
9144,75,63,94,4,5,4,13,Champions
9359,267,11,47,3,2,3,8,Casual Users
9438,2717,6,6,1,1,1,3,Lost
9713,383,15,22,3,3,2,8,Loyal Users
9860,139,10,16,4,2,2,8,Promising
10085,263,41,98,3,4,4,11,Loyal Users
10120,166,86,299,3,5,5,13,Loyal Users
10288,26,147,713,5,5,5,15,Champions
10500,0,38,114,5,4,4,13,Champions
10636,64,44,75,5,4,4,13,Champions
10876,648,16,38,2,3,3,8,Casual Users
10968,395,44,130,3,4,4,11,Loyal Users
10991,6042,27,27,1,4,2,7,At Risk
11080,1254,16,43,2,3,3,8,Casual Users
11090,3027,30,76,1,4,4,9,At Risk
11197,98,9,17,4,2,2,8,Promising
11417,1,95,173,5,5,5,15,Champions
11613,208,33,227,3,4,5,12,Loyal Users
12402,8,68,198,5,5,5,15,Champions
12527,264,19,30,3,3,2,8,Loyal Users
12599,893,8,20,2,2,2,6,Lost
12855,667,8,22,2,2,2,6,Lost
13178,106,24,44,4,4,3,11,Loyal Users
13277,1151,27,42,2,4,3,9,At Risk
616,3,23,44,5,4,3,12,Loyal Users
628,2410,5,8,1,1,1,3,Lost
632,385,42,114,3,4,4,11,Loyal Users
681,84,7,43,4,2,3,9,Promising
964,1411,16,23,1,3,2,6,Casual Users
1392,5,14,21,5,3,2,10,Loyal Users
1526,2837,86,107,1,5,4,10,At Risk
1535,4255,10,27,1,2,2,5,Lost
2017,1863,5,13,1,1,1,3,Lost
2063,1436,5,11,1,1,1,3,Lost
2382,1011,5,11,2,1,1,4,Lost
2423,780,6,13,2,1,1,4,Lost
2448,5861,5,18,1,1,2,4,Lost
2456,1235,15,43,2,3,3,8,Casual Users
2621,408,21,31,3,3,2,8,Loyal Users
3134,122,31,53,4,4,3,11,Loyal Users
3464,125,79,237,4,5,5,14,Champions
3554,1755,5,17,1,1,2,4,Lost
3581,890,5,6,2,1,1,4,Lost
4207,83,25,38,4,4,3,11,Loyal Users
4265,3284,5,10,1,1,1,3,Lost
4596,86,16,54,4,3,3,10,Loyal Users
4677,126,61,148,4,5,5,14,Champions
4701,50,105,230,5,5,5,15,Champions
5002,7,26,61,5,4,3,12,Loyal Users
5371,434,14,22,3,3,2,8,Loyal Users
5419,548,7,23,2,2,2,6,Lost
5681,39,49,236,5,5,5,15,Champions
6410,592,7,13,2,2,1,5,Lost
6546,697,9,16,2,2,2,6,Lost
6594,985,24,174,2,4,5,11,At Risk
6673,566,26,35,2,4,3,9,At Risk
7155,577,5,5,2,1,1,4,Lost
7297,35,63,239,5,5,5,15,Champions
7426,153,31,44,4,4,3,11,Loyal Users
7537,412,6,9,3,1,1,5,Casual Users
7573,152,86,148,4,5,5,14,Champions
7905,939,45,194,2,4,5,11,At Risk
7934,282,14,120,3,3,4,10,Loyal Users
8013,0,172,385,5,5,5,15,Champions
8148,167,36,72,3,4,4,11,Loyal Users
8315,137,25,53,4,4,3,11,Loyal Users
8719,333,11,17,3,2,2,7,Casual Users
9124,434,34,92,3,4,4,11,Loyal Users
9240,688,6,9,2,1,1,4,Lost
9244,1692,10,42,1,2,3,6,Lost
9304,14,29,46,5,4,3,12,Loyal Users
9525,253,11,15,3,2,1,6,Casual Users
9865,78,78,398,4,5,5,14,Champions
9869,1144,6,8,2,1,1,4,Lost
10038,472,12,78,2,3,4,9,Casual Users
10439,107,50,183,4,5,5,14,Champions
10513,503,28,59,2,4,3,9,At Risk
11078,364,17,23,3,3,2,8,Loyal Users
11092,410,12,26,3,3,2,8,Loyal Users
11276,1578,8,21,1,2,2,5,Lost
11388,575,9,42,2,2,3,7,Lost
11421,2227,6,7,1,1,1,3,Lost
11788,1630,19,34,1,3,3,7,Casual Users
11797,76,71,465,4,5,5,14,Champions
11925,1367,26,87,1,4,4,9,At Risk
11945,859,203,592,2,5,5,12,At Risk
12018,261,10,16,3,2,2,7,Casual Users
12522,744,47,124,2,5,4,11,At Risk
12979,831,81,202,2,5,5,12,At Risk
13363,1789,10,28,1,2,2,5,Lost
174,160,11,23,4,2,2,8,Promising
215,2003,5,6,1,1,1,3,Lost
410,1614,13,25,1,3,2,6,Casual Users
996,216,21,125,3,3,4,10,Loyal Users
1178,174,75,236,3,5,5,13,Loyal Users
1309,736,18,78,2,3,4,9,Casual Users
1338,54,9,25,5,2,2,9,Promising
1481,133,15,56,4,3,3,10,Loyal Users
1584,3,91,346,5,5,5,15,Champions
1674,2131,5,7,1,1,1,3,Lost
2186,2363,11,25,1,2,2,5,Lost
2287,90,48,245,4,5,5,14,Champions
2362,54,73,391,5,5,5,15,Champions
2514,151,50,95,4,5,4,13,Champions
2799,567,16,139,2,3,4,9,Casual Users
3156,109,5,5,4,1,1,6,Promising
3363,2779,6,9,1,1,1,3,Lost
3524,14,94,395,5,5,5,15,Champions
3605,234,50,184,3,5,5,13,Loyal Users
3809,732,9,48,2,2,3,7,Lost
4674,1,149,644,5,5,5,15,Champions
5019,352,5,5,3,1,1,5,Casual Users
5134,4855,5,9,1,1,1,3,Lost
5170,1097,14,63,2,3,4,9,Casual Users
5296,5524,6,21,1,1,2,4,Lost
5517,408,11,18,3,2,2,7,Casual Users
5684,4020,32,112,1,4,4,9,At Risk
5919,839,11,49,2,2,3,7,Lost
6069,28,95,404,5,5,5,15,Champions
6373,25,27,81,5,4,4,13,Champions
6427,6135,14,51,1,3,3,7,Casual Users
6871,422,18,51,3,3,3,9,Loyal Users
7456,3425,7,18,1,2,2,5,Lost
7543,843,50,122,2,5,4,11,At Risk
7790,5037,5,9,1,1,1,3,Lost
7843,542,38,113,2,4,4,10,At Risk
7904,101,5,7,4,1,1,6,Promising
8209,80,12,20,4,3,2,9,Loyal Users
8265,5,84,428,5,5,5,15,Champions
8382,845,15,74,2,3,4,9,Casual Users
8485,606,15,34,2,3,3,8,Casual Users
8625,32,19,46,5,3,3,11,Loyal Users
8709,14,54,377,5,5,5,15,Champions
8879,1629,5,6,1,1,1,3,Lost
8955,2646,6,8,1,1,1,3,Lost
9133,271,31,102,3,4,4,11,Loyal Users
9363,434,18,191,3,3,5,11,Loyal Users
9500,31,6,15,5,1,1,7,Promising
9870,154,6,9,4,1,1,6,Promising
9877,838,9,9,2,2,1,5,Lost
10145,6,83,308,5,5,5,15,Champions
10494,44,206,510,5,5,5,15,Champions
10515,13,25,40,5,4,3,12,Loyal Users
10693,1143,14,27,2,3,2,7,Casual Users
10923,1396,28,45,1,4,3,8,At Risk
11209,362,35,166,3,4,5,12,Loyal Users
11255,410,31,73,3,4,4,11,Loyal Users
12143,3138,17,52,1,3,3,7,Casual Users
12188,232,45,268,3,4,5,12,Loyal Users
12949,18,64,100,5,5,4,14,Champions
13084,1158,12,29,2,3,2,7,Casual Users
13265,0,7,22,5,2,2,9,Promising
13515,941,6,19,2,1,2,5,Lost
172,1431,6,7,1,1,1,3,Lost
562,237,5,8,3,1,1,5,Casual Users
716,2149,14,46,1,3,3,7,Casual Users
864,84,84,195,4,5,5,14,Champions
1054,150,65,135,4,5,4,13,Champions
1429,217,14,17,3,3,2,8,Loyal Users
1776,173,24,95,3,4,4,11,Loyal Users
1891,5294,17,17,1,3,2,6,Casual Users
1948,86,77,161,4,5,5,14,Champions
1999,3704,5,10,1,1,1,3,Lost
2215,803,14,19,2,3,2,7,Casual Users
2282,155,28,128,4,4,4,12,Champions
2381,266,6,10,3,1,1,5,Casual Users
2900,126,13,39,4,3,3,10,Loyal Users
2969,117,26,95,4,4,4,12,Champions
3055,1419,6,8,1,1,1,3,Lost
3057,120,44,50,4,4,3,11,Loyal Users
3555,2163,53,106,1,5,4,10,At Risk
3837,95,8,32,4,2,3,9,Promising
4179,426,10,19,3,2,2,7,Casual Users
4732,8,56,195,5,5,5,15,Champions
5073,128,40,136,4,4,4,12,Champions
5250,1656,7,16,1,2,2,5,Lost
5616,87,67,451,4,5,5,14,Champions
5665,13,63,164,5,5,5,15,Champions
5837,1421,8,9,1,2,1,4,Lost
5863,65,14,44,5,3,3,11,Loyal Users
6104,1163,8,25,2,2,2,6,Lost
6699,91,19,101,4,3,4,11,Loyal Users
6828,434,5,9,3,1,1,5,Casual Users
6930,50,12,17,5,3,2,10,Loyal Users
6972,181,10,16,3,2,2,7,Casual Users
7224,47,11,26,5,2,2,9,Promising
7364,1706,6,9,1,1,1,3,Lost
7498,2,34,64,5,4,4,13,Champions
7527,1287,6,18,1,1,2,4,Lost
7822,582,14,23,2,3,2,7,Casual Users
8048,0,84,481,5,5,5,15,Champions
8101,1233,7,10,2,2,1,5,Lost
8920,283,30,54,3,4,3,10,Loyal Users
9050,215,46,243,3,5,5,13,Loyal Users
9897,1280,10,22,1,2,2,5,Lost
9978,2240,8,63,1,2,4,7,Lost
10071,114,8,24,4,2,2,8,Promising
10076,2207,24,43,1,4,3,8,At Risk
10324,2143,5,11,1,1,1,3,Lost
10437,2744,8,15,1,2,1,4,Lost
10546,3940,6,6,1,1,1,3,Lost
10730,1202,8,31,2,2,2,6,Lost
10783,287,25,90,3,4,4,11,Loyal Users
10809,700,17,195,2,3,5,10,Casual Users
11157,115,7,25,4,2,2,8,Promising
11268,136,43,62,4,4,3,11,Loyal Users
11486,16,160,692,5,5,5,15,Champions
11643,137,16,56,4,3,3,10,Loyal Users
11774,859,30,62,2,4,3,9,At Risk
11813,2050,9,15,1,2,1,4,Lost
12159,274,16,23,3,3,2,8,Loyal Users
12240,128,75,149,4,5,5,14,Champions
12413,453,8,10,3,2,1,6,Casual Users
12732,4,102,661,5,5,5,15,Champions
12733,10,42,105,5,4,4,13,Champions
13445,2494,26,34,1,4,3,8,At Risk
13472,668,7,10,2,2,1,5,Lost
13473,109,10,14,4,2,1,7,Promising
13530,1111,8,14,2,2,1,5,Lost
13539,1049,11,12,2,2,1,5,Lost
252,428,7,38,3,2,3,8,Casual Users
399,201,19,30,3,3,2,8,Loyal Users
551,877,13,27,2,3,2,7,Casual Users
1063,94,13,23,4,3,2,9,Loyal Users
1067,259,27,113,3,4,4,11,Loyal Users
1411,429,54,207,3,5,5,13,Loyal Users
1630,2438,7,12,1,2,1,4,Lost
1676,2049,13,25,1,3,2,6,Casual Users
1862,5,111,397,5,5,5,15,Champions
2175,790,6,29,2,1,2,5,Lost
2289,258,32,64,3,4,4,11,Loyal Users
2340,3726,5,12,1,1,1,3,Lost
2500,105,32,165,4,4,5,13,Champions
2639,1014,12,28,2,3,2,7,Casual Users
2676,549,23,30,2,4,2,8,At Risk
2745,15,16,25,5,3,2,10,Loyal Users
2815,283,10,16,3,2,2,7,Casual Users
2913,583,10,17,2,2,2,6,Lost
2976,18,28,96,5,4,4,13,Champions
3221,1128,11,12,2,2,1,5,Lost
3701,554,9,19,2,2,2,6,Lost
3838,439,12,28,3,3,2,8,Loyal Users
3929,445,9,12,3,2,1,6,Casual Users
4108,108,152,358,4,5,5,14,Champions
4303,115,7,9,4,2,1,7,Promising
4744,414,13,68,3,3,4,10,Loyal Users
4749,227,66,366,3,5,5,13,Loyal Users
5685,34,36,47,5,4,3,12,Loyal Users
5690,5208,9,9,1,2,1,4,Lost
5753,458,50,112,3,5,4,12,Loyal Users
6061,13,59,90,5,5,4,14,Champions
6233,99,18,54,4,3,3,10,Loyal Users
6649,17,7,9,5,2,1,8,Promising
6964,490,6,13,2,1,1,4,Lost
6995,115,32,66,4,4,4,12,Champions
7104,295,10,12,3,2,1,6,Casual Users
7141,155,82,297,4,5,5,14,Champions
7627,677,7,15,2,2,1,5,Lost
8057,1410,9,43,1,2,3,6,Lost
8275,566,21,129,2,3,4,9,Casual Users
8294,1530,17,45,1,3,3,7,Casual Users
8362,274,6,36,3,1,3,7,Casual Users
8471,122,39,87,4,4,4,12,Champions
8517,120,7,8,4,2,1,7,Promising
9111,435,11,34,3,2,3,8,Casual Users
9321,1056,90,196,2,5,5,12,At Risk
9893,82,16,113,4,3,4,11,Loyal Users
10156,450,39,87,3,4,4,11,Loyal Users
10232,155,51,125,4,5,4,13,Champions
10533,305,24,69,3,4,4,11,Loyal Users
10624,180,36,149,3,4,5,12,Loyal Users
11074,283,23,68,3,4,4,11,Loyal Users
11100,89,12,12,4,3,1,8,Loyal Users
11218,1122,7,17,2,2,2,6,Lost
12438,118,5,10,4,1,1,6,Promising
12502,0,71,333,5,5,5,15,Champions
12600,24,51,174,5,5,5,15,Champions
12656,1139,16,25,2,3,2,7,Casual Users
12852,4652,37,89,1,4,4,9,At Risk
13243,108,48,264,4,5,5,14,Champions
144,68,66,130,5,5,4,14,Champions
153,1727,13,27,1,3,2,6,Casual Users
420,410,8,15,3,2,1,6,Casual Users
705,9,21,67,5,3,4,12,Loyal Users
785,684,11,24,2,2,2,6,Lost
851,791,32,129,2,4,4,10,At Risk
1013,820,48,90,2,5,4,11,At Risk
1109,66,15,106,5,3,4,12,Loyal Users
1278,24,14,20,5,3,2,10,Loyal Users
1640,1653,5,6,1,1,1,3,Lost
1710,423,6,7,3,1,1,5,Casual Users
1962,790,21,37,2,3,3,8,Casual Users
2295,5093,10,94,1,2,4,7,Lost
2528,363,35,112,3,4,4,11,Loyal Users
2963,35,76,582,5,5,5,15,Champions
3236,1058,5,10,2,1,1,4,Lost
3949,82,7,34,4,2,3,9,Promising
3980,1410,10,51,1,2,3,6,Lost
4019,504,13,26,2,3,2,7,Casual Users
4222,4737,5,14,1,1,1,3,Lost
4337,3179,14,24,1,3,2,6,Casual Users
4430,1545,15,45,1,3,3,7,Casual Users
4598,152,55,96,4,5,4,13,Champions
4602,325,35,291,3,4,5,12,Loyal Users
4982,1550,13,27,1,3,2,6,Casual Users
4986,36,20,134,5,3,4,12,Loyal Users
5275,12,11,22,5,2,2,9,Promising
5441,1839,5,10,1,1,1,3,Lost
5622,16,91,361,5,5,5,15,Champions
5721,3314,32,58,1,4,3,8,At Risk
6058,1,35,90,5,4,4,13,Champions
6315,988,11,18,2,2,2,6,Lost
6424,1864,6,18,1,1,2,4,Lost
6615,438,61,146,3,5,4,12,Loyal Users
6680,1293,19,61,1,3,3,7,Casual Users
6916,12,48,182,5,5,5,15,Champions
7135,3288,8,35,1,2,3,6,Lost
7246,855,12,69,2,3,4,9,Casual Users
7384,884,9,19,2,2,2,6,Lost
7679,2058,13,25,1,3,2,6,Casual Users
7955,168,11,31,3,2,2,7,Casual Users
8072,75,121,573,4,5,5,14,Champions
8304,77,97,230,4,5,5,14,Champions
8358,280,7,20,3,2,2,7,Casual Users
8597,1155,13,18,2,3,2,7,Casual Users
8618,34,18,26,5,3,2,10,Loyal Users
8710,1413,21,99,1,3,4,8,Casual Users
8843,313,9,12,3,2,1,6,Casual Users
8974,152,14,26,4,3,2,9,Loyal Users
9382,840,5,7,2,1,1,4,Lost
9529,27,7,39,5,2,3,10,Promising
9589,12,63,375,5,5,5,15,Champions
9666,550,24,94,2,4,4,10,At Risk
9704,1419,7,9,1,2,1,4,Lost
9788,1152,5,7,2,1,1,4,Lost
10217,1170,5,6,2,1,1,4,Lost
10929,515,14,18,2,3,2,7,Casual Users
11064,3010,6,16,1,1,2,4,Lost
11093,2163,13,31,1,3,2,6,Casual Users
11128,139,6,11,4,1,1,6,Promising
11166,72,6,12,4,1,1,6,Promising
11716,694,13,27,2,3,2,7,Casual Users
11855,453,28,33,3,4,3,10,Loyal Users
11899,35,64,162,5,5,5,15,Champions
12105,160,40,65,4,4,4,12,Champions
12121,657,14,20,2,3,2,7,Casual Users
12164,19,10,19,5,2,2,9,Promising
12255,2425,8,13,1,2,1,4,Lost
12754,570,30,35,2,4,3,9,At Risk
12941,92,38,91,4,4,4,12,Champions
13183,397,36,53,3,4,3,10,Loyal Users
670,1954,10,16,1,2,2,5,Lost
745,35,58,236,5,5,5,15,Champions
927,2396,6,7,1,1,1,3,Lost
949,3,183,571,5,5,5,15,Champions
1174,290,12,17,3,3,2,8,Loyal Users
1734,1408,13,20,1,3,2,6,Casual Users
1867,0,53,188,5,5,5,15,Champions
2002,310,36,52,3,4,3,10,Loyal Users
2301,1531,12,123,1,3,4,8,Casual Users
2645,491,29,170,2,4,5,11,At Risk
2658,557,13,26,2,3,2,7,Casual Users
2830,129,7,11,4,2,1,7,Promising
3271,1955,8,47,1,2,3,6,Lost
3308,1470,18,37,1,3,3,7,Casual Users
3705,2292,5,6,1,1,1,3,Lost
3853,363,7,23,3,2,2,7,Casual Users
3901,732,14,49,2,3,3,8,Casual Users
4331,268,7,13,3,2,1,6,Casual Users
4398,3418,20,30,1,3,2,6,Casual Users
4600,380,18,95,3,3,4,10,Loyal Users
4621,124,5,16,4,1,2,7,Promising
5169,736,16,90,2,3,4,9,Casual Users
5436,25,83,261,5,5,5,15,Champions
5877,977,5,11,2,1,1,4,Lost
5994,217,5,9,3,1,1,5,Casual Users
6133,1288,20,48,1,3,3,7,Casual Users
6526,17,131,564,5,5,5,15,Champions
6885,504,10,11,2,2,1,5,Lost
6998,1413,6,17,1,1,2,4,Lost
7255,155,17,34,4,3,3,10,Loyal Users
7399,271,72,122,3,5,4,12,Loyal Users
7507,10,5,6,5,1,1,7,Promising
7760,127,10,42,4,2,3,9,Promising
8214,0,52,146,5,5,4,14,Champions
8259,34,79,479,5,5,5,15,Champions
8289,110,19,91,4,3,4,11,Loyal Users
8420,408,50,232,3,5,5,13,Loyal Users
8433,32,39,64,5,4,4,13,Champions
8518,428,6,9,3,1,1,5,Casual Users
8871,1086,18,112,2,3,4,9,Casual Users
8897,220,24,203,3,4,5,12,Loyal Users
8900,250,37,161,3,4,5,12,Loyal Users
9437,1292,18,21,1,3,2,6,Casual Users
9453,405,42,71,3,4,4,11,Loyal Users
9457,816,19,21,2,3,2,7,Casual Users
10242,1875,6,21,1,1,2,4,Lost
10275,915,7,28,2,2,2,6,Lost
10399,1570,5,16,1,1,2,4,Lost
10762,123,7,11,4,2,1,7,Promising
10789,404,8,15,3,2,1,6,Casual Users
11864,1498,7,29,1,2,2,5,Lost
12189,532,5,6,2,1,1,4,Lost
12314,1824,6,28,1,1,2,4,Lost
12376,427,23,133,3,4,4,11,Loyal Users
12698,262,10,18,3,2,2,7,Casual Users
12813,684,10,29,2,2,2,6,Lost
12982,536,12,19,2,3,2,7,Casual Users
13192,1631,11,18,1,2,2,5,Lost
13360,1097,7,22,2,2,2,6,Lost
13404,153,9,33,4,2,3,9,Promising
13487,126,26,38,4,4,3,11,Loyal Users
18,4493,9,16,1,2,2,5,Lost
475,298,19,62,3,3,3,9,Loyal Users
947,11,13,34,5,3,3,11,Loyal Users
1044,4018,5,10,1,1,1,3,Lost
1246,77,66,130,4,5,4,13,Champions
1292,1411,6,7,1,1,1,3,Lost
1361,25,7,8,5,2,1,8,Promising
1719,416,18,35,3,3,3,9,Loyal Users
1741,863,11,63,2,2,4,8,Lost
1762,242,27,186,3,4,5,12,Loyal Users
1768,13,60,284,5,5,5,15,Champions
1900,221,23,38,3,4,3,10,Loyal Users
1929,285,36,93,3,4,4,11,Loyal Users
2066,295,6,19,3,1,2,6,Casual Users
2117,414,52,135,3,5,4,12,Loyal Users
2425,217,110,161,3,5,5,13,Loyal Users
2501,183,6,8,3,1,1,5,Casual Users
2507,104,59,249,4,5,5,14,Champions
2626,112,18,98,4,3,4,11,Loyal Users
2859,44,46,482,5,5,5,15,Champions
3148,38,20,57,5,3,3,11,Loyal Users
3394,1964,8,10,1,2,1,4,Lost
3395,147,11,12,4,2,1,7,Promising
3769,1720,18,117,1,3,4,8,Casual Users
3831,33,69,150,5,5,5,15,Champions
3874,108,34,150,4,4,5,13,Champions
4310,1423,11,23,1,2,2,5,Lost
4330,1748,7,12,1,2,1,4,Lost
4549,64,48,106,5,5,4,14,Champions
4707,411,5,5,3,1,1,5,Casual Users
4795,4122,11,11,1,2,1,4,Lost
4941,1873,5,40,1,1,3,5,Lost
5380,269,9,10,3,2,1,6,Casual Users
5706,101,55,515,4,5,5,14,Champions
5831,4854,12,20,1,3,2,6,Casual Users
5908,647,8,9,2,2,1,5,Lost
6118,27,75,202,5,5,5,15,Champions
6209,1659,17,26,1,3,2,6,Casual Users
6247,264,9,55,3,2,3,8,Casual Users
6352,318,12,23,3,3,2,8,Loyal Users
6527,8,101,310,5,5,5,15,Champions
6628,256,20,125,3,3,4,10,Loyal Users
6735,857,15,23,2,3,2,7,Casual Users
7196,2812,16,42,1,3,3,7,Casual Users
7390,150,49,124,4,5,4,13,Champions
7459,708,25,75,2,4,4,10,At Risk
7635,553,17,20,2,3,2,7,Casual Users
7858,1651,12,84,1,3,4,8,Casual Users
8235,282,24,96,3,4,4,11,Loyal Users
8466,2536,5,28,1,1,2,4,Lost
8796,230,10,22,3,2,2,7,Casual Users
8918,285,54,71,3,5,4,12,Loyal Users
8919,4412,13,15,1,3,1,5,Casual Users
9129,544,15,49,2,3,3,8,Casual Users
9199,2155,13,28,1,3,2,6,Casual Users
9250,107,68,81,4,5,4,13,Champions
9381,1120,17,42,2,3,3,8,Casual Users
9599,268,15,40,3,3,3,9,Loyal Users
9795,1222,5,5,2,1,1,4,Lost
10192,2130,17,33,1,3,3,7,Casual Users
10581,109,7,54,4,2,3,9,Promising
10711,33,46,255,5,5,5,15,Champions
10853,280,65,364,3,5,5,13,Loyal Users
11499,1144,6,11,2,1,1,4,Lost
11552,4483,18,26,1,3,2,6,Casual Users
11758,71,8,9,4,2,1,7,Promising
12021,1896,5,14,1,1,1,3,Lost
12177,1073,27,71,2,4,4,10,At Risk
12399,109,16,71,4,3,4,11,Loyal Users
12448,729,31,57,2,4,3,9,At Risk
12451,894,30,51,2,4,3,9,At Risk
12968,679,7,8,2,2,1,5,Lost
13129,313,42,51,3,4,3,10,Loyal Users
13232,3661,9,15,1,2,1,4,Lost
74,672,7,31,2,2,2,6,Lost
138,144,30,46,4,4,3,11,Loyal Users
755,296,17,44,3,3,3,9,Loyal Users
934,163,26,143,4,4,4,12,Champions
1097,153,64,119,4,5,4,13,Champions
1117,40,48,180,5,5,5,15,Champions
1204,1888,6,6,1,1,1,3,Lost
1258,44,9,128,5,2,4,11,Promising
1424,281,10,15,3,2,1,6,Casual Users
1713,244,14,103,3,3,4,10,Loyal Users
1928,274,27,43,3,4,3,10,Loyal Users
2095,3968,38,69,1,4,4,9,At Risk
2377,14,12,21,5,3,2,10,Loyal Users
2509,610,15,50,2,3,3,8,Casual Users
2570,2541,5,9,1,1,1,3,Lost
2982,711,58,88,2,5,4,11,At Risk
3583,132,35,154,4,4,5,13,Champions
3729,3313,5,5,1,1,1,3,Lost
4121,2440,5,8,1,1,1,3,Lost
4171,2318,8,12,1,2,1,4,Lost
4196,44,100,320,5,5,5,15,Champions
4373,49,83,221,5,5,5,15,Champions
4574,141,24,37,4,4,3,11,Loyal Users
4985,374,57,145,3,5,4,12,Loyal Users
5034,406,28,70,3,4,4,11,Loyal Users
5582,121,8,9,4,2,1,7,Promising
5673,117,36,245,4,4,5,13,Champions
6033,249,8,8,3,2,1,6,Casual Users
6083,94,48,93,4,5,4,13,Champions
7443,5,89,145,5,5,4,14,Champions
7729,84,34,96,4,4,4,12,Champions
7747,1205,6,6,2,1,1,4,Lost
7869,1422,15,30,1,3,2,6,Casual Users
7927,146,10,28,4,2,2,8,Promising
8065,3326,6,12,1,1,1,3,Lost
8183,1131,5,31,2,1,2,5,Lost
8319,12,106,551,5,5,5,15,Champions
8599,102,126,412,4,5,5,14,Champions
8603,1653,5,17,1,1,2,4,Lost
8644,422,32,58,3,4,3,10,Loyal Users
8882,130,12,93,4,3,4,11,Loyal Users
8948,239,15,27,3,3,2,8,Loyal Users
9208,1055,11,50,2,2,3,7,Lost
9851,156,9,31,4,2,2,8,Promising
9884,548,14,30,2,3,2,7,Casual Users
10191,24,83,263,5,5,5,15,Champions
10642,1959,8,59,1,2,3,6,Lost
10836,1847,21,33,1,3,3,7,Casual Users
10887,411,14,34,3,3,3,9,Loyal Users
10933,123,8,66,4,2,4,10,Promising
10988,402,11,23,3,2,2,7,Casual Users
11095,4,8,13,5,2,1,8,Promising
11150,101,9,22,4,2,2,8,Promising
11340,101,24,69,4,4,4,12,Champions
11359,820,7,11,2,2,1,5,Lost
11371,76,32,66,4,4,4,12,Champions
11794,627,5,7,2,1,1,4,Lost
12206,267,32,59,3,4,3,10,Loyal Users
12354,130,13,37,4,3,3,10,Loyal Users
12680,394,23,42,3,4,3,10,Loyal Users
12756,2,17,54,5,3,3,11,Loyal Users
13126,83,35,137,4,4,4,12,Champions
13203,289,35,97,3,4,4,11,Loyal Users
13284,592,12,24,2,3,2,7,Casual Users
13480,1780,5,19,1,1,2,4,Lost
104,407,13,73,3,3,4,10,Loyal Users
180,24,83,370,5,5,5,15,Champions
468,3907,5,9,1,1,1,3,Lost
483,399,24,49,3,4,3,10,Loyal Users
643,1206,6,93,2,1,4,7,Lost
656,121,23,74,4,4,4,12,Champions
917,0,25,72,5,4,4,13,Champions
932,18,72,401,5,5,5,15,Champions
1416,2268,7,27,1,2,2,5,Lost
1803,981,18,106,2,3,4,9,Casual Users
2118,135,26,42,4,4,3,11,Loyal Users
2140,4819,7,11,1,2,1,4,Lost
2265,11,147,182,5,5,5,15,Champions
2673,277,19,57,3,3,3,9,Loyal Users
2700,408,26,58,3,4,3,10,Loyal Users
2838,9,71,121,5,5,4,14,Champions
2979,1651,16,30,1,3,2,6,Casual Users
3227,254,46,63,3,5,4,12,Loyal Users
3368,20,80,115,5,5,4,14,Champions
3416,44,12,68,5,3,4,12,Loyal Users
3470,441,46,166,3,5,5,13,Loyal Users
3596,2015,12,48,1,3,3,7,Casual Users
3870,663,16,28,2,3,2,7,Casual Users
4467,92,37,62,4,4,3,11,Loyal Users
5435,1999,14,51,1,3,3,7,Casual Users
5455,145,39,224,4,4,5,13,Champions
5477,101,17,87,4,3,4,11,Loyal Users
5544,1497,99,332,1,5,5,11,At Risk
5565,575,11,21,2,2,2,6,Lost
5636,703,27,48,2,4,3,9,At Risk
5754,101,7,9,4,2,1,7,Promising
5802,424,38,365,3,4,5,12,Loyal Users
5809,146,9,38,4,2,3,9,Promising
6039,132,42,85,4,4,4,12,Champions
6092,143,36,117,4,4,4,12,Champions
6413,3255,9,11,1,2,1,4,Lost
6485,409,17,25,3,3,2,8,Loyal Users
6544,3337,5,48,1,1,3,5,Lost
6590,139,9,22,4,2,2,8,Promising
6790,10,13,25,5,3,2,10,Loyal Users
7062,293,7,65,3,2,4,9,Casual Users
7245,372,18,38,3,3,3,9,Loyal Users
7609,12,26,112,5,4,4,13,Champions
7811,4727,5,9,1,1,1,3,Lost
7917,359,20,52,3,3,3,9,Loyal Users
8190,100,184,560,4,5,5,14,Champions
8278,5,48,345,5,5,5,15,Champions
8394,9,120,305,5,5,5,15,Champions
8422,917,5,23,2,1,2,5,Lost
8439,139,9,17,4,2,2,8,Promising
8502,527,28,101,2,4,4,10,At Risk
8764,238,61,316,3,5,5,13,Loyal Users
8831,825,16,33,2,3,3,8,Casual Users
9109,83,17,28,4,3,2,9,Loyal Users
9543,12,88,345,5,5,5,15,Champions
9626,1418,21,63,1,3,4,8,Casual Users
9645,163,112,382,4,5,5,14,Champions
9799,823,6,12,2,1,1,4,Lost
10189,253,21,83,3,3,4,10,Loyal Users
10678,1840,10,51,1,2,3,6,Lost
10827,441,5,7,3,1,1,5,Casual Users
10893,546,7,10,2,2,1,5,Lost
11267,1095,5,30,2,1,2,5,Lost
11807,951,12,42,2,3,3,8,Casual Users
11827,6,141,224,5,5,5,15,Champions
12074,269,10,17,3,2,2,7,Casual Users
12214,2,108,384,5,5,5,15,Champions
12375,993,23,52,2,4,3,9,At Risk
12476,4469,15,59,1,3,3,7,Casual Users
12701,52,112,191,5,5,5,15,Champions
13276,2205,15,15,1,3,1,5,Casual Users
134,426,11,18,3,2,2,7,Casual Users
584,2630,6,12,1,1,1,3,Lost
841,1851,7,13,1,2,1,4,Lost
878,38,85,218,5,5,5,15,Champions
991,796,84,164,2,5,5,12,At Risk
1857,34,6,10,5,1,1,7,Promising
1933,3,146,201,5,5,5,15,Champions
2110,24,36,82,5,4,4,13,Champions
2182,282,63,182,3,5,5,13,Loyal Users
2417,310,12,55,3,3,3,9,Loyal Users
2546,301,21,27,3,3,2,8,Loyal Users
2973,395,20,33,3,3,3,9,Loyal Users
3088,273,7,23,3,2,2,7,Casual Users
3291,904,5,7,2,1,1,4,Lost
4214,1431,5,7,1,1,1,3,Lost
4234,2,22,39,5,4,3,12,Loyal Users
4367,676,34,104,2,4,4,10,At Risk
4797,122,40,61,4,4,3,11,Loyal Users
5083,1004,9,58,2,2,3,7,Lost
5107,968,11,30,2,2,2,6,Lost
5301,280,68,186,3,5,5,13,Loyal Users
5566,591,8,8,2,2,1,5,Lost
5901,101,32,232,4,4,5,13,Champions
6025,854,9,17,2,2,2,6,Lost
6131,294,98,167,3,5,5,13,Loyal Users
6205,683,8,19,2,2,2,6,Lost
6428,240,7,57,3,2,3,8,Casual Users
6696,227,6,38,3,1,3,7,Casual Users
6908,409,45,137,3,4,4,11,Loyal Users
7565,807,11,34,2,2,3,7,Lost
7770,414,71,148,3,5,5,13,Loyal Users
8096,19,139,388,5,5,5,15,Champions
8317,993,11,27,2,2,2,6,Lost
9048,14,75,324,5,5,5,15,Champions
9082,860,16,24,2,3,2,7,Casual Users
9518,6,9,18,5,2,2,9,Promising
9532,43,30,83,5,4,4,13,Champions
9673,539,5,7,2,1,1,4,Lost
10383,1055,13,15,2,3,1,6,Casual Users
10488,226,8,20,3,2,2,7,Casual Users
10936,809,28,118,2,4,4,10,At Risk
11230,751,35,52,2,4,3,9,At Risk
11324,88,164,535,4,5,5,14,Champions
11434,407,9,33,3,2,3,8,Casual Users
12250,371,6,16,3,1,2,6,Casual Users
12406,1691,8,9,1,2,1,4,Lost
12437,4,199,541,5,5,5,15,Champions
12602,1273,7,11,1,2,1,4,Lost
12692,269,112,549,3,5,5,13,Loyal Users
12793,1258,13,18,1,3,2,6,Casual Users
12912,1751,8,24,1,2,2,5,Lost
12933,124,26,143,4,4,4,12,Champions
13161,8,32,161,5,4,5,14,Champions
407,137,62,91,4,5,4,13,Champions
521,574,8,12,2,2,1,5,Lost
788,1957,12,23,1,3,2,6,Casual Users
2184,6,66,159,5,5,5,15,Champions
2643,197,22,61,3,4,3,10,Loyal Users
2730,627,8,11,2,2,1,5,Lost
2733,601,15,140,2,3,4,9,Casual Users
3345,579,11,17,2,2,2,6,Lost
4106,2695,6,10,1,1,1,3,Lost
4178,57,68,88,5,5,4,14,Champions
4811,3840,7,31,1,2,2,5,Lost
5389,151,21,53,4,3,3,10,Loyal Users
5403,1663,8,10,1,2,1,4,Lost
5530,13,9,16,5,2,2,9,Promising
5833,10,34,114,5,4,4,13,Champions
5848,422,69,159,3,5,5,13,Loyal Users
6484,1427,9,20,1,2,2,5,Lost
6524,10,52,177,5,5,5,15,Champions
6599,114,98,571,4,5,5,14,Champions
6604,1090,8,12,2,2,1,5,Lost
6799,575,82,114,2,5,4,11,At Risk
6943,170,16,182,3,3,5,11,Loyal Users
7043,66,32,260,5,4,5,14,Champions
7129,4894,7,28,1,2,2,5,Lost
7164,740,25,50,2,4,3,9,At Risk
7232,48,13,31,5,3,2,10,Loyal Users
7482,2409,15,97,1,3,4,8,Casual Users
7885,251,24,133,3,4,4,11,Loyal Users
7888,2880,11,42,1,2,3,6,Lost
8345,18,45,128,5,4,4,13,Champions
8771,795,5,7,2,1,1,4,Lost
8836,144,6,10,4,1,1,6,Promising
9277,12,196,614,5,5,5,15,Champions
9372,385,11,23,3,2,2,7,Casual Users
9419,308,11,23,3,2,2,7,Casual Users
9680,146,31,109,4,4,4,12,Champions
9843,536,8,14,2,2,1,5,Lost
9908,3544,13,35,1,3,3,7,Casual Users
10420,2262,5,8,1,1,1,3,Lost
10467,19,64,441,5,5,5,15,Champions
10566,1410,5,30,1,1,2,4,Lost
10691,145,26,35,4,4,3,11,Loyal Users
10719,0,74,253,5,5,5,15,Champions
10855,449,15,19,3,3,2,8,Loyal Users
10878,4417,5,11,1,1,1,3,Lost
11485,133,23,170,4,4,5,13,Champions
11926,5681,15,21,1,3,2,6,Casual Users
12773,1767,15,87,1,3,4,8,Casual Users
12840,3789,8,13,1,2,1,4,Lost
13262,27,60,184,5,5,5,15,Champions
13292,2712,9,19,1,2,2,5,Lost
13557,42,82,463,5,5,5,15,Champions
617,3440,6,10,1,1,1,3,Lost
701,121,44,76,4,4,4,12,Champions
963,132,27,82,4,4,4,12,Champions
1009,1570,37,140,1,4,4,9,At Risk
1107,2296,5,12,1,1,1,3,Lost
1387,88,17,40,4,3,3,10,Loyal Users
2021,405,12,121,3,3,4,10,Loyal Users
2599,4000,5,14,1,1,1,3,Lost
2690,130,33,131,4,4,4,12,Champions
2713,12,14,50,5,3,3,11,Loyal Users
3542,101,9,18,4,2,2,8,Promising
3688,110,28,115,4,4,4,12,Champions
3696,830,10,27,2,2,2,6,Lost
3782,4,75,119,5,5,4,14,Champions
3993,854,13,35,2,3,3,8,Casual Users
4232,427,11,28,3,2,2,7,Casual Users
4421,1078,17,58,2,3,3,8,Casual Users
4607,2253,10,21,1,2,2,5,Lost
5289,0,69,354,5,5,5,15,Champions
5979,121,48,283,4,5,5,14,Champions
6117,428,8,88,3,2,4,9,Casual Users
6135,1276,31,83,1,4,4,9,At Risk
6278,3424,7,72,1,2,4,7,Lost
6407,188,51,500,3,5,5,13,Loyal Users
6496,159,36,234,4,4,5,13,Champions
6542,4869,17,25,1,3,2,6,Casual Users
6794,14,78,173,5,5,5,15,Champions
6804,30,39,115,5,4,4,13,Champions
7000,3597,13,16,1,3,2,6,Casual Users
7040,30,52,174,5,5,5,15,Champions
7310,300,19,104,3,3,4,10,Loyal Users
7385,97,99,634,4,5,5,14,Champions
7505,88,80,376,4,5,5,14,Champions
7762,2554,5,17,1,1,2,4,Lost
7943,395,19,43,3,3,3,9,Loyal Users
8251,383,8,53,3,2,3,8,Casual Users
8261,138,48,147,4,5,5,14,Champions
8437,540,13,84,2,3,4,9,Casual Users
8527,11,40,183,5,4,5,14,Champions
8559,876,7,12,2,2,1,5,Lost
9348,127,19,72,4,3,4,11,Loyal Users
9509,109,19,46,4,3,3,10,Loyal Users
10034,2418,8,14,1,2,1,4,Lost
10262,154,51,101,4,5,4,13,Champions
10481,81,18,53,4,3,3,10,Loyal Users
10834,109,58,117,4,5,4,13,Champions
10857,391,16,73,3,3,4,10,Loyal Users
10921,1179,10,20,2,2,2,6,Lost
11018,395,14,14,3,3,1,7,Loyal Users
11229,103,5,33,4,1,3,8,Promising
11246,1985,9,13,1,2,1,4,Lost
11831,277,9,16,3,2,2,7,Casual Users
12213,542,10,64,2,2,4,8,Lost
12516,4197,6,35,1,1,3,5,Lost
12664,1123,18,34,2,3,3,8,Casual Users
12771,150,10,34,4,2,3,9,Promising
12785,40,59,614,5,5,5,15,Champions
12795,156,5,8,4,1,1,6,Promising
13114,90,61,177,4,5,5,14,Champions
13306,418,53,234,3,5,5,13,Loyal Users
13317,3276,10,18,1,2,2,5,Lost
36,2570,6,43,1,1,3,5,Lost
187,1968,23,27,1,4,2,7,At Risk
208,120,40,100,4,4,4,12,Champions
315,77,73,312,4,5,5,14,Champions
393,1152,13,24,2,3,2,7,Casual Users
954,683,10,51,2,2,3,7,Lost
1217,125,12,16,4,3,2,9,Loyal Users
1277,304,12,38,3,3,3,9,Loyal Users
1359,2450,5,13,1,1,1,3,Lost
1656,21,58,75,5,5,4,14,Champions
1882,129,9,14,4,2,1,7,Promising
1993,118,17,30,4,3,2,9,Loyal Users
2057,93,55,114,4,5,4,13,Champions
2086,1569,5,5,1,1,1,3,Lost
2208,1415,16,43,1,3,3,7,Casual Users
2370,300,10,22,3,2,2,7,Casual Users
2454,11,5,12,5,1,1,7,Promising
2511,301,70,181,3,5,5,13,Loyal Users
2558,114,32,41,4,4,3,11,Loyal Users
2746,65,26,106,5,4,4,13,Champions
3046,129,38,56,4,4,3,11,Loyal Users
3381,1448,6,9,1,1,1,3,Lost
3402,1980,20,100,1,3,4,8,Casual Users
3444,997,29,127,2,4,4,10,At Risk
3568,3386,6,15,1,1,1,3,Lost
3712,683,8,45,2,2,3,7,Lost
3778,973,7,7,2,2,1,5,Lost
3846,262,12,16,3,3,2,8,Loyal Users
4319,154,13,198,4,3,5,12,Loyal Users
4380,835,5,32,2,1,3,6,Lost
4484,5448,6,6,1,1,1,3,Lost
4513,428,6,8,3,1,1,5,Casual Users
4618,5010,14,122,1,3,4,8,Casual Users
5133,796,5,11,2,1,1,4,Lost
5745,2,32,100,5,4,4,13,Champions
5883,62,6,9,5,1,1,7,Promising
5990,234,14,76,3,3,4,10,Loyal Users
6459,1752,14,15,1,3,1,5,Casual Users
6905,6,92,267,5,5,5,15,Champions
6942,440,5,14,3,1,1,5,Casual Users
7475,120,16,46,4,3,3,10,Loyal Users
7624,605,5,10,2,1,1,4,Lost
7797,178,33,151,3,4,5,12,Loyal Users
8282,2317,43,79,1,4,4,9,At Risk
8414,2,73,143,5,5,4,14,Champions
8543,274,10,14,3,2,1,6,Casual Users
8754,28,32,61,5,4,3,12,Loyal Users
8838,210,33,86,3,4,4,11,Loyal Users
9460,231,10,42,3,2,3,8,Casual Users
9671,636,27,77,2,4,4,10,At Risk
10064,144,69,110,4,5,4,13,Champions
10110,455,15,39,3,3,3,9,Loyal Users
10218,4,11,55,5,2,3,10,Promising
10941,148,5,15,4,1,1,6,Promising
11122,526,8,8,2,2,1,5,Lost
11205,1311,19,140,1,3,4,8,Casual Users
11409,148,77,138,4,5,4,13,Champions
11632,83,7,16,4,2,2,8,Promising
11860,90,19,59,4,3,3,10,Loyal Users
11871,89,23,52,4,4,3,11,Loyal Users
11969,924,15,57,2,3,3,8,Casual Users
12205,125,9,45,4,2,3,9,Promising
12407,784,35,90,2,4,4,10,At Risk
12422,258,12,16,3,3,2,8,Loyal Users
12682,5,128,298,5,5,5,15,Champions
12922,511,19,40,2,3,3,8,Casual Users
12971,943,30,66,2,4,4,10,At Risk
12973,1129,9,9,2,2,1,5,Lost
13420,2250,7,29,1,2,2,5,Lost
13526,1648,10,35,1,2,3,6,Lost
89,1594,8,21,1,2,2,5,Lost
401,124,34,247,4,4,5,13,Champions
422,965,8,22,2,2,2,6,Lost
517,313,11,16,3,2,2,7,Casual Users
1138,570,20,45,2,3,3,8,Casual Users
1413,1157,16,42,2,3,3,8,Casual Users
1476,205,18,93,3,3,4,10,Loyal Users
2310,104,19,40,4,3,3,10,Loyal Users
2376,19,6,10,5,1,1,7,Promising
2457,152,64,350,4,5,5,14,Champions
2487,361,30,82,3,4,4,11,Loyal Users
2555,208,139,211,3,5,5,13,Loyal Users
2706,23,10,25,5,2,2,9,Promising
2965,161,45,79,4,4,4,12,Champions
3050,671,20,71,2,3,4,9,Casual Users
3053,24,9,11,5,2,1,8,Promising
3245,83,16,131,4,3,4,11,Loyal Users
3376,19,84,345,5,5,5,15,Champions
3406,1068,36,103,2,4,4,10,At Risk
3523,1108,5,9,2,1,1,4,Lost
3668,293,19,23,3,3,2,8,Loyal Users
3825,643,6,16,2,1,2,5,Lost
3836,545,10,19,2,2,2,6,Lost
3910,4172,5,8,1,1,1,3,Lost
4173,68,11,84,5,2,4,11,Promising
4585,78,40,130,4,4,4,12,Champions
5125,39,8,14,5,2,1,8,Promising
5391,3809,7,28,1,2,2,5,Lost
5431,881,10,18,2,2,2,6,Lost
5581,4239,9,12,1,2,1,4,Lost
5806,146,15,73,4,3,4,11,Loyal Users
5836,132,112,407,4,5,5,14,Champions
5911,160,24,40,4,4,3,11,Loyal Users
6047,237,45,243,3,4,5,12,Loyal Users
6078,263,6,11,3,1,1,5,Casual Users
6153,1209,20,70,2,3,4,9,Casual Users
6303,1119,10,30,2,2,2,6,Lost
6306,560,43,114,2,4,4,10,At Risk
6438,2,65,127,5,5,4,14,Champions
6477,1881,18,26,1,3,2,6,Casual Users
6490,620,100,244,2,5,5,12,At Risk
6634,130,34,45,4,4,3,11,Loyal Users
6638,11,80,216,5,5,5,15,Champions
6721,579,11,15,2,2,1,5,Lost
6819,93,23,67,4,4,4,12,Champions
7166,80,56,179,4,5,5,14,Champions
7466,411,7,8,3,2,1,6,Casual Users
7476,101,98,816,4,5,5,14,Champions
7874,96,128,298,4,5,5,14,Champions
7999,271,19,55,3,3,3,9,Loyal Users
8054,95,35,136,4,4,4,12,Champions
9067,600,11,16,2,2,2,6,Lost
9901,410,23,34,3,4,3,10,Loyal Users
10403,130,57,87,4,5,4,13,Champions
10725,1122,20,50,2,3,3,8,Casual Users
10867,54,116,498,5,5,5,15,Champions
11292,1281,10,26,1,2,2,5,Lost
11442,5604,5,5,1,1,1,3,Lost
11660,828,16,35,2,3,3,8,Casual Users
11817,23,144,1114,5,5,5,15,Champions
12141,277,14,70,3,3,4,10,Loyal Users
12160,269,15,43,3,3,3,9,Loyal Users
12285,88,5,16,4,1,2,7,Promising
12444,3736,8,35,1,2,3,6,Lost
12622,26,39,70,5,4,4,13,Champions
12916,544,45,174,2,4,5,11,At Risk
12991,243,23,82,3,4,4,11,Loyal Users
13100,1685,20,47,1,3,3,7,Casual Users
13963,26,47,79,5,5,4,14,Champions
14173,1792,7,18,1,2,2,5,Lost
14331,11,58,181,5,5,5,15,Champions
14605,25,92,240,5,5,5,15,Champions
14802,228,21,87,3,3,4,10,Loyal Users
14987,839,7,17,2,2,2,6,Lost
15313,426,15,31,3,3,2,8,Loyal Users
15378,15,86,237,5,5,5,15,Champions
15627,55,111,612,5,5,5,15,Champions
15654,118,10,20,4,2,2,8,Promising
15954,23,16,22,5,3,2,10,Loyal Users
16046,123,106,393,4,5,5,14,Champions
16143,2076,5,5,1,1,1,3,Lost
16904,121,65,167,4,5,5,14,Champions
17656,3418,12,48,1,3,3,7,Casual Users
18078,22,121,791,5,5,5,15,Champions
18205,243,6,6,3,1,1,5,Casual Users
18489,129,17,38,4,3,3,10,Loyal Users
18611,182,13,67,3,3,4,10,Loyal Users
18995,315,23,60,3,4,3,10,Loyal Users
19227,109,113,288,4,5,5,14,Champions
19388,112,5,10,4,1,1,6,Promising
19737,280,38,71,3,4,4,11,Loyal Users
20027,0,87,211,5,5,5,15,Champions
20560,139,5,8,4,1,1,6,Promising
20708,3428,7,8,1,2,1,4,Lost
20815,23,16,65,5,3,4,12,Loyal Users
21310,208,38,73,3,4,4,11,Loyal Users
21702,5,53,190,5,5,5,15,Champions
22548,733,46,81,2,5,4,11,At Risk
22597,126,61,410,4,5,5,14,Champions
22604,15,95,172,5,5,5,15,Champions
22810,303,12,18,3,3,2,8,Loyal Users
22866,1417,5,27,1,1,2,4,Lost
23140,43,113,275,5,5,5,15,Champions
23326,2276,12,22,1,3,2,6,Casual Users
23435,136,116,261,4,5,5,14,Champions
23456,73,44,89,4,4,4,12,Champions
23718,576,10,20,2,2,2,6,Lost
23743,3294,6,7,1,1,1,3,Lost
24001,2008,20,50,1,3,3,7,Casual Users
24088,676,62,79,2,5,4,11,At Risk
24325,424,51,386,3,5,5,13,Loyal Users
24583,111,17,27,4,3,2,9,Loyal Users
24756,211,51,154,3,5,5,13,Loyal Users
24780,160,61,91,4,5,4,13,Champions
24874,2,117,260,5,5,5,15,Champions
25108,359,8,25,3,2,2,7,Casual Users
25328,266,8,15,3,2,1,6,Casual Users
25757,3695,6,21,1,1,2,4,Lost
26141,131,33,112,4,4,4,12,Champions
26284,827,11,20,2,2,2,6,Lost
26458,1844,10,37,1,2,3,6,Lost
13944,38,26,95,5,4,4,13,Champions
14753,171,17,122,3,3,4,10,Loyal Users
14897,1179,8,23,2,2,2,6,Lost
14898,57,12,109,5,3,4,12,Loyal Users
15072,689,7,8,2,2,1,5,Lost
15077,41,24,45,5,4,3,12,Loyal Users
15317,395,13,19,3,3,2,8,Loyal Users
15399,49,36,48,5,4,3,12,Loyal Users
15433,115,20,71,4,3,4,11,Loyal Users
15526,758,43,105,2,4,4,10,At Risk
15671,792,6,17,2,1,2,5,Lost
15751,1552,12,18,1,3,2,6,Casual Users
16092,250,117,374,3,5,5,13,Loyal Users
16126,2766,7,12,1,2,1,4,Lost
16279,724,9,18,2,2,2,6,Lost
16367,5,11,20,5,2,2,9,Promising
16465,2128,8,13,1,2,1,4,Lost
16480,3728,7,8,1,2,1,4,Lost
16527,17,73,110,5,5,4,14,Champions
17057,566,17,50,2,3,3,8,Casual Users
17485,595,10,14,2,2,1,5,Lost
17591,417,15,33,3,3,3,9,Loyal Users
17870,390,9,52,3,2,3,8,Casual Users
17892,6,10,28,5,2,2,9,Promising
17933,362,15,70,3,3,4,10,Loyal Users
18025,125,42,75,4,4,4,12,Champions
18267,11,190,257,5,5,5,15,Champions
18312,421,6,9,3,1,1,5,Casual Users
18367,2363,8,20,1,2,2,5,Lost
18393,169,6,21,3,1,2,6,Casual Users
18437,1509,22,40,1,4,3,8,At Risk
18510,126,10,132,4,2,4,10,Promising
18527,4,63,232,5,5,5,15,Champions
18530,2148,10,15,1,2,1,4,Lost
18627,13,111,462,5,5,5,15,Champions
18653,108,35,323,4,4,5,13,Champions
18657,1115,23,165,2,4,5,11,At Risk
18666,650,5,28,2,1,2,5,Lost
19031,3606,7,12,1,2,1,4,Lost
19037,1545,23,43,1,4,3,8,At Risk
19050,91,107,207,4,5,5,14,Champions
19177,1852,9,54,1,2,3,6,Lost
19842,299,8,26,3,2,2,7,Casual Users
20053,969,31,112,2,4,4,10,At Risk
20108,957,9,13,2,2,1,5,Lost
20175,232,21,39,3,3,3,9,Loyal Users
21048,2263,5,7,1,1,1,3,Lost
21250,2492,6,6,1,1,1,3,Lost
21544,121,105,678,4,5,5,14,Champions
21572,570,8,12,2,2,1,5,Lost
21578,1451,26,49,1,4,3,8,At Risk
21733,118,78,420,4,5,5,14,Champions
21818,1436,19,46,1,3,3,7,Casual Users
21961,48,18,39,5,3,3,11,Loyal Users
22051,475,11,13,2,2,1,5,Lost
22055,19,41,131,5,4,4,13,Champions
22065,503,22,42,2,4,3,9,At Risk
22613,38,22,77,5,4,4,13,Champions
22644,12,14,41,5,3,3,11,Loyal Users
22704,1436,8,35,1,2,3,6,Lost
22927,655,16,26,2,3,2,7,Casual Users
23028,2,22,137,5,4,4,13,Champions
23112,867,11,17,2,2,2,6,Lost
23429,90,64,141,4,5,4,13,Champions
24652,292,23,90,3,4,4,11,Loyal Users
24693,0,35,110,5,4,4,13,Champions
24768,142,58,120,4,5,4,13,Champions
25241,4705,5,6,1,1,1,3,Lost
25327,90,13,30,4,3,2,9,Loyal Users
25338,121,9,22,4,2,2,8,Promising
25357,156,90,299,4,5,5,14,Champions
25668,1411,13,34,1,3,3,7,Casual Users
26001,1,112,264,5,5,5,15,Champions
26183,153,13,32,4,3,3,10,Loyal Users
13667,1971,9,18,1,2,2,5,Lost
13753,501,42,72,2,4,4,10,At Risk
14072,3477,8,8,1,2,1,4,Lost
14106,536,5,17,2,1,2,5,Lost
14129,179,17,202,3,3,5,11,Loyal Users
14271,155,65,162,4,5,5,14,Champions
14512,390,5,9,3,1,1,5,Casual Users
14719,834,10,11,2,2,1,5,Lost
14736,3619,13,30,1,3,2,6,Casual Users
14836,135,10,14,4,2,1,7,Promising
14928,1686,8,20,1,2,2,5,Lost
15102,3335,26,34,1,4,3,8,At Risk
15215,37,102,271,5,5,5,15,Champions
15371,209,57,85,3,5,4,12,Loyal Users
15717,1087,6,17,2,1,2,5,Lost
15728,4231,12,27,1,3,2,6,Casual Users
16007,811,8,22,2,2,2,6,Lost
16036,129,15,51,4,3,3,10,Loyal Users
16298,813,22,96,2,4,4,10,At Risk
16310,1478,20,31,1,3,2,6,Casual Users
17088,118,25,120,4,4,4,12,Champions
17440,432,7,12,3,2,1,6,Casual Users
17487,27,83,228,5,5,5,15,Champions
17548,9,9,25,5,2,2,9,Promising
17658,173,125,262,3,5,5,13,Loyal Users
17681,263,5,25,3,1,2,6,Casual Users
17721,143,93,231,4,5,5,14,Champions
17863,116,38,64,4,4,4,12,Champions
17943,587,51,103,2,5,4,11,At Risk
18217,5,136,244,5,5,5,15,Champions
18314,2456,13,36,1,3,3,7,Casual Users
18420,143,59,163,4,5,5,14,Champions
18667,15,45,96,5,4,4,13,Champions
18753,399,53,178,3,5,5,13,Loyal Users
18877,410,23,65,3,4,4,11,Loyal Users
18894,2266,7,7,1,2,1,4,Lost
18964,1021,11,14,2,2,1,5,Lost
19732,293,5,8,3,1,1,5,Casual Users
19863,8,109,507,5,5,5,15,Champions
19911,3879,14,36,1,3,3,7,Casual Users
19919,684,14,139,2,3,4,9,Casual Users
20291,2148,5,31,1,1,2,4,Lost
20529,414,50,135,3,5,4,12,Loyal Users
20647,37,5,25,5,1,2,8,Promising
20841,175,45,173,3,4,5,12,Loyal Users
20850,354,5,11,3,1,1,5,Casual Users
21349,153,8,16,4,2,2,8,Promising
21458,125,64,219,4,5,5,14,Champions
21685,173,49,343,3,5,5,13,Loyal Users
21838,0,108,499,5,5,5,15,Champions
21954,129,12,29,4,3,2,9,Loyal Users
22180,389,20,45,3,3,3,9,Loyal Users
22216,2730,6,6,1,1,1,3,Lost
22457,233,29,215,3,4,5,12,Loyal Users
22534,1578,12,19,1,3,2,6,Casual Users
22622,405,10,17,3,2,2,7,Casual Users
22932,114,13,56,4,3,3,10,Loyal Users
23223,935,29,97,2,4,4,10,At Risk
23282,90,5,7,4,1,1,6,Promising
23656,1,11,23,5,2,2,9,Promising
23849,104,10,30,4,2,2,8,Promising
24062,123,32,136,4,4,4,12,Champions
24750,2712,16,26,1,3,2,6,Casual Users
25029,408,58,263,3,5,5,13,Loyal Users
25165,683,12,34,2,3,3,8,Casual Users
25291,27,81,221,5,5,5,15,Champions
26075,415,24,40,3,4,3,10,Loyal Users
26076,2038,6,10,1,1,1,3,Lost
26086,354,62,254,3,5,5,13,Loyal Users
13695,131,7,22,4,2,2,8,Promising
13740,183,17,123,3,3,4,10,Loyal Users
14426,143,8,57,4,2,3,9,Promising
14520,190,20,21,3,3,2,8,Loyal Users
14607,5,104,215,5,5,5,15,Champions
15154,21,8,12,5,2,1,8,Promising
15156,177,44,88,3,4,4,11,Loyal Users
15178,1,47,147,5,5,5,15,Champions
15213,95,8,11,4,2,1,7,Promising
16306,646,23,75,2,4,4,10,At Risk
16611,2334,11,33,1,2,3,6,Lost
16900,304,8,14,3,2,1,6,Casual Users
17011,5236,14,39,1,3,3,7,Casual Users
17034,1543,6,10,1,1,1,3,Lost
17035,1,84,126,5,5,4,14,Champions
17178,3245,11,11,1,2,1,4,Lost
17800,224,7,14,3,2,1,6,Casual Users
17848,1281,6,11,1,1,1,3,Lost
17910,395,8,9,3,2,1,6,Casual Users
18338,312,11,64,3,2,4,9,Casual Users
18384,3792,40,95,1,4,4,9,At Risk
18460,512,7,13,2,2,1,5,Lost
18669,315,22,61,3,4,3,10,Loyal Users
19639,411,6,56,3,1,3,7,Casual Users
19648,319,43,109,3,4,4,11,Loyal Users
19689,10,58,145,5,5,4,14,Champions
20081,20,6,17,5,1,2,8,Promising
20507,1711,18,55,1,3,3,7,Casual Users
20580,1414,7,16,1,2,2,5,Lost
20589,139,69,149,4,5,5,14,Champions
20615,1821,22,70,1,4,4,9,At Risk
20705,591,9,28,2,2,2,6,Lost
20912,312,9,58,3,2,3,8,Casual Users
21095,84,62,175,4,5,5,14,Champions
21271,128,67,187,4,5,5,14,Champions
21340,375,38,48,3,4,3,10,Loyal Users
21777,45,14,64,5,3,4,12,Loyal Users
22032,440,20,44,3,3,3,9,Loyal Users
22191,780,45,218,2,4,5,11,At Risk
22212,304,49,57,3,5,3,11,Loyal Users
22511,2700,10,13,1,2,1,4,Lost
22811,143,28,42,4,4,3,11,Loyal Users
23240,7,66,340,5,5,5,15,Champions
23400,196,22,25,3,4,2,9,Loyal Users
23511,13,101,227,5,5,5,15,Champions
23659,601,151,495,2,5,5,12,At Risk
23842,694,7,21,2,2,2,6,Lost
23903,865,13,25,2,3,2,7,Casual Users
24149,1595,51,88,1,5,4,10,At Risk
24833,394,13,23,3,3,2,8,Loyal Users
25118,123,40,173,4,4,5,13,Champions
25332,394,68,226,3,5,5,13,Loyal Users
25347,628,11,19,2,2,2,6,Lost
25376,41,18,91,5,3,4,12,Loyal Users
25710,1432,20,47,1,3,3,7,Casual Users
25814,2526,9,53,1,2,3,6,Lost
25846,1304,6,9,1,1,1,3,Lost
26229,280,57,183,3,5,5,13,Loyal Users
26420,76,102,185,4,5,5,14,Champions
26429,133,72,177,4,5,5,14,Champions
13718,942,10,27,2,2,2,6,Lost
14039,16,67,162,5,5,5,15,Champions
14122,82,32,118,4,4,4,12,Champions
14440,120,63,255,4,5,5,14,Champions
15656,21,60,122,5,5,4,14,Champions
15685,73,28,59,4,4,3,11,Loyal Users
15843,745,8,18,2,2,2,6,Lost
16172,1240,12,60,2,3,3,8,Casual Users
16407,613,5,43,2,1,3,6,Lost
16550,296,13,20,3,3,2,8,Loyal Users
16624,271,36,207,3,4,5,12,Loyal Users
16794,42,31,63,5,4,4,13,Champions
17068,29,20,41,5,3,3,11,Loyal Users
17243,493,26,111,2,4,4,10,At Risk
17638,118,21,94,4,3,4,11,Loyal Users
17699,571,11,68,2,2,4,8,Lost
18195,98,48,88,4,5,4,13,Champions
18302,69,180,310,5,5,5,15,Champions
18709,182,22,30,3,4,2,9,Loyal Users
18787,96,10,127,4,2,4,10,Promising
18792,223,15,43,3,3,3,9,Loyal Users
18933,3218,5,11,1,1,1,3,Lost
19036,661,19,22,2,3,2,7,Casual Users
19237,96,25,82,4,4,4,12,Champions
19307,107,122,595,4,5,5,14,Champions
19409,3377,5,7,1,1,1,3,Lost
19488,1133,5,8,2,1,1,4,Lost
19917,126,76,152,4,5,5,14,Champions
19937,12,89,328,5,5,5,15,Champions
20003,70,27,78,4,4,4,12,Champions
21162,2594,6,19,1,1,2,4,Lost
21781,125,54,145,4,5,4,13,Champions
22114,291,27,34,3,4,3,10,Loyal Users
22304,113,38,78,4,4,4,12,Champions
22417,499,7,14,2,2,1,5,Lost
22728,13,40,197,5,4,5,14,Champions
22794,141,62,120,4,5,4,13,Champions
23305,87,14,29,4,3,2,9,Loyal Users
23354,76,38,280,4,4,5,13,Champions
23838,149,18,112,4,3,4,11,Loyal Users
23911,1652,6,38,1,1,3,5,Lost
23928,28,25,83,5,4,4,13,Champions
24111,228,9,14,3,2,1,6,Casual Users
24296,386,17,86,3,3,4,10,Loyal Users
24373,316,40,47,3,4,3,10,Loyal Users
24508,3248,6,28,1,1,2,4,Lost
24614,3238,115,255,1,5,5,11,At Risk
24727,1570,5,6,1,1,1,3,Lost
25131,268,34,62,3,4,3,10,Loyal Users
25269,420,46,90,3,5,4,12,Loyal Users
25321,423,12,21,3,3,2,8,Loyal Users
25402,451,8,10,3,2,1,6,Casual Users
25912,134,7,14,4,2,1,7,Promising
26154,139,84,205,4,5,5,14,Champions
26328,957,44,109,2,4,4,10,At Risk
13635,545,24,70,2,4,4,10,At Risk
13686,966,15,43,2,3,3,8,Casual Users
14059,415,35,189,3,4,5,12,Loyal Users
14068,1161,19,71,2,3,4,9,Casual Users
14181,113,28,59,4,4,3,11,Loyal Users
14568,51,46,88,5,5,4,14,Champions
14573,4444,5,9,1,1,1,3,Lost
14646,20,32,44,5,4,3,12,Loyal Users
14665,757,6,15,2,1,1,4,Lost
14690,382,20,136,3,3,4,10,Loyal Users
15266,20,43,99,5,4,4,13,Champions
15308,82,5,9,4,1,1,6,Promising
15496,600,9,29,2,2,2,6,Lost
15878,48,190,603,5,5,5,15,Champions
15948,17,150,902,5,5,5,15,Champions
16399,426,30,40,3,4,3,10,Loyal Users
16435,262,27,96,3,4,4,11,Loyal Users
16569,419,8,9,3,2,1,6,Casual Users
16661,28,145,422,5,5,5,15,Champions
17374,264,8,13,3,2,1,6,Casual Users
17434,101,8,12,4,2,1,7,Promising
17881,105,36,65,4,4,4,12,Champions
19105,887,21,31,2,3,2,7,Casual Users
19392,2110,7,9,1,2,1,4,Lost
19397,1266,20,92,1,3,4,8,Casual Users
19607,747,17,49,2,3,3,8,Casual Users
19697,86,11,11,4,2,1,7,Promising
19869,379,12,15,3,3,1,7,Loyal Users
20165,118,55,76,4,5,4,13,Champions
20204,569,32,113,2,4,4,10,At Risk
20420,243,47,81,3,5,4,12,Loyal Users
20469,848,9,14,2,2,1,5,Lost
20937,409,22,86,3,4,4,11,Loyal Users
21083,410,11,94,3,2,4,9,Casual Users
21128,1130,13,47,2,3,3,8,Casual Users
21146,72,86,116,4,5,4,13,Champions
21641,2699,12,24,1,3,2,6,Casual Users
21876,0,22,30,5,4,2,11,Loyal Users
22238,1056,5,42,2,1,3,6,Lost
22557,19,128,590,5,5,5,15,Champions
23138,54,39,107,5,4,4,13,Champions
23460,2285,5,7,1,1,1,3,Lost
23982,62,93,420,5,5,5,15,Champions
24032,67,30,91,5,4,4,13,Champions
24462,500,13,19,2,3,2,7,Casual Users
24657,476,11,20,2,2,2,6,Lost
24779,111,23,67,4,4,4,12,Champions
25527,116,18,31,4,3,2,9,Loyal Users
25682,1428,8,33,1,2,3,6,Lost
25975,85,18,29,4,3,2,9,Loyal Users
26050,4305,6,6,1,1,1,3,Lost
26194,91,6,23,4,1,2,7,Promising
26195,12,198,433,5,5,5,15,Champions
26332,2402,17,24,1,3,2,6,Casual Users
13668,688,8,10,2,2,1,5,Lost
13928,85,19,49,4,3,3,10,Loyal Users
14686,62,14,131,5,3,4,12,Loyal Users
14983,379,8,11,3,2,1,6,Casual Users
15078,585,11,27,2,2,2,6,Lost
15149,4232,12,26,1,3,2,6,Casual Users
15184,1985,8,14,1,2,1,4,Lost
15576,2144,7,21,1,2,2,5,Lost
15586,30,82,561,5,5,5,15,Champions
15879,217,6,52,3,1,3,7,Casual Users
15972,293,44,96,3,4,4,11,Loyal Users
15985,67,150,537,5,5,5,15,Champions
16091,144,193,285,4,5,5,14,Champions
16254,413,5,15,3,1,1,5,Casual Users
16334,1819,7,22,1,2,2,5,Lost
16428,54,59,487,5,5,5,15,Champions
16438,642,12,21,2,3,2,7,Casual Users
16923,154,32,70,4,4,4,12,Champions
17214,57,36,98,5,4,4,13,Champions
17865,114,10,43,4,2,3,9,Promising
18348,102,88,362,4,5,5,14,Champions
18450,35,59,124,5,5,4,14,Champions
18735,796,6,15,2,1,1,4,Lost
19032,270,50,179,3,5,5,13,Loyal Users
19269,220,27,186,3,4,5,12,Loyal Users
19817,116,43,127,4,4,4,12,Champions
20174,30,16,57,5,3,3,11,Loyal Users
20440,234,72,123,3,5,4,12,Loyal Users
20441,727,25,131,2,4,4,10,At Risk
21097,78,16,44,4,3,3,10,Loyal Users
21148,3592,8,29,1,2,2,5,Lost
22091,275,19,31,3,3,2,8,Loyal Users
22118,84,21,70,4,3,4,11,Loyal Users
22658,402,15,22,3,3,2,8,Loyal Users
22783,446,6,9,3,1,1,5,Casual Users
23289,136,24,36,4,4,3,11,Loyal Users
23735,1822,33,46,1,4,3,8,At Risk
23808,1818,6,11,1,1,1,3,Lost
24392,412,19,55,3,3,3,9,Loyal Users
24553,149,49,247,4,5,5,14,Champions
25025,158,40,70,4,4,4,12,Champions
25383,115,6,23,4,1,2,7,Promising
25552,5392,9,10,1,2,1,4,Lost
26138,436,47,111,3,5,4,12,Loyal Users
26166,3936,6,27,1,1,2,4,Lost
26286,825,18,49,2,3,3,8,Casual Users
26339,568,11,24,2,2,2,6,Lost
13774,8,52,186,5,5,5,15,Champions
14260,418,33,56,3,4,3,10,Loyal Users
14395,122,16,181,4,3,5,12,Loyal Users
14406,741,12,13,2,3,1,6,Casual Users
14457,1253,6,14,2,1,1,4,Lost
14666,3660,5,10,1,1,1,3,Lost
15484,108,33,101,4,4,4,12,Champions
15603,3067,7,12,1,2,1,4,Lost
15721,106,36,341,4,4,5,13,Champions
16025,102,14,42,4,3,3,10,Loyal Users
16441,3868,6,8,1,1,1,3,Lost
16735,688,35,66,2,4,4,10,At Risk
16788,3258,12,25,1,3,2,6,Casual Users
16990,295,5,6,3,1,1,5,Casual Users
17042,337,36,452,3,4,5,12,Loyal Users
17379,173,63,150,3,5,5,13,Loyal Users
17764,4,75,94,5,5,4,14,Champions
17786,372,18,21,3,3,2,8,Loyal Users
18023,0,60,125,5,5,4,14,Champions
18454,676,20,42,2,3,3,8,Casual Users
18586,125,26,61,4,4,3,11,Loyal Users
18906,446,54,86,3,5,4,12,Loyal Users
18986,49,16,57,5,3,3,11,Loyal Users
19800,463,8,10,3,2,1,6,Casual Users
19865,63,35,235,5,4,5,14,Champions
20380,83,10,23,4,2,2,8,Promising
20582,19,217,467,5,5,5,15,Champions
20968,129,16,31,4,3,2,9,Loyal Users
21119,3595,6,7,1,1,1,3,Lost
21767,104,92,205,4,5,5,14,Champions
22232,107,12,14,4,3,1,8,Loyal Users
22279,2408,7,15,1,2,1,4,Lost
22302,1271,10,37,1,2,3,6,Lost
22305,260,150,274,3,5,5,13,Loyal Users
22579,724,10,55,2,2,3,7,Lost
22876,11,60,124,5,5,4,14,Champions
23298,368,27,42,3,4,3,10,Loyal Users
23532,136,31,100,4,4,4,12,Champions
23722,115,61,186,4,5,5,14,Champions
24356,2140,5,13,1,1,1,3,Lost
24593,282,12,27,3,3,2,8,Loyal Users
25034,2005,9,73,1,2,4,7,Lost
25059,679,17,70,2,3,4,9,Casual Users
25112,2578,6,19,1,1,2,4,Lost
25399,85,14,26,4,3,2,9,Loyal Users
25728,131,59,250,4,5,5,14,Champions
26098,2482,7,12,1,2,1,4,Lost
13780,40,28,47,5,4,3,12,Loyal Users
14272,1967,25,151,1,4,5,10,At Risk
14834,240,10,13,3,2,1,6,Casual Users
15042,2955,9,11,1,2,1,4,Lost
15089,289,7,19,3,2,2,7,Casual Users
15167,139,57,67,4,5,4,13,Champions
15903,510,5,6,2,1,1,4,Lost
16010,2970,5,10,1,1,1,3,Lost
16170,17,49,93,5,5,4,14,Champions
16202,11,52,180,5,5,5,15,Champions
16518,411,10,24,3,2,2,7,Casual Users
16538,229,58,85,3,5,4,12,Loyal Users
16803,89,163,593,4,5,5,14,Champions
17443,140,11,17,4,2,2,8,Promising
17473,580,5,28,2,1,2,5,Lost
18046,190,5,22,3,1,2,6,Casual Users
18250,164,23,68,4,4,4,12,Champions
18523,1306,5,6,1,1,1,3,Lost
18822,955,5,17,2,1,2,5,Lost
18835,7,36,145,5,4,4,13,Champions
18916,2574,7,12,1,2,1,4,Lost
19194,105,10,23,4,2,2,8,Promising
19205,693,30,85,2,4,4,10,At Risk
19360,131,55,200,4,5,5,14,Champions
19472,600,12,27,2,3,2,7,Casual Users
19522,27,83,397,5,5,5,15,Champions
20250,419,8,11,3,2,1,6,Casual Users
20346,1016,10,15,2,2,1,5,Lost
20460,412,38,151,3,4,5,12,Loyal Users
20466,86,144,381,4,5,5,14,Champions
20491,2444,14,19,1,3,2,6,Casual Users
20859,835,15,48,2,3,3,8,Casual Users
21490,393,11,15,3,2,1,6,Casual Users
21501,176,15,26,3,3,2,8,Loyal Users
21686,8,67,364,5,5,5,15,Champions
21782,459,15,59,3,3,3,9,Loyal Users
21807,98,20,29,4,3,2,9,Loyal Users
21810,136,22,56,4,4,3,11,Loyal Users
22501,19,97,202,5,5,5,15,Champions
22928,2769,13,103,1,3,4,8,Casual Users
23156,271,6,22,3,1,2,6,Casual Users
23626,393,12,45,3,3,3,9,Loyal Users
23863,28,34,50,5,4,3,12,Loyal Users
24100,904,13,24,2,3,2,7,Casual Users
24321,97,13,20,4,3,2,9,Loyal Users
24384,420,12,18,3,3,2,8,Loyal Users
24491,5563,10,24,1,2,2,5,Lost
24601,75,24,47,4,4,3,11,Loyal Users
24640,1483,12,23,1,3,2,6,Casual Users
24857,864,7,7,2,2,1,5,Lost
24950,97,65,290,4,5,5,14,Champions
25180,1130,11,13,2,2,1,5,Lost
25200,2026,5,10,1,1,1,3,Lost
26044,22,22,31,5,4,2,11,Loyal Users
26115,432,8,8,3,2,1,6,Casual Users
26171,145,7,60,4,2,3,9,Promising
26225,16,57,106,5,5,4,14,Champions
13881,932,8,35,2,2,3,7,Lost
13922,33,32,126,5,4,4,13,Champions
14222,2118,11,42,1,2,3,6,Lost
14817,146,13,38,4,3,3,10,Loyal Users
15674,414,15,51,3,3,3,9,Loyal Users
15711,1096,25,25,2,4,2,8,At Risk
15946,147,7,8,4,2,1,7,Promising
16067,429,19,79,3,3,4,10,Loyal Users
16215,263,12,15,3,3,1,7,Loyal Users
16216,3,125,471,5,5,5,15,Champions
16418,2675,9,22,1,2,2,5,Lost
16490,44,40,65,5,4,4,13,Champions
16577,406,6,26,3,1,2,6,Casual Users
16633,126,28,48,4,4,3,11,Loyal Users
16860,252,22,79,3,4,4,11,Loyal Users
16986,21,70,279,5,5,5,15,Champions
17085,91,9,32,4,2,3,9,Promising
17801,443,5,7,3,1,1,5,Casual Users
17930,2,27,90,5,4,4,13,Champions
18003,57,20,189,5,3,5,13,Loyal Users
18675,1328,5,14,1,1,1,3,Lost
18683,498,41,168,2,4,5,11,At Risk
18850,3245,31,71,1,4,4,9,At Risk
18945,9,40,111,5,4,4,13,Champions
19017,925,66,154,2,5,5,12,At Risk
19043,122,59,168,4,5,5,14,Champions
19152,109,5,6,4,1,1,6,Promising
19485,48,91,134,5,5,4,14,Champions
19541,99,31,58,4,4,3,11,Loyal Users
19766,993,12,24,2,3,2,7,Casual Users
20219,94,51,389,4,5,5,14,Champions
20320,193,19,24,3,3,2,8,Loyal Users
20417,331,69,111,3,5,4,12,Loyal Users
21204,3540,19,30,1,3,2,6,Casual Users
21649,1971,7,26,1,2,2,5,Lost
21716,121,15,26,4,3,2,9,Loyal Users
21799,4,141,706,5,5,5,15,Champions
21873,1108,6,8,2,1,1,4,Lost
22043,445,16,33,3,3,3,9,Loyal Users
22355,4539,13,38,1,3,3,7,Casual Users
22384,91,28,46,4,4,3,11,Loyal Users
22573,34,61,104,5,5,4,14,Champions
23065,444,5,11,3,1,1,5,Casual Users
23110,255,67,133,3,5,4,12,Loyal Users
23340,1489,10,36,1,2,3,6,Lost
23484,727,6,35,2,1,3,6,Lost
23601,399,19,31,3,3,2,8,Loyal Users
23841,27,141,463,5,5,5,15,Champions
23916,3811,6,6,1,1,1,3,Lost
24185,694,9,10,2,2,1,5,Lost
24567,244,10,21,3,2,2,7,Casual Users
24598,455,17,26,3,3,2,8,Loyal Users
24791,341,6,46,3,1,3,7,Casual Users
24825,1445,17,77,1,3,4,8,Casual Users
24839,280,12,15,3,3,1,7,Loyal Users
24958,22,107,181,5,5,5,15,Champions
25415,720,16,64,2,3,4,9,Casual Users
25516,553,19,32,2,3,3,8,Casual Users
25980,700,12,25,2,3,2,7,Casual Users
26186,249,6,19,3,1,2,6,Casual Users
26231,163,9,27,4,2,2,8,Promising
26438,1739,27,71,1,4,4,9,At Risk
13826,2078,6,7,1,1,1,3,Lost
13931,153,27,319,4,4,5,13,Champions
14048,427,10,64,3,2,4,9,Casual Users
14484,2502,6,17,1,1,2,4,Lost
14635,122,47,102,4,5,4,13,Champions
14794,101,159,661,4,5,5,14,Champions
15068,298,10,13,3,2,1,6,Casual Users
15698,28,14,26,5,3,2,10,Loyal Users
15970,2121,14,18,1,3,2,6,Casual Users
16884,144,71,183,4,5,5,14,Champions
17428,122,11,13,4,2,1,7,Promising
17583,439,5,7,3,1,1,5,Casual Users
17807,106,8,10,4,2,1,7,Promising
18533,2415,25,70,1,4,4,9,At Risk
18624,546,52,96,2,5,4,11,At Risk
18887,103,25,93,4,4,4,12,Champions
19093,372,33,66,3,4,4,11,Loyal Users
19523,14,45,219,5,4,5,14,Champions
19745,241,19,99,3,3,4,10,Loyal Users
19860,1288,8,10,1,2,1,4,Lost
20071,413,5,9,3,1,1,5,Casual Users
20240,546,12,20,2,3,2,7,Casual Users
20310,4666,22,66,1,4,4,9,At Risk
20858,391,36,216,3,4,5,12,Loyal Users
20935,100,20,64,4,3,4,11,Loyal Users
21333,288,7,23,3,2,2,7,Casual Users
21476,950,11,22,2,2,2,6,Lost
21477,1256,8,8,2,2,1,5,Lost
21596,423,41,62,3,4,3,10,Loyal Users
21621,3489,15,29,1,3,2,6,Casual Users
21655,410,14,29,3,3,2,8,Loyal Users
21785,1019,10,25,2,2,2,6,Lost
21996,219,26,121,3,4,4,11,Loyal Users
22028,245,39,126,3,4,4,11,Loyal Users
22144,91,49,318,4,5,5,14,Champions
22269,245,57,132,3,5,4,12,Loyal Users
22681,105,14,65,4,3,4,11,Loyal Users
22797,2394,9,13,1,2,1,4,Lost
23312,305,23,80,3,4,4,11,Loyal Users
23934,134,54,109,4,5,4,13,Champions
23997,134,53,110,4,5,4,13,Champions
24510,413,36,186,3,4,5,12,Loyal Users
24957,2692,6,26,1,1,2,4,Lost
25160,619,20,46,2,3,3,8,Casual Users
25363,515,6,6,2,1,1,4,Lost
26236,2308,11,30,1,2,2,5,Lost
26334,2995,7,9,1,2,1,4,Lost
13806,403,16,21,3,3,2,8,Loyal Users
13860,441,18,22,3,3,2,8,Loyal Users
14107,29,62,95,5,5,4,14,Champions
14159,726,10,41,2,2,3,7,Lost
14392,107,14,35,4,3,3,10,Loyal Users
14497,4,13,16,5,3,2,10,Loyal Users
14683,50,11,23,5,2,2,9,Promising
14734,121,5,16,4,1,2,7,Promising
15022,120,70,200,4,5,5,14,Champions
15063,1882,31,104,1,4,4,9,At Risk
15118,116,67,177,4,5,5,14,Champions
15131,727,18,64,2,3,4,9,Casual Users
16127,249,8,15,3,2,1,6,Casual Users
16128,91,49,97,4,5,4,13,Champions
16269,861,7,9,2,2,1,5,Lost
16282,5,34,134,5,4,4,13,Champions
16309,11,18,25,5,3,2,10,Loyal Users
16434,1006,11,25,2,2,2,6,Lost
17027,85,13,37,4,3,3,10,Loyal Users
17128,9,5,6,5,1,1,7,Promising
17461,390,20,56,3,3,3,9,Loyal Users
17579,280,9,20,3,2,2,7,Casual Users
17595,191,85,194,3,5,5,13,Loyal Users
17727,101,7,35,4,2,3,9,Promising
18141,83,30,96,4,4,4,12,Champions
18208,36,31,78,5,4,4,13,Champions
18475,12,15,54,5,3,3,11,Loyal Users
19213,851,7,11,2,2,1,5,Lost
19329,155,11,15,4,2,1,7,Promising
19511,259,13,26,3,3,2,8,Loyal Users
19596,645,59,270,2,5,5,12,At Risk
19613,3477,6,6,1,1,1,3,Lost
20043,1691,11,27,1,2,2,5,Lost
20186,0,31,80,5,4,4,13,Champions
20322,1682,15,53,1,3,3,7,Casual Users
20591,2983,10,28,1,2,2,5,Lost
20627,10,8,29,5,2,2,9,Promising
20632,1123,45,297,2,4,5,11,At Risk
20655,1380,22,72,1,4,4,9,At Risk
21102,422,18,30,3,3,2,8,Loyal Users
21205,59,59,138,5,5,4,14,Champions
21449,5392,5,7,1,1,1,3,Lost
21590,1134,36,74,2,4,4,10,At Risk
21742,130,100,401,4,5,5,14,Champions
21943,258,5,5,3,1,1,5,Casual Users
22351,779,5,11,2,1,1,4,Lost
22898,691,53,194,2,5,5,12,At Risk
22931,138,9,54,4,2,3,9,Promising
23050,38,67,139,5,5,4,14,Champions
23200,161,28,83,4,4,4,12,Champions
23274,1900,36,126,1,4,4,9,At Risk
23338,114,83,195,4,5,5,14,Champions
23534,14,21,62,5,3,3,11,Loyal Users
23550,2009,7,10,1,2,1,4,Lost
23559,89,19,88,4,3,4,11,Loyal Users
23865,548,36,69,2,4,4,10,At Risk
23909,423,5,5,3,1,1,5,Casual Users
24089,2,114,378,5,5,5,15,Champions
24416,130,33,88,4,4,4,12,Champions
24807,181,40,80,3,4,4,11,Loyal Users
25266,483,31,118,2,4,4,10,At Risk
25392,851,11,23,2,2,2,6,Lost
25426,836,6,36,2,1,3,6,Lost
25487,112,25,62,4,4,3,11,Loyal Users
25625,4670,5,7,1,1,1,3,Lost
25748,28,27,80,5,4,4,13,Champions
25949,113,7,24,4,2,2,8,Promising
26007,146,106,383,4,5,5,14,Champions
26034,5668,8,8,1,2,1,4,Lost
13872,1707,8,40,1,2,3,6,Lost
14146,0,68,92,5,5,4,14,Champions
14386,212,175,527,3,5,5,13,Loyal Users
14602,133,24,46,4,4,3,11,Loyal Users
14678,256,7,19,3,2,2,7,Casual Users
14768,111,128,289,4,5,5,14,Champions
14796,423,14,44,3,3,3,9,Loyal Users
14807,2,105,190,5,5,5,15,Champions
14842,13,37,99,5,4,4,13,Champions
14912,1572,9,58,1,2,3,6,Lost
14937,276,45,73,3,4,4,11,Loyal Users
15079,79,10,34,4,2,3,9,Promising
15527,598,43,97,2,4,4,10,At Risk
16414,7,46,210,5,5,5,15,Champions
16647,5046,7,7,1,2,1,4,Lost
16681,34,41,180,5,4,5,14,Champions
16994,373,8,38,3,2,3,8,Casual Users
17197,122,18,41,4,3,3,10,Loyal Users
17200,152,13,20,4,3,2,9,Loyal Users
17308,132,44,105,4,4,4,12,Champions
17580,12,44,59,5,4,3,12,Loyal Users
17833,1237,11,14,2,2,1,5,Lost
20084,825,67,302,2,5,5,12,At Risk
20104,6,53,267,5,5,5,15,Champions
20323,149,10,15,4,2,1,7,Promising
20432,110,7,90,4,2,4,10,Promising
20447,2142,26,51,1,4,3,8,At Risk
20598,5487,12,17,1,3,2,6,Casual Users
20760,416,19,50,3,3,3,9,Loyal Users
20910,844,7,32,2,2,3,7,Lost
21071,1398,6,16,1,1,2,4,Lost
21812,3659,7,7,1,2,1,4,Lost
21813,679,5,9,2,1,1,4,Lost
22015,495,15,41,2,3,3,8,Casual Users
22052,148,134,579,4,5,5,14,Champions
22093,849,9,14,2,2,1,5,Lost
22123,174,100,534,3,5,5,13,Loyal Users
22332,22,37,181,5,4,5,14,Champions
22476,829,13,18,2,3,2,7,Casual Users
23124,282,5,47,3,1,3,7,Casual Users
23253,282,9,38,3,2,3,8,Casual Users
23588,480,5,65,2,1,4,7,Lost
23702,3531,7,7,1,2,1,4,Lost
23833,1,22,80,5,4,4,13,Champions
23939,330,47,145,3,5,4,12,Loyal Users
24410,215,13,14,3,3,1,7,Loyal Users
24473,15,22,96,5,4,4,13,Champions
24480,265,8,11,3,2,1,6,Casual Users
24729,426,40,88,3,4,4,11,Loyal Users
24742,97,51,196,4,5,5,14,Champions
25746,140,61,268,4,5,5,14,Champions
25750,2421,15,37,1,3,3,7,Casual Users
26437,837,6,10,2,1,1,4,Lost
13651,43,69,249,5,5,5,15,Champions
13662,1759,20,44,1,3,3,7,Casual Users
13724,4606,13,19,1,3,2,6,Casual Users
13755,273,24,94,3,4,4,11,Loyal Users
14071,90,58,226,4,5,5,14,Champions
14086,4358,6,8,1,1,1,3,Lost
14097,1580,5,6,1,1,1,3,Lost
14253,632,19,53,2,3,3,8,Casual Users
14335,2563,6,7,1,1,1,3,Lost
14383,206,7,97,3,2,4,9,Casual Users
14695,350,44,64,3,4,4,11,Loyal Users
14851,18,30,92,5,4,4,13,Champions
15265,154,34,41,4,4,3,11,Loyal Users
15481,3,82,203,5,5,5,15,Champions
15642,43,89,184,5,5,5,15,Champions
15743,679,6,6,2,1,1,4,Lost
15817,1375,10,46,1,2,3,6,Lost
16329,878,27,96,2,4,4,10,At Risk
16663,77,23,164,4,4,5,13,Champions
16690,453,15,73,3,3,4,10,Loyal Users
17146,7,27,78,5,4,4,13,Champions
17339,65,44,200,5,4,5,14,Champions
17381,433,23,51,3,4,3,10,Loyal Users
17467,2122,20,67,1,3,4,8,Casual Users
17799,275,30,37,3,4,3,10,Loyal Users
17803,89,14,59,4,3,3,10,Loyal Users
18148,5010,5,13,1,1,1,3,Lost
18260,427,8,17,3,2,2,7,Casual Users
18297,124,41,281,4,4,5,13,Champions
18316,19,55,267,5,5,5,15,Champions
18387,14,22,177,5,4,5,14,Champions
18485,143,56,375,4,5,5,14,Champions
18634,279,102,306,3,5,5,13,Loyal Users
18725,857,7,45,2,2,3,7,Lost
18904,26,13,17,5,3,2,10,Loyal Users
19250,694,15,107,2,3,4,9,Casual Users
19713,259,23,59,3,4,3,10,Loyal Users
19994,720,18,94,2,3,4,9,Casual Users
20110,670,20,54,2,3,3,8,Casual Users
20482,4876,27,72,1,4,4,9,At Risk
20728,1288,19,24,1,3,2,6,Casual Users
20829,95,24,66,4,4,4,12,Champions
20867,2806,6,8,1,1,1,3,Lost
20886,198,22,26,3,4,2,9,Loyal Users
21074,493,8,35,2,2,3,7,Lost
21353,41,5,44,5,1,3,9,Promising
21567,275,10,17,3,2,2,7,Casual Users
21697,81,71,190,4,5,5,14,Champions
21824,4423,9,11,1,2,1,4,Lost
21879,288,47,258,3,5,5,13,Loyal Users
21928,852,10,14,2,2,1,5,Lost
22246,277,22,45,3,4,3,10,Loyal Users
22426,520,16,22,2,3,2,7,Casual Users
22675,144,15,16,4,3,2,9,Loyal Users
22807,168,29,187,3,4,5,12,Loyal Users
23095,1083,9,17,2,2,2,6,Lost
23149,3469,5,10,1,1,1,3,Lost
23580,54,11,18,5,2,2,9,Promising
23593,5020,5,23,1,1,2,4,Lost
23645,254,21,28,3,3,2,8,Loyal Users
23688,68,56,395,5,5,5,15,Champions
23721,283,19,60,3,3,3,9,Loyal Users
23764,6,36,153,5,4,5,14,Champions
24074,130,18,40,4,3,3,10,Loyal Users
24320,219,13,53,3,3,3,9,Loyal Users
24389,80,6,8,4,1,1,6,Promising
24505,214,43,65,3,4,4,11,Loyal Users
24653,1187,15,30,2,3,2,7,Casual Users
24782,193,16,57,3,3,3,9,Loyal Users
24929,9,51,155,5,5,5,15,Champions
25001,124,12,63,4,3,4,11,Loyal Users
25154,848,11,19,2,2,2,6,Lost
25229,228,5,6,3,1,1,5,Casual Users
25334,123,9,31,4,2,2,8,Promising
25400,87,12,61,4,3,3,10,Loyal Users
25755,104,30,74,4,4,4,12,Champions
25900,848,19,21,2,3,2,7,Casual Users
26006,259,13,67,3,3,4,10,Loyal Users
26193,517,9,19,2,2,2,6,Lost
13605,103,133,282,4,5,5,14,Champions
13614,142,7,11,4,2,1,7,Promising
13729,583,39,174,2,4,5,11,At Risk
13821,683,30,42,2,4,3,9,At Risk
13952,232,6,10,3,1,1,5,Casual Users
13987,1395,10,14,1,2,1,4,Lost
14196,143,37,61,4,4,3,11,Loyal Users
14504,211,10,16,3,2,2,7,Casual Users
14539,448,8,25,3,2,2,7,Casual Users
14705,598,5,6,2,1,1,4,Lost
14737,688,46,106,2,5,4,11,At Risk
15005,1870,7,17,1,2,2,5,Lost
16105,425,23,46,3,4,3,10,Loyal Users
16750,409,12,38,3,3,3,9,Loyal Users
16821,1008,8,38,2,2,3,7,Lost
16908,1823,9,56,1,2,3,6,Lost
17012,183,47,101,3,5,4,12,Loyal Users
17320,2128,6,8,1,1,1,3,Lost
17458,428,6,9,3,1,1,5,Casual Users
17576,72,117,470,4,5,5,14,Champions
17711,1206,45,293,2,4,5,11,At Risk
18243,4717,6,6,1,1,1,3,Lost
18453,2400,7,17,1,2,2,5,Lost
18829,155,8,10,4,2,1,7,Promising
18909,85,37,91,4,4,4,12,Champions
19022,883,8,32,2,2,3,7,Lost
19198,643,6,15,2,1,1,4,Lost
19370,370,6,20,3,1,2,6,Casual Users
19547,18,115,153,5,5,5,15,Champions
19588,762,65,190,2,5,5,12,At Risk
19899,25,91,365,5,5,5,15,Champions
20044,12,16,41,5,3,3,11,Loyal Users
20051,675,23,52,2,4,3,9,At Risk
20383,111,5,26,4,1,2,7,Promising
20385,1232,7,25,2,2,2,6,Lost
20463,139,81,518,4,5,5,14,Champions
20572,713,17,27,2,3,2,7,Casual Users
20716,107,93,198,4,5,5,14,Champions
21104,402,5,6,3,1,1,5,Casual Users
21107,245,23,75,3,4,4,11,Loyal Users
21190,409,7,17,3,2,2,7,Casual Users
21301,1838,5,15,1,1,1,3,Lost
21315,244,16,43,3,3,3,9,Loyal Users
21386,11,40,153,5,4,5,14,Champions
21481,3474,5,6,1,1,1,3,Lost
21543,463,27,73,3,4,4,11,Loyal Users
21595,67,95,406,5,5,5,15,Champions
21766,391,15,18,3,3,2,8,Loyal Users
21891,3653,26,98,1,4,4,9,At Risk
21951,3177,6,7,1,1,1,3,Lost
21999,32,43,100,5,4,4,13,Champions
22578,4,7,21,5,2,2,9,Promising
22779,351,14,125,3,3,4,10,Loyal Users
23170,3,11,16,5,2,2,9,Promising
23352,2903,5,6,1,1,1,3,Lost
23549,106,23,52,4,4,3,11,Loyal Users
23949,283,9,15,3,2,1,6,Casual Users
23988,2415,25,29,1,4,2,7,At Risk
24247,113,12,44,4,3,3,10,Loyal Users
24297,434,7,11,3,2,1,6,Casual Users
24557,752,8,17,2,2,2,6,Lost
24616,120,59,137,4,5,4,13,Champions
24911,34,12,28,5,3,2,10,Loyal Users
24937,23,16,41,5,3,3,11,Loyal Users
25159,1844,5,7,1,1,1,3,Lost
25311,247,116,129,3,5,4,12,Loyal Users
25386,340,32,41,3,4,3,10,Loyal Users
26103,458,18,22,3,3,2,8,Loyal Users
26204,120,31,103,4,4,4,12,Champions
26300,12,58,138,5,5,4,14,Champions
26325,1947,19,42,1,3,3,7,Casual Users
26388,2961,6,23,1,1,2,4,Lost
13710,14,58,114,5,5,4,14,Champions
13793,1717,5,8,1,1,1,3,Lost
13882,105,50,90,4,5,4,13,Champions
13899,18,6,13,5,1,1,7,Promising
13976,147,14,19,4,3,2,9,Loyal Users
14211,676,8,9,2,2,1,5,Lost
14601,292,5,6,3,1,1,5,Casual Users
14778,293,10,21,3,2,2,7,Casual Users
15344,70,59,112,4,5,4,13,Champions
15422,398,14,25,3,3,2,8,Loyal Users
15444,32,20,184,5,3,5,13,Loyal Users
15536,254,120,257,3,5,5,13,Loyal Users
15796,881,5,8,2,1,1,4,Lost
16089,3124,8,23,1,2,2,5,Lost
16217,28,11,58,5,2,3,10,Promising
16531,35,82,408,5,5,5,15,Champions
16568,153,19,48,4,3,3,10,Loyal Users
16683,59,46,182,5,5,5,15,Champions
16734,406,50,208,3,5,5,13,Loyal Users
16864,300,8,14,3,2,1,6,Casual Users
17021,343,32,63,3,4,4,11,Loyal Users
17182,901,17,52,2,3,3,8,Casual Users
17278,245,58,170,3,5,5,13,Loyal Users
17327,488,19,98,2,3,4,9,Casual Users
17328,2558,15,34,1,3,3,7,Casual Users
17365,267,9,18,3,2,2,7,Casual Users
17495,1752,27,172,1,4,5,10,At Risk
17534,2744,66,122,1,5,4,10,At Risk
18112,2593,10,46,1,2,3,6,Lost
18184,3678,12,18,1,3,2,6,Casual Users
18249,1086,7,7,2,2,1,5,Lost
18256,4892,6,13,1,1,1,3,Lost
18359,94,20,39,4,3,3,10,Loyal Users
18440,439,6,8,3,1,1,5,Casual Users
18622,289,13,20,3,3,2,8,Loyal Users
18999,17,80,254,5,5,5,15,Champions
19256,102,150,393,4,5,5,14,Champions
19421,68,36,200,5,4,5,14,Champions
19443,142,20,90,4,3,4,11,Loyal Users
19450,3612,6,26,1,1,2,4,Lost
19803,36,88,472,5,5,5,15,Champions
19881,2113,8,12,1,2,1,4,Lost
20067,822,7,27,2,2,2,6,Lost
20261,75,113,598,4,5,5,14,Champions
20744,439,54,173,3,5,5,13,Loyal Users
20801,25,14,44,5,3,3,11,Loyal Users
21002,29,28,189,5,4,5,14,Champions
21195,2,15,108,5,3,4,12,Loyal Users
21238,4462,9,17,1,2,2,5,Lost
21608,1399,7,8,1,2,1,4,Lost
21806,122,140,536,4,5,5,14,Champions
21831,993,13,23,2,3,2,7,Casual Users
22108,153,11,30,4,2,2,8,Promising
22119,17,47,124,5,5,4,14,Champions
22165,336,15,66,3,3,4,10,Loyal Users
22222,29,59,458,5,5,5,15,Champions
22475,3846,8,47,1,2,3,6,Lost
22552,422,7,24,3,2,2,7,Casual Users
22567,215,10,14,3,2,1,6,Casual Users
22600,216,88,313,3,5,5,13,Loyal Users
23316,371,5,7,3,1,1,5,Casual Users
23541,3965,8,25,1,2,2,5,Lost
23690,132,9,15,4,2,1,7,Promising
24170,434,11,19,3,2,2,7,Casual Users
24499,2740,6,10,1,1,1,3,Lost
24555,5,35,137,5,4,4,13,Champions
24933,88,52,244,4,5,5,14,Champions
25085,693,15,32,2,3,3,8,Casual Users
25178,239,6,6,3,1,1,5,Casual Users
25274,7,129,383,5,5,5,15,Champions
25330,524,12,27,2,3,2,7,Casual Users
25553,839,13,25,2,3,2,7,Casual Users
25555,100,6,18,4,1,2,7,Promising
25804,367,6,14,3,1,1,5,Casual Users
25818,373,14,102,3,3,4,10,Loyal Users
25865,2260,12,32,1,3,3,7,Casual Users
26003,75,173,472,4,5,5,14,Champions
26134,1273,14,58,1,3,3,7,Casual Users
26197,144,5,8,4,1,1,6,Promising
13610,4411,5,6,1,1,1,3,Lost
13957,108,8,10,4,2,1,7,Promising
14076,64,36,146,5,4,4,13,Champions
14682,763,5,9,2,1,1,4,Lost
14722,2315,7,16,1,2,2,5,Lost
14792,651,12,16,2,3,2,7,Casual Users
15001,1027,12,21,2,3,2,7,Casual Users
15390,1313,45,55,1,4,3,8,At Risk
15406,48,39,175,5,4,5,14,Champions
15679,2163,8,29,1,2,2,5,Lost
15989,552,11,22,2,2,2,6,Lost
16211,26,31,91,5,4,4,13,Champions
16603,823,10,27,2,2,2,6,Lost
16827,25,6,40,5,1,3,9,Promising
17578,1288,7,8,1,2,1,4,Lost
17725,701,19,48,2,3,3,8,Casual Users
18054,1208,5,17,2,1,2,5,Lost
18181,1170,11,11,2,2,1,5,Lost
18396,57,169,468,5,5,5,15,Champions
18482,219,18,29,3,3,2,8,Loyal Users
18484,355,14,31,3,3,2,8,Loyal Users
18600,405,6,8,3,1,1,5,Casual Users
18885,133,30,68,4,4,4,12,Champions
19134,817,31,44,2,4,3,9,At Risk
19245,2998,6,12,1,1,1,3,Lost
19371,559,10,68,2,2,4,8,Lost
19410,830,17,23,2,3,2,7,Casual Users
19510,711,10,11,2,2,1,5,Lost
19593,137,17,55,4,3,3,10,Loyal Users
19657,433,6,8,3,1,1,5,Casual Users
19867,1031,5,20,2,1,2,5,Lost
20321,2093,10,18,1,2,2,5,Lost
20345,15,51,85,5,5,4,14,Champions
20704,186,45,164,3,4,5,12,Loyal Users
21085,2475,5,41,1,1,3,5,Lost
21166,4309,10,19,1,2,2,5,Lost
21502,582,14,24,2,3,2,7,Casual Users
21594,101,8,45,4,2,3,9,Promising
21607,5,68,220,5,5,5,15,Champions
21835,9,130,351,5,5,5,15,Champions
22278,2125,8,108,1,2,4,7,Lost
22633,467,29,68,3,4,4,11,Loyal Users
22697,2,64,159,5,5,5,15,Champions
22699,288,20,31,3,3,2,8,Loyal Users
22885,1295,5,12,1,1,1,3,Lost
22955,139,33,62,4,4,3,11,Loyal Users
22997,8,80,617,5,5,5,15,Champions
23071,684,8,10,2,2,1,5,Lost
23294,111,44,351,4,4,5,13,Champions
23879,90,59,107,4,5,4,13,Champions
23951,4717,7,21,1,2,2,5,Lost
24581,4265,6,19,1,1,2,4,Lost
25032,429,8,11,3,2,1,6,Casual Users
25482,1416,10,20,1,2,2,5,Lost
26403,107,62,311,4,5,5,14,Champions
26444,573,8,21,2,2,2,6,Lost
13636,196,7,40,3,2,3,8,Casual Users
13646,108,38,215,4,4,5,13,Champions
14130,780,55,146,2,5,4,11,At Risk
14305,30,28,30,5,4,2,11,Loyal Users
14471,146,71,94,4,5,4,13,Champions
14634,155,13,113,4,3,4,11,Loyal Users
14822,505,20,56,2,3,3,8,Casual Users
14900,683,5,7,2,1,1,4,Lost
14929,1839,10,26,1,2,2,5,Lost
15120,1866,9,28,1,2,2,5,Lost
15210,560,5,15,2,1,1,4,Lost
15498,90,47,242,4,5,5,14,Champions
16173,12,261,398,5,5,5,15,Champions
16378,4448,26,71,1,4,4,9,At Risk
16432,1118,18,26,2,3,2,7,Casual Users
16650,278,10,12,3,2,1,6,Casual Users
16667,1510,11,15,1,2,1,4,Lost
16701,800,23,52,2,4,3,9,At Risk
17123,132,6,20,4,1,2,7,Promising
18419,8,183,421,5,5,5,15,Champions
18538,529,12,45,2,3,3,8,Casual Users
18550,2717,9,16,1,2,2,5,Lost
18706,132,11,14,4,2,1,7,Promising
18755,182,79,199,3,5,5,13,Loyal Users
18868,5000,10,14,1,2,1,4,Lost
19126,940,25,111,2,4,4,10,At Risk
19309,245,6,37,3,1,3,7,Casual Users
19425,252,11,20,3,2,2,7,Casual Users
19455,929,5,8,2,1,1,4,Lost
20028,222,44,171,3,4,5,12,Loyal Users
20307,34,26,49,5,4,3,12,Loyal Users
20480,664,12,31,2,3,2,7,Casual Users
20531,581,15,29,2,3,2,7,Casual Users
20892,824,5,15,2,1,1,4,Lost
21381,53,116,678,5,5,5,15,Champions
21738,69,43,135,5,4,4,13,Champions
21768,1082,15,23,2,3,2,7,Casual Users
21792,130,20,31,4,3,2,9,Loyal Users
21920,145,17,27,4,3,2,9,Loyal Users
22210,752,21,97,2,3,4,9,Casual Users
22253,145,53,76,4,5,4,13,Champions
22591,101,37,62,4,4,3,11,Loyal Users
22698,18,27,78,5,4,4,13,Champions
22770,512,10,88,2,2,4,8,Lost
23018,102,46,166,4,5,5,14,Champions
23437,152,47,94,4,5,4,13,Champions
23465,1150,5,27,2,1,2,5,Lost
23633,1246,5,7,2,1,1,4,Lost
23886,2861,11,21,1,2,2,5,Lost
24298,4461,5,5,1,1,1,3,Lost
24352,311,7,22,3,2,2,7,Casual Users
24396,276,9,35,3,2,3,8,Casual Users
24398,291,14,24,3,3,2,8,Loyal Users
25301,32,156,329,5,5,5,15,Champions
25340,124,7,10,4,2,1,7,Promising
25414,137,55,220,4,5,5,14,Champions
25543,171,6,10,3,1,1,5,Casual Users
25711,514,13,33,2,3,3,8,Casual Users
25715,8,73,263,5,5,5,15,Champions
25798,857,15,67,2,3,4,9,Casual Users
25930,106,25,53,4,4,3,11,Loyal Users
26137,3836,5,8,1,1,1,3,Lost
26331,285,10,92,3,2,4,9,Casual Users
13663,0,5,37,5,1,3,9,Promising
13809,159,37,49,4,4,3,11,Loyal Users
14021,1220,27,66,2,4,4,10,At Risk
14186,284,6,8,3,1,1,5,Casual Users
14247,521,11,40,2,2,3,7,Lost
14394,1104,7,27,2,2,2,6,Lost
14594,88,28,46,4,4,3,11,Loyal Users
14700,369,23,73,3,4,4,11,Loyal Users
14726,119,17,131,4,3,4,11,Loyal Users
14739,235,5,12,3,1,1,5,Casual Users
14901,2583,13,15,1,3,1,5,Casual Users
14927,138,18,63,4,3,4,11,Loyal Users
15227,138,12,15,4,3,1,8,Loyal Users
15287,3748,10,13,1,2,1,4,Lost
15936,379,52,78,3,5,4,12,Loyal Users
16107,97,13,26,4,3,2,9,Loyal Users
16223,18,68,145,5,5,4,14,Champions
16287,88,5,7,4,1,1,6,Promising
16496,159,13,18,4,3,2,9,Loyal Users
16674,130,5,6,4,1,1,6,Promising
16692,2704,31,159,1,4,5,10,At Risk
16789,178,29,89,3,4,4,11,Loyal Users
16892,3695,19,19,1,3,2,6,Casual Users
16996,1845,15,48,1,3,3,7,Casual Users
17106,1231,13,50,2,3,3,8,Casual Users
17530,52,28,58,5,4,3,12,Loyal Users
17738,102,15,33,4,3,3,10,Loyal Users
18189,2414,12,13,1,3,1,5,Casual Users
18421,423,26,40,3,4,3,10,Loyal Users
18513,71,65,273,4,5,5,14,Champions
19401,231,23,81,3,4,4,11,Loyal Users
19495,332,10,41,3,2,3,8,Casual Users
19734,857,22,45,2,4,3,9,At Risk
20078,155,41,75,4,4,4,12,Champions
21157,967,5,5,2,1,1,4,Lost
21374,2283,11,46,1,2,3,6,Lost
21397,128,11,55,4,2,3,9,Promising
21479,379,13,19,3,3,2,8,Loyal Users
21520,2757,17,40,1,3,3,7,Casual Users
21674,1422,7,8,1,2,1,4,Lost
21847,74,56,161,4,5,5,14,Champions
22049,2745,5,14,1,1,1,3,Lost
22507,23,82,181,5,5,5,15,Champions
23172,6,143,569,5,5,5,15,Champions
23196,816,15,121,2,3,4,9,Casual Users
23254,2,54,96,5,5,4,14,Champions
23887,1752,7,8,1,2,1,4,Lost
24212,48,38,267,5,4,5,14,Champions
24487,916,13,37,2,3,3,8,Casual Users
24805,81,95,378,4,5,5,14,Champions
24921,659,7,9,2,2,1,5,Lost
25111,133,32,64,4,4,4,12,Champions
25132,7,95,206,5,5,5,15,Champions
25926,422,14,35,3,3,3,9,Loyal Users
26058,1798,25,74,1,4,4,9,At Risk
26415,855,18,36,2,3,3,8,Casual Users
26461,17,23,88,5,4,4,13,Champions
14057,117,26,45,4,4,3,11,Loyal Users
14378,3,82,198,5,5,5,15,Champions
14697,182,40,213,3,4,5,12,Loyal Users
15087,486,12,57,2,3,3,8,Casual Users
15142,460,9,72,3,2,4,9,Casual Users
15214,56,112,178,5,5,5,15,Champions
15434,424,5,29,3,1,2,6,Casual Users
15680,11,34,38,5,4,3,12,Loyal Users
16050,185,5,11,3,1,1,5,Casual Users
16108,295,6,9,3,1,1,5,Casual Users
16208,4,63,76,5,5,4,14,Champions
16384,811,6,8,2,1,1,4,Lost
16669,24,20,40,5,3,3,11,Loyal Users
16725,585,11,36,2,2,3,7,Lost
16814,219,8,57,3,2,3,8,Casual Users
16970,503,62,118,2,5,4,11,At Risk
17022,2840,7,11,1,2,1,4,Lost
17406,3143,7,15,1,2,1,4,Lost
17523,65,10,10,5,2,1,8,Promising
17710,11,44,141,5,4,4,13,Champions
17745,3152,9,18,1,2,2,5,Lost
17945,333,27,58,3,4,3,10,Loyal Users
18111,305,28,41,3,4,3,10,Loyal Users
18288,19,12,54,5,3,3,11,Loyal Users
19158,145,10,85,4,2,4,10,Promising
19437,4856,20,33,1,3,3,7,Casual Users
19956,330,10,11,3,2,1,6,Casual Users
20007,110,13,28,4,3,2,9,Loyal Users
20118,257,7,20,3,2,2,7,Casual Users
20405,542,10,47,2,2,3,7,Lost
20419,68,13,64,5,3,4,12,Loyal Users
20590,86,66,113,4,5,4,13,Champions
20726,1679,105,320,1,5,5,11,At Risk
20835,3793,6,9,1,1,1,3,Lost
20938,4723,5,21,1,1,2,4,Lost
21380,114,39,149,4,4,5,13,Champions
21515,2000,12,27,1,3,2,6,Casual Users
21529,40,14,32,5,3,3,11,Loyal Users
21624,424,10,17,3,2,2,7,Casual Users
21921,112,23,42,4,4,3,11,Loyal Users
22184,1034,25,51,2,4,3,9,At Risk
22529,2466,8,24,1,2,2,5,Lost
22660,20,23,54,5,4,3,12,Loyal Users
22788,240,30,114,3,4,4,11,Loyal Users
23055,1439,12,152,1,3,5,9,Casual Users
23204,295,30,61,3,4,3,10,Loyal Users
23280,226,11,24,3,2,2,7,Casual Users
23345,12,19,128,5,3,4,12,Loyal Users
23812,310,36,83,3,4,4,11,Loyal Users
24182,683,6,7,2,1,1,4,Lost
24399,419,12,19,3,3,2,8,Loyal Users
24736,721,6,17,2,1,2,5,Lost
24810,4,10,37,5,2,3,10,Promising
24891,127,17,24,4,3,2,9,Loyal Users
25156,426,53,184,3,5,5,13,Loyal Users
25632,689,10,27,2,2,2,6,Lost
25649,7,80,217,5,5,5,15,Champions
25787,142,93,169,4,5,5,14,Champions
25987,99,26,90,4,4,4,12,Champions
26223,124,30,59,4,4,3,11,Loyal Users
13599,261,45,177,3,4,5,12,Loyal Users
13656,637,14,117,2,3,4,9,Casual Users
13705,138,86,539,4,5,5,14,Champions
14027,71,93,329,4,5,5,14,Champions
14187,1434,26,40,1,4,3,8,At Risk
14553,16,26,112,5,4,4,13,Champions
14748,981,23,44,2,4,3,9,At Risk
14878,2628,11,14,1,2,1,4,Lost
15337,17,32,134,5,4,4,13,Champions
15665,1581,6,11,1,1,1,3,Lost
15756,4892,6,6,1,1,1,3,Lost
15859,121,28,146,4,4,4,12,Champions
16528,8,15,22,5,3,2,10,Loyal Users
16881,2019,9,9,1,2,1,4,Lost
16936,1421,38,215,1,4,5,10,At Risk
16962,93,5,17,4,1,2,7,Promising
17086,3,118,365,5,5,5,15,Champions
18013,274,42,137,3,4,4,11,Loyal Users
19089,1828,11,37,1,2,3,6,Lost
19122,65,53,196,5,5,5,15,Champions
19230,999,14,14,2,3,1,6,Casual Users
19333,95,8,46,4,2,3,9,Promising
19363,455,5,6,3,1,1,5,Casual Users
19549,653,10,37,2,2,3,7,Lost
19739,87,85,314,4,5,5,14,Champions
20370,125,64,288,4,5,5,14,Champions
20680,614,15,65,2,3,4,9,Casual Users
20722,37,118,329,5,5,5,15,Champions
20995,2370,65,124,1,5,4,10,At Risk
21139,3,15,26,5,3,2,10,Loyal Users
21354,3022,6,6,1,1,1,3,Lost
21400,3,6,17,5,1,2,8,Promising
21563,124,10,71,4,2,4,10,Promising
21637,449,24,50,3,4,3,10,Loyal Users
21687,382,37,279,3,4,5,12,Loyal Users
21701,1133,26,32,2,4,3,9,At Risk
21746,674,110,244,2,5,5,12,At Risk
22197,1560,21,52,1,3,3,7,Casual Users
22375,4862,12,43,1,3,3,7,Casual Users
23165,230,42,147,3,4,5,12,Loyal Users
23173,447,5,18,3,1,2,6,Casual Users
24006,1271,14,18,1,3,2,6,Casual Users
24069,2869,6,6,1,1,1,3,Lost
24409,1942,9,9,1,2,1,4,Lost
24585,123,53,111,4,5,4,13,Champions
24766,211,7,10,3,2,1,6,Casual Users
24844,523,8,31,2,2,2,6,Lost
25353,2,137,327,5,5,5,15,Champions
25549,45,47,89,5,5,4,14,Champions
25583,2804,5,7,1,1,1,3,Lost
25640,0,80,455,5,5,5,15,Champions
25840,2241,13,69,1,3,4,8,Casual Users
26188,259,41,160,3,4,5,12,Loyal Users
26395,1,38,62,5,4,3,12,Loyal Users
26428,5,81,199,5,5,5,15,Champions
13606,4723,8,23,1,2,2,5,Lost
13704,110,17,35,4,3,3,10,Loyal Users
13896,2263,6,25,1,1,2,4,Lost
14923,132,24,80,4,4,4,12,Champions
15160,307,8,22,3,2,2,7,Casual Users
15220,248,67,246,3,5,5,13,Loyal Users
15448,79,83,225,4,5,5,14,Champions
15616,251,23,95,3,4,4,11,Loyal Users
16124,90,74,204,4,5,5,14,Champions
16704,1692,5,10,1,1,1,3,Lost
16850,4,85,257,5,5,5,15,Champions
16852,403,7,19,3,2,2,7,Casual Users
16886,256,147,295,3,5,5,13,Loyal Users
16898,70,15,36,4,3,3,10,Loyal Users
17133,19,80,197,5,5,5,15,Champions
17518,35,51,214,5,5,5,15,Champions
17577,36,117,202,5,5,5,15,Champions
17616,241,39,112,3,4,4,11,Loyal Users
17664,395,34,71,3,4,4,11,Loyal Users
17891,17,53,198,5,5,5,15,Champions
18247,66,80,219,5,5,5,15,Champions
19124,108,35,97,4,4,4,12,Champions
19182,23,64,128,5,5,4,14,Champions
19305,0,91,117,5,5,4,14,Champions
19948,439,11,21,3,2,2,7,Casual Users
20196,90,113,163,4,5,5,14,Champions
20274,858,11,12,2,2,1,5,Lost
20317,720,30,147,2,4,5,11,At Risk
21257,11,55,176,5,5,5,15,Champions
21413,573,38,109,2,4,4,10,At Risk
22008,30,22,45,5,4,3,12,Loyal Users
22073,29,105,262,5,5,5,15,Champions
22289,866,26,62,2,4,3,9,At Risk
22869,55,26,124,5,4,4,13,Champions
22907,393,5,8,3,1,1,5,Casual Users
22985,1099,5,36,2,1,3,6,Lost
22988,3977,21,37,1,3,3,7,Casual Users
23314,18,74,243,5,5,5,15,Champions
23630,1162,26,127,2,4,4,10,At Risk
24946,812,28,147,2,4,5,11,At Risk
25621,5,9,16,5,2,2,9,Promising
25880,433,7,19,3,2,2,7,Casual Users
26116,47,34,54,5,4,3,12,Loyal Users
13819,10,72,273,5,5,5,15,Champions
14189,298,18,68,3,3,4,10,Loyal Users
14694,13,23,70,5,4,4,13,Champions
14981,30,127,446,5,5,5,15,Champions
15006,31,33,87,5,4,4,13,Champions
15158,5573,7,14,1,2,1,4,Lost
15166,871,9,41,2,2,3,7,Lost
15273,270,11,42,3,2,3,8,Casual Users
15309,1458,29,36,1,4,3,8,At Risk
15358,143,58,128,4,5,4,13,Champions
15396,371,22,142,3,4,4,11,Loyal Users
16059,4449,5,10,1,1,1,3,Lost
16161,25,61,128,5,5,4,14,Champions
16262,991,8,70,2,2,4,8,Lost
16729,111,14,50,4,3,3,10,Loyal Users
16758,37,13,77,5,3,4,12,Loyal Users
16937,2927,15,18,1,3,2,6,Casual Users
17122,2747,11,12,1,2,1,4,Lost
17232,405,27,49,3,4,3,10,Loyal Users
17300,385,106,189,3,5,5,13,Loyal Users
17316,1436,9,17,1,2,2,5,Lost
17338,2311,26,26,1,4,2,7,At Risk
17432,0,45,212,5,4,5,14,Champions
17667,3731,8,16,1,2,2,5,Lost
17887,1,55,116,5,5,4,14,Champions
17912,279,6,7,3,1,1,5,Casual Users
18136,375,6,8,3,1,1,5,Casual Users
18298,124,24,40,4,4,3,11,Loyal Users
18333,5423,34,53,1,4,3,8,At Risk
18356,247,9,25,3,2,2,7,Casual Users
18385,2298,6,10,1,1,1,3,Lost
18451,207,28,64,3,4,4,11,Loyal Users
18630,224,6,8,3,1,1,5,Casual Users
18853,121,22,74,4,4,4,12,Champions
18949,1077,14,106,2,3,4,9,Casual Users
19462,306,11,23,3,2,2,7,Casual Users
19857,103,70,76,4,5,4,13,Champions
20427,66,108,218,5,5,5,15,Champions
20690,104,25,103,4,4,4,12,Champions
20918,436,5,20,3,1,2,6,Casual Users
21075,207,57,63,3,5,4,12,Loyal Users
21110,164,12,43,4,3,3,10,Loyal Users
21663,678,10,18,2,2,2,6,Lost
22005,393,7,36,3,2,3,8,Casual Users
22056,0,19,31,5,3,2,10,Loyal Users
22138,10,37,168,5,4,5,14,Champions
22763,1166,14,58,2,3,3,8,Casual Users
22923,603,21,150,2,3,5,10,Casual Users
22925,116,18,25,4,3,2,9,Loyal Users
23147,2147,6,7,1,1,1,3,Lost
23290,2721,10,83,1,2,4,7,Lost
23478,139,81,112,4,5,4,13,Champions
23528,1775,6,16,1,1,2,4,Lost
23540,110,71,410,4,5,5,14,Champions
23597,141,25,80,4,4,4,12,Champions
23805,37,46,163,5,5,5,15,Champions
24163,0,100,209,5,5,5,15,Champions
24369,2,85,139,5,5,4,14,Champions
24492,128,23,117,4,4,4,12,Champions
24572,3619,7,7,1,2,1,4,Lost
24661,18,12,24,5,3,2,10,Loyal Users
24970,495,26,112,2,4,4,10,At Risk
25223,2261,26,57,1,4,3,8,At Risk
25658,417,9,25,3,2,2,7,Casual Users
25663,16,27,61,5,4,3,12,Loyal Users
25788,1517,30,41,1,4,3,8,At Risk
26036,25,37,83,5,4,4,13,Champions
26345,2427,12,24,1,3,2,6,Casual Users
13834,1,8,12,5,2,1,8,Promising
14127,1675,15,79,1,3,4,8,Casual Users
14971,886,18,46,2,3,3,8,Casual Users
15107,591,11,54,2,2,3,7,Lost
15269,424,32,143,3,4,4,11,Loyal Users
15375,543,6,25,2,1,2,5,Lost
15597,87,25,93,4,4,4,12,Champions
15736,145,34,122,4,4,4,12,Champions
15821,31,105,170,5,5,5,15,Champions
15924,1033,16,25,2,3,2,7,Casual Users
16051,142,39,154,4,4,5,13,Champions
16239,597,9,37,2,2,3,7,Lost
16346,141,78,247,4,5,5,14,Champions
16430,2272,5,5,1,1,1,3,Lost
16709,684,12,101,2,3,4,9,Casual Users
16710,95,8,15,4,2,1,7,Promising
17224,2833,9,29,1,2,2,5,Lost
17529,403,7,22,3,2,2,7,Casual Users
17686,413,32,59,3,4,3,10,Loyal Users
17758,1282,7,18,1,2,2,5,Lost
18476,5,37,175,5,4,5,14,Champions
18569,46,64,145,5,5,4,14,Champions
18843,230,14,26,3,3,2,8,Loyal Users
18861,427,8,11,3,2,1,6,Casual Users
19064,570,5,7,2,1,1,4,Lost
19139,1599,5,9,1,1,1,3,Lost
19600,275,14,35,3,3,3,9,Loyal Users
19992,112,14,42,4,3,3,10,Loyal Users
20074,483,22,47,2,4,3,9,At Risk
20263,593,12,19,2,3,2,7,Casual Users
20965,571,10,18,2,2,2,6,Lost
20993,117,56,131,4,5,4,13,Champions
21007,7,68,105,5,5,4,14,Champions
21339,252,7,21,3,2,2,7,Casual Users
21350,2,135,253,5,5,5,15,Champions
21796,1449,6,16,1,1,2,4,Lost
21797,590,6,33,2,1,3,6,Lost
22791,773,5,6,2,1,1,4,Lost
22878,956,8,33,2,2,3,7,Lost
23441,2542,9,9,1,2,1,4,Lost
23810,219,56,128,3,5,4,12,Loyal Users
23847,3,44,224,5,4,5,14,Champions
24013,172,11,16,3,2,2,7,Casual Users
24031,586,7,39,2,2,3,7,Lost
24432,1837,9,39,1,2,3,6,Lost
24586,611,13,120,2,3,4,9,Casual Users
24793,24,38,223,5,4,5,14,Champions
25204,408,30,134,3,4,4,11,Loyal Users
25221,21,13,17,5,3,2,10,Loyal Users
25333,128,152,593,4,5,5,14,Champions
25538,2144,7,9,1,2,1,4,Lost
25684,203,31,62,3,4,3,10,Loyal Users
25739,295,12,13,3,3,1,7,Loyal Users
26130,1143,16,42,2,3,3,8,Casual Users
13715,170,12,32,3,3,3,9,Loyal Users
13776,969,36,97,2,4,4,10,At Risk
14206,1476,7,32,1,2,3,6,Lost
14238,4436,6,6,1,1,1,3,Lost
14341,28,112,182,5,5,5,15,Champions
14424,1159,28,186,2,4,5,11,At Risk
14478,1532,31,168,1,4,5,10,At Risk
14566,23,20,49,5,3,3,11,Loyal Users
14661,1012,6,9,2,1,1,4,Lost
14843,75,56,203,4,5,5,14,Champions
15143,974,10,23,2,2,2,6,Lost
15185,0,197,432,5,5,5,15,Champions
15300,420,18,46,3,3,3,9,Loyal Users
15362,525,19,32,2,3,3,8,Casual Users
15461,2268,10,38,1,2,3,6,Lost
15541,1712,23,134,1,4,4,9,At Risk
15762,2136,7,10,1,2,1,4,Lost
15890,36,34,47,5,4,3,12,Loyal Users
16233,65,72,167,5,5,5,15,Champions
16567,1141,5,20,2,1,2,5,Lost
16639,173,12,49,3,3,3,9,Loyal Users
17047,125,57,226,4,5,5,14,Champions
17090,1148,44,110,2,4,4,10,At Risk
17773,432,55,136,3,5,4,12,Loyal Users
18398,4988,5,6,1,1,1,3,Lost
18531,1099,6,16,2,1,2,5,Lost
18958,2020,10,15,1,2,1,4,Lost
19014,842,15,68,2,3,4,9,Casual Users
19142,582,6,8,2,1,1,4,Lost
19282,106,20,22,4,3,2,9,Loyal Users
19887,663,36,86,2,4,4,10,At Risk
20503,264,17,35,3,3,3,9,Loyal Users
20618,226,36,105,3,4,4,11,Loyal Users
21076,1242,16,23,2,3,2,7,Casual Users
21256,222,59,73,3,5,4,12,Loyal Users
21525,297,10,26,3,2,2,7,Casual Users
21727,251,11,22,3,2,2,7,Casual Users
22019,34,13,32,5,3,3,11,Loyal Users
22559,1382,5,9,1,1,1,3,Lost
22822,275,22,88,3,4,4,11,Loyal Users
22856,137,149,454,4,5,5,14,Champions
23042,1097,5,7,2,1,1,4,Lost
23771,710,10,39,2,2,3,7,Lost
23785,239,16,41,3,3,3,9,Loyal Users
23821,438,5,7,3,1,1,5,Casual Users
23881,2004,5,30,1,1,2,4,Lost
23902,86,11,46,4,2,3,9,Promising
24012,4650,5,16,1,1,2,4,Lost
24785,560,31,85,2,4,4,10,At Risk
24895,4722,16,24,1,3,2,6,Casual Users
24949,921,7,17,2,2,2,6,Lost
25175,218,21,160,3,3,5,11,Loyal Users
25409,2826,7,26,1,2,2,5,Lost
25438,711,5,8,2,1,1,4,Lost
25447,83,10,50,4,2,3,9,Promising
25485,345,5,29,3,1,2,6,Casual Users
25566,905,20,27,2,3,2,7,Casual Users
25665,2388,23,56,1,4,3,8,At Risk
25844,3127,9,43,1,2,3,6,Lost
25884,437,25,43,3,4,3,10,Loyal Users
26224,2044,20,44,1,3,3,7,Casual Users
26310,5,57,337,5,5,5,15,Champions
26467,122,95,527,4,5,5,14,Champions
13709,18,53,161,5,5,5,15,Champions
13759,13,72,284,5,5,5,15,Champions
13889,5129,5,6,1,1,1,3,Lost
14083,1565,10,37,1,2,3,6,Lost
14116,1847,15,112,1,3,4,8,Casual Users
14362,135,53,217,4,5,5,14,Champions
14443,3555,12,35,1,3,3,7,Casual Users
14506,1826,32,109,1,4,4,9,At Risk
14530,80,51,174,4,5,5,14,Champions
14613,156,11,25,4,2,2,8,Promising
14631,35,94,197,5,5,5,15,Champions
15008,110,5,16,4,1,2,7,Promising
15140,447,11,20,3,2,2,7,Casual Users
15201,270,47,122,3,5,4,12,Loyal Users
15369,44,36,134,5,4,4,13,Champions
15767,3860,5,16,1,1,2,4,Lost
15910,18,20,46,5,3,3,11,Loyal Users
16163,121,9,22,4,2,2,8,Promising
16426,1369,8,17,1,2,2,5,Lost
16935,92,71,199,4,5,5,14,Champions
16975,8,146,292,5,5,5,15,Champions
17096,1164,23,77,2,4,4,10,At Risk
17252,65,108,393,5,5,5,15,Champions
17552,1986,11,13,1,2,1,4,Lost
17604,850,6,8,2,1,1,4,Lost
17867,530,19,23,2,3,2,7,Casual Users
18120,1428,7,16,1,2,2,5,Lost
18202,3,77,170,5,5,5,15,Champions
18888,3079,7,44,1,2,3,6,Lost
18914,108,14,70,4,3,4,11,Loyal Users
18996,277,124,496,3,5,5,13,Loyal Users
19028,108,88,408,4,5,5,14,Champions
19128,988,6,9,2,1,1,4,Lost
19292,120,78,267,4,5,5,14,Champions
19591,1413,6,32,1,1,3,5,Lost
19930,20,87,232,5,5,5,15,Champions
19989,7,9,27,5,2,2,9,Promising
20181,416,5,29,3,1,2,6,Casual Users
20242,624,8,86,2,2,4,8,Lost
20279,65,42,54,5,4,3,12,Loyal Users
20357,884,10,19,2,2,2,6,Lost
20566,21,31,159,5,4,5,14,Champions
20989,38,144,545,5,5,5,15,Champions
21290,3,76,531,5,5,5,15,Champions
21343,289,22,84,3,4,4,11,Loyal Users
21880,282,52,118,3,5,4,12,Loyal Users
22561,445,45,197,3,4,5,12,Loyal Users
22764,583,18,53,2,3,3,8,Casual Users
22805,2,144,703,5,5,5,15,Champions
23085,3,7,9,5,2,1,8,Promising
23135,121,30,132,4,4,4,12,Champions
23695,91,35,77,4,4,4,12,Champions
23705,26,13,22,5,3,2,10,Loyal Users
23759,458,9,12,3,2,1,6,Casual Users
23891,1545,10,39,1,2,3,6,Lost
23917,40,5,12,5,1,1,7,Promising
23972,135,62,205,4,5,5,14,Champions
24063,442,17,22,3,3,2,8,Loyal Users
24082,18,6,17,5,1,2,8,Promising
24275,291,30,92,3,4,4,11,Loyal Users
25006,298,151,243,3,5,5,13,Loyal Users
25174,192,26,45,3,4,3,10,Loyal Users
25734,90,7,14,4,2,1,7,Promising
25843,78,35,101,4,4,4,12,Champions
26158,138,5,14,4,1,1,6,Promising
26308,478,17,60,2,3,3,8,Casual Users
26411,55,19,112,5,3,4,12,Loyal Users
13683,87,15,43,4,3,3,10,Loyal Users
14442,12,26,72,5,4,4,13,Champions
14509,5667,5,9,1,1,1,3,Lost
14866,127,37,44,4,4,3,11,Loyal Users
15099,988,8,13,2,2,1,5,Lost
15392,163,70,255,4,5,5,14,Champions
15669,529,7,13,2,2,1,5,Lost
16301,9,44,180,5,4,5,14,Champions
16376,2,6,43,5,1,3,9,Promising
17015,246,20,36,3,3,3,9,Loyal Users
17139,24,57,464,5,5,5,15,Champions
17215,2744,15,71,1,3,4,8,Casual Users
17369,2131,6,12,1,1,1,3,Lost
17405,2599,6,36,1,1,3,5,Lost
17450,4,44,67,5,4,4,13,Champions
17729,13,47,255,5,5,5,15,Champions
18089,254,56,98,3,5,4,12,Loyal Users
18291,132,152,296,4,5,5,14,Champions
18340,8,117,533,5,5,5,15,Champions
18648,601,18,92,2,3,4,9,Casual Users
19141,2204,5,11,1,1,1,3,Lost
19262,133,17,140,4,3,4,11,Loyal Users
19295,45,74,143,5,5,4,14,Champions
19344,409,17,86,3,3,4,10,Loyal Users
19379,828,24,94,2,4,4,10,At Risk
19445,125,6,46,4,1,3,8,Promising
19721,137,7,12,4,2,1,7,Promising
20048,2131,6,9,1,1,1,3,Lost
20222,533,28,39,2,4,3,9,At Risk
20225,3133,6,13,1,1,1,3,Lost
20402,358,21,90,3,3,4,10,Loyal Users
20652,137,62,112,4,5,4,13,Champions
20682,132,26,72,4,4,4,12,Champions
20838,127,5,14,4,1,1,6,Promising
21322,130,66,203,4,5,5,14,Champions
21816,0,60,153,5,5,5,15,Champions
21828,136,24,55,4,4,3,11,Loyal Users
22047,2789,9,11,1,2,1,4,Lost
22174,53,9,16,5,2,2,9,Promising
22300,3008,5,8,1,1,1,3,Lost
22329,12,79,418,5,5,5,15,Champions
22781,12,112,242,5,5,5,15,Champions
22895,109,6,6,4,1,1,6,Promising
23158,277,16,128,3,3,4,10,Loyal Users
23259,1135,6,13,2,1,1,4,Lost
23641,5,38,88,5,4,4,13,Champions
23663,1772,5,8,1,1,1,3,Lost
23875,1538,10,45,1,2,3,6,Lost
23967,105,53,139,4,5,4,13,Champions
24158,3871,5,21,1,1,2,4,Lost
24165,21,25,190,5,4,5,14,Champions
24290,157,24,80,4,4,4,12,Champions
24477,997,13,18,2,3,2,7,Casual Users
24611,21,54,216,5,5,5,15,Champions
24625,1448,9,26,1,2,2,5,Lost
24961,406,10,47,3,2,3,8,Casual Users
25078,386,7,45,3,2,3,8,Casual Users
25323,939,10,44,2,2,3,7,Lost
25398,1098,8,21,2,2,2,6,Lost
25683,101,42,85,4,4,4,12,Champions
25707,4361,32,53,1,4,3,8,At Risk
25727,1,39,118,5,4,4,13,Champions
25905,572,13,49,2,3,3,8,Casual Users
25938,369,19,33,3,3,3,9,Loyal Users
26040,1934,11,22,1,2,2,5,Lost
26342,135,25,54,4,4,3,11,Loyal Users
26419,230,84,191,3,5,5,13,Loyal Users
26466,32,107,438,5,5,5,15,Champions
13723,1,34,171,5,4,5,14,Champions
13943,3588,42,81,1,4,4,9,At Risk
13947,260,30,159,3,4,5,12,Loyal Users
14074,719,5,47,2,1,3,6,Lost
14249,384,13,24,3,3,2,8,Loyal Users
14503,41,130,366,5,5,5,15,Champions
14651,2,53,112,5,5,4,14,Champions
15021,1258,8,9,1,2,1,4,Lost
15623,446,8,24,3,2,2,7,Casual Users
16557,1936,10,35,1,2,3,6,Lost
16636,704,11,51,2,2,3,7,Lost
16783,4149,5,22,1,1,2,4,Lost
16844,142,35,63,4,4,4,12,Champions
16903,797,12,83,2,3,4,9,Casual Users
17009,76,127,618,4,5,5,14,Champions
17832,244,18,84,3,3,4,10,Loyal Users
18047,324,34,101,3,4,4,11,Loyal Users
18200,5112,6,18,1,1,2,4,Lost
18434,11,72,583,5,5,5,15,Champions
18436,1688,5,15,1,1,1,3,Lost
18720,686,15,17,2,3,2,7,Casual Users
18807,90,47,71,4,5,4,13,Champions
19253,4703,11,12,1,2,1,4,Lost
19460,1237,7,43,2,2,3,7,Lost
19574,3,78,105,5,5,4,14,Champions
19582,362,6,9,3,1,1,5,Casual Users
19902,38,94,304,5,5,5,15,Champions
20012,265,11,36,3,2,3,8,Casual Users
20063,629,10,16,2,2,2,6,Lost
20164,395,5,6,3,1,1,5,Casual Users
20351,3,45,119,5,4,4,13,Champions
20654,159,14,21,4,3,2,9,Loyal Users
21059,13,68,190,5,5,5,15,Champions
21265,40,8,63,5,2,4,11,Promising
21665,407,19,59,3,3,3,9,Loyal Users
22069,875,8,8,2,2,1,5,Lost
22715,3731,18,35,1,3,3,7,Casual Users
22731,440,34,62,3,4,3,10,Loyal Users
22888,348,17,152,3,3,5,11,Loyal Users
23198,21,44,215,5,4,5,14,Champions
23492,3719,21,94,1,3,4,8,Casual Users
23538,208,14,73,3,3,4,10,Loyal Users
23684,162,77,217,4,5,5,14,Champions
24304,526,22,107,2,4,4,10,At Risk
24387,1695,10,74,1,2,4,7,Lost
24425,2608,5,16,1,1,2,4,Lost
24613,75,75,285,4,5,5,14,Champions
24617,450,34,60,3,4,3,10,Loyal Users
24717,1361,5,15,1,1,1,3,Lost
24867,104,6,13,4,1,1,6,Promising
25652,6,98,367,5,5,5,15,Champions
26161,1671,11,21,1,2,2,5,Lost
13750,2,116,661,5,5,5,15,Champions
13934,385,10,21,3,2,2,7,Casual Users
13956,84,23,42,4,4,3,11,Loyal Users
13978,284,37,152,3,4,5,12,Loyal Users
14227,1984,14,42,1,3,3,7,Casual Users
14464,830,12,45,2,3,3,8,Casual Users
14653,310,11,38,3,2,3,8,Casual Users
14761,2854,6,27,1,1,2,4,Lost
14859,36,32,44,5,4,3,12,Loyal Users
14994,3086,6,20,1,1,2,4,Lost
15030,60,71,524,5,5,5,15,Champions
15373,1097,10,11,2,2,1,5,Lost
15475,437,19,52,3,3,3,9,Loyal Users
15561,471,21,46,2,3,3,8,Casual Users
15709,135,41,74,4,4,4,12,Champions
15880,1288,16,46,1,3,3,7,Casual Users
16350,1832,5,6,1,1,1,3,Lost
16498,5,35,124,5,4,4,13,Champions
16517,159,7,91,4,2,4,10,Promising
16857,1522,10,11,1,2,1,4,Lost
16931,24,80,176,5,5,5,15,Champions
17061,627,23,98,2,4,4,10,At Risk
17558,3156,5,8,1,1,1,3,Lost
17696,407,12,16,3,3,2,8,Loyal Users
17756,28,88,552,5,5,5,15,Champions
18273,546,24,68,2,4,4,10,At Risk
18815,232,48,73,3,5,4,12,Loyal Users
19009,117,37,122,4,4,4,12,Champions
19192,2462,10,32,1,2,3,6,Lost
19483,124,9,87,4,2,4,10,Promising
19684,1598,11,16,1,2,2,5,Lost
19719,105,16,71,4,3,4,11,Loyal Users
19777,95,104,206,4,5,5,14,Champions
19845,312,11,33,3,2,3,8,Casual Users
20401,596,13,120,2,3,4,9,Casual Users
20991,125,42,351,4,4,5,13,Champions
21004,121,57,307,4,5,5,14,Champions
21182,518,7,9,2,2,1,5,Lost
21391,297,23,156,3,4,5,12,Loyal Users
21474,961,19,77,2,3,4,9,Casual Users
22100,0,46,457,5,5,5,15,Champions
22297,100,13,22,4,3,2,9,Loyal Users
22520,2658,16,27,1,3,2,6,Casual Users
22566,310,8,25,3,2,2,7,Casual Users
23006,893,10,26,2,2,2,6,Lost
23012,1675,7,22,1,2,2,5,Lost
23022,857,17,98,2,3,4,9,Casual Users
23105,143,42,200,4,4,5,13,Champions
23275,90,56,116,4,5,4,13,Champions
23392,403,26,99,3,4,4,11,Loyal Users
23469,65,168,790,5,5,5,15,Champions
23772,146,21,30,4,3,2,9,Loyal Users
23817,257,71,128,3,5,4,12,Loyal Users
23990,2986,9,16,1,2,2,5,Lost
24148,182,21,49,3,3,3,9,Loyal Users
24211,967,6,29,2,1,2,5,Lost
24385,425,7,10,3,2,1,6,Casual Users
24599,410,11,30,3,2,2,7,Casual Users
24804,6,33,75,5,4,4,13,Champions
25021,102,11,13,4,2,1,7,Promising
25378,26,36,89,5,4,4,13,Champions
25676,53,54,111,5,5,4,14,Champions
26069,263,5,26,3,1,2,6,Casual Users
26080,4,25,244,5,4,5,14,Champions
26169,58,97,346,5,5,5,15,Champions
26313,300,134,395,3,5,5,13,Loyal Users
13626,80,152,578,4,5,5,14,Champions
14243,2889,5,6,1,1,1,3,Lost
14623,84,47,135,4,5,4,13,Champions
15054,1171,12,69,2,3,4,9,Casual Users
15095,969,26,68,2,4,4,10,At Risk
15141,145,5,29,4,1,2,7,Promising
15282,482,16,66,2,3,4,9,Casual Users
15298,2760,6,10,1,1,1,3,Lost
15381,53,29,172,5,4,5,14,Champions
15391,303,19,20,3,3,2,8,Loyal Users
15488,397,7,26,3,2,2,7,Casual Users
15714,10,21,26,5,3,2,10,Loyal Users
15926,162,6,17,4,1,2,7,Promising
16072,4822,11,11,1,2,1,4,Lost
16275,121,10,11,4,2,1,7,Promising
16542,172,9,22,3,2,2,7,Casual Users
16656,3531,8,79,1,2,4,7,Lost
16727,40,93,332,5,5,5,15,Champions
16778,3396,5,11,1,1,1,3,Lost
16938,118,52,95,4,5,4,13,Champions
17409,262,11,23,3,2,2,7,Casual Users
17413,3469,5,6,1,1,1,3,Lost
17614,1881,9,12,1,2,1,4,Lost
17726,35,76,312,5,5,5,15,Champions
18042,98,43,105,4,4,4,12,Champions
18383,11,90,294,5,5,5,15,Champions
18532,65,110,361,5,5,5,15,Champions
18849,115,28,201,4,4,5,13,Champions
18915,429,13,31,3,3,2,8,Loyal Users
19075,381,12,41,3,3,3,9,Loyal Users
19127,92,49,98,4,5,4,13,Champions
19220,141,15,21,4,3,2,9,Loyal Users
19501,118,5,6,4,1,1,6,Promising
19986,156,51,466,4,5,5,14,Champions
20082,2576,12,17,1,3,2,6,Casual Users
20681,273,34,243,3,4,5,12,Loyal Users
20692,7,27,47,5,4,3,12,Loyal Users
20758,23,16,73,5,3,4,12,Loyal Users
20877,967,11,29,2,2,2,6,Lost
21176,216,50,139,3,5,4,12,Loyal Users
21808,279,14,179,3,3,5,11,Loyal Users
21827,413,20,40,3,3,3,9,Loyal Users
21916,13,70,138,5,5,4,14,Champions
22156,283,19,50,3,3,3,9,Loyal Users
22182,274,34,84,3,4,4,11,Loyal Users
22296,460,24,102,3,4,4,11,Loyal Users
22393,1536,22,38,1,4,3,8,At Risk
22419,43,5,6,5,1,1,7,Promising
22480,567,7,45,2,2,3,7,Lost
22754,161,39,77,4,4,4,12,Champions
22938,568,11,19,2,2,2,6,Lost
23244,1941,10,53,1,2,3,6,Lost
23486,1037,6,28,2,1,2,5,Lost
23488,995,34,54,2,4,3,9,At Risk
23519,105,35,134,4,4,4,12,Champions
23689,1083,11,27,2,2,2,6,Lost
23761,151,11,15,4,2,1,7,Promising
23919,408,11,16,3,2,2,7,Casual Users
24122,166,5,17,3,1,2,6,Casual Users
24199,475,22,50,2,4,3,9,At Risk
24216,25,76,151,5,5,5,15,Champions
24456,22,154,646,5,5,5,15,Champions
24494,1577,14,28,1,3,2,6,Casual Users
24519,125,30,37,4,4,3,11,Loyal Users
24532,1886,5,7,1,1,1,3,Lost
24547,15,104,275,5,5,5,15,Champions
24721,146,20,51,4,3,3,10,Loyal Users
25275,128,5,16,4,1,2,7,Promising
25430,1264,10,34,1,2,3,6,Lost
25551,2758,5,5,1,1,1,3,Lost
25768,25,7,8,5,2,1,8,Promising
25881,316,59,276,3,5,5,13,Loyal Users
26037,680,7,10,2,2,1,5,Lost
13620,483,14,31,2,3,2,7,Casual Users
14103,82,17,163,4,3,5,12,Loyal Users
14201,582,10,20,2,2,2,6,Lost
14203,31,17,21,5,3,2,10,Loyal Users
14233,86,47,230,4,5,5,14,Champions
14369,72,91,225,4,5,5,14,Champions
14559,1664,7,29,1,2,2,5,Lost
14629,987,12,47,2,3,3,8,Casual Users
14663,1503,12,22,1,3,2,6,Casual Users
14821,422,55,201,3,5,5,13,Loyal Users
14969,2965,8,35,1,2,3,6,Lost
15261,1863,5,9,1,1,1,3,Lost
15295,4,55,217,5,5,5,15,Champions
15407,1015,6,21,2,1,2,5,Lost
15521,14,236,526,5,5,5,15,Champions
15788,31,74,260,5,5,5,15,Champions
16403,3449,6,8,1,1,1,3,Lost
16427,415,76,298,3,5,5,13,Loyal Users
16489,1141,7,25,2,2,2,6,Lost
16508,2638,6,7,1,1,1,3,Lost
17132,85,68,256,4,5,5,14,Champions
17670,119,141,914,4,5,5,14,Champions
17719,71,51,67,4,5,4,13,Champions
17749,2710,5,6,1,1,1,3,Lost
17797,253,117,736,3,5,5,13,Loyal Users
17960,1546,7,7,1,2,1,4,Lost
18019,2436,5,67,1,1,4,6,Lost
18066,529,33,183,2,4,5,11,At Risk
18106,2117,27,111,1,4,4,9,At Risk
18146,742,16,78,2,3,4,9,Casual Users
18699,3603,9,12,1,2,1,4,Lost
18834,1600,7,10,1,2,1,4,Lost
19020,831,8,18,2,2,2,6,Lost
19308,1384,7,7,1,2,1,4,Lost
19417,106,44,86,4,4,4,12,Champions
19692,307,30,196,3,4,5,12,Loyal Users
19708,10,27,69,5,4,4,13,Champions
19754,1546,28,33,1,4,3,8,At Risk
19784,106,20,33,4,3,3,10,Loyal Users
19888,301,18,34,3,3,3,9,Loyal Users
20172,3546,19,37,1,3,3,7,Casual Users
20603,50,146,781,5,5,5,15,Champions
20641,65,81,544,5,5,5,15,Champions
20648,1034,35,271,2,4,5,11,At Risk
20733,443,7,10,3,2,1,6,Casual Users
21304,711,6,7,2,1,1,4,Lost
21486,791,28,93,2,4,4,10,At Risk
21560,1843,13,38,1,3,3,7,Casual Users
21679,21,82,113,5,5,4,14,Champions
21692,817,25,45,2,4,3,9,At Risk
21970,58,29,100,5,4,4,13,Champions
22001,6,78,307,5,5,5,15,Champions
22464,269,83,197,3,5,5,13,Loyal Users
23224,133,26,138,4,4,4,12,Champions
23448,196,18,50,3,3,3,9,Loyal Users
23947,2420,11,32,1,2,3,6,Lost
24051,115,65,114,4,5,4,13,Champions
24452,693,13,32,2,3,3,8,Casual Users
24513,161,19,27,4,3,2,9,Loyal Users
24668,1745,5,11,1,1,1,3,Lost
24936,3430,6,13,1,1,1,3,Lost
25230,61,75,456,5,5,5,15,Champions
25433,995,10,13,2,2,1,5,Lost
25605,317,37,83,3,4,4,11,Loyal Users
25800,9,155,346,5,5,5,15,Champions
25802,277,33,51,3,4,3,10,Loyal Users
26163,94,51,70,4,5,4,13,Champions
26212,104,40,140,4,4,4,12,Champions
26264,2,53,129,5,5,4,14,Champions
13632,25,19,33,5,3,3,11,Loyal Users
13853,130,11,21,4,2,2,8,Promising
13885,18,32,132,5,4,4,13,Champions
13941,30,29,161,5,4,5,14,Champions
13968,103,20,39,4,3,3,10,Loyal Users
14604,252,6,10,3,1,1,5,Casual Users
14844,5,71,157,5,5,5,15,Champions
14925,176,37,182,3,4,5,12,Loyal Users
14940,92,25,43,4,4,3,11,Loyal Users
15048,613,20,105,2,3,4,9,Casual Users
15082,1896,18,29,1,3,2,6,Casual Users
15212,209,10,18,3,2,2,7,Casual Users
15249,425,11,19,3,2,2,7,Casual Users
15542,120,17,25,4,3,2,9,Loyal Users
15845,0,18,38,5,3,3,11,Loyal Users
16084,3518,57,278,1,5,5,11,At Risk
16742,655,20,34,2,3,3,8,Casual Users
16894,9,7,14,5,2,1,8,Promising
17087,181,5,6,3,1,1,5,Casual Users
17294,1,11,16,5,2,2,9,Promising
17893,8,23,33,5,4,3,12,Loyal Users
18242,851,21,35,2,3,3,8,Casual Users
18854,1868,6,10,1,1,1,3,Lost
19151,297,23,38,3,4,3,10,Loyal Users
19201,1461,29,29,1,4,2,7,At Risk
19339,1402,7,13,1,2,1,4,Lost
19602,2493,5,7,1,1,1,3,Lost
19673,132,28,45,4,4,3,11,Loyal Users
19825,4941,8,41,1,2,3,6,Lost
19933,107,86,147,4,5,5,14,Champions
20216,126,18,73,4,3,4,11,Loyal Users
20769,148,28,55,4,4,3,11,Loyal Users
21156,37,63,351,5,5,5,15,Champions
21170,171,9,39,3,2,3,8,Casual Users
22076,1663,36,86,1,4,4,9,At Risk
22146,524,8,22,2,2,2,6,Lost
22219,15,33,156,5,4,5,14,Champions
22254,331,11,42,3,2,3,8,Casual Users
22261,316,16,36,3,3,3,9,Loyal Users
22325,1488,7,29,1,2,2,5,Lost
22337,11,176,440,5,5,5,15,Champions
22372,535,16,29,2,3,2,7,Casual Users
22380,243,131,359,3,5,5,13,Loyal Users
22569,8,63,119,5,5,4,14,Champions
22921,1307,5,8,1,1,1,3,Lost
23119,4007,9,21,1,2,2,5,Lost
23285,3704,31,47,1,4,3,8,At Risk
23749,2976,12,35,1,3,3,7,Casual Users
24090,58,95,314,5,5,5,15,Champions
24180,36,23,76,5,4,4,13,Champions
24346,419,7,48,3,2,3,8,Casual Users
24431,17,102,291,5,5,5,15,Champions
24737,288,65,146,3,5,4,12,Loyal Users
25066,4824,5,15,1,1,1,3,Lost
25202,22,37,104,5,4,4,13,Champions
25216,2117,17,44,1,3,3,7,Casual Users
25401,269,20,83,3,3,4,10,Loyal Users
25428,2713,15,58,1,3,3,7,Casual Users
25899,4688,8,13,1,2,1,4,Lost
25927,655,23,66,2,4,4,10,At Risk
25958,156,34,63,4,4,4,12,Champions
26025,16,58,254,5,5,5,15,Champions
26276,65,66,497,5,5,5,15,Champions
26454,2422,7,72,1,2,4,7,Lost
13741,105,69,327,4,5,5,14,Champions
14012,425,13,19,3,3,2,8,Loyal Users
14094,12,12,28,5,3,2,10,Loyal Users
14982,112,43,120,4,4,4,12,Champions
15366,288,5,7,3,1,1,5,Casual Users
15606,1108,7,13,2,2,1,5,Lost
15661,719,14,29,2,3,2,7,Casual Users
15891,87,17,38,4,3,3,10,Loyal Users
16118,283,54,108,3,5,4,12,Loyal Users
16245,402,11,18,3,2,2,7,Casual Users
16302,708,19,32,2,3,3,8,Casual Users
16590,673,13,41,2,3,3,8,Casual Users
17292,124,78,284,4,5,5,14,Champions
17343,3744,11,12,1,2,1,4,Lost
17626,708,6,10,2,1,1,4,Lost
17747,104,24,48,4,4,3,11,Loyal Users
17857,11,24,40,5,4,3,12,Loyal Users
17872,130,102,556,4,5,5,14,Champions
18132,38,37,145,5,4,4,13,Champions
18337,1146,5,5,2,1,1,4,Lost
18427,2,48,423,5,5,5,15,Champions
18597,2447,5,8,1,1,1,3,Lost
18731,128,24,44,4,4,3,11,Loyal Users
18764,146,8,14,4,2,1,7,Promising
19012,90,83,156,4,5,5,14,Champions
19153,2439,7,11,1,2,1,4,Lost
19268,810,6,9,2,1,1,4,Lost
19395,296,35,66,3,4,4,11,Loyal Users
19635,257,20,66,3,3,4,10,Loyal Users
19725,357,9,21,3,2,2,7,Casual Users
20089,246,14,48,3,3,3,9,Loyal Users
20534,291,8,16,3,2,2,7,Casual Users
20597,27,34,62,5,4,3,12,Loyal Users
20757,644,18,23,2,3,2,7,Casual Users
21414,448,27,51,3,4,3,10,Loyal Users
21533,3421,11,11,1,2,1,4,Lost
22505,9,130,468,5,5,5,15,Champions
22832,132,42,139,4,4,4,12,Champions
23126,123,6,29,4,1,2,7,Promising
23160,606,45,104,2,4,4,10,At Risk
23251,2432,6,7,1,1,1,3,Lost
23372,983,14,27,2,3,2,7,Casual Users
23475,587,61,305,2,5,5,12,At Risk
23703,119,119,356,4,5,5,14,Champions
23787,211,72,334,3,5,5,13,Loyal Users
24019,1958,18,32,1,3,3,7,Casual Users
24034,1588,10,14,1,2,1,4,Lost
24261,268,69,201,3,5,5,13,Loyal Users
24746,186,47,51,3,5,3,11,Loyal Users
24789,175,9,22,3,2,2,7,Casual Users
24892,235,13,18,3,3,2,8,Loyal Users
24902,1440,7,14,1,2,1,4,Lost
25129,24,11,48,5,2,3,10,Promising
25170,1830,6,16,1,1,2,4,Lost
25173,939,10,22,2,2,2,6,Lost
25408,4714,7,26,1,2,2,5,Lost
25457,16,22,117,5,4,4,13,Champions
25514,117,49,93,4,5,4,13,Champions
25850,2872,11,24,1,2,2,5,Lost
26062,73,5,51,4,1,3,8,Promising
26072,1412,6,6,1,1,1,3,Lost
26270,107,7,48,4,2,3,9,Promising
26292,2273,7,9,1,2,1,4,Lost
26347,42,7,8,5,2,1,8,Promising
13731,7,31,49,5,4,3,12,Loyal Users
13905,689,7,10,2,2,1,5,Lost
13925,111,31,45,4,4,3,11,Loyal Users
14063,416,40,69,3,4,4,11,Loyal Users
14492,423,10,24,3,2,2,7,Casual Users
14581,144,33,151,4,4,5,13,Champions
14960,26,45,222,5,4,5,14,Champions
14973,30,5,19,5,1,2,8,Promising
15041,748,30,105,2,4,4,10,At Risk
15047,869,8,13,2,2,1,5,Lost
15512,117,54,114,4,5,4,13,Champions
15707,172,11,103,3,2,4,9,Casual Users
16035,2259,9,17,1,2,2,5,Lost
16090,110,27,72,4,4,4,12,Champions
16167,17,16,25,5,3,2,10,Loyal Users
16210,225,31,81,3,4,4,11,Loyal Users
16368,176,5,7,3,1,1,5,Casual Users
16493,118,45,91,4,4,4,12,Champions
16644,383,6,10,3,1,1,5,Casual Users
16833,1679,13,25,1,3,2,6,Casual Users
17131,8,20,63,5,3,4,12,Loyal Users
17141,151,185,283,4,5,5,14,Champions
17628,572,20,87,2,3,4,9,Casual Users
17990,135,21,49,4,3,3,10,Loyal Users
18377,1648,5,11,1,1,1,3,Lost
18402,3861,5,6,1,1,1,3,Lost
18631,97,57,182,4,5,5,14,Champions
18643,2730,6,21,1,1,2,4,Lost
18865,1,28,47,5,4,3,12,Loyal Users
18912,21,75,389,5,5,5,15,Champions
19233,1068,28,50,2,4,3,9,At Risk
19632,124,11,14,4,2,1,7,Promising
19671,2704,5,11,1,1,1,3,Lost
19773,51,98,429,5,5,5,15,Champions
19795,2030,17,22,1,3,2,6,Casual Users
20023,667,6,10,2,1,1,4,Lost
20248,1527,6,8,1,1,1,3,Lost
20462,1527,8,50,1,2,3,6,Lost
20499,3917,8,43,1,2,3,6,Lost
20817,233,43,278,3,4,5,12,Loyal Users
21127,843,19,19,2,3,2,7,Casual Users
21356,1372,5,7,1,1,1,3,Lost
21662,2630,5,15,1,1,1,3,Lost
21725,70,47,251,4,5,5,14,Champions
21747,416,6,12,3,1,1,5,Casual Users
21881,2387,14,59,1,3,3,7,Casual Users
22007,85,16,134,4,3,4,11,Loyal Users
22163,42,29,108,5,4,4,13,Champions
22431,3569,5,5,1,1,1,3,Lost
22531,1293,17,54,1,3,3,7,Casual Users
22852,16,21,31,5,3,2,10,Loyal Users
23370,1242,7,14,2,2,1,5,Lost
23927,125,6,39,4,1,3,8,Promising
24607,177,17,129,3,3,4,10,Loyal Users
25345,82,71,117,4,5,4,13,Champions
25404,85,16,16,4,3,2,9,Loyal Users
25697,3872,6,44,1,1,3,5,Lost
26102,191,25,41,3,4,3,10,Loyal Users
26318,2582,9,10,1,2,1,4,Lost
26356,1133,17,23,2,3,2,7,Casual Users
13770,6,72,112,5,5,4,14,Champions
13863,116,44,211,4,4,5,13,Champions
13966,582,21,52,2,3,3,8,Casual Users
13971,140,24,40,4,4,3,11,Loyal Users
14061,726,40,80,2,4,4,10,At Risk
14259,119,8,10,4,2,1,7,Promising
14299,64,57,98,5,5,4,14,Champions
14303,134,31,62,4,4,3,11,Loyal Users
14428,17,126,486,5,5,5,15,Champions
14438,1915,5,21,1,1,2,4,Lost
14673,55,51,87,5,5,4,14,Champions
14839,2655,7,9,1,2,1,4,Lost
14986,2791,28,51,1,4,3,8,At Risk
15033,110,45,134,4,4,4,12,Champions
15179,104,189,467,4,5,5,14,Champions
15420,877,10,21,2,2,2,6,Lost
15772,804,49,83,2,5,4,11,At Risk
15933,59,118,924,5,5,5,15,Champions
16195,369,27,170,3,4,5,12,Loyal Users
16421,217,42,338,3,4,5,12,Loyal Users
16614,3970,8,36,1,2,3,6,Lost
17175,140,80,127,4,5,4,13,Champions
17526,851,5,12,2,1,1,4,Lost
17845,99,45,206,4,4,5,13,Champions
17923,3039,15,40,1,3,3,7,Casual Users
18229,94,54,173,4,5,5,14,Champions
18280,122,88,398,4,5,5,14,Champions
18322,708,12,17,2,3,2,7,Casual Users
18577,138,38,95,4,4,4,12,Champions
18985,17,85,377,5,5,5,15,Champions
19057,287,7,11,3,2,1,6,Casual Users
19518,84,12,30,4,3,2,9,Loyal Users
19623,117,49,290,4,5,5,14,Champions
19695,117,92,174,4,5,5,14,Champions
19830,498,5,25,2,1,2,5,Lost
19924,1170,10,49,2,2,3,7,Lost
20062,806,23,102,2,4,4,10,At Risk
20214,132,79,196,4,5,5,14,Champions
20366,12,73,206,5,5,5,15,Champions
20528,140,52,99,4,5,4,13,Champions
20588,274,49,116,3,5,4,12,Loyal Users
20985,46,124,371,5,5,5,15,Champions
21390,410,38,314,3,4,5,12,Loyal Users
21989,305,13,59,3,3,3,9,Loyal Users
22067,2024,8,17,1,2,2,5,Lost
22131,147,25,40,4,4,3,11,Loyal Users
22383,521,17,47,2,3,3,8,Casual Users
22462,120,91,479,4,5,5,14,Champions
22577,3442,29,60,1,4,3,8,At Risk
22651,1236,13,81,2,3,4,9,Casual Users
22976,277,73,108,3,5,4,12,Loyal Users
23142,1274,27,120,1,4,4,9,At Risk
23313,2026,6,8,1,1,1,3,Lost
23524,132,30,99,4,4,4,12,Champions
24007,5,6,21,5,1,2,8,Promising
24417,130,107,347,4,5,5,14,Champions
24515,119,13,30,4,3,2,9,Loyal Users
24548,2554,24,82,1,4,4,9,At Risk
25295,19,137,578,5,5,5,15,Champions
25359,2998,5,5,1,1,1,3,Lost
25760,133,152,564,4,5,5,14,Champions
25815,962,29,48,2,4,3,9,At Risk
26150,1467,10,42,1,2,3,6,Lost
26192,514,9,11,2,2,1,5,Lost
13602,1551,7,14,1,2,1,4,Lost
13852,111,19,45,4,3,3,10,Loyal Users
13871,2792,7,7,1,2,1,4,Lost
13969,1582,18,24,1,3,2,6,Casual Users
13977,1139,7,8,2,2,1,5,Lost
14169,282,12,45,3,3,3,9,Loyal Users
14279,399,20,35,3,3,3,9,Loyal Users
14342,1302,8,16,1,2,2,5,Lost
14398,1855,13,59,1,3,3,7,Casual Users
14468,472,26,174,2,4,5,11,At Risk
14701,297,40,113,3,4,4,11,Loyal Users
14704,1787,6,48,1,1,3,5,Lost
15554,1635,22,96,1,4,4,9,At Risk
15731,267,38,61,3,4,3,10,Loyal Users
15837,1,72,291,5,5,5,15,Champions
16083,106,35,77,4,4,4,12,Champions
16286,110,16,44,4,3,3,10,Loyal Users
16325,421,30,73,3,4,4,11,Loyal Users
16398,57,15,106,5,3,4,12,Loyal Users
16479,856,43,153,2,4,5,11,At Risk
16870,3355,5,31,1,1,2,4,Lost
16976,105,98,462,4,5,5,14,Champions
17107,52,66,73,5,5,4,14,Champions
17149,715,18,21,2,3,2,7,Casual Users
17436,2,6,18,5,1,2,8,Promising
18310,1118,6,15,2,1,1,4,Lost
18719,1020,8,34,2,2,3,7,Lost
18817,5448,11,78,1,2,4,7,Lost
18940,106,122,337,4,5,5,14,Champions
18968,368,5,13,3,1,1,5,Casual Users
19080,159,37,134,4,4,4,12,Champions
19238,102,36,294,4,4,5,13,Champions
19481,424,27,44,3,4,3,10,Loyal Users
19793,154,13,87,4,3,4,11,Loyal Users
20182,4417,5,9,1,1,1,3,Lost
20400,125,94,131,4,5,4,13,Champions
20586,128,32,67,4,4,4,12,Champions
21038,451,14,38,3,3,3,9,Loyal Users
21109,141,7,50,4,2,3,9,Promising
21198,137,9,34,4,2,3,9,Promising
21331,593,14,33,2,3,3,8,Casual Users
21493,825,10,18,2,2,2,6,Lost
22013,25,53,246,5,5,5,15,Champions
22022,131,64,405,4,5,5,14,Champions
22044,2450,6,13,1,1,1,3,Lost
22060,305,72,132,3,5,4,12,Loyal Users
22294,946,13,32,2,3,3,8,Casual Users
22331,708,15,29,2,3,2,7,Casual Users
22458,219,7,19,3,2,2,7,Casual Users
22716,445,5,9,3,1,1,5,Casual Users
22912,44,90,310,5,5,5,15,Champions
23201,123,29,97,4,4,4,12,Champions
23343,4626,6,48,1,1,3,5,Lost
23598,2255,8,27,1,2,2,5,Lost
23816,1003,17,32,2,3,3,8,Casual Users
24828,546,26,59,2,4,3,9,At Risk
25049,155,41,161,4,4,5,13,Champions
25502,154,53,98,4,5,4,13,Champions
25964,132,13,16,4,3,2,9,Loyal Users
26174,3980,14,51,1,3,3,7,Casual Users
26254,1254,6,10,2,1,1,4,Lost
26370,2,36,87,5,4,4,13,Champions
13799,549,8,13,2,2,1,5,Lost
13999,2100,9,21,1,2,2,5,Lost
14050,100,114,679,4,5,5,14,Champions
14373,428,7,11,3,2,1,6,Casual Users
14376,27,41,211,5,4,5,14,Champions
14835,702,6,11,2,1,1,4,Lost
14907,703,6,6,2,1,1,4,Lost
14950,1,48,221,5,5,5,15,Champions
15768,125,13,43,4,3,3,10,Loyal Users
16033,2096,8,22,1,2,2,5,Lost
16042,376,26,97,3,4,4,11,Loyal Users
16385,415,47,165,3,5,5,13,Loyal Users
16511,370,8,16,3,2,2,7,Casual Users
16537,232,5,8,3,1,1,5,Casual Users
16717,656,25,42,2,4,3,9,At Risk
17546,143,37,71,4,4,4,12,Champions
17987,33,130,312,5,5,5,15,Champions
18004,843,7,26,2,2,2,6,Lost
18321,400,73,92,3,5,4,12,Loyal Users
18353,2082,8,17,1,2,2,5,Lost
18362,140,35,57,4,4,3,11,Loyal Users
18820,777,5,14,2,1,1,4,Lost
18957,130,51,116,4,5,4,13,Champions
18959,160,67,135,4,5,4,13,Champions
19104,0,8,14,5,2,1,8,Promising
19400,1564,8,17,1,2,2,5,Lost
20428,432,5,21,3,1,2,6,Casual Users
20513,400,30,48,3,4,3,10,Loyal Users
20732,405,23,83,3,4,4,11,Loyal Users
20870,131,41,116,4,4,4,12,Champions
21237,4569,8,11,1,2,1,4,Lost
21341,4184,6,7,1,1,1,3,Lost
22103,34,33,60,5,4,3,12,Loyal Users
22245,2237,14,75,1,3,4,8,Casual Users
22319,37,19,103,5,3,4,12,Loyal Users
22900,348,12,63,3,3,4,10,Loyal Users
22979,92,83,345,4,5,5,14,Champions
23080,239,81,148,3,5,5,13,Loyal Users
23287,111,40,52,4,4,3,11,Loyal Users
23366,544,7,9,2,2,1,5,Lost
23542,822,9,34,2,2,3,7,Lost
23814,1833,11,29,1,2,2,5,Lost
24073,1472,29,74,1,4,4,9,At Risk
24362,115,29,71,4,4,4,12,Champions
25144,4543,8,45,1,2,3,6,Lost
25675,23,39,89,5,4,4,13,Champions
25999,424,34,77,3,4,4,11,Loyal Users
26010,1840,5,15,1,1,1,3,Lost
26105,2874,41,59,1,4,3,8,At Risk
26108,819,9,22,2,2,2,6,Lost
26181,294,6,36,3,1,3,7,Casual Users
26306,283,30,63,3,4,4,11,Loyal Users
13756,224,11,117,3,2,4,9,Casual Users
13797,5,167,509,5,5,5,15,Champions
13883,3432,19,38,1,3,3,7,Casual Users
14226,1411,6,6,1,1,1,3,Lost
14306,53,34,142,5,4,4,13,Champions
14388,1044,41,87,2,4,4,10,At Risk
14521,18,93,197,5,5,5,15,Champions
14754,257,21,198,3,3,5,11,Loyal Users
14763,423,9,17,3,2,2,7,Casual Users
14939,150,26,41,4,4,3,11,Loyal Users
15000,745,10,17,2,2,2,6,Lost
15011,75,27,55,4,4,3,11,Loyal Users
15135,1641,36,44,1,4,3,8,At Risk
15153,237,12,80,3,3,4,10,Loyal Users
16190,1960,10,16,1,2,2,5,Lost
16268,245,21,71,3,3,4,10,Loyal Users
16589,517,10,30,2,2,2,6,Lost
16838,992,13,21,2,3,2,7,Casual Users
17063,238,34,263,3,4,5,12,Loyal Users
17471,2116,12,128,1,3,4,8,Casual Users
17765,5,15,67,5,3,4,12,Loyal Users
17936,1682,10,22,1,2,2,5,Lost
18687,193,5,9,3,1,1,5,Casual Users
18785,407,9,27,3,2,2,7,Casual Users
18847,1,5,18,5,1,2,8,Promising
19123,364,6,7,3,1,1,5,Casual Users
19361,201,11,42,3,2,3,8,Casual Users
19430,806,9,14,2,2,1,5,Lost
19573,2164,6,34,1,1,3,5,Lost
20093,20,13,16,5,3,2,10,Loyal Users
20259,8,63,305,5,5,5,15,Champions
20686,51,10,39,5,2,3,10,Promising
20687,109,10,42,4,2,3,9,Promising
20772,108,31,51,4,4,3,11,Loyal Users
20998,83,59,111,4,5,4,13,Champions
21062,4410,6,6,1,1,1,3,Lost
21154,1966,6,12,1,1,1,3,Lost
21552,1338,5,5,1,1,1,3,Lost
21741,2129,6,35,1,1,3,5,Lost
21791,147,69,311,4,5,5,14,Champions
22207,2894,5,18,1,1,2,4,Lost
22416,1990,7,8,1,2,1,4,Lost
22606,662,7,10,2,2,1,5,Lost
22710,605,15,26,2,3,2,7,Casual Users
23002,725,6,6,2,1,1,4,Lost
23029,30,28,56,5,4,3,12,Loyal Users
23075,2424,8,14,1,2,1,4,Lost
23094,1274,14,26,1,3,2,6,Casual Users
23230,233,43,98,3,4,4,11,Loyal Users
23232,69,76,142,5,5,4,14,Champions
23307,714,6,10,2,1,1,4,Lost
23420,872,8,14,2,2,1,5,Lost
23513,255,17,22,3,3,2,8,Loyal Users
23611,32,24,31,5,4,2,11,Loyal Users
23677,94,23,67,4,4,4,12,Champions
23800,142,180,278,4,5,5,14,Champions
23890,79,41,93,4,4,4,12,Champions
24394,153,30,161,4,4,5,13,Champions
24403,5564,5,28,1,1,2,4,Lost
24968,184,42,95,3,4,4,11,Loyal Users
25069,3854,5,9,1,1,1,3,Lost
25242,28,37,119,5,4,4,13,Champions
25367,339,6,11,3,1,1,5,Casual Users
25419,130,8,38,4,2,3,9,Promising
25809,1553,9,44,1,2,3,6,Lost
25825,5,29,63,5,4,4,13,Champions
13664,15,135,229,5,5,5,15,Champions
13758,1273,8,10,1,2,1,4,Lost
13788,642,37,75,2,4,4,10,At Risk
13870,23,8,15,5,2,1,8,Promising
14121,38,13,141,5,3,4,12,Loyal Users
14304,3471,11,28,1,2,2,5,Lost
14441,3140,19,29,1,3,2,6,Casual Users
14913,23,37,44,5,4,3,12,Loyal Users
14951,6002,6,7,1,1,1,3,Lost
15124,23,31,94,5,4,4,13,Champions
15168,130,48,77,4,5,4,13,Champions
15192,2746,7,7,1,2,1,4,Lost
15306,66,112,487,5,5,5,15,Champions
15528,2641,5,6,1,1,1,3,Lost
15553,449,6,13,3,1,1,5,Casual Users
15630,111,46,126,4,5,4,13,Champions
15682,374,17,50,3,3,3,9,Loyal Users
15722,58,77,418,5,5,5,15,Champions
16060,6,26,75,5,4,4,13,Champions
16101,5,154,258,5,5,5,15,Champions
16106,1586,12,24,1,3,2,6,Casual Users
16492,575,17,33,2,3,3,8,Casual Users
17024,533,12,49,2,3,3,8,Casual Users
17084,190,27,115,3,4,4,11,Loyal Users
17333,94,70,142,4,5,4,13,Champions
17763,261,6,10,3,1,1,5,Casual Users
17823,241,65,327,3,5,5,13,Loyal Users
18016,45,187,597,5,5,5,15,Champions
18336,525,7,8,2,2,1,5,Lost
18347,35,65,220,5,5,5,15,Champions
18424,19,79,418,5,5,5,15,Champions
18444,2849,8,18,1,2,2,5,Lost
18517,238,6,15,3,1,1,5,Casual Users
18574,1611,6,19,1,1,2,4,Lost
18713,82,39,85,4,4,4,12,Champions
18773,293,15,144,3,3,4,10,Loyal Users
19168,711,10,18,2,2,2,6,Lost
19277,106,19,53,4,3,3,10,Loyal Users
19315,299,48,230,3,5,5,13,Loyal Users
19791,4147,5,7,1,1,1,3,Lost
19806,219,12,19,3,3,2,8,Loyal Users
20254,1038,5,31,2,1,2,5,Lost
20258,226,37,119,3,4,4,11,Loyal Users
20361,22,82,219,5,5,5,15,Champions
20530,1131,30,92,2,4,4,10,At Risk
20905,5,13,47,5,3,3,11,Loyal Users
21178,3075,9,12,1,2,1,4,Lost
21431,18,30,47,5,4,3,12,Loyal Users
21561,283,72,173,3,5,5,13,Loyal Users
21784,237,54,201,3,5,5,13,Loyal Users
22042,61,21,37,5,3,3,11,Loyal Users
22161,116,17,53,4,3,3,10,Loyal Users
22239,14,170,405,5,5,5,15,Champions
22466,395,13,26,3,3,2,8,Loyal Users
22503,188,20,47,3,3,3,9,Loyal Users
22634,422,10,16,3,2,2,7,Casual Users
22677,937,6,30,2,1,2,5,Lost
22757,2,125,355,5,5,5,15,Champions
23122,3936,13,26,1,3,2,6,Casual Users
23132,68,24,229,5,4,5,14,Champions
23296,2799,18,76,1,3,4,8,Casual Users
23620,613,12,39,2,3,3,8,Casual Users
23873,3,18,139,5,3,4,12,Loyal Users
24005,16,31,58,5,4,3,12,Loyal Users
24206,289,7,28,3,2,2,7,Casual Users
24284,216,31,49,3,4,3,10,Loyal Users
24675,581,8,18,2,2,2,6,Lost
24959,17,176,240,5,5,5,15,Champions
25031,127,18,58,4,3,3,10,Loyal Users
25056,652,8,16,2,2,2,6,Lost
25194,934,6,23,2,1,2,5,Lost
25348,502,56,131,2,5,4,11,At Risk
25736,3367,5,6,1,1,1,3,Lost
25761,105,51,65,4,5,4,13,Champions
25971,47,50,295,5,5,5,15,Champions
26396,1413,13,18,1,3,2,6,Casual Users
26413,422,6,13,3,1,1,5,Casual Users
13638,615,6,12,2,1,1,4,Lost
13930,4,22,115,5,4,4,13,Champions
13979,8,56,320,5,5,5,15,Champions
14023,11,101,440,5,5,5,15,Champions
14133,2804,7,13,1,2,1,4,Lost
14251,8,49,91,5,5,4,14,Champions
14329,106,60,122,4,5,4,13,Champions
14885,189,19,74,3,3,4,10,Loyal Users
15035,78,46,431,4,5,5,14,Champions
15165,19,14,20,5,3,2,10,Loyal Users
15297,33,17,101,5,3,4,12,Loyal Users
15331,1015,19,26,2,3,2,7,Casual Users
15423,395,11,20,3,2,2,7,Casual Users
15489,85,46,155,4,5,5,14,Champions
15737,414,22,82,3,4,4,11,Loyal Users
15758,720,8,15,2,2,1,5,Lost
15897,244,6,7,3,1,1,5,Casual Users
15971,319,71,110,3,5,4,12,Loyal Users
16079,28,59,91,5,5,4,14,Champions
16174,50,50,79,5,5,4,14,Champions
16252,3569,7,88,1,2,4,7,Lost
16593,251,34,96,3,4,4,11,Loyal Users
16638,4230,7,35,1,2,3,6,Lost
16817,130,74,275,4,5,5,14,Champions
17093,2125,28,36,1,4,3,8,At Risk
17309,155,309,784,4,5,5,14,Champions
17370,66,51,119,5,5,4,14,Champions
17456,2,83,537,5,5,5,15,Champions
17507,365,6,10,3,1,1,5,Casual Users
17714,1124,19,80,2,3,4,9,Casual Users
17814,74,100,255,4,5,5,14,Champions
17816,611,6,6,2,1,1,4,Lost
17914,671,33,54,2,4,3,9,At Risk
18410,1161,5,33,2,1,3,6,Lost
19111,69,7,10,5,2,1,8,Promising
19467,107,23,147,4,4,5,13,Champions
20162,1291,14,17,1,3,2,6,Casual Users
20376,285,33,56,3,4,3,10,Loyal Users
20552,441,16,16,3,3,2,8,Loyal Users
20770,110,38,55,4,4,3,11,Loyal Users
20792,175,25,44,3,4,3,10,Loyal Users
21105,90,20,42,4,3,3,10,Loyal Users
21169,0,123,216,5,5,5,15,Champions
21489,165,5,5,4,1,1,6,Promising
21516,129,5,12,4,1,1,6,Promising
21689,75,55,183,4,5,5,14,Champions
21703,377,7,9,3,2,1,6,Casual Users
21814,39,119,229,5,5,5,15,Champions
22099,875,5,7,2,1,1,4,Lost
22435,974,20,39,2,3,3,8,Casual Users
22843,2631,28,54,1,4,3,8,At Risk
23146,156,84,216,4,5,5,14,Champions
23355,963,9,28,2,2,2,6,Lost
23376,32,15,27,5,3,2,10,Loyal Users
23679,1662,8,27,1,2,2,5,Lost
23693,2137,5,6,1,1,1,3,Lost
23813,1972,7,22,1,2,2,5,Lost
24049,136,9,44,4,2,3,9,Promising
24066,42,5,12,5,1,1,7,Promising
24302,0,106,640,5,5,5,15,Champions
24353,437,9,12,3,2,1,6,Casual Users
24485,229,78,234,3,5,5,13,Loyal Users
24705,119,9,38,4,2,3,9,Promising
24708,364,44,115,3,4,4,11,Loyal Users
24861,41,50,140,5,5,4,14,Champions
25224,279,72,88,3,5,4,12,Loyal Users
25477,115,31,88,4,4,4,12,Champions
25481,420,16,29,3,3,2,8,Loyal Users
25849,971,30,44,2,4,3,9,At Risk
25956,111,19,84,4,3,4,11,Loyal Users
26065,399,9,10,3,2,1,6,Casual Users
26172,369,9,20,3,2,2,7,Casual Users
26327,242,93,300,3,5,5,13,Loyal Users
13600,838,27,121,2,4,4,10,At Risk
14330,106,28,31,4,4,2,10,Loyal Users
14519,823,26,41,2,4,3,9,At Risk
14633,412,106,272,3,5,5,13,Loyal Users
14636,27,126,197,5,5,5,15,Champions
15019,883,6,17,2,1,2,5,Lost
15020,346,18,34,3,3,3,9,Loyal Users
15291,50,112,428,5,5,5,15,Champions
15389,3386,6,9,1,1,1,3,Lost
15418,859,8,14,2,2,1,5,Lost
15911,40,33,103,5,4,4,13,Champions
15969,1,129,680,5,5,5,15,Champions
16335,34,141,294,5,5,5,15,Champions
16702,2178,6,10,1,1,1,3,Lost
16759,997,7,14,2,2,1,5,Lost
16812,239,33,133,3,4,4,11,Loyal Users
16961,3815,6,14,1,1,1,3,Lost
17262,227,77,99,3,5,4,12,Loyal Users
17820,37,131,184,5,5,5,15,Champions
18284,118,25,101,4,4,4,12,Champions
18623,709,23,128,2,4,4,10,At Risk
18715,4469,10,19,1,2,2,5,Lost
18736,402,28,118,3,4,4,11,Loyal Users
18761,152,7,8,4,2,1,7,Promising
18946,1413,10,16,1,2,2,5,Lost
19069,1299,5,10,1,1,1,3,Lost
19266,491,8,14,2,2,1,5,Lost
19525,199,77,279,3,5,5,13,Loyal Users
19543,1099,5,27,2,1,2,5,Lost
19544,1737,20,49,1,3,3,7,Casual Users
19599,2710,14,78,1,3,4,8,Casual Users
19604,252,17,19,3,3,2,8,Loyal Users
19894,248,11,19,3,2,2,7,Casual Users
19981,2862,7,32,1,2,3,6,Lost
20359,4,19,80,5,3,4,12,Loyal Users
20476,2184,7,54,1,2,3,6,Lost
20788,260,27,34,3,4,3,10,Loyal Users
20818,202,32,70,3,4,4,11,Loyal Users
21060,419,6,8,3,1,1,5,Casual Users
21437,27,103,243,5,5,5,15,Champions
21627,596,11,25,2,2,2,6,Lost
21676,387,11,37,3,2,3,8,Casual Users
22155,25,18,73,5,3,4,12,Loyal Users
22673,415,7,17,3,2,2,7,Casual Users
22774,469,26,61,3,4,3,10,Loyal Users
22801,76,45,116,4,4,4,12,Champions
22958,424,28,58,3,4,3,10,Loyal Users
22972,102,54,266,4,5,5,14,Champions
23127,4677,5,10,1,1,1,3,Lost
23263,118,8,11,4,2,1,7,Promising
23391,1269,9,9,1,2,1,4,Lost
23440,117,5,60,4,1,3,8,Promising
23599,3584,20,35,1,3,3,7,Casual Users
23996,2229,5,5,1,1,1,3,Lost
24016,238,11,39,3,2,3,8,Casual Users
24234,397,13,20,3,3,2,8,Loyal Users
24379,3527,6,11,1,1,1,3,Lost
24743,902,5,8,2,1,1,4,Lost
24770,154,115,315,4,5,5,14,Champions
24881,1513,6,13,1,1,1,3,Lost
24918,1422,21,43,1,3,3,7,Casual Users
25002,1511,6,10,1,1,1,3,Lost
25522,1128,15,32,2,3,3,8,Casual Users
25657,5493,8,13,1,2,1,4,Lost
25882,636,8,13,2,2,1,5,Lost
26081,143,47,80,4,5,4,13,Champions
26250,145,54,95,4,5,4,13,Champions
26412,278,11,47,3,2,3,8,Casual Users
26463,642,24,86,2,4,4,10,At Risk
13618,3286,6,8,1,1,1,3,Lost
13708,155,26,45,4,4,3,11,Loyal Users
13727,123,77,152,4,5,5,14,Champions
14185,546,18,31,2,3,2,7,Casual Users
14262,391,36,47,3,4,3,10,Loyal Users
15657,30,12,62,5,3,3,11,Loyal Users
15681,109,63,219,4,5,5,14,Champions
15683,598,5,9,2,1,1,4,Lost
15839,140,29,142,4,4,4,12,Champions
16267,85,94,270,4,5,5,14,Champions
17235,1,108,531,5,5,5,15,Champions
17289,366,39,63,3,4,4,11,Loyal Users
18098,2863,6,6,1,1,1,3,Lost
18685,292,15,30,3,3,2,8,Loyal Users
19546,12,164,261,5,5,5,15,Champions
19633,0,14,72,5,3,4,12,Loyal Users
20266,1152,6,15,2,1,1,4,Lost
20272,964,7,14,2,2,1,5,Lost
20567,1025,137,470,2,5,5,12,At Risk
20920,285,36,90,3,4,4,11,Loyal Users
21042,128,92,220,4,5,5,14,Champions
21143,1857,9,13,1,2,1,4,Lost
21698,810,61,112,2,5,4,11,At Risk
21882,28,178,383,5,5,5,15,Champions
22242,218,6,7,3,1,1,5,Casual Users
22424,1,116,203,5,5,5,15,Champions
22523,6,44,222,5,4,5,14,Champions
22670,430,9,17,3,2,2,7,Casual Users
22740,842,19,36,2,3,3,8,Casual Users
23195,2308,23,27,1,4,2,7,At Risk
23276,11,100,248,5,5,5,15,Champions
23504,296,29,44,3,4,3,10,Loyal Users
23766,4262,7,21,1,2,2,5,Lost
23786,143,52,249,4,5,5,14,Champions
23804,13,102,699,5,5,5,15,Champions
23943,672,8,28,2,2,2,6,Lost
24025,426,78,226,3,5,5,13,Loyal Users
24140,1315,5,7,1,1,1,3,Lost
24141,2278,8,15,1,2,1,4,Lost
24444,1005,12,34,2,3,3,8,Casual Users
24493,4409,9,22,1,2,2,5,Lost
24592,1292,5,8,1,1,1,3,Lost
24854,109,52,136,4,5,4,13,Champions
24899,141,9,48,4,2,3,9,Promising
24930,3795,12,42,1,3,3,7,Casual Users
25720,344,71,360,3,5,5,13,Loyal Users
25866,2403,7,18,1,2,2,5,Lost
25875,36,61,360,5,5,5,15,Champions
25916,1545,21,23,1,3,2,6,Casual Users
25940,539,12,16,2,3,2,7,Casual Users
13647,379,20,89,3,3,4,10,Loyal Users
13888,88,22,92,4,4,4,12,Champions
14212,26,14,22,5,3,2,10,Loyal Users
14480,98,43,74,4,4,4,12,Champions
15288,2179,15,15,1,3,1,5,Casual Users
15467,29,67,155,5,5,5,15,Champions
15477,969,5,20,2,1,2,5,Lost
15486,986,33,132,2,4,4,10,At Risk
15490,392,16,55,3,3,3,9,Loyal Users
15513,81,76,576,4,5,5,14,Champions
15697,2338,6,31,1,1,2,4,Lost
15770,269,9,9,3,2,1,6,Casual Users
15993,277,28,65,3,4,4,11,Loyal Users
16194,90,188,530,4,5,5,14,Champions
16231,1007,22,63,2,4,4,10,At Risk
16308,104,42,115,4,4,4,12,Champions
16520,383,53,204,3,5,5,13,Loyal Users
16730,244,17,54,3,3,3,9,Loyal Users
16993,232,14,15,3,3,1,7,Loyal Users
17115,683,9,26,2,2,2,6,Lost
17290,156,15,36,4,3,3,10,Loyal Users
17810,489,5,26,2,1,2,5,Lost
17815,2800,8,12,1,2,1,4,Lost
18000,990,35,117,2,4,4,10,At Risk
18010,1,38,197,5,4,5,14,Champions
18226,2140,12,46,1,3,3,7,Casual Users
18534,102,56,147,4,5,5,14,Champions
18784,424,14,23,3,3,2,8,Loyal Users
19061,10,30,59,5,4,3,12,Loyal Users
19121,159,11,16,4,2,2,8,Promising
19265,331,9,35,3,2,3,8,Casual Users
19738,453,8,14,3,2,1,6,Casual Users
19756,562,9,36,2,2,3,7,Lost
19834,1849,5,15,1,1,1,3,Lost
19908,129,22,31,4,4,2,10,Loyal Users
19926,102,5,9,4,1,1,6,Promising
20218,618,24,40,2,4,3,9,At Risk
20296,3,50,108,5,5,4,14,Champions
20676,405,7,42,3,2,3,8,Casual Users
20796,19,69,111,5,5,4,14,Champions
20811,1554,11,29,1,2,2,5,Lost
20851,16,69,500,5,5,5,15,Champions
21295,1313,38,154,1,4,5,10,At Risk
21347,21,207,417,5,5,5,15,Champions
21865,415,14,17,3,3,2,8,Loyal Users
22865,159,6,15,4,1,1,6,Promising
22904,128,14,44,4,3,3,10,Loyal Users
23031,124,37,123,4,4,4,12,Champions
23033,134,53,356,4,5,5,14,Champions
23107,1003,6,11,2,1,1,4,Lost
23243,32,14,32,5,3,3,11,Loyal Users
23789,2,32,126,5,4,4,13,Champions
23878,23,19,21,5,3,2,10,Loyal Users
23976,120,85,250,4,5,5,14,Champions
24496,7,114,142,5,5,4,14,Champions
24824,2,10,54,5,2,3,10,Promising
25076,1,37,239,5,4,5,14,Champions
25077,515,85,454,2,5,5,12,At Risk
25142,8,9,28,5,2,2,9,Promising
25299,661,6,7,2,1,1,4,Lost
25349,651,7,14,2,2,1,5,Lost
25432,839,14,43,2,3,3,8,Casual Users
25442,1068,5,13,2,1,1,4,Lost
25491,887,9,28,2,2,2,6,Lost
25564,718,9,10,2,2,1,5,Lost
25666,386,10,13,3,2,1,6,Casual Users
25677,19,29,109,5,4,4,13,Champions
25911,141,12,27,4,3,2,9,Loyal Users
26149,1542,8,9,1,2,1,4,Lost
26237,130,5,14,4,1,1,6,Promising
13697,878,9,29,2,2,2,6,Lost
14322,613,34,333,2,4,5,11,At Risk
14397,2,5,25,5,1,2,8,Promising
14563,80,25,36,4,4,3,11,Loyal Users
14765,2829,5,17,1,1,2,4,Lost
14784,496,11,32,2,2,3,7,Lost
15025,65,80,165,5,5,5,15,Champions
15032,90,36,163,4,4,5,13,Champions
15706,799,12,15,2,3,1,6,Casual Users
15741,177,11,13,3,2,1,6,Casual Users
16044,1818,7,25,1,2,2,5,Lost
16066,429,30,48,3,4,3,10,Loyal Users
16109,272,30,86,3,4,4,11,Loyal Users
16412,526,7,14,2,2,1,5,Lost
16579,129,59,339,4,5,5,14,Champions
17218,1450,42,103,1,4,4,9,At Risk
17452,1429,5,38,1,1,3,5,Lost
17553,599,11,15,2,2,1,5,Lost
17802,391,59,149,3,5,5,13,Loyal Users
17925,1170,5,9,2,1,1,4,Lost
19482,249,39,250,3,4,5,12,Loyal Users
19563,232,9,28,3,2,2,7,Casual Users
19783,402,11,52,3,2,3,8,Casual Users
19808,1344,12,16,1,3,2,6,Casual Users
20005,379,9,47,3,2,3,8,Casual Users
20008,130,64,472,4,5,5,14,Champions
20015,1956,13,44,1,3,3,7,Casual Users
20156,2374,6,27,1,1,2,4,Lost
20337,125,24,73,4,4,4,12,Champions
20371,698,21,84,2,3,4,9,Casual Users
20711,645,17,50,2,3,3,8,Casual Users
20745,134,12,26,4,3,2,9,Loyal Users
20805,136,11,22,4,2,2,8,Promising
20806,438,15,33,3,3,3,9,Loyal Users
20966,1995,11,26,1,2,2,5,Lost
21079,1425,5,16,1,1,2,4,Lost
21335,820,12,53,2,3,3,8,Casual Users
21376,246,22,66,3,4,4,11,Loyal Users
21534,5,16,22,5,3,2,10,Loyal Users
21849,516,6,7,2,1,1,4,Lost
21997,38,63,380,5,5,5,15,Champions
22220,5,5,13,5,1,1,7,Promising
22291,150,18,53,4,3,3,10,Loyal Users
22335,317,8,12,3,2,1,6,Casual Users
22385,223,8,8,3,2,1,6,Casual Users
22439,142,17,45,4,3,3,10,Loyal Users
22954,8,23,49,5,4,3,12,Loyal Users
23088,335,20,22,3,3,2,8,Loyal Users
23273,3512,6,9,1,1,1,3,Lost
23411,990,6,10,2,1,1,4,Lost
23485,4428,5,6,1,1,1,3,Lost
23637,580,7,17,2,2,2,6,Lost
23661,443,20,32,3,3,3,9,Loyal Users
24039,2,122,235,5,5,5,15,Champions
24291,150,51,105,4,5,4,13,Champions
24507,99,5,14,4,1,1,6,Promising
24660,790,9,13,2,2,1,5,Lost
25027,109,38,199,4,4,5,13,Champions
25133,382,33,148,3,4,5,12,Loyal Users
25391,421,33,72,3,4,4,11,Loyal Users
25523,6,71,226,5,5,5,15,Champions
25622,261,35,146,3,4,4,11,Loyal Users
25836,164,165,246,4,5,5,14,Champions
25868,266,10,23,3,2,2,7,Casual Users
25896,500,7,16,2,2,2,6,Lost
26127,17,46,104,5,5,4,14,Champions
26259,122,29,132,4,4,4,12,Champions
13625,715,35,61,2,4,3,9,At Risk
13929,2,49,151,5,5,5,15,Champions
14170,355,69,159,3,5,5,13,Loyal Users
14171,807,5,15,2,1,1,4,Lost
14489,118,5,10,4,1,1,6,Promising
15065,88,72,165,4,5,5,14,Champions
15084,4,154,535,5,5,5,15,Champions
15293,1845,7,21,1,2,2,5,Lost
15310,224,48,80,3,5,4,12,Loyal Users
15372,2372,9,31,1,2,2,5,Lost
15412,26,7,22,5,2,2,9,Promising
15608,3,23,68,5,4,4,13,Champions
15726,91,47,52,4,5,3,12,Loyal Users
15732,3905,8,15,1,2,1,4,Lost
15734,2250,7,55,1,2,3,6,Lost
15847,439,46,61,3,5,3,11,Loyal Users
15975,1171,11,16,2,2,2,6,Lost
16095,101,33,97,4,4,4,12,Champions
16337,1160,51,181,2,5,5,12,At Risk
16440,413,5,7,3,1,1,5,Casual Users
16808,730,7,11,2,2,1,5,Lost
16925,803,26,114,2,4,4,10,At Risk
17449,627,20,33,2,3,3,8,Casual Users
17633,2,33,104,5,4,4,13,Champions
17724,2126,10,16,1,2,2,5,Lost
17784,4170,5,12,1,1,1,3,Lost
17822,3173,5,5,1,1,1,3,Lost
18578,257,36,246,3,4,5,12,Loyal Users
18658,860,7,33,2,2,3,7,Lost
19196,586,10,17,2,2,2,6,Lost
19514,1105,11,51,2,2,3,7,Lost
19664,697,7,40,2,2,3,7,Lost
19716,270,45,107,3,4,4,11,Loyal Users
19785,258,23,58,3,4,3,10,Loyal Users
19900,2,25,38,5,4,3,12,Loyal Users
19963,2139,5,27,1,1,2,4,Lost
20119,0,81,194,5,5,5,15,Champions
20217,303,14,20,3,3,2,8,Loyal Users
20227,94,40,66,4,4,4,12,Champions
20685,911,12,12,2,3,1,6,Casual Users
20873,1110,5,15,2,1,1,4,Lost
21080,265,55,196,3,5,5,13,Loyal Users
21483,596,13,39,2,3,3,8,Casual Users
21645,413,12,14,3,3,1,7,Loyal Users
21646,104,17,83,4,3,4,11,Loyal Users
21895,1369,8,16,1,2,2,5,Lost
21972,140,11,33,4,2,3,9,Promising
22027,243,20,98,3,3,4,10,Loyal Users
22081,27,54,279,5,5,5,15,Champions
22288,254,24,40,3,4,3,10,Loyal Users
22527,239,28,76,3,4,4,11,Loyal Users
22572,77,17,27,4,3,2,9,Loyal Users
22717,130,72,128,4,5,4,13,Champions
22814,26,26,42,5,4,3,12,Loyal Users
23665,1039,9,12,2,2,1,5,Lost
23744,2232,12,46,1,3,3,7,Casual Users
24183,69,150,203,5,5,5,15,Champions
24551,15,64,135,5,5,4,14,Champions
24620,432,17,47,3,3,3,9,Loyal Users
24725,995,14,24,2,3,2,7,Casual Users
24924,2831,9,13,1,2,1,4,Lost
24931,2482,5,8,1,1,1,3,Lost
25045,2960,7,17,1,2,2,5,Lost
25577,726,22,71,2,4,4,10,At Risk
25597,1,83,237,5,5,5,15,Champions
25659,42,56,151,5,5,5,15,Champions
25672,113,34,66,4,4,4,12,Champions
25678,9,53,187,5,5,5,15,Champions
25693,0,19,119,5,3,4,12,Loyal Users
25863,703,7,8,2,2,1,5,Lost
26144,2556,83,146,1,5,4,10,At Risk
26176,3641,16,79,1,3,4,8,Casual Users
26240,2920,10,81,1,2,4,7,Lost
26303,412,18,46,3,3,3,9,Loyal Users
26316,25,78,323,5,5,5,15,Champions
13937,2698,7,7,1,2,1,4,Lost
13986,116,91,473,4,5,5,14,Champions
14371,2755,5,15,1,1,1,3,Lost
14390,282,5,19,3,1,2,6,Casual Users
14459,826,13,30,2,3,2,7,Casual Users
14572,1180,10,54,2,2,3,7,Lost
14630,294,25,91,3,4,4,11,Loyal Users
14677,219,11,41,3,2,3,8,Casual Users
15385,0,28,159,5,4,5,14,Champions
15822,269,36,152,3,4,5,12,Loyal Users
16156,86,18,30,4,3,2,9,Loyal Users
16607,3976,5,5,1,1,1,3,Lost
16620,239,49,134,3,5,4,12,Loyal Users
16642,71,63,138,4,5,4,13,Champions
16785,44,20,45,5,3,3,11,Loyal Users
17228,241,35,40,3,4,3,10,Loyal Users
17248,276,77,205,3,5,5,13,Loyal Users
17514,1662,10,11,1,2,1,4,Lost
17684,1463,6,27,1,1,2,4,Lost
17717,104,17,46,4,3,3,10,Loyal Users
17734,1762,25,57,1,4,3,8,At Risk
17831,484,27,126,2,4,4,10,At Risk
18592,580,11,13,2,2,1,5,Lost
18604,268,37,55,3,4,3,10,Loyal Users
19322,1264,9,24,1,2,2,5,Lost
19323,1325,15,19,1,3,2,6,Casual Users
19578,600,10,15,2,2,1,5,Lost
19700,26,131,427,5,5,5,15,Champions
19841,11,45,81,5,4,4,13,Champions
20167,2654,18,34,1,3,3,7,Casual Users
20179,43,15,25,5,3,2,10,Loyal Users
20369,5044,9,12,1,2,1,4,Lost
20384,2,80,266,5,5,5,15,Champions
20761,841,26,121,2,4,4,10,At Risk
20942,11,82,338,5,5,5,15,Champions
21281,164,21,51,4,3,3,10,Loyal Users
21574,2,25,69,5,4,4,13,Champions
21600,735,18,18,2,3,2,7,Casual Users
21609,1726,5,35,1,1,3,5,Lost
21794,163,14,33,4,3,3,10,Loyal Users
21802,804,10,86,2,2,4,8,Lost
21967,1122,7,21,2,2,2,6,Lost
21986,141,25,41,4,4,3,11,Loyal Users
22162,3140,21,35,1,3,3,7,Casual Users
22224,336,8,12,3,2,1,6,Casual Users
22654,126,8,51,4,2,3,9,Promising
22799,0,27,70,5,4,4,13,Champions
23292,277,17,27,3,3,2,8,Loyal Users
23407,504,13,26,2,3,2,7,Casual Users
23506,1126,26,133,2,4,4,10,At Risk
23955,1981,6,7,1,1,1,3,Lost
23965,975,6,8,2,1,1,4,Lost
24173,23,10,15,5,2,1,8,Promising
24998,1263,11,43,1,2,3,6,Lost
25082,24,11,15,5,2,1,8,Promising
25339,264,9,19,3,2,2,7,Casual Users
25455,2984,16,40,1,3,3,7,Casual Users
25770,1413,9,14,1,2,1,4,Lost
25937,253,34,65,3,4,4,11,Loyal Users
26132,695,12,18,2,3,2,7,Casual Users
26218,486,55,389,2,5,5,12,At Risk
13631,1419,26,42,1,4,3,8,At Risk
14119,137,10,19,4,2,2,8,Promising
14298,354,18,47,3,3,3,9,Loyal Users
14412,82,100,240,4,5,5,14,Champions
14590,27,62,77,5,5,4,14,Champions
14908,733,15,23,2,3,2,7,Casual Users
15088,265,81,133,3,5,4,12,Loyal Users
15121,132,83,207,4,5,5,14,Champions
15122,145,42,159,4,4,5,13,Champions
15222,2947,9,10,1,2,1,4,Lost
15233,961,13,99,2,3,4,9,Casual Users
15510,511,37,112,2,4,4,10,At Risk
15571,779,5,8,2,1,1,4,Lost
15663,25,74,408,5,5,5,15,Champions
15677,253,24,112,3,4,4,11,Loyal Users
15773,147,16,26,4,3,2,9,Loyal Users
16207,1107,8,20,2,2,2,6,Lost
16583,49,34,51,5,4,3,12,Loyal Users
16673,224,13,46,3,3,3,9,Loyal Users
16848,143,16,31,4,3,2,9,Loyal Users
16854,85,12,22,4,3,2,9,Loyal Users
17364,44,79,238,5,5,5,15,Champions
17511,2146,8,22,1,2,2,5,Lost
17520,265,65,103,3,5,4,12,Loyal Users
17835,5,16,110,5,3,4,12,Loyal Users
17856,258,5,51,3,1,3,7,Casual Users
17929,16,30,49,5,4,3,12,Loyal Users
18126,1061,5,7,2,1,1,4,Lost
18352,145,30,115,4,4,4,12,Champions
18426,1640,7,9,1,2,1,4,Lost
18682,77,49,241,4,5,5,14,Champions
19223,827,28,65,2,4,4,10,At Risk
19415,753,7,8,2,2,1,5,Lost
19477,928,5,6,2,1,1,4,Lost
19590,89,10,25,4,2,2,8,Promising
20407,158,7,17,4,2,2,8,Promising
21351,825,15,50,2,3,3,8,Casual Users
21438,1247,10,18,2,2,2,6,Lost
21640,704,20,32,2,3,3,8,Casual Users
21889,0,14,37,5,3,3,11,Loyal Users
21896,2800,5,12,1,1,1,3,Lost
22532,2040,15,30,1,3,2,6,Casual Users
22861,4101,18,35,1,3,3,7,Casual Users
22867,716,13,21,2,3,2,7,Casual Users
22962,204,21,116,3,3,4,10,Loyal Users
23045,274,75,280,3,5,5,13,Loyal Users
23221,2847,26,46,1,4,3,8,At Risk
23409,113,9,18,4,2,2,8,Promising
23412,43,88,266,5,5,5,15,Champions
23416,158,32,42,4,4,3,11,Loyal Users
23681,0,25,59,5,4,3,12,Loyal Users
23714,5,97,156,5,5,5,15,Champions
23937,3999,5,9,1,1,1,3,Lost
24108,67,30,77,5,4,4,13,Champions
24264,425,12,43,3,3,3,9,Loyal Users
24286,379,9,23,3,2,2,7,Casual Users
24799,23,34,73,5,4,4,13,Champions
25370,153,18,44,4,3,3,10,Loyal Users
25598,1,92,131,5,5,4,14,Champions
25685,1849,7,12,1,2,1,4,Lost
25732,355,29,149,3,4,5,12,Loyal Users
25821,56,50,106,5,5,4,14,Champions
25986,412,19,31,3,3,2,8,Loyal Users
25988,937,16,56,2,3,3,8,Casual Users
25989,9,29,119,5,4,4,13,Champions
26146,4254,15,30,1,3,2,6,Casual Users
26202,572,5,8,2,1,1,4,Lost
26404,1436,9,26,1,2,2,5,Lost
26421,1636,5,11,1,1,1,3,Lost
26455,457,16,21,3,3,2,8,Loyal Users
13666,1265,11,65,1,2,4,7,Lost
13901,409,6,53,3,1,3,7,Casual Users
14368,293,24,42,3,4,3,10,Loyal Users
14446,925,10,17,2,2,2,6,Lost
14485,2037,7,8,1,2,1,4,Lost
14498,3589,7,58,1,2,3,6,Lost
14562,110,90,520,4,5,5,14,Champions
14569,2602,5,15,1,1,1,3,Lost
14718,851,65,106,2,5,4,11,At Risk
14798,7,172,496,5,5,5,15,Champions
15181,6,13,37,5,3,3,11,Loyal Users
15692,1154,10,62,2,2,3,7,Lost
15810,40,13,38,5,3,3,11,Loyal Users
15886,2360,25,59,1,4,3,8,At Risk
15887,75,10,29,4,2,2,8,Promising
15999,2,63,457,5,5,5,15,Champions
16304,481,6,15,2,1,1,4,Lost
16321,60,44,74,5,4,4,13,Champions
17288,2,127,313,5,5,5,15,Champions
17559,0,75,276,5,5,5,15,Champions
17826,1231,16,26,2,3,2,7,Casual Users
18022,385,5,8,3,1,1,5,Casual Users
18082,108,95,216,4,5,5,14,Champions
18179,539,30,44,2,4,3,9,At Risk
18277,978,31,156,2,4,5,11,At Risk
18676,370,30,39,3,4,3,10,Loyal Users
18744,370,6,9,3,1,1,5,Casual Users
18852,126,45,126,4,4,4,12,Champions
19041,121,47,60,4,5,3,12,Loyal Users
19071,604,47,86,2,5,4,11,At Risk
19199,125,19,33,4,3,3,10,Loyal Users
19364,244,30,51,3,4,3,10,Loyal Users
19491,1247,28,103,2,4,4,10,At Risk
19508,9,63,160,5,5,5,15,Champions
19682,129,43,87,4,4,4,12,Champions
19707,20,124,274,5,5,5,15,Champions
19779,1468,7,13,1,2,1,4,Lost
20243,41,37,64,5,4,4,13,Champions
20606,396,60,125,3,5,4,12,Loyal Users
20630,3,46,236,5,5,5,15,Champions
20749,7,37,80,5,4,4,13,Champions
21292,140,16,27,4,3,2,9,Loyal Users
21398,1123,5,7,2,1,1,4,Lost
21526,120,101,385,4,5,5,14,Champions
21775,28,9,15,5,2,1,8,Promising
21985,109,60,248,4,5,5,14,Champions
22009,453,5,18,3,1,2,6,Casual Users
22459,43,7,52,5,2,3,10,Promising
22553,177,13,35,3,3,3,9,Loyal Users
22627,1652,7,23,1,2,2,5,Lost
22648,1873,5,5,1,1,1,3,Lost
22742,185,30,87,3,4,4,11,Loyal Users
22792,343,15,16,3,3,2,8,Loyal Users
22989,112,9,27,4,2,2,8,Promising
23067,397,12,32,3,3,3,9,Loyal Users
23574,121,100,182,4,5,5,14,Champions
23774,243,13,45,3,3,3,9,Loyal Users
23818,2277,13,19,1,3,2,6,Casual Users
23966,393,14,52,3,3,3,9,Loyal Users
24421,135,14,33,4,3,3,10,Loyal Users
24647,432,7,13,3,2,1,6,Casual Users
24977,5422,12,40,1,3,3,7,Casual Users
25026,281,5,9,3,1,1,5,Casual Users
25403,129,28,37,4,4,3,11,Loyal Users
25568,101,23,37,4,4,3,11,Loyal Users
25644,401,19,49,3,3,3,9,Loyal Users
25764,277,38,59,3,4,3,10,Loyal Users
25919,128,88,585,4,5,5,14,Champions
25950,21,65,168,5,5,5,15,Champions
26302,679,14,59,2,3,3,8,Casual Users
14078,387,19,28,3,3,2,8,Loyal Users
14184,0,11,24,5,2,2,9,Promising
15126,833,14,54,2,3,3,8,Casual Users
15446,418,5,26,3,1,2,6,Casual Users
15699,536,26,91,2,4,4,10,At Risk
15779,1002,34,46,2,4,3,9,At Risk
15945,395,97,193,3,5,5,13,Loyal Users
15994,242,6,8,3,1,1,5,Casual Users
16205,84,23,89,4,4,4,12,Champions
16485,0,82,222,5,5,5,15,Champions
16659,1686,7,86,1,2,4,7,Lost
17247,17,82,326,5,5,5,15,Champions
17322,2175,13,25,1,3,2,6,Casual Users
17512,587,9,26,2,2,2,6,Lost
17640,830,202,649,2,5,5,12,At Risk
18225,294,34,81,3,4,4,11,Loyal Users
18231,4383,7,21,1,2,2,5,Lost
18524,410,15,25,3,3,2,8,Loyal Users
19096,39,19,34,5,3,3,11,Loyal Users
19258,2848,9,12,1,2,1,4,Lost
19302,0,37,89,5,4,4,13,Champions
19562,2201,11,28,1,2,2,5,Lost
20292,698,9,51,2,2,3,7,Lost
20319,838,11,11,2,2,1,5,Lost
20360,51,57,104,5,5,4,14,Champions
20725,47,15,55,5,3,3,11,Loyal Users
20777,1760,128,191,1,5,5,11,At Risk
20881,2413,23,50,1,4,3,8,At Risk
21202,438,12,21,3,3,2,8,Loyal Users
21509,852,13,16,2,3,2,7,Casual Users
21644,410,121,306,3,5,5,13,Loyal Users
21893,250,39,158,3,4,5,12,Loyal Users
21940,783,5,7,2,1,1,4,Lost
22088,50,65,258,5,5,5,15,Champions
22145,48,131,387,5,5,5,15,Champions
22418,168,123,231,3,5,5,13,Loyal Users
22474,1297,12,19,1,3,2,6,Casual Users
22544,62,246,564,5,5,5,15,Champions
22556,393,13,47,3,3,3,9,Loyal Users
22575,120,38,138,4,4,4,12,Champions
22615,113,38,47,4,4,3,11,Loyal Users
22766,119,15,42,4,3,3,10,Loyal Users
22795,92,40,89,4,4,4,12,Champions
23265,962,5,13,2,1,1,4,Lost
23266,261,5,14,3,1,1,5,Casual Users
23315,4145,10,10,1,2,1,4,Lost
23461,2583,32,162,1,4,5,10,At Risk
23622,1583,11,50,1,2,3,6,Lost
23728,114,42,117,4,4,4,12,Champions
23896,93,44,136,4,4,4,12,Champions
24058,13,70,186,5,5,5,15,Champions
24102,94,152,510,4,5,5,14,Champions
24301,561,6,6,2,1,1,4,Lost
24579,2303,6,9,1,1,1,3,Lost
24815,3436,8,16,1,2,2,5,Lost
24851,265,40,139,3,4,4,11,Loyal Users
24906,102,123,285,4,5,5,14,Champions
25079,871,10,13,2,2,1,5,Lost
25088,500,6,33,2,1,3,6,Lost
25148,1968,5,5,1,1,1,3,Lost
25215,713,6,21,2,1,2,5,Lost
25614,430,47,88,3,5,4,12,Loyal Users
26151,230,9,30,3,2,2,7,Casual Users
26291,113,35,102,4,4,4,12,Champions
26357,144,5,10,4,1,1,6,Promising
13831,21,56,244,5,5,5,15,Champions
14120,420,66,147,3,5,5,13,Loyal Users
14270,65,18,162,5,3,5,13,Loyal Users
15136,49,44,231,5,4,5,14,Champions
15609,2745,9,12,1,2,1,4,Lost
15629,1,19,49,5,3,3,11,Loyal Users
15824,4,23,181,5,4,5,14,Champions
16039,137,72,76,4,5,4,13,Champions
16151,1118,17,18,2,3,2,7,Casual Users
16359,13,118,389,5,5,5,15,Champions
16397,229,5,13,3,1,1,5,Casual Users
16468,2160,12,58,1,3,3,7,Casual Users
17000,363,50,205,3,5,5,13,Loyal Users
17110,827,9,26,2,2,2,6,Lost
17356,1310,10,17,1,2,2,5,Lost
17408,8,40,93,5,4,4,13,Champions
17601,0,287,594,5,5,5,15,Champions
17659,1866,8,21,1,2,2,5,Lost
17834,43,77,362,5,5,5,15,Champions
18049,19,6,12,5,1,1,7,Promising
18164,176,5,7,3,1,1,5,Casual Users
18395,97,8,14,4,2,1,7,Promising
18579,277,91,211,3,5,5,13,Loyal Users
18913,128,93,225,4,5,5,14,Champions
19049,244,6,6,3,1,1,5,Casual Users
19771,141,30,35,4,4,3,11,Loyal Users
19977,47,10,82,5,2,4,11,Promising
20037,2107,18,36,1,3,3,7,Casual Users
20246,11,57,242,5,5,5,15,Champions
20327,966,9,35,2,2,3,7,Lost
20363,1610,15,29,1,3,2,6,Casual Users
20517,970,18,27,2,3,2,7,Casual Users
20527,61,45,250,5,4,5,14,Champions
20849,319,22,41,3,4,3,10,Loyal Users
20862,520,13,33,2,3,3,8,Casual Users
21098,1863,5,26,1,1,2,4,Lost
21466,121,44,93,4,4,4,12,Champions
21557,448,21,49,3,3,3,9,Loyal Users
21854,137,19,54,4,3,3,10,Loyal Users
21866,45,38,54,5,4,3,12,Loyal Users
21977,157,44,175,4,4,5,13,Champions
22098,2553,5,6,1,1,1,3,Lost
22415,622,47,111,2,5,4,11,At Risk
22639,149,98,278,4,5,5,14,Champions
22919,495,27,64,2,4,4,10,At Risk
23037,60,134,236,5,5,5,15,Champions
23497,672,40,248,2,4,5,11,At Risk
24280,426,65,119,3,5,4,12,Loyal Users
24665,160,22,75,4,4,4,12,Champions
24685,26,7,18,5,2,2,9,Promising
24907,8,49,171,5,5,5,15,Champions
25134,189,5,13,3,1,1,5,Casual Users
25731,16,129,240,5,5,5,15,Champions
25946,13,17,62,5,3,3,11,Loyal Users
26153,230,32,46,3,4,3,10,Loyal Users
13790,181,44,117,3,4,4,11,Loyal Users
13816,8,29,97,5,4,4,13,Champions
13848,20,12,19,5,3,2,10,Loyal Users
13865,217,14,26,3,3,2,8,Loyal Users
13918,11,52,205,5,5,5,15,Champions
13953,2517,5,6,1,1,1,3,Lost
14011,121,7,47,4,2,3,9,Promising
14175,2850,7,10,1,2,1,4,Lost
14321,14,56,114,5,5,4,14,Champions
14366,147,20,22,4,3,2,9,Loyal Users
14959,188,98,272,3,5,5,13,Loyal Users
15492,122,12,35,4,3,3,10,Loyal Users
15523,531,13,109,2,3,4,9,Casual Users
15739,432,52,150,3,5,5,13,Loyal Users
15761,104,18,47,4,3,3,10,Loyal Users
15979,163,6,10,4,1,1,6,Promising
16004,326,10,18,3,2,2,7,Casual Users
16260,117,19,54,4,3,3,10,Loyal Users
16374,0,61,141,5,5,4,14,Champions
16423,1595,14,20,1,3,2,6,Casual Users
16439,63,57,251,5,5,5,15,Champions
16691,102,27,43,4,4,3,11,Loyal Users
16749,1088,15,28,2,3,2,7,Casual Users
17145,1414,9,25,1,2,2,5,Lost
18263,2096,9,32,1,2,3,6,Lost
18439,24,52,232,5,5,5,15,Champions
18952,585,16,29,2,3,2,7,Casual Users
19670,568,22,37,2,4,3,9,At Risk
19781,548,24,42,2,4,3,9,At Risk
19895,163,28,104,4,4,4,12,Champions
20019,215,169,635,3,5,5,13,Loyal Users
20502,98,18,35,4,3,3,10,Loyal Users
20536,53,43,132,5,4,4,13,Champions
20707,205,27,95,3,4,4,11,Loyal Users
20861,12,144,239,5,5,5,15,Champions
20876,1149,10,41,2,2,3,7,Lost
20990,370,7,16,3,2,2,7,Casual Users
21081,439,17,87,3,3,4,10,Loyal Users
21259,1061,10,15,2,2,1,5,Lost
21588,107,53,116,4,5,4,13,Champions
21734,2713,10,14,1,2,1,4,Lost
21836,122,12,17,4,3,2,9,Loyal Users
21912,188,104,216,3,5,5,13,Loyal Users
22113,28,21,77,5,3,4,12,Loyal Users
22143,241,9,46,3,2,3,8,Casual Users
22256,3191,10,15,1,2,1,4,Lost
22610,2265,11,33,1,2,3,6,Lost
22712,846,18,29,2,3,2,7,Casual Users
22720,1,11,18,5,2,2,9,Promising
22847,1695,7,52,1,2,3,6,Lost
22992,809,18,37,2,3,3,8,Casual Users
23083,37,179,521,5,5,5,15,Champions
23207,3,33,116,5,4,4,13,Champions
23281,947,7,12,2,2,1,5,Lost
23304,277,5,9,3,1,1,5,Casual Users
23733,1011,31,97,2,4,4,10,At Risk
23929,1793,6,11,1,1,1,3,Lost
23980,256,5,12,3,1,1,5,Casual Users
24003,105,5,6,4,1,1,6,Promising
24560,452,16,26,3,3,2,8,Loyal Users
24580,259,45,91,3,4,4,11,Loyal Users
24604,430,9,11,3,2,1,6,Casual Users
25830,2358,8,10,1,2,1,4,Lost
25983,377,20,142,3,3,4,10,Loyal Users
26282,281,35,67,3,4,4,11,Loyal Users
13777,301,14,34,3,3,3,9,Loyal Users
13822,376,32,53,3,4,3,10,Loyal Users
14223,299,20,24,3,3,2,8,Loyal Users
14286,280,10,12,3,2,1,6,Casual Users
14750,83,64,120,4,5,4,13,Champions
14922,1026,20,123,2,3,4,9,Casual Users
14991,38,54,168,5,5,5,15,Champions
15195,79,25,75,4,4,4,12,Champions
15551,2,94,386,5,5,5,15,Champions
16152,2603,25,62,1,4,3,8,At Risk
16365,2815,5,5,1,1,1,3,Lost
16551,4233,7,9,1,2,1,4,Lost
17054,92,5,7,4,1,1,6,Promising
17303,276,20,40,3,3,3,9,Loyal Users
17668,560,19,59,2,3,3,8,Casual Users
17794,170,46,71,3,5,4,12,Loyal Users
18061,177,35,51,3,4,3,10,Loyal Users
18341,29,103,428,5,5,5,15,Champions
18543,1130,53,147,2,5,5,12,At Risk
18549,1404,8,22,1,2,2,5,Lost
18557,413,6,11,3,1,1,5,Casual Users
18625,1185,5,8,2,1,1,4,Lost
18789,127,7,38,4,2,3,9,Promising
18858,243,70,194,3,5,5,13,Loyal Users
18984,4,31,62,5,4,3,12,Loyal Users
19312,2166,7,16,1,2,2,5,Lost
19381,142,47,69,4,5,4,13,Champions
20086,473,24,50,2,4,3,9,At Risk
20143,66,118,469,5,5,5,15,Champions
20149,1216,5,12,2,1,1,4,Lost
20189,775,8,12,2,2,1,5,Lost
21180,953,14,55,2,3,3,8,Casual Users
21196,10,79,276,5,5,5,15,Champions
21241,262,15,23,3,3,2,8,Loyal Users
21406,159,13,119,4,3,4,11,Loyal Users
21454,59,63,171,5,5,5,15,Champions
21469,91,14,70,4,3,4,11,Loyal Users
21975,523,57,305,2,5,5,12,At Risk
21983,115,11,26,4,2,2,8,Promising
21992,17,20,25,5,3,2,10,Loyal Users
22274,905,22,134,2,4,4,10,At Risk
22429,731,22,137,2,4,4,10,At Risk
22436,19,59,300,5,5,5,15,Champions
22679,115,29,45,4,4,3,11,Loyal Users
22815,2949,5,7,1,1,1,3,Lost
23066,2855,6,9,1,1,1,3,Lost
23096,1675,7,13,1,2,1,4,Lost
23555,90,42,211,4,4,5,13,Champions
23628,12,34,153,5,4,5,14,Champions
24156,279,12,18,3,3,2,8,Loyal Users
24266,121,15,40,4,3,3,10,Loyal Users
24372,123,7,10,4,2,1,7,Promising
24461,170,5,8,3,1,1,5,Casual Users
24656,299,7,18,3,2,2,7,Casual Users
24800,452,58,78,3,5,4,12,Loyal Users
24988,4880,8,8,1,2,1,4,Lost
25281,1166,25,49,2,4,3,9,At Risk
25396,143,40,65,4,4,4,12,Champions
25563,1677,11,156,1,2,5,8,Lost
25774,234,23,75,3,4,4,11,Loyal Users
26077,25,15,43,5,3,3,11,Loyal Users
13762,1598,7,13,1,2,1,4,Lost
13769,239,8,8,3,2,1,6,Casual Users
13787,3788,7,29,1,2,2,5,Lost
14374,379,111,547,3,5,5,13,Loyal Users
14491,224,67,477,3,5,5,13,Loyal Users
14919,235,35,90,3,4,4,11,Loyal Users
14920,107,8,18,4,2,2,8,Promising
14955,142,15,30,4,3,2,9,Loyal Users
14995,30,6,13,5,1,1,7,Promising
15052,2477,5,13,1,1,1,3,Lost
15320,428,27,53,3,4,3,10,Loyal Users
15335,12,8,24,5,2,2,9,Promising
15805,1420,6,9,1,1,1,3,Lost
15830,721,11,71,2,2,4,8,Lost
15842,4861,8,9,1,2,1,4,Lost
16472,308,9,32,3,2,3,8,Casual Users
16708,409,22,49,3,4,3,10,Loyal Users
16888,3889,7,17,1,2,2,5,Lost
16951,1943,6,40,1,1,3,5,Lost
17134,71,58,87,4,5,4,13,Champions
17280,376,60,150,3,5,5,13,Loyal Users
17372,1579,26,68,1,4,4,9,At Risk
17540,229,21,62,3,3,3,9,Loyal Users
18535,96,95,349,4,5,5,14,Champions
18845,698,12,19,2,3,2,7,Casual Users
19082,6,73,224,5,5,5,15,Champions
19090,703,7,9,2,2,1,5,Lost
19653,277,18,42,3,3,3,9,Loyal Users
19789,103,8,37,4,2,3,9,Promising
19914,129,12,72,4,3,4,11,Loyal Users
20055,0,164,676,5,5,5,15,Champions
20072,34,32,50,5,4,3,12,Loyal Users
20115,3031,11,28,1,2,2,5,Lost
20202,434,21,30,3,3,2,8,Loyal Users
20348,30,32,55,5,4,3,12,Loyal Users
20430,771,8,12,2,2,1,5,Lost
20605,128,26,75,4,4,4,12,Champions
20947,1134,7,9,2,2,1,5,Lost
21248,405,37,65,3,4,4,11,Loyal Users
21576,840,20,31,2,3,2,7,Casual Users
22006,21,32,96,5,4,4,13,Champions
22079,147,22,43,4,4,3,11,Loyal Users
22221,1975,55,115,1,5,4,10,At Risk
22703,3703,7,21,1,2,2,5,Lost
22926,66,8,11,5,2,1,8,Promising
22944,710,33,64,2,4,4,10,At Risk
22977,235,24,116,3,4,4,11,Loyal Users
23241,277,8,19,3,2,2,7,Casual Users
23410,407,13,36,3,3,3,9,Loyal Users
23500,2435,115,183,1,5,5,11,At Risk
24153,4441,6,22,1,1,2,4,Lost
24273,232,5,69,3,1,4,8,Casual Users
24451,808,9,23,2,2,2,6,Lost
24831,423,21,32,3,3,3,9,Loyal Users
25656,574,9,10,2,2,1,5,Lost
25790,130,59,229,4,5,5,14,Champions
26042,413,25,63,3,4,4,11,Loyal Users
26203,151,84,150,4,5,5,14,Champions
26296,106,102,369,4,5,5,14,Champions
13866,2404,6,7,1,1,1,3,Lost
14515,78,23,163,4,4,5,13,Champions
14544,261,7,33,3,2,3,8,Casual Users
14916,1792,5,16,1,1,2,4,Lost
14934,527,13,107,2,3,4,9,Casual Users
15417,421,14,24,3,3,2,8,Loyal Users
15611,121,8,15,4,2,1,7,Promising
15672,244,28,161,3,4,5,12,Loyal Users
15749,2162,11,27,1,2,2,5,Lost
15867,948,44,261,2,4,5,11,At Risk
16555,10,74,420,5,5,5,15,Champions
16737,85,59,145,4,5,4,13,Champions
16906,91,8,27,4,2,2,8,Promising
17340,824,20,55,2,3,3,8,Casual Users
17651,382,9,31,3,2,2,7,Casual Users
17897,2427,5,11,1,1,1,3,Lost
18270,462,5,10,3,1,1,5,Casual Users
18637,438,5,9,3,1,1,5,Casual Users
19098,38,29,75,5,4,4,13,Champions
19274,124,48,113,4,5,4,13,Champions
19304,3961,5,7,1,1,1,3,Lost
19377,84,62,179,4,5,5,14,Champions
19537,66,97,351,5,5,5,15,Champions
19693,123,11,13,4,2,1,7,Promising
20031,110,43,129,4,4,4,12,Champions
20275,833,8,21,2,2,2,6,Lost
20878,1133,5,7,2,1,1,4,Lost
20953,235,17,59,3,3,3,9,Loyal Users
21144,86,5,5,4,1,1,6,Promising
21410,58,27,125,5,4,4,13,Champions
21444,1964,11,12,1,2,1,4,Lost
21491,65,64,391,5,5,5,15,Champions
21900,101,19,66,4,3,4,11,Loyal Users
22078,65,89,456,5,5,5,15,Champions
22122,5,136,773,5,5,5,15,Champions
22200,587,48,53,2,5,3,10,At Risk
22281,591,14,32,2,3,3,8,Casual Users
22316,281,18,42,3,3,3,9,Loyal Users
22727,125,48,113,4,5,4,13,Champions
22758,80,14,56,4,3,3,10,Loyal Users
22804,131,73,236,4,5,5,14,Champions
22838,99,93,417,4,5,5,14,Champions
23004,860,32,77,2,4,4,10,At Risk
23062,74,5,9,4,1,1,6,Promising
23180,177,24,63,3,4,4,11,Loyal Users
23257,428,12,22,3,3,2,8,Loyal Users
23356,44,91,426,5,5,5,15,Champions
23396,27,85,245,5,5,5,15,Champions
23422,476,37,93,2,4,4,10,At Risk
23796,2144,5,6,1,1,1,3,Lost
23978,24,17,42,5,3,3,11,Loyal Users
24010,283,24,110,3,4,4,11,Loyal Users
24449,409,12,33,3,3,3,9,Loyal Users
25030,232,8,82,3,2,4,9,Casual Users
25143,1225,23,27,2,4,2,8,At Risk
25171,227,8,23,3,2,2,7,Casual Users
25315,34,29,147,5,4,5,14,Champions
25320,1116,13,18,2,3,2,7,Casual Users
25424,110,29,254,4,4,5,13,Champions
26277,318,12,44,3,3,3,9,Loyal Users
14017,1799,31,74,1,4,4,9,At Risk
14019,126,44,82,4,4,4,12,Champions
14109,424,6,17,3,1,2,6,Casual Users
14609,969,17,53,2,3,3,8,Casual Users
14755,4710,9,24,1,2,2,5,Lost
14899,402,36,83,3,4,4,11,Loyal Users
14976,1723,13,32,1,3,3,7,Casual Users
15036,1184,12,21,2,3,2,7,Casual Users
15299,9,18,108,5,3,4,12,Loyal Users
15352,2276,16,44,1,3,3,7,Casual Users
15493,458,50,70,3,5,4,12,Loyal Users
15500,105,7,13,4,2,1,7,Promising
15802,17,133,366,5,5,5,15,Champions
16451,1400,25,56,1,4,3,8,At Risk
16514,2514,13,32,1,3,3,7,Casual Users
16586,293,88,551,3,5,5,13,Loyal Users
16625,424,54,187,3,5,5,13,Loyal Users
16919,52,19,57,5,3,3,11,Loyal Users
17144,15,201,380,5,5,5,15,Champions
17188,143,77,151,4,5,5,14,Champions
17199,287,75,406,3,5,5,13,Loyal Users
17227,7,40,256,5,4,5,14,Champions
17351,807,34,385,2,4,5,11,At Risk
17368,239,19,39,3,3,3,9,Loyal Users
17403,137,5,14,4,1,1,6,Promising
17411,72,16,18,4,3,2,9,Loyal Users
17421,277,35,74,3,4,4,11,Loyal Users
17425,355,13,41,3,3,3,9,Loyal Users
17480,1439,8,12,1,2,1,4,Lost
17944,34,196,874,5,5,5,15,Champions
18292,3033,5,9,1,1,1,3,Lost
19068,805,6,20,2,1,2,5,Lost
19257,462,18,25,3,3,2,8,Loyal Users
19384,1150,24,41,2,4,3,9,At Risk
19554,228,44,236,3,4,5,12,Loyal Users
19629,80,63,703,4,5,5,14,Champions
19799,2292,6,10,1,1,1,3,Lost
19913,106,34,173,4,4,5,13,Champions
19999,257,20,46,3,3,3,9,Loyal Users
20001,75,45,96,4,4,4,12,Champions
20152,422,5,10,3,1,1,5,Casual Users
20439,124,11,23,4,2,2,8,Promising
20545,1278,7,9,1,2,1,4,Lost
20645,118,37,106,4,4,4,12,Champions
21497,6,108,201,5,5,5,15,Champions
21527,414,27,71,3,4,4,11,Loyal Users
21539,105,35,59,4,4,3,11,Loyal Users
21583,1446,9,16,1,2,2,5,Lost
21730,9,6,8,5,1,1,7,Promising
21981,992,9,26,2,2,2,6,Lost
22702,123,97,372,4,5,5,14,Champions
22829,132,7,17,4,2,2,8,Promising
22915,1849,9,24,1,2,2,5,Lost
23030,25,13,23,5,3,2,10,Loyal Users
23405,70,19,150,4,3,5,12,Loyal Users
23531,3874,9,37,1,2,3,6,Lost
23614,5,31,146,5,4,4,13,Champions
23680,27,90,450,5,5,5,15,Champions
23876,1003,13,68,2,3,4,9,Casual Users
24114,832,13,29,2,3,2,7,Casual Users
24181,4751,6,15,1,1,1,3,Lost
24422,161,26,38,4,4,3,11,Loyal Users
24628,2848,9,13,1,2,1,4,Lost
24773,22,85,379,5,5,5,15,Champions
24938,886,14,40,2,3,3,8,Casual Users
24945,927,11,39,2,2,3,7,Lost
25065,2464,5,9,1,1,1,3,Lost
25136,2816,7,13,1,2,1,4,Lost
25304,419,8,13,3,2,1,6,Casual Users
25490,376,5,19,3,1,2,6,Casual Users
25575,3124,6,29,1,1,2,4,Lost
25718,220,70,122,3,5,4,12,Loyal Users
25910,27,22,34,5,4,3,12,Loyal Users
26209,283,7,16,3,2,2,7,Casual Users
26374,3444,7,14,1,2,1,4,Lost
26449,104,25,106,4,4,4,12,Champions
13693,440,5,36,3,1,3,7,Casual Users
13877,4128,17,27,1,3,2,6,Casual Users
13984,119,7,17,4,2,2,8,Promising
14029,0,22,55,5,4,3,12,Loyal Users
14123,1123,9,28,2,2,2,6,Lost
14224,13,149,895,5,5,5,15,Champions
15351,1826,6,18,1,1,2,4,Lost
15361,4,46,72,5,5,4,14,Champions
15591,143,16,87,4,3,4,11,Loyal Users
15610,0,18,118,5,3,4,12,Loyal Users
15715,111,122,249,4,5,5,14,Champions
15771,1274,20,43,1,3,3,7,Casual Users
16132,16,23,34,5,4,3,12,Loyal Users
16660,1388,7,15,1,2,1,4,Lost
16830,350,11,26,3,2,2,7,Casual Users
16875,370,32,69,3,4,4,11,Loyal Users
16915,148,71,185,4,5,5,14,Champions
17605,568,15,38,2,3,3,8,Casual Users
17716,1247,5,12,2,1,1,4,Lost
17940,30,70,415,5,5,5,15,Champions
18127,386,39,53,3,4,3,10,Loyal Users
18542,103,80,154,4,5,5,14,Champions
18901,371,8,15,3,2,1,6,Casual Users
19095,144,33,75,4,4,4,12,Champions
19342,429,7,26,3,2,2,7,Casual Users
19416,830,18,104,2,3,4,9,Casual Users
19539,1380,29,140,1,4,4,9,At Risk
19552,0,56,229,5,5,5,15,Champions
19595,124,10,72,4,2,4,10,Promising
19625,594,8,89,2,2,4,8,Lost
19953,1641,7,11,1,2,1,4,Lost
20300,659,9,15,2,2,1,5,Lost
20397,1241,7,20,2,2,2,6,Lost
20547,1839,5,6,1,1,1,3,Lost
21100,82,48,214,4,5,5,14,Champions
21255,408,24,60,3,4,3,10,Loyal Users
21355,3938,5,6,1,1,1,3,Lost
21434,411,23,43,3,4,3,10,Loyal Users
21751,530,10,24,2,2,2,6,Lost
21759,125,18,24,4,3,2,9,Loyal Users
21822,731,16,43,2,3,3,8,Casual Users
22033,139,14,34,4,3,3,10,Loyal Users
22528,12,62,290,5,5,5,15,Champions
22537,84,5,11,4,1,1,6,Promising
22554,1973,30,60,1,4,3,8,At Risk
22996,299,13,21,3,3,2,8,Loyal Users
23640,157,54,298,4,5,5,14,Champions
24187,216,17,25,3,3,2,8,Loyal Users
24239,543,30,108,2,4,4,10,At Risk
24256,265,17,39,3,3,3,9,Loyal Users
24434,131,6,27,4,1,2,7,Promising
24556,1424,9,22,1,2,2,5,Lost
25161,1534,12,12,1,3,1,5,Casual Users
25495,1270,27,184,1,4,5,10,At Risk
25935,268,8,8,3,2,1,6,Casual Users
26253,2017,10,11,1,2,1,4,Lost
26373,257,41,90,3,4,4,11,Loyal Users
13854,1,73,138,5,5,4,14,Champions
13913,98,120,187,4,5,5,14,Champions
13926,149,49,73,4,5,4,13,Champions
13933,128,7,71,4,2,4,10,Promising
14352,2036,8,8,1,2,1,4,Lost
14549,156,43,171,4,4,5,13,Champions
14552,344,7,11,3,2,1,6,Casual Users
14667,149,15,60,4,3,3,10,Loyal Users
14740,1358,10,39,1,2,3,6,Lost
14767,722,27,145,2,4,4,10,At Risk
14877,38,6,16,5,1,2,8,Promising
14953,23,36,70,5,4,4,13,Champions
15294,1652,34,73,1,4,4,9,At Risk
15552,125,34,83,4,4,4,12,Champions
16182,3,75,92,5,5,4,14,Champions
16198,138,7,20,4,2,2,8,Promising
16238,156,20,76,4,3,4,11,Loyal Users
16914,288,37,113,3,4,4,11,Loyal Users
17237,1028,8,16,2,2,2,6,Lost
17310,842,6,12,2,1,1,4,Lost
17451,1557,11,16,1,2,2,5,Lost
17474,883,16,43,2,3,3,8,Casual Users
17537,7,16,22,5,3,2,10,Loyal Users
17657,624,105,252,2,5,5,12,At Risk
17778,311,16,29,3,3,2,8,Loyal Users
18056,133,5,26,4,1,2,7,Promising
18186,244,11,31,3,2,2,7,Casual Users
18308,26,44,146,5,4,4,13,Champions
18344,17,144,588,5,5,5,15,Champions
18349,138,5,12,4,1,1,6,Promising
18389,1,5,7,5,1,1,7,Promising
18525,140,45,79,4,4,4,12,Champions
18580,122,88,125,4,5,4,13,Champions
18796,2403,6,12,1,1,1,3,Lost
18799,44,66,130,5,5,4,14,Champions
18997,167,52,125,3,5,4,12,Loyal Users
19157,82,17,23,4,3,2,9,Loyal Users
19847,142,21,39,4,3,3,10,Loyal Users
19916,138,26,139,4,4,4,12,Champions
20446,35,41,288,5,4,5,14,Champions
20479,234,35,198,3,4,5,12,Loyal Users
20973,30,53,105,5,5,4,14,Champions
21152,191,5,8,3,1,1,5,Casual Users
21185,536,5,9,2,1,1,4,Lost
21274,715,68,454,2,5,5,12,At Risk
21423,283,7,24,3,2,2,7,Casual Users
22053,602,13,140,2,3,4,9,Casual Users
22082,1281,12,58,1,3,3,7,Casual Users
22358,1681,12,15,1,3,1,5,Casual Users
22813,309,14,19,3,3,2,8,Loyal Users
22892,5594,6,8,1,1,1,3,Lost
22934,4409,9,46,1,2,3,6,Lost
22987,84,27,87,4,4,4,12,Champions
23649,239,6,7,3,1,1,5,Casual Users
24271,98,92,135,4,5,4,13,Champions
24502,132,19,46,4,3,3,10,Loyal Users
24972,216,32,51,3,4,3,10,Loyal Users
25040,254,11,12,3,2,1,6,Casual Users
25362,1947,9,25,1,2,2,5,Lost
25393,273,6,28,3,1,2,6,Casual Users
25860,2533,5,24,1,1,2,4,Lost
25915,4159,16,29,1,3,2,6,Casual Users
13924,5015,11,27,1,2,2,5,Lost
14114,3888,6,7,1,1,1,3,Lost
14595,4406,5,5,1,1,1,3,Lost
14756,3,22,94,5,4,4,13,Champions
14886,810,6,16,2,1,2,5,Lost
15250,120,42,118,4,4,4,12,Champions
15708,40,13,62,5,3,3,11,Loyal Users
15838,208,5,6,3,1,1,5,Casual Users
15932,143,5,10,4,1,1,6,Promising
16112,118,25,70,4,4,4,12,Champions
16373,566,21,36,2,3,3,8,Casual Users
16481,1028,14,24,2,3,2,7,Casual Users
16679,570,52,168,2,5,5,12,At Risk
17371,184,12,23,3,3,2,8,Loyal Users
17654,975,83,248,2,5,5,12,At Risk
17735,99,17,84,4,3,4,11,Loyal Users
18039,4051,75,152,1,5,5,11,At Risk
18537,279,46,171,3,5,5,13,Loyal Users
19106,1530,8,15,1,2,1,4,Lost
19208,565,16,78,2,3,4,9,Casual Users
19429,2370,19,33,1,3,3,7,Casual Users
19691,120,16,32,4,3,3,10,Loyal Users
19755,132,45,202,4,4,5,13,Champions
19896,358,45,111,3,4,4,11,Loyal Users
19941,93,96,190,4,5,5,14,Champions
20111,114,57,152,4,5,5,14,Champions
20311,742,7,17,2,2,2,6,Lost
21091,32,50,390,5,5,5,15,Champions
21254,1874,10,27,1,2,2,5,Lost
21507,1,95,604,5,5,5,15,Champions
21783,232,45,70,3,4,4,11,Loyal Users
21805,234,28,60,3,4,3,10,Loyal Users
22167,1112,5,23,2,1,2,5,Lost
22186,1645,21,96,1,3,4,8,Casual Users
22226,11,131,342,5,5,5,15,Champions
22340,247,23,97,3,4,4,11,Loyal Users
22496,100,147,668,4,5,5,14,Champions
22714,391,11,20,3,2,2,7,Casual Users
22719,81,75,228,4,5,5,14,Champions
22891,74,55,209,4,5,5,14,Champions
23210,102,45,130,4,4,4,12,Champions
23357,1352,15,40,1,3,3,7,Casual Users
23417,149,17,118,4,3,4,11,Loyal Users
23945,55,55,99,5,5,4,14,Champions
24381,270,13,61,3,3,3,9,Loyal Users
24673,288,8,9,3,2,1,6,Casual Users
25211,1574,8,14,1,2,1,4,Lost
25554,573,6,6,2,1,1,4,Lost
25561,2,88,290,5,5,5,15,Champions
25584,402,6,18,3,1,2,6,Casual Users
26019,78,10,12,4,2,1,7,Promising
26380,678,9,14,2,2,1,5,Lost
26408,167,89,222,3,5,5,13,Loyal Users
26460,157,44,83,4,4,4,12,Champions
13608,374,5,26,3,1,2,6,Casual Users
13962,418,24,45,3,4,3,10,Loyal Users
14005,393,9,12,3,2,1,6,Casual Users
14093,134,97,611,4,5,5,14,Champions
14460,251,24,31,3,4,2,9,Loyal Users
14626,258,6,40,3,1,3,7,Casual Users
14805,653,63,102,2,5,4,11,At Risk
15182,10,54,75,5,5,4,14,Champions
15340,23,52,391,5,5,5,15,Champions
15428,130,13,30,4,3,2,9,Loyal Users
15442,1257,10,16,2,2,2,6,Lost
15712,238,6,11,3,1,1,5,Casual Users
15729,2,53,367,5,5,5,15,Champions
15776,72,8,51,4,2,3,9,Promising
16256,2427,11,11,1,2,1,4,Lost
16356,5861,9,9,1,2,1,4,Lost
16868,23,92,505,5,5,5,15,Champions
16978,2593,8,16,1,2,2,5,Lost
17151,92,21,34,4,3,3,10,Loyal Users
17181,2402,8,14,1,2,1,4,Lost
17311,45,31,93,5,4,4,13,Champions
18131,1522,16,87,1,3,4,8,Casual Users
18157,33,170,370,5,5,5,15,Champions
18185,850,29,73,2,4,4,10,At Risk
18203,76,6,14,4,1,1,6,Promising
18276,152,24,40,4,4,3,11,Loyal Users
18767,866,6,8,2,1,1,4,Lost
18769,72,16,55,4,3,3,10,Loyal Users
18951,437,9,66,3,2,4,9,Casual Users
18963,14,5,15,5,1,1,7,Promising
19191,95,70,186,4,5,5,14,Champions
19386,8,97,357,5,5,5,15,Champions
19668,9,41,57,5,4,3,12,Loyal Users
20079,260,22,67,3,4,4,11,Loyal Users
20372,153,10,26,4,2,2,8,Promising
20701,302,75,108,3,5,4,12,Loyal Users
20868,985,13,31,2,3,2,7,Casual Users
20906,424,6,16,3,1,2,6,Casual Users
20975,342,11,20,3,2,2,7,Casual Users
21193,451,16,36,3,3,3,9,Loyal Users
21524,289,5,8,3,1,1,5,Casual Users
21728,659,11,52,2,2,3,7,Lost
21982,3,74,194,5,5,5,15,Champions
22133,385,9,20,3,2,2,7,Casual Users
23061,2432,5,16,1,1,2,4,Lost
23074,2678,17,25,1,3,2,6,Casual Users
23159,22,73,230,5,5,5,15,Champions
23579,667,13,18,2,3,2,7,Casual Users
23782,459,10,20,3,2,2,7,Casual Users
23791,496,9,14,2,2,1,5,Lost
23981,464,11,21,3,2,2,7,Casual Users
24118,2486,45,89,1,4,4,9,At Risk
24459,1128,5,8,2,1,1,4,Lost
24568,1180,5,10,2,1,1,4,Lost
25550,125,8,8,4,2,1,7,Promising
25785,559,6,16,2,1,2,5,Lost
26094,408,15,26,3,3,2,8,Loyal Users
13592,676,5,18,2,1,2,5,Lost
13920,107,13,24,4,3,2,9,Loyal Users
14269,459,61,73,3,5,4,12,Loyal Users
14356,2953,11,28,1,2,2,5,Lost
14400,1728,13,24,1,3,2,6,Casual Users
14502,142,36,51,4,4,3,11,Loyal Users
14599,5,179,607,5,5,5,15,Champions
14858,3671,30,134,1,4,4,9,At Risk
15045,2988,6,9,1,1,1,3,Lost
15278,458,13,50,3,3,3,9,Loyal Users
15487,1464,21,104,1,3,4,8,Casual Users
15550,502,25,184,2,4,5,11,At Risk
15556,86,36,57,4,4,3,11,Loyal Users
15759,4,138,435,5,5,5,15,Champions
16212,427,6,8,3,1,1,5,Casual Users
16381,56,40,146,5,4,4,13,Champions
16409,757,7,22,2,2,2,6,Lost
16705,91,62,185,4,5,5,14,Champions
16712,121,20,36,4,3,3,10,Loyal Users
16739,1524,7,32,1,2,3,6,Lost
17352,96,12,19,4,3,2,9,Loyal Users
17426,125,16,17,4,3,2,9,Loyal Users
17442,120,23,43,4,4,3,11,Loyal Users
17649,82,80,280,4,5,5,14,Champions
17877,798,17,91,2,3,4,9,Casual Users
17979,447,21,41,3,3,3,9,Loyal Users
18163,442,28,115,3,4,4,11,Loyal Users
18196,543,26,56,2,4,3,9,At Risk
18287,2981,6,7,1,1,1,3,Lost
18364,132,50,94,4,5,4,13,Champions
18477,257,55,97,3,5,4,12,Loyal Users
18703,144,34,91,4,4,4,12,Champions
18714,2293,8,8,1,2,1,4,Lost
19006,244,28,43,3,4,3,10,Loyal Users
19143,175,9,9,3,2,1,6,Casual Users
19290,388,28,49,3,4,3,10,Loyal Users
19447,3901,5,5,1,1,1,3,Lost
19662,332,13,88,3,3,4,10,Loyal Users
19730,65,14,21,5,3,2,10,Loyal Users
19835,46,58,352,5,5,5,15,Champions
19920,369,8,8,3,2,1,6,Casual Users
19931,1313,41,54,1,4,3,8,At Risk
20090,69,26,84,5,4,4,13,Champions
20139,87,20,35,4,3,3,10,Loyal Users
20297,826,15,26,2,3,2,7,Casual Users
20786,15,9,17,5,2,2,9,Promising
20889,416,17,114,3,3,4,10,Loyal Users
20941,131,6,6,4,1,1,6,Promising
21000,140,5,11,4,1,1,6,Promising
21132,1850,9,11,1,2,1,4,Lost
21173,2343,5,6,1,1,1,3,Lost
21253,271,32,92,3,4,4,11,Loyal Users
21329,429,7,18,3,2,2,7,Casual Users
21500,26,23,41,5,4,3,12,Loyal Users
21617,3,21,49,5,3,3,11,Loyal Users
21639,90,81,304,4,5,5,14,Champions
21987,29,13,26,5,3,2,10,Loyal Users
22494,985,8,29,2,2,2,6,Lost
22602,265,35,345,3,4,5,12,Loyal Users
22674,1297,7,7,1,2,1,4,Lost
22700,1583,8,14,1,2,1,4,Lost
23003,2294,16,90,1,3,4,8,Casual Users
23089,4230,42,89,1,4,4,9,At Risk
23114,413,6,20,3,1,2,6,Casual Users
23192,2433,5,6,1,1,1,3,Lost
23231,4096,5,12,1,1,1,3,Lost
23258,640,14,103,2,3,4,9,Casual Users
23508,78,24,79,4,4,4,12,Champions
23510,8,31,100,5,4,4,13,Champions
24316,2568,9,16,1,2,2,5,Lost
24597,789,5,55,2,1,3,6,Lost
24859,3278,5,5,1,1,1,3,Lost
25220,1033,10,12,2,2,1,5,Lost
25237,106,35,50,4,4,3,11,Loyal Users
25255,17,30,109,5,4,4,13,Champions
25634,2966,6,7,1,1,1,3,Lost
26126,472,25,27,2,4,2,8,At Risk
26173,3726,9,9,1,2,1,4,Lost
13747,104,21,96,4,3,4,11,Loyal Users
13796,405,5,16,3,1,2,6,Casual Users
14176,842,10,21,2,2,2,6,Lost
14267,117,22,69,4,4,4,12,Champions
14312,183,107,247,3,5,5,13,Loyal Users
14612,2100,8,59,1,2,3,6,Lost
14758,413,22,48,3,4,3,10,Loyal Users
15341,169,19,68,3,3,4,10,Loyal Users
16037,1550,9,40,1,2,3,6,Lost
16100,5856,6,13,1,1,1,3,Lost
16130,515,5,6,2,1,1,4,Lost
16293,8,40,204,5,4,5,14,Champions
16454,96,66,213,4,5,5,14,Champions
16752,132,22,35,4,4,3,11,Loyal Users
17354,2392,6,10,1,1,1,3,Lost
17597,369,11,14,3,2,1,6,Casual Users
17795,121,7,35,4,2,3,9,Promising
17880,836,14,19,2,3,2,7,Casual Users
17920,428,15,23,3,3,2,8,Loyal Users
18063,156,35,77,4,4,4,12,Champions
18069,98,15,23,4,3,2,9,Loyal Users
18230,28,49,141,5,5,4,14,Champions
19083,698,5,7,2,1,1,4,Lost
19651,1267,6,13,1,1,1,3,Lost
19829,66,62,261,5,5,5,15,Champions
19898,235,11,18,3,2,2,7,Casual Users
20022,1048,6,52,2,1,3,6,Lost
20392,386,85,207,3,5,5,13,Loyal Users
20541,16,16,32,5,3,3,11,Loyal Users
20619,127,31,52,4,4,3,11,Loyal Users
20826,267,37,88,3,4,4,11,Loyal Users
20964,609,23,55,2,4,3,9,At Risk
20983,1,79,154,5,5,5,15,Champions
20984,79,58,142,4,5,4,13,Champions
21070,119,13,58,4,3,3,10,Loyal Users
21142,18,63,90,5,5,4,14,Champions
21445,551,12,75,2,3,4,9,Casual Users
21610,2512,56,84,1,5,4,10,At Risk
21619,6,73,113,5,5,4,14,Champions
21821,90,25,42,4,4,3,11,Loyal Users
21901,1589,14,36,1,3,3,7,Casual Users
21925,9,172,435,5,5,5,15,Champions
22038,162,22,33,4,4,3,11,Loyal Users
22359,415,11,19,3,2,2,7,Casual Users
22423,72,58,201,4,5,5,14,Champions
22538,1556,5,17,1,1,2,4,Lost
23328,3708,12,12,1,3,1,5,Casual Users
23330,688,38,331,2,4,5,11,At Risk
23452,1271,10,17,1,2,2,5,Lost
23458,1086,10,66,2,2,4,8,Lost
23621,529,8,13,2,2,1,5,Lost
23745,244,33,63,3,4,4,11,Loyal Users
24481,98,25,27,4,4,2,10,Loyal Users
24577,93,37,65,4,4,4,12,Champions
24808,3026,6,7,1,1,1,3,Lost
24809,2303,13,26,1,3,2,6,Casual Users
25314,8,122,149,5,5,5,15,Champions
25483,26,42,203,5,4,5,14,Champions
25647,2448,9,10,1,2,1,4,Lost
25842,60,18,30,5,3,2,10,Loyal Users
26245,161,6,43,4,1,3,8,Promising
26249,59,38,72,5,4,4,13,Champions
26453,933,6,22,2,1,2,5,Lost
13692,110,8,23,4,2,2,8,Promising
13950,124,13,120,4,3,4,11,Loyal Users
14560,1,111,230,5,5,5,15,Champions
14772,17,186,729,5,5,5,15,Champions
14857,13,48,251,5,5,5,15,Champions
15437,18,47,83,5,5,4,14,Champions
15678,665,65,93,2,5,4,11,At Risk
15782,423,12,18,3,3,2,8,Loyal Users
16028,1809,5,16,1,1,2,4,Lost
16154,665,8,9,2,2,1,5,Lost
16502,108,32,161,4,4,5,13,Champions
16686,98,18,57,4,3,3,10,Loyal Users
16866,1282,18,25,1,3,2,6,Casual Users
16940,14,16,36,5,3,3,11,Loyal Users
16989,1236,12,25,2,3,2,7,Casual Users
17393,5,117,162,5,5,5,15,Champions
17997,135,14,41,4,3,3,10,Loyal Users
18119,255,6,15,3,1,1,5,Casual Users
18137,397,35,63,3,4,4,11,Loyal Users
18138,115,18,51,4,3,3,10,Loyal Users
18204,108,40,102,4,4,4,12,Champions
18210,3231,7,65,1,2,4,7,Lost
18281,281,34,57,3,4,3,10,Loyal Users
18309,53,38,61,5,4,3,12,Loyal Users
18368,1502,6,41,1,1,3,5,Lost
18545,80,9,33,4,2,3,9,Promising
18672,275,32,69,3,4,4,11,Loyal Users
19221,2257,34,85,1,4,4,9,At Risk
19327,10,60,119,5,5,4,14,Champions
19424,384,25,41,3,4,3,10,Loyal Users
19568,43,7,41,5,2,3,10,Promising
20623,1034,30,54,2,4,3,9,At Risk
20714,120,16,35,4,3,3,10,Loyal Users
20869,1270,16,26,1,3,2,6,Casual Users
20987,3121,5,10,1,1,1,3,Lost
20988,131,53,273,4,5,5,14,Champions
21228,190,20,76,3,3,4,10,Loyal Users
21297,403,27,125,3,4,4,11,Loyal Users
21309,3398,6,67,1,1,4,6,Lost
21764,39,73,153,5,5,5,15,Champions
21963,116,30,219,4,4,5,13,Champions
22292,119,108,309,4,5,5,14,Champions
22306,1192,9,14,2,2,1,5,Lost
22549,842,5,7,2,1,1,4,Lost
22603,303,6,9,3,1,1,5,Casual Users
22744,305,12,14,3,3,1,7,Loyal Users
22827,169,70,131,3,5,4,12,Loyal Users
23627,6,6,8,5,1,1,7,Promising
24052,307,23,86,3,4,4,11,Loyal Users
24056,1837,15,23,1,3,2,6,Casual Users
24626,1596,115,265,1,5,5,11,At Risk
24635,567,5,6,2,1,1,4,Lost
25443,274,71,171,3,5,5,13,Loyal Users
25613,412,7,21,3,2,2,7,Casual Users
25700,1009,14,50,2,3,3,8,Casual Users
25703,366,5,26,3,1,2,6,Casual Users
26248,241,33,56,3,4,3,10,Loyal Users
13593,101,122,665,4,5,5,14,Champions
13764,121,24,70,4,4,4,12,Champions
14218,96,37,44,4,4,3,11,Loyal Users
14309,387,22,29,3,4,2,9,Loyal Users
14358,73,13,15,4,3,1,8,Loyal Users
14710,29,16,40,5,3,3,11,Loyal Users
14849,0,35,140,5,4,4,13,Champions
15016,1128,17,48,2,3,3,8,Casual Users
15211,8,32,113,5,4,4,13,Champions
15687,3095,6,12,1,1,1,3,Lost
15799,1280,27,44,1,4,3,8,At Risk
15981,1401,12,15,1,3,1,5,Casual Users
16248,54,117,383,5,5,5,15,Champions
16307,308,67,636,3,5,5,13,Loyal Users
16546,299,5,5,3,1,1,5,Casual Users
16616,137,24,44,4,4,3,11,Loyal Users
16618,671,45,226,2,4,5,11,At Risk
16654,409,30,70,3,4,4,11,Loyal Users
16822,20,11,35,5,2,3,10,Promising
16841,1293,38,82,1,4,4,9,At Risk
16855,3589,36,105,1,4,4,9,At Risk
16983,747,8,9,2,2,1,5,Lost
17005,1228,26,74,2,4,4,10,At Risk
17304,125,30,116,4,4,4,12,Champions
17366,2985,11,20,1,2,2,5,Lost
17490,2412,5,17,1,1,2,4,Lost
17695,65,74,288,5,5,5,15,Champions
17827,1404,12,27,1,3,2,6,Casual Users
17875,124,15,95,4,3,4,11,Loyal Users
17992,1754,6,16,1,1,2,4,Lost
18152,80,106,364,4,5,5,14,Champions
18416,131,21,189,4,3,5,12,Loyal Users
18602,0,75,245,5,5,5,15,Champions
18837,65,36,95,5,4,4,13,Champions
18928,2513,16,34,1,3,3,7,Casual Users
18977,297,8,42,3,2,3,8,Casual Users
19011,13,9,54,5,2,3,10,Promising
19427,74,73,493,4,5,5,14,Champions
19466,272,14,66,3,3,4,10,Loyal Users
19624,788,25,60,2,4,3,9,At Risk
20026,1522,6,26,1,1,2,4,Lost
20197,151,5,8,4,1,1,6,Promising
20215,35,47,186,5,5,5,15,Champions
20251,1264,13,49,1,3,3,7,Casual Users
20339,108,10,17,4,2,2,8,Promising
20551,171,8,36,3,2,3,8,Casual Users
21424,113,43,130,4,4,4,12,Champions
21660,132,15,25,4,3,2,9,Loyal Users
21709,65,5,46,5,1,3,9,Promising
21931,2412,6,28,1,1,2,4,Lost
22016,569,6,9,2,1,1,4,Lost
22105,135,26,93,4,4,4,12,Champions
22272,180,11,126,3,2,4,9,Casual Users
22314,1404,5,5,1,1,1,3,Lost
22410,214,50,61,3,5,3,11,Loyal Users
22680,1,86,193,5,5,5,15,Champions
22837,10,6,10,5,1,1,7,Promising
23384,963,51,106,2,5,4,11,At Risk
23775,213,12,21,3,3,2,8,Loyal Users
23855,1087,6,24,2,1,2,5,Lost
23926,13,27,46,5,4,3,12,Loyal Users
24028,950,6,20,2,1,2,5,Lost
24045,430,20,25,3,3,2,8,Loyal Users
24500,3439,15,23,1,3,2,6,Casual Users
24658,589,7,8,2,2,1,5,Lost
24684,78,13,16,4,3,2,9,Loyal Users
24712,1308,8,30,1,2,2,5,Lost
25758,834,24,46,2,4,3,9,At Risk
25852,420,8,14,3,2,1,6,Casual Users
26055,791,30,69,2,4,4,10,At Risk
13649,117,43,107,4,4,4,12,Champions
13744,296,114,165,3,5,5,13,Loyal Users
13891,269,17,27,3,3,2,8,Loyal Users
14199,138,9,52,4,2,3,9,Promising
14781,547,8,30,2,2,2,6,Lost
14910,224,7,12,3,2,1,6,Casual Users
15217,177,42,146,3,4,4,11,Loyal Users
15507,31,105,243,5,5,5,15,Champions
15525,37,14,14,5,3,1,9,Loyal Users
15798,322,8,15,3,2,1,6,Casual Users
15951,160,15,30,4,3,2,9,Loyal Users
16249,863,19,47,2,3,3,8,Casual Users
16471,1980,7,16,1,2,2,5,Lost
16802,453,8,14,3,2,1,6,Casual Users
17298,121,51,102,4,5,4,13,Champions
17349,550,7,19,2,2,2,6,Lost
17387,35,9,9,5,2,1,8,Promising
17481,271,39,136,3,4,4,11,Loyal Users
17590,1184,5,9,2,1,1,4,Lost
17661,1568,5,6,1,1,1,3,Lost
17776,352,44,234,3,4,5,12,Loyal Users
17942,11,20,109,5,3,4,12,Loyal Users
18090,26,20,50,5,3,3,11,Loyal Users
18142,36,23,39,5,4,3,12,Loyal Users
18642,24,11,30,5,2,2,9,Promising
18702,3490,5,6,1,1,1,3,Lost
18846,1258,7,9,1,2,1,4,Lost
18919,1837,24,35,1,4,3,8,At Risk
19169,24,159,222,5,5,5,15,Champions
19193,766,10,24,2,2,2,6,Lost
19246,164,8,15,4,2,1,7,Promising
19426,1277,13,22,1,3,2,6,Casual Users
19644,1298,5,6,1,1,1,3,Lost
19802,1476,16,32,1,3,3,7,Casual Users
19812,868,11,12,2,2,1,5,Lost
20454,623,12,28,2,3,2,7,Casual Users
20486,7,34,41,5,4,3,12,Loyal Users
20823,1338,5,10,1,1,1,3,Lost
20914,134,60,137,4,5,4,13,Champions
21046,602,7,8,2,2,1,5,Lost
21171,23,13,28,5,3,2,10,Loyal Users
21211,128,39,162,4,4,5,13,Champions
21234,3053,9,18,1,2,2,5,Lost
21657,28,24,76,5,4,4,13,Champions
21922,1387,12,59,1,3,3,7,Casual Users
21933,393,9,15,3,2,1,6,Casual Users
22094,25,85,424,5,5,5,15,Champions
22463,407,17,35,3,3,3,9,Loyal Users
22718,367,27,42,3,4,3,10,Loyal Users
23023,2543,5,48,1,1,3,5,Lost
23404,726,31,120,2,4,4,10,At Risk
23586,40,118,571,5,5,5,15,Champions
23748,75,14,56,4,3,3,10,Loyal Users
23795,59,130,316,5,5,5,15,Champions
23964,1010,13,18,2,3,2,7,Casual Users
23984,605,5,20,2,1,2,5,Lost
24027,430,33,148,3,4,5,12,Loyal Users
24240,825,16,69,2,3,4,9,Casual Users
24401,111,122,226,4,5,5,14,Champions
24697,4141,9,22,1,2,2,5,Lost
24703,63,134,285,5,5,5,15,Champions
24722,5103,7,13,1,2,1,4,Lost
24885,96,10,31,4,2,2,8,Promising
25007,13,43,80,5,4,4,13,Champions
25073,3537,7,19,1,2,2,5,Lost
25122,116,19,33,4,3,3,10,Loyal Users
25195,56,14,34,5,3,3,11,Loyal Users
25263,888,5,13,2,1,1,4,Lost
25354,185,8,8,3,2,1,6,Casual Users
25413,5633,7,9,1,2,1,4,Lost
25479,1142,44,95,2,4,4,10,At Risk
25817,15,53,177,5,5,5,15,Champions
25858,57,77,223,5,5,5,15,Champions
25977,1258,5,13,1,1,1,3,Lost
26221,120,30,48,4,4,3,11,Loyal Users
13673,373,81,187,3,5,5,13,Loyal Users
13846,1730,13,58,1,3,3,7,Casual Users
14268,145,7,9,4,2,1,7,Promising
14820,580,8,27,2,2,2,6,Lost
15155,405,6,27,3,1,2,6,Casual Users
15675,158,57,213,4,5,5,14,Champions
15754,138,13,35,4,3,3,10,Loyal Users
16135,87,31,67,4,4,4,12,Champions
16225,91,41,90,4,4,4,12,Champions
16482,349,52,113,3,5,4,12,Loyal Users
17050,280,6,46,3,1,3,7,Casual Users
17256,890,11,14,2,2,1,5,Lost
17306,155,18,28,4,3,2,9,Loyal Users
17348,28,58,329,5,5,5,15,Champions
17905,16,38,99,5,4,4,13,Champions
18305,73,51,94,4,5,4,13,Champions
18491,840,22,39,2,4,3,9,At Risk
18495,58,83,279,5,5,5,15,Champions
18519,1952,5,11,1,1,1,3,Lost
18670,714,21,34,2,3,3,8,Casual Users
18803,1437,6,6,1,1,1,3,Lost
18830,481,5,24,2,1,2,5,Lost
19072,235,20,47,3,3,3,9,Loyal Users
19081,187,40,98,3,4,4,11,Loyal Users
19641,76,52,64,4,5,4,13,Champions
19774,3583,6,7,1,1,1,3,Lost
19798,56,73,603,5,5,5,15,Champions
20046,163,7,39,4,2,3,9,Promising
20288,739,9,73,2,2,4,8,Lost
20522,224,13,20,3,3,2,8,Loyal Users
20675,6,35,169,5,4,5,14,Champions
20976,431,24,65,3,4,4,11,Loyal Users
21020,1011,7,11,2,2,1,5,Lost
21357,2444,8,14,1,2,1,4,Lost
21436,972,22,51,2,4,3,9,At Risk
21530,1413,7,13,1,2,1,4,Lost
22739,132,82,466,4,5,5,14,Champions
23431,1671,5,22,1,1,2,4,Lost
23678,102,37,95,4,4,4,12,Champions
23710,65,35,58,5,4,3,12,Loyal Users
23820,91,39,165,4,4,5,13,Champions
23889,870,40,43,2,4,3,9,At Risk
23918,7,162,777,5,5,5,15,Champions
24161,104,5,13,4,1,1,6,Promising
24191,1351,5,32,1,1,3,5,Lost
24358,229,37,84,3,4,4,11,Loyal Users
24424,572,28,78,2,4,4,10,At Risk
24543,1416,6,7,1,1,1,3,Lost
24654,900,10,30,2,2,2,6,Lost
24777,1222,15,33,2,3,3,8,Casual Users
25152,657,8,15,2,2,1,5,Lost
25358,422,32,51,3,4,3,10,Loyal Users
25581,4,11,43,5,2,3,10,Promising
25620,546,12,77,2,3,4,9,Casual Users
25811,225,74,137,3,5,4,12,Loyal Users
25982,823,8,29,2,2,2,6,Lost
25997,2850,5,8,1,1,1,3,Lost
26053,23,16,58,5,3,3,11,Loyal Users
26205,118,26,69,4,4,4,12,Champions
26211,192,7,12,3,2,1,6,Casual Users
26367,105,110,262,4,5,5,14,Champions
26369,2,105,250,5,5,5,15,Champions
26441,2508,12,12,1,3,1,5,Casual Users
26459,102,6,44,4,1,3,8,Promising
13942,408,35,136,3,4,4,11,Loyal Users
14313,11,12,44,5,3,3,11,Loyal Users
14405,165,22,31,4,4,2,10,Loyal Users
14868,1402,29,111,1,4,4,9,At Risk
15094,3450,5,11,1,1,1,3,Lost
15545,1086,12,29,2,3,2,7,Casual Users
15625,6,133,589,5,5,5,15,Champions
15641,869,24,132,2,4,4,10,At Risk
15872,38,23,34,5,4,3,12,Loyal Users
16276,20,50,132,5,5,4,14,Champions
16556,14,53,229,5,5,5,15,Champions
16632,1117,14,42,2,3,3,8,Casual Users
16831,1581,9,12,1,2,1,4,Lost
16877,519,9,37,2,2,3,7,Lost
16896,1,27,46,5,4,3,12,Loyal Users
17030,1075,10,15,2,2,1,5,Lost
17168,656,33,108,2,4,4,10,At Risk
17194,155,5,11,4,1,1,6,Promising
17234,1821,10,17,1,2,2,5,Lost
17363,850,11,19,2,2,2,6,Lost
17418,661,7,7,2,2,1,5,Lost
17644,253,41,147,3,4,5,12,Loyal Users
17766,1661,6,39,1,1,3,5,Lost
17921,596,6,6,2,1,1,4,Lost
18175,10,42,111,5,4,4,13,Champions
18176,3177,8,10,1,2,1,4,Lost
18279,179,5,12,3,1,1,5,Casual Users
18306,1302,26,55,1,4,3,8,At Risk
18458,147,5,8,4,1,1,6,Promising
18546,310,32,108,3,4,4,11,Loyal Users
19054,1,47,231,5,5,5,15,Champions
19120,67,141,977,5,5,5,15,Champions
19225,834,16,40,2,3,3,8,Casual Users
19313,352,36,75,3,4,4,11,Loyal Users
19452,80,80,166,4,5,5,14,Champions
19469,1840,9,14,1,2,1,4,Lost
19855,2114,9,18,1,2,2,5,Lost
19923,675,15,46,2,3,3,8,Casual Users
19982,91,18,23,4,3,2,9,Loyal Users
20169,2537,7,55,1,2,3,6,Lost
20273,81,36,56,4,4,3,11,Loyal Users
20408,848,8,18,2,2,2,6,Lost
20564,602,18,54,2,3,3,8,Casual Users
20784,1170,37,255,2,4,5,11,At Risk
20812,938,7,23,2,2,2,6,Lost
21405,105,28,191,4,4,5,13,Champions
21451,84,7,15,4,2,1,7,Promising
21658,314,14,52,3,3,3,9,Loyal Users
21714,63,88,176,5,5,5,15,Champions
21918,719,29,110,2,4,4,10,At Risk
22456,650,9,15,2,2,1,5,Lost
22508,66,7,9,5,2,1,8,Promising
22513,3545,5,12,1,1,1,3,Lost
22897,278,26,46,3,4,3,10,Loyal Users
23182,937,5,5,2,1,1,4,Lost
23333,767,25,73,2,4,4,10,At Risk
23536,1217,15,37,2,3,3,8,Casual Users
23617,275,78,129,3,5,4,12,Loyal Users
23717,801,33,118,2,4,4,10,At Risk
23895,3557,5,7,1,1,1,3,Lost
23906,1017,5,18,2,1,2,5,Lost
24380,138,21,58,4,3,3,10,Loyal Users
24490,56,43,113,5,4,4,13,Champions
24558,276,12,18,3,3,2,8,Loyal Users
24713,2764,15,62,1,3,3,7,Casual Users
24753,269,13,53,3,3,3,9,Loyal Users
25035,1578,31,44,1,4,3,8,At Risk
25116,3062,7,10,1,2,1,4,Lost
25197,25,29,96,5,4,4,13,Champions
25225,3002,7,35,1,2,3,6,Lost
25669,506,7,54,2,2,3,7,Lost
25819,3562,16,37,1,3,3,7,Casual Users
25970,165,7,7,4,2,1,7,Promising
26117,124,30,50,4,4,3,11,Loyal Users
26445,3006,6,13,1,1,1,3,Lost
14081,160,7,7,4,2,1,7,Promising
14215,399,18,35,3,3,3,9,Loyal Users
14301,338,9,35,3,2,3,8,Casual Users
14421,199,30,107,3,4,4,11,Loyal Users
14545,425,18,27,3,3,2,8,Loyal Users
14745,3,109,353,5,5,5,15,Champions
14924,200,45,75,3,4,4,11,Loyal Users
14956,835,186,589,2,5,5,12,At Risk
14957,6,24,26,5,4,2,11,Loyal Users
15109,1290,22,26,1,4,2,7,At Risk
15284,523,11,57,2,2,3,7,Lost
15450,3585,12,28,1,3,2,6,Casual Users
16193,0,54,98,5,5,4,14,Champions
16330,829,6,6,2,1,1,4,Lost
16342,450,25,79,3,4,4,11,Loyal Users
16437,153,72,143,4,5,4,13,Champions
16456,114,162,240,4,5,5,14,Champions
16535,132,31,58,4,4,3,11,Loyal Users
16731,282,23,61,3,4,3,10,Loyal Users
16836,27,62,169,5,5,5,15,Champions
16973,8,81,124,5,5,4,14,Champions
17037,600,162,221,2,5,5,12,At Risk
17065,726,14,15,2,3,1,6,Casual Users
17082,77,95,300,4,5,5,14,Champions
17217,15,80,358,5,5,5,15,Champions
17376,0,27,56,5,4,3,12,Loyal Users
17612,682,106,797,2,5,5,12,At Risk
18017,1226,6,14,2,1,1,4,Lost
18095,718,8,33,2,2,3,7,Lost
18493,3246,6,11,1,1,1,3,Lost
18587,2103,16,258,1,3,5,9,Casual Users
18610,1526,40,118,1,4,4,9,At Risk
18656,479,10,48,2,2,3,7,Lost
19074,2511,5,6,1,1,1,3,Lost
19314,1690,5,7,1,1,1,3,Lost
19577,422,15,16,3,3,2,8,Loyal Users
19598,826,6,11,2,1,1,4,Lost
19631,196,67,154,3,5,5,13,Loyal Users
20264,2557,5,5,1,1,1,3,Lost
20451,0,51,294,5,5,5,15,Champions
20721,28,47,206,5,5,5,15,Champions
21150,93,76,165,4,5,5,14,Champions
21235,1807,12,21,1,3,2,6,Casual Users
21327,56,9,125,5,2,4,11,Promising
21704,24,8,23,5,2,2,9,Promising
21705,212,61,134,3,5,4,12,Loyal Users
21755,7,44,142,5,4,4,13,Champions
22087,60,25,39,5,4,3,12,Loyal Users
22450,845,16,33,2,3,3,8,Casual Users
22949,453,9,10,3,2,1,6,Casual Users
23595,1145,11,24,2,2,2,6,Lost
24428,268,32,42,3,4,3,10,Loyal Users
24503,409,12,33,3,3,3,9,Loyal Users
24594,2632,26,80,1,4,4,9,At Risk
24927,212,61,109,3,5,4,12,Loyal Users
24955,2612,6,6,1,1,1,3,Lost
25047,112,9,36,4,2,3,9,Promising
25894,12,34,91,5,4,4,13,Champions
26228,164,27,99,4,4,4,12,Champions
26307,320,8,15,3,2,1,6,Casual Users
26422,1189,106,139,2,5,4,11,At Risk
13815,728,5,7,2,1,1,4,Lost
13849,409,27,61,3,4,3,10,Loyal Users
14002,132,40,78,4,4,4,12,Champions
14026,65,10,21,5,2,2,9,Promising
14277,362,5,8,3,1,1,5,Casual Users
14288,81,6,14,4,1,1,6,Promising
14639,136,9,37,4,2,3,9,Promising
14664,69,10,18,5,2,2,9,Promising
14727,85,215,532,4,5,5,14,Champions
14731,695,20,63,2,3,4,9,Casual Users
14840,1457,41,74,1,4,4,9,At Risk
14933,1268,5,6,1,1,1,3,Lost
15229,81,44,66,4,4,4,12,Champions
15251,1815,5,20,1,1,2,4,Lost
15765,32,13,31,5,3,2,10,Loyal Users
16157,36,42,141,5,4,4,13,Champions
16484,568,22,72,2,4,4,10,At Risk
16599,365,34,135,3,4,4,11,Loyal Users
16782,620,44,192,2,4,5,11,At Risk
16897,2478,6,13,1,1,1,3,Lost
17184,120,29,46,4,4,3,11,Loyal Users
17216,432,16,20,3,3,2,8,Loyal Users
17229,127,62,142,4,5,4,13,Champions
17390,2,150,759,5,5,5,15,Champions
17422,1847,8,31,1,2,2,5,Lost
17581,15,88,809,5,5,5,15,Champions
17828,154,25,40,4,4,3,11,Loyal Users
17975,243,10,37,3,2,3,8,Casual Users
18154,699,7,20,2,2,2,6,Lost
18187,548,27,56,2,4,3,9,At Risk
18233,288,86,466,3,5,5,13,Loyal Users
18501,411,9,41,3,2,3,8,Casual Users
18680,533,28,47,2,4,3,9,At Risk
18808,1981,6,38,1,1,3,5,Lost
18890,945,11,25,2,2,2,6,Lost
19086,75,42,69,4,4,4,12,Champions
19116,129,47,101,4,5,4,13,Champions
19391,44,7,12,5,2,1,8,Promising
19423,797,10,38,2,2,3,7,Lost
19474,1084,5,7,2,1,1,4,Lost
19712,849,23,30,2,4,2,8,At Risk
19714,2408,12,14,1,3,1,5,Casual Users
20600,19,57,88,5,5,4,14,Champions
21005,3255,8,30,1,2,2,5,Lost
21273,1763,15,18,1,3,2,6,Casual Users
21521,216,23,73,3,4,4,11,Loyal Users
21542,72,9,59,4,2,3,9,Promising
21801,221,13,41,3,3,3,9,Loyal Users
21871,1034,6,22,2,1,2,5,Lost
21964,216,12,21,3,3,2,8,Loyal Users
22176,18,39,137,5,4,4,13,Champions
22362,1327,17,104,1,3,4,8,Casual Users
22589,274,28,42,3,4,3,10,Loyal Users
22612,0,7,20,5,2,2,9,Promising
22943,109,161,556,4,5,5,14,Champions
22957,157,60,182,4,5,5,14,Champions
23052,1,72,350,5,5,5,15,Champions
23111,85,40,81,4,4,4,12,Champions
23151,2568,12,32,1,3,3,7,Casual Users
23301,233,37,69,3,4,4,11,Loyal Users
23490,2588,5,36,1,1,3,5,Lost
23763,19,105,362,5,5,5,15,Champions
24155,1244,9,23,2,2,2,6,Lost
24469,844,8,13,2,2,1,5,Lost
24566,3072,9,18,1,2,2,5,Lost
24678,146,18,44,4,3,3,10,Loyal Users
24790,168,27,127,3,4,4,11,Loyal Users
24928,2382,13,20,1,3,2,6,Casual Users
25716,63,10,23,5,2,2,9,Promising
25816,229,8,26,3,2,2,7,Casual Users
25855,4568,9,21,1,2,2,5,Lost
26157,544,14,54,2,3,3,8,Casual Users
26398,1025,11,75,2,2,4,8,Lost
13671,1026,12,121,2,3,4,9,Casual Users
13989,532,36,68,2,4,4,10,At Risk
14046,680,14,31,2,3,2,7,Casual Users
14142,129,78,391,4,5,5,14,Champions
14256,2068,12,38,1,3,3,7,Casual Users
14469,29,92,420,5,5,5,15,Champions
14795,224,36,80,3,4,4,11,Loyal Users
14816,70,54,315,4,5,5,14,Champions
14962,594,6,18,2,1,2,5,Lost
14966,81,48,94,4,5,4,13,Champions
15134,42,34,51,5,4,3,12,Loyal Users
15959,3013,13,23,1,3,2,6,Casual Users
16058,5,22,68,5,4,4,13,Champions
16448,218,27,83,3,4,4,11,Loyal Users
16945,2428,5,6,1,1,1,3,Lost
17212,11,201,380,5,5,5,15,Champions
17360,3,11,30,5,2,2,9,Promising
18135,726,29,56,2,4,3,9,At Risk
18320,116,44,313,4,4,5,13,Champions
18447,153,12,67,4,3,4,11,Loyal Users
18559,827,13,44,2,3,3,8,Casual Users
18855,1,60,208,5,5,5,15,Champions
19125,278,88,250,3,5,5,13,Loyal Users
19471,1614,79,347,1,5,5,11,At Risk
20010,251,13,31,3,3,2,8,Loyal Users
20085,1586,5,18,1,1,2,4,Lost
20587,1535,6,6,1,1,1,3,Lost
20832,352,27,57,3,4,3,10,Loyal Users
20863,134,11,26,4,2,2,8,Promising
20899,36,83,92,5,5,4,14,Champions
21024,10,128,193,5,5,5,15,Champions
21480,271,5,9,3,1,1,5,Casual Users
21504,4812,20,31,1,3,2,6,Casual Users
21536,405,11,20,3,2,2,7,Casual Users
21586,5078,16,30,1,3,2,6,Casual Users
21736,5074,27,59,1,4,3,8,At Risk
21844,4825,10,56,1,2,3,6,Lost
21875,130,17,40,4,3,3,10,Loyal Users
21924,3285,6,21,1,1,2,4,Lost
22136,1098,7,9,2,2,1,5,Lost
22404,87,25,94,4,4,4,12,Champions
22571,1313,12,49,1,3,3,7,Casual Users
22696,571,6,10,2,1,1,4,Lost
22724,3225,7,25,1,2,2,5,Lost
22743,1297,7,7,1,2,1,4,Lost
22793,3858,7,9,1,2,1,4,Lost
23324,432,5,28,3,1,2,6,Casual Users
23535,128,21,133,4,3,4,11,Loyal Users
24534,1163,6,18,2,1,2,5,Lost
24562,1689,7,27,1,2,2,5,Lost
24925,396,15,44,3,3,3,9,Loyal Users
25063,1713,7,16,1,2,2,5,Lost
25199,1241,6,8,2,1,1,4,Lost
25201,1148,32,262,2,4,5,11,At Risk
25903,1831,8,29,1,2,2,5,Lost
26051,423,54,70,3,5,4,12,Loyal Users
26180,249,32,113,3,4,4,11,Loyal Users
14047,4084,5,5,1,1,1,3,Lost
14138,4207,11,20,1,2,2,5,Lost
14340,1437,11,31,1,2,2,5,Lost
14487,11,27,49,5,4,3,12,Loyal Users
14577,445,13,111,3,3,4,10,Loyal Users
15281,2739,8,27,1,2,2,5,Lost
15411,647,47,234,2,5,5,12,At Risk
15804,102,27,95,4,4,4,12,Champions
15863,128,65,317,4,5,5,14,Champions
16110,2022,17,23,1,3,2,6,Casual Users
16447,142,30,50,4,4,3,11,Loyal Users
16768,220,37,59,3,4,3,10,Loyal Users
16890,846,15,63,2,3,4,9,Casual Users
17102,2651,6,9,1,1,1,3,Lost
17143,235,68,158,3,5,5,13,Loyal Users
17460,4284,5,15,1,1,1,3,Lost
17472,432,12,15,3,3,1,7,Loyal Users
17498,99,5,7,4,1,1,6,Promising
17838,83,51,117,4,5,4,13,Champions
17858,396,7,9,3,2,1,6,Casual Users
18492,1220,6,12,2,1,1,4,Lost
18739,1732,5,8,1,1,1,3,Lost
18790,1129,14,49,2,3,3,8,Casual Users
18823,1537,57,154,1,5,5,11,At Risk
19102,2008,8,11,1,2,1,4,Lost
19226,62,102,127,5,5,4,14,Champions
19555,1534,9,16,1,2,2,5,Lost
19559,1836,7,20,1,2,2,5,Lost
19674,825,13,16,2,3,2,7,Casual Users
20070,980,6,14,2,1,1,4,Lost
20095,407,31,123,3,4,4,11,Loyal Users
20205,8,127,811,5,5,5,15,Champions
20393,54,17,31,5,3,2,10,Loyal Users
20970,40,17,53,5,3,3,11,Loyal Users
20997,536,47,329,2,5,5,12,At Risk
21032,102,27,182,4,4,5,13,Champions
21242,847,17,28,2,3,2,7,Casual Users
21532,385,6,20,3,1,2,6,Casual Users
21929,159,34,86,4,4,4,12,Champions
22115,138,24,81,4,4,4,12,Champions
22328,521,41,75,2,4,4,10,At Risk
22617,506,10,18,2,2,2,6,Lost
22765,593,13,33,2,3,3,8,Casual Users
22853,2870,19,54,1,3,3,7,Casual Users
23197,331,23,82,3,4,4,11,Loyal Users
23426,0,67,144,5,5,4,14,Champions
23561,192,24,33,3,4,3,10,Loyal Users
23578,28,48,114,5,5,4,14,Champions
23713,1923,22,61,1,4,3,8,At Risk
23985,1167,16,32,2,3,3,8,Casual Users
24024,9,63,140,5,5,4,14,Champions
24364,229,58,207,3,5,5,13,Loyal Users
24484,1316,18,23,1,3,2,6,Casual Users
24687,1742,10,25,1,2,2,5,Lost
24784,2561,5,5,1,1,1,3,Lost
25723,126,11,28,4,2,2,8,Promising
25794,148,10,44,4,2,3,9,Promising
26041,129,121,569,4,5,5,14,Champions
26067,713,18,35,2,3,3,8,Casual Users
26074,3696,6,7,1,1,1,3,Lost
26324,4452,12,15,1,3,1,5,Casual Users
26359,164,59,208,4,5,5,14,Champions
26397,1987,5,10,1,1,1,3,Lost
13658,90,24,59,4,4,3,11,Loyal Users
13725,74,7,11,4,2,1,7,Promising
13912,2517,6,9,1,1,1,3,Lost
14087,6,40,241,5,4,5,14,Champions
14168,13,9,46,5,2,3,10,Promising
14178,57,47,300,5,5,5,15,Champions
14296,389,13,63,3,3,4,10,Loyal Users
14346,149,27,88,4,4,4,12,Champions
14614,116,19,21,4,3,2,9,Loyal Users
14696,20,122,745,5,5,5,15,Champions
14946,25,11,15,5,2,1,8,Promising
15285,176,53,94,3,5,4,12,Loyal Users
15383,81,20,42,4,3,3,10,Loyal Users
15605,1508,6,11,1,1,1,3,Lost
15813,190,81,420,3,5,5,13,Loyal Users
15988,860,6,8,2,1,1,4,Lost
16003,1559,14,34,1,3,3,7,Casual Users
16086,250,48,247,3,5,5,13,Loyal Users
16281,132,12,18,4,3,2,9,Loyal Users
16382,44,59,242,5,5,5,15,Champions
16422,2062,10,32,1,2,3,6,Lost
16501,214,5,10,3,1,1,5,Casual Users
16635,869,18,44,2,3,3,8,Casual Users
16757,3587,12,30,1,3,2,6,Casual Users
16955,1156,10,11,2,2,1,5,Lost
16982,724,34,46,2,4,3,9,At Risk
16988,55,37,482,5,4,5,14,Champions
17002,261,6,26,3,1,2,6,Casual Users
17210,283,74,119,3,5,4,12,Loyal Users
17416,95,5,46,4,1,3,8,Promising
18526,1,129,984,5,5,5,15,Champions
18638,1405,11,19,1,2,2,5,Lost
18836,678,25,45,2,4,3,9,At Risk
19055,102,10,19,4,2,2,8,Promising
19228,178,31,234,3,4,5,12,Loyal Users
19301,22,59,121,5,5,4,14,Champions
19533,2442,6,11,1,1,1,3,Lost
19616,8,11,23,5,2,2,9,Promising
19667,386,9,30,3,2,2,7,Casual Users
20030,297,49,71,3,5,4,12,Loyal Users
20309,26,132,368,5,5,5,15,Champions
20999,4679,15,31,1,3,2,6,Casual Users
21123,13,91,100,5,5,4,14,Champions
21197,805,78,233,2,5,5,12,At Risk
21593,810,30,150,2,4,5,11,At Risk
21684,1182,16,33,2,3,3,8,Casual Users
21717,0,116,221,5,5,5,15,Champions
21862,461,10,19,3,2,2,7,Casual Users
21868,2046,5,15,1,1,1,3,Lost
21898,119,21,43,4,3,3,10,Loyal Users
21980,516,6,18,2,1,2,5,Lost
22010,25,22,39,5,4,3,12,Loyal Users
22310,0,214,732,5,5,5,15,Champions
22686,252,22,65,3,4,4,11,Loyal Users
22701,967,20,23,2,3,2,7,Casual Users
22722,412,34,78,3,4,4,11,Loyal Users
22828,234,14,27,3,3,2,8,Loyal Users
22868,1689,14,23,1,3,2,6,Casual Users
23368,100,143,339,4,5,5,14,Champions
23537,11,67,256,5,5,5,15,Champions
23603,3873,6,7,1,1,1,3,Lost
23616,127,5,8,4,1,1,6,Promising
24023,424,13,29,3,3,2,8,Loyal Users
24146,163,11,75,4,2,4,10,Promising
24375,90,12,103,4,3,4,11,Loyal Users
24615,2289,6,9,1,1,1,3,Lost
24762,424,15,28,3,3,2,8,Loyal Users
25100,834,35,70,2,4,4,10,At Risk
25653,293,7,17,3,2,2,7,Casual Users
25976,6,29,55,5,4,3,12,Loyal Users
26329,155,45,135,4,4,4,12,Champions
26418,348,9,10,3,2,1,6,Casual Users
13669,1495,26,137,1,4,4,9,At Risk
13742,836,8,8,2,2,1,5,Lost
13861,147,18,48,4,3,3,10,Loyal Users
14022,75,45,217,4,4,5,13,Champions
14179,5,54,121,5,5,4,14,Champions
14200,449,17,82,3,3,4,10,Loyal Users
14235,165,6,6,4,1,1,6,Promising
14463,42,59,91,5,5,4,14,Champions
14576,1122,14,37,2,3,3,8,Casual Users
14893,3378,8,13,1,2,1,4,Lost
14985,3270,10,17,1,2,2,5,Lost
14992,487,74,319,2,5,5,12,At Risk
15522,5241,5,11,1,1,1,3,Lost
16380,603,13,17,2,3,2,7,Casual Users
16581,90,10,26,4,2,2,8,Promising
16873,853,14,15,2,3,1,6,Casual Users
17272,22,15,86,5,3,4,12,Loyal Users
17454,18,7,9,5,2,1,8,Promising
17569,965,17,123,2,3,4,9,Casual Users
17676,1924,7,12,1,2,1,4,Lost
17707,419,44,64,3,4,4,11,Loyal Users
17846,431,31,102,3,4,4,11,Loyal Users
17919,54,114,409,5,5,5,15,Champions
17954,234,5,9,3,1,1,5,Casual Users
18114,879,16,28,2,3,2,7,Casual Users
18251,1279,5,32,1,1,3,5,Lost
18661,86,38,174,4,4,5,13,Champions
18671,1456,13,16,1,3,2,6,Casual Users
19004,315,89,218,3,5,5,13,Loyal Users
19170,3191,9,38,1,2,3,6,Lost
19298,296,21,49,3,3,3,9,Loyal Users
19419,126,108,1197,4,5,5,14,Champions
19484,477,37,159,2,4,5,11,At Risk
19892,2385,16,29,1,3,2,6,Casual Users
19993,398,18,23,3,3,2,8,Loyal Users
20065,128,7,10,4,2,1,7,Promising
20245,164,5,7,4,1,1,6,Promising
20833,434,12,113,3,3,4,10,Loyal Users
21013,350,9,28,3,2,2,7,Casual Users
21055,447,5,5,3,1,1,5,Casual Users
21067,2410,27,55,1,4,3,8,At Risk
21494,572,14,35,2,3,3,8,Casual Users
22172,91,6,10,4,1,1,6,Promising
22398,38,20,65,5,3,4,12,Loyal Users
22425,173,54,486,3,5,5,13,Loyal Users
22446,16,46,195,5,5,5,15,Champions
22545,1563,8,25,1,2,2,5,Lost
22547,2304,9,51,1,2,3,6,Lost
22682,9,233,677,5,5,5,15,Champions
23827,801,5,42,2,1,3,6,Lost
23857,533,36,42,2,4,3,9,At Risk
24036,1979,70,170,1,5,5,11,At Risk
24044,102,73,345,4,5,5,14,Champions
24134,29,93,240,5,5,5,15,Champions
24539,2982,6,7,1,1,1,3,Lost
24565,109,39,51,4,4,3,11,Loyal Users
25188,243,51,166,3,5,5,13,Loyal Users
25273,443,21,39,3,3,3,9,Loyal Users
25450,360,24,115,3,4,4,11,Loyal Users
25474,1592,5,26,1,1,2,4,Lost
25705,8,45,179,5,4,5,14,Champions
26123,695,41,66,2,4,4,10,At Risk
26239,940,19,89,2,3,4,9,Casual Users
14232,51,29,60,5,4,3,12,Loyal Users
14285,376,12,46,3,3,3,9,Loyal Users
14537,568,5,5,2,1,1,4,Lost
14883,332,51,173,3,5,5,13,Loyal Users
14926,22,47,112,5,5,4,14,Champions
15139,456,15,29,3,3,2,8,Loyal Users
15568,120,47,240,4,5,5,14,Champions
15787,1539,13,23,1,3,2,6,Casual Users
15874,3998,18,27,1,3,2,6,Casual Users
16021,2611,6,7,1,1,1,3,Lost
16186,885,21,75,2,3,4,9,Casual Users
16658,1530,9,46,1,2,3,6,Lost
16865,92,63,109,4,5,4,13,Champions
16867,4077,12,16,1,3,2,6,Casual Users
16980,443,5,11,3,1,1,5,Casual Users
17159,1538,8,18,1,2,2,5,Lost
18122,4423,7,10,1,2,1,4,Lost
18236,515,49,91,2,5,4,11,At Risk
18262,886,19,83,2,3,4,9,Casual Users
18325,156,41,257,4,4,5,13,Champions
18520,234,33,44,3,4,3,10,Loyal Users
18566,2929,7,38,1,2,3,6,Lost
18980,214,36,48,3,4,3,10,Loyal Users
19025,633,7,8,2,2,1,5,Lost
19294,2705,8,32,1,2,3,6,Lost
19373,450,22,29,3,4,2,9,Loyal Users
19387,198,11,26,3,2,2,7,Casual Users
19650,4309,7,25,1,2,2,5,Lost
20173,13,33,127,5,4,4,13,Champions
20187,3420,7,21,1,2,2,5,Lost
20208,222,48,223,3,5,5,13,Loyal Users
20253,111,43,155,4,4,5,13,Champions
20657,7,88,347,5,5,5,15,Champions
20860,116,24,53,4,4,3,11,Loyal Users
20958,427,21,31,3,3,2,8,Loyal Users
21321,415,20,72,3,3,4,10,Loyal Users
21427,762,38,101,2,4,4,10,At Risk
21447,3,127,315,5,5,5,15,Champions
21460,1134,11,23,2,2,2,6,Lost
21634,702,9,71,2,2,4,8,Lost
21720,60,54,160,5,5,5,15,Champions
21957,573,5,22,2,1,2,5,Lost
22276,267,7,33,3,2,3,8,Casual Users
22816,515,8,28,2,2,2,6,Lost
22875,70,6,57,4,1,3,8,Promising
23036,259,31,120,3,4,4,11,Loyal Users
23101,2430,5,10,1,1,1,3,Lost
23216,628,11,21,2,2,2,6,Lost
24250,426,16,22,3,3,2,8,Loyal Users
24795,307,30,46,3,4,3,10,Loyal Users
24963,29,23,67,5,4,4,13,Champions
24975,177,86,396,3,5,5,13,Loyal Users
25244,234,7,21,3,2,2,7,Casual Users
25441,3005,6,26,1,1,2,4,Lost
25544,1380,22,33,1,4,3,8,At Risk
25586,118,38,77,4,4,4,12,Champions
25615,1688,6,84,1,1,4,6,Lost
26078,11,52,120,5,5,4,14,Champions
26368,6,153,243,5,5,5,15,Champions
13660,2615,7,36,1,2,3,6,Lost
13837,233,31,84,3,4,4,11,Loyal Users
14263,2,24,103,5,4,4,13,Champions
14316,154,127,198,4,5,5,14,Champions
14372,276,17,67,3,3,4,10,Loyal Users
14379,838,5,9,2,1,1,4,Lost
14467,415,24,48,3,4,3,10,Loyal Users
14688,748,6,12,2,1,1,4,Lost
15226,15,45,118,5,4,4,13,Champions
15235,350,8,11,3,2,1,6,Casual Users
15589,123,23,49,4,4,3,11,Loyal Users
16068,47,127,240,5,5,5,15,Champions
16177,0,63,119,5,5,4,14,Champions
16790,1531,11,155,1,2,5,8,Lost
16823,2946,18,60,1,3,3,7,Casual Users
17079,96,12,21,4,3,2,9,Loyal Users
17169,128,81,310,4,5,5,14,Champions
17315,1484,6,6,1,1,1,3,Lost
17468,224,12,35,3,3,3,9,Loyal Users
17621,13,18,24,5,3,2,10,Loyal Users
17902,1408,14,28,1,3,2,6,Casual Users
18155,67,120,534,5,5,5,15,Champions
18232,188,102,211,3,5,5,13,Loyal Users
18465,79,9,37,4,2,3,9,Promising
18635,401,12,21,3,3,2,8,Loyal Users
18681,85,24,195,4,4,5,13,Champions
18871,139,22,52,4,4,3,11,Loyal Users
18943,304,23,71,3,4,4,11,Loyal Users
19129,135,10,21,4,2,2,8,Promising
19609,703,32,45,2,4,3,9,At Risk
20068,443,16,17,3,3,2,8,Loyal Users
20350,595,13,23,2,3,2,7,Casual Users
20404,3826,35,60,1,4,3,8,At Risk
20626,112,41,151,4,4,5,13,Champions
21419,3796,11,12,1,2,1,4,Lost
21514,270,9,13,3,2,1,6,Casual Users
22126,163,40,114,4,4,4,12,Champions
22339,4689,6,7,1,1,1,3,Lost
22365,135,66,150,4,5,5,14,Champions
22676,67,130,317,5,5,5,15,Champions
22687,963,5,7,2,1,1,4,Lost
22803,2252,5,21,1,1,2,4,Lost
22848,569,11,34,2,2,3,7,Lost
22858,91,8,20,4,2,2,8,Promising
22974,1630,6,9,1,1,1,3,Lost
23194,69,82,417,5,5,5,15,Champions
23327,3403,7,16,1,2,2,5,Lost
23673,1952,10,11,1,2,1,4,Lost
23840,389,53,116,3,5,4,12,Loyal Users
23941,1443,34,147,1,4,5,10,At Risk
24126,4667,8,9,1,2,1,4,Lost
24131,1959,5,7,1,1,1,3,Lost
24313,7,123,414,5,5,5,15,Champions
24344,3765,7,11,1,2,1,4,Lost
24360,69,40,109,5,4,4,13,Champions
24406,1462,36,298,1,4,5,10,At Risk
24530,460,24,30,3,4,2,9,Loyal Users
24954,10,50,58,5,5,3,13,Loyal Users
25052,122,17,73,4,3,4,11,Loyal Users
25289,24,65,172,5,5,5,15,Champions
25365,2126,12,66,1,3,4,8,Casual Users
25936,2938,7,13,1,2,1,4,Lost
26113,1691,28,55,1,4,3,8,At Risk
26206,7,115,375,5,5,5,15,Champions
26365,107,29,42,4,4,3,11,Loyal Users
14435,213,62,124,3,5,4,12,Loyal Users
14517,240,73,161,3,5,5,13,Loyal Users
14621,23,36,78,5,4,4,13,Champions
14698,9,125,460,5,5,5,15,Champions
15123,122,14,129,4,3,4,11,Loyal Users
15286,28,11,50,5,2,3,10,Promising
15316,34,45,268,5,4,5,14,Champions
15858,82,118,456,4,5,5,14,Champions
15864,1,37,103,5,4,4,13,Champions
15866,24,28,46,5,4,3,12,Loyal Users
15869,428,20,198,3,3,5,11,Loyal Users
15978,713,14,54,2,3,3,8,Casual Users
16324,1428,8,34,1,2,3,6,Lost
16772,1624,8,10,1,2,1,4,Lost
16837,84,86,204,4,5,5,14,Champions
16872,599,6,13,2,1,1,4,Lost
17275,145,26,45,4,4,3,11,Loyal Users
17439,1869,6,14,1,1,1,3,Lost
17532,30,9,26,5,2,2,9,Promising
17662,991,5,5,2,1,1,4,Lost
18357,104,70,91,4,5,4,13,Champions
18411,18,32,76,5,4,4,13,Champions
18629,222,18,27,3,3,2,8,Loyal Users
18639,531,55,213,2,5,5,12,At Risk
18692,26,96,259,5,5,5,15,Champions
18788,36,31,288,5,4,5,14,Champions
19110,52,42,152,5,4,5,14,Champions
19278,460,6,7,3,1,1,5,Casual Users
19287,154,16,66,4,3,4,11,Loyal Users
19870,31,82,161,5,5,5,15,Champions
20638,3107,5,44,1,1,3,5,Lost
20857,124,61,135,4,5,4,13,Champions
20916,407,119,302,3,5,5,13,Loyal Users
20950,492,17,53,2,3,3,8,Casual Users
20959,534,12,174,2,3,5,10,Casual Users
21215,2478,11,17,1,2,2,5,Lost
21541,111,54,112,4,5,4,13,Champions
21780,874,8,13,2,2,1,5,Lost
21848,147,38,155,4,4,5,13,Champions
21976,435,9,19,3,2,2,7,Casual Users
21998,47,115,262,5,5,5,15,Champions
22250,5020,25,50,1,4,3,8,At Risk
22516,4428,7,18,1,2,2,5,Lost
22662,145,13,23,4,3,2,9,Loyal Users
22889,4,140,502,5,5,5,15,Champions
23164,672,9,52,2,2,3,7,Lost
23516,3189,6,18,1,1,2,4,Lost
23615,96,45,112,4,4,4,12,Champions
23742,39,55,136,5,5,4,14,Champions
23920,264,11,26,3,2,2,7,Casual Users
24076,437,32,49,3,4,3,10,Loyal Users
24215,435,7,12,3,2,1,6,Casual Users
24317,2115,5,11,1,1,1,3,Lost
24322,421,31,47,3,4,3,10,Loyal Users
25307,268,15,30,3,3,2,8,Loyal Users
25486,572,7,49,2,2,3,7,Lost
25709,440,6,7,3,1,1,5,Casual Users
25747,274,61,239,3,5,5,13,Loyal Users
25756,234,52,132,3,5,4,12,Loyal Users
25876,297,7,26,3,2,2,7,Casual Users
26462,1548,5,13,1,1,1,3,Lost
13785,296,28,86,3,4,4,11,Loyal Users
13818,110,187,417,4,5,5,14,Champions
13867,87,13,36,4,3,3,10,Loyal Users
13985,1398,15,32,1,3,3,7,Casual Users
14250,1304,5,6,1,1,1,3,Lost
14357,112,17,44,4,3,3,10,Loyal Users
14884,76,99,140,4,5,4,13,Champions
15137,56,22,59,5,4,3,12,Loyal Users
15246,669,15,25,2,3,2,7,Casual Users
15256,324,13,24,3,3,2,8,Loyal Users
15271,552,34,71,2,4,4,10,At Risk
15578,1264,56,88,1,5,4,10,At Risk
16139,4072,7,34,1,2,3,6,Lost
16349,304,5,9,3,1,1,5,Casual Users
16598,394,8,21,3,2,2,7,Casual Users
17269,0,65,217,5,5,5,15,Champions
17568,62,62,85,5,5,4,14,Champions
17645,91,20,30,4,3,2,9,Loyal Users
17671,238,98,510,3,5,5,13,Loyal Users
17876,3995,8,14,1,2,1,4,Lost
18749,129,64,110,4,5,4,13,Champions
18801,53,37,55,5,4,3,12,Loyal Users
18993,68,56,499,5,5,5,15,Champions
19053,1368,8,16,1,2,2,5,Lost
19108,277,42,214,3,4,5,12,Loyal Users
19179,15,23,86,5,4,4,13,Champions
19366,58,111,247,5,5,5,15,Champions
19411,138,17,60,4,3,3,10,Loyal Users
19581,3111,5,15,1,1,1,3,Lost
19728,101,54,189,4,5,5,14,Champions
19742,602,6,25,2,1,2,5,Lost
19824,998,6,9,2,1,1,4,Lost
19932,378,24,35,3,4,3,10,Loyal Users
20252,79,9,14,4,2,1,7,Promising
20293,527,28,168,2,4,5,11,At Risk
20659,4124,22,62,1,4,3,8,At Risk
20927,0,205,420,5,5,5,15,Champions
21125,851,14,18,2,3,2,7,Casual Users
21457,3486,9,40,1,2,3,6,Lost
21867,286,70,263,3,5,5,13,Loyal Users
22497,1966,7,17,1,2,2,5,Lost
22562,479,65,309,2,5,5,12,At Risk
22705,1149,19,59,2,3,3,8,Casual Users
22706,3637,5,11,1,1,1,3,Lost
22730,362,5,31,3,1,2,6,Casual Users
22762,95,12,30,4,3,2,9,Loyal Users
22947,11,61,215,5,5,5,15,Champions
22961,415,6,23,3,1,2,6,Casual Users
23005,144,13,36,4,3,3,10,Loyal Users
23233,396,13,15,3,3,1,7,Loyal Users
23624,419,6,6,3,1,1,5,Casual Users
23991,1533,12,38,1,3,3,7,Casual Users
24236,1365,17,22,1,3,2,6,Casual Users
24243,1,15,20,5,3,2,10,Loyal Users
25101,1291,5,6,1,1,1,3,Lost
25135,295,8,22,3,2,2,7,Casual Users
25257,430,9,15,3,2,1,6,Casual Users
25595,3580,6,8,1,1,1,3,Lost
25854,403,11,21,3,2,2,7,Casual Users
26246,625,5,6,2,1,1,4,Lost
26456,1542,5,12,1,1,1,3,Lost
13595,3261,6,7,1,1,1,3,Lost
13617,3820,5,22,1,1,2,4,Lost
13981,670,20,112,2,3,4,9,Casual Users
14073,1446,9,35,1,2,3,6,Lost
14902,883,34,88,2,4,4,10,At Risk
15349,27,12,25,5,3,2,10,Loyal Users
15424,435,25,77,3,4,4,11,Loyal Users
15436,1251,10,19,2,2,2,6,Lost
15555,118,109,177,4,5,5,14,Champions
15826,884,25,83,2,4,4,10,At Risk
15917,118,11,25,4,2,2,8,Promising
16023,411,28,74,3,4,4,11,Loyal Users
16162,2191,8,16,1,2,2,5,Lost
16188,288,19,34,3,3,3,9,Loyal Users
16280,1410,12,56,1,3,3,7,Casual Users
16433,35,156,446,5,5,5,15,Champions
16504,839,58,316,2,5,5,12,At Risk
16641,19,6,10,5,1,1,7,Promising
16804,285,6,15,3,1,1,5,Casual Users
16941,2920,13,30,1,3,2,6,Casual Users
17260,683,16,54,2,3,3,8,Casual Users
17375,1569,5,6,1,1,1,3,Lost
17646,23,77,409,5,5,5,15,Champions
18294,846,35,63,2,4,4,10,At Risk
18360,117,17,30,4,3,2,9,Loyal Users
18783,689,5,11,2,1,1,4,Lost
18824,116,49,80,4,5,4,13,Champions
19087,40,25,257,5,4,5,14,Champions
19254,387,18,22,3,3,2,8,Loyal Users
19704,262,7,13,3,2,1,6,Casual Users
19743,9,23,30,5,4,2,11,Loyal Users
19818,10,62,179,5,5,5,15,Champions
20133,1812,17,64,1,3,4,8,Casual Users
20563,405,15,63,3,3,4,10,Loyal Users
20592,312,13,70,3,3,4,10,Loyal Users
20825,173,9,28,3,2,2,7,Casual Users
20978,171,17,124,3,3,4,10,Loyal Users
21017,3888,25,39,1,4,3,8,At Risk
21063,77,59,419,4,5,5,14,Champions
21336,123,53,211,4,5,5,14,Champions
21416,4663,10,10,1,2,1,4,Lost
21678,3348,5,13,1,1,1,3,Lost
21690,115,41,116,4,4,4,12,Champions
21779,146,14,25,4,3,2,9,Loyal Users
22334,30,123,472,5,5,5,15,Champions
22650,54,57,124,5,5,4,14,Champions
22721,714,6,10,2,1,1,4,Lost
23342,111,9,141,4,2,4,10,Promising
23480,133,91,160,4,5,5,14,Champions
23521,696,33,158,2,4,5,11,At Risk
23572,123,72,124,4,5,4,13,Champions
23828,115,31,74,4,4,4,12,Champions
24696,3834,13,13,1,3,1,5,Casual Users
24772,6,15,27,5,3,2,10,Loyal Users
25248,2808,5,15,1,1,1,3,Lost
25435,399,6,15,3,1,1,5,Casual Users
25592,447,8,26,3,2,2,7,Casual Users
25642,105,25,78,4,4,4,12,Champions
25992,671,11,20,2,2,2,6,Lost
26047,1256,22,53,2,4,3,9,At Risk
26351,420,13,34,3,3,3,9,Loyal Users
26382,109,25,64,4,4,4,12,Champions
13699,20,113,464,5,5,5,15,Champions
13935,73,5,22,4,1,2,7,Promising
14000,0,50,75,5,5,4,14,Champions
14024,67,12,24,5,3,2,10,Loyal Users
14319,669,6,43,2,1,3,6,Lost
14320,173,10,20,3,2,2,7,Casual Users
14511,886,28,126,2,4,4,10,At Risk
14762,3461,7,9,1,2,1,4,Lost
14911,115,202,486,4,5,5,14,Champions
15328,18,5,12,5,1,1,7,Promising
15472,3236,36,70,1,4,4,9,At Risk
15539,370,15,52,3,3,3,9,Loyal Users
15748,2,22,85,5,4,4,13,Champions
15791,743,13,34,2,3,3,8,Casual Users
16093,200,18,65,3,3,4,10,Loyal Users
16169,75,27,252,4,4,5,13,Champions
16361,3,120,179,5,5,5,15,Champions
16570,254,66,130,3,5,4,12,Loyal Users
16713,2498,5,13,1,1,1,3,Lost
16964,992,12,16,2,3,2,7,Casual Users
16987,460,40,118,3,4,4,11,Loyal Users
17105,482,14,71,2,3,4,9,Casual Users
17226,0,75,235,5,5,5,15,Champions
17250,111,137,331,4,5,5,14,Champions
17733,111,85,522,4,5,5,14,Champions
17791,9,37,52,5,4,3,12,Loyal Users
17957,91,32,140,4,4,4,12,Champions
17963,3295,64,143,1,5,4,10,At Risk
18033,824,15,54,2,3,3,8,Casual Users
18073,23,130,319,5,5,5,15,Champions
18110,741,34,65,2,4,4,10,At Risk
18207,374,36,66,3,4,4,11,Loyal Users
18452,614,73,183,2,5,5,12,At Risk
18456,2711,6,10,1,1,1,3,Lost
18488,443,34,54,3,4,3,10,Loyal Users
18528,124,17,38,4,3,3,10,Loyal Users
18556,295,74,346,3,5,5,13,Loyal Users
18935,2288,14,21,1,3,2,6,Casual Users
18992,146,47,134,4,5,4,13,Champions
19239,2566,13,52,1,3,3,7,Casual Users
19372,178,9,36,3,2,3,8,Casual Users
19749,266,14,35,3,3,3,9,Loyal Users
20049,223,43,229,3,4,5,12,Loyal Users
20514,1936,43,191,1,4,5,10,At Risk
20750,474,54,255,2,5,5,12,At Risk
20809,106,14,130,4,3,4,11,Loyal Users
20865,41,18,27,5,3,2,10,Loyal Users
20949,136,57,169,4,5,5,14,Champions
20979,2466,28,159,1,4,5,10,At Risk
21426,664,50,84,2,5,4,11,At Risk
21628,151,7,24,4,2,2,8,Promising
22036,1048,6,20,2,1,2,5,Lost
22092,81,127,376,4,5,5,14,Champions
22299,69,15,37,5,3,3,11,Loyal Users
22336,251,45,81,3,4,4,11,Loyal Users
22343,109,80,141,4,5,4,13,Champions
22413,1012,7,14,2,2,1,5,Lost
22509,2876,5,7,1,1,1,3,Lost
22524,5250,14,14,1,3,1,5,Casual Users
22585,66,116,335,5,5,5,15,Champions
22598,663,18,60,2,3,3,8,Casual Users
22649,1859,12,45,1,3,3,7,Casual Users
23040,166,52,192,3,5,5,13,Loyal Users
23068,4023,6,8,1,1,1,3,Lost
23350,514,14,23,2,3,2,7,Casual Users
23660,1835,10,12,1,2,1,4,Lost
24064,1,6,6,5,1,1,7,Promising
24105,3525,6,17,1,1,2,4,Lost
24367,5,9,21,5,2,2,9,Promising
24849,137,46,130,4,5,4,13,Champions
24966,113,18,44,4,3,3,10,Loyal Users
25019,580,25,82,2,4,4,10,At Risk
25252,8,57,311,5,5,5,15,Champions
25394,383,7,25,3,2,2,7,Casual Users
25536,668,30,79,2,4,4,10,At Risk
25998,297,36,267,3,4,5,12,Loyal Users
26009,49,89,166,5,5,5,15,Champions
26043,419,9,24,3,2,2,7,Casual Users
26220,11,46,66,5,5,4,14,Champions
26255,221,13,65,3,3,4,10,Loyal Users
13808,939,8,95,2,2,4,8,Lost
13823,413,9,33,3,2,3,8,Casual Users
14053,452,7,21,3,2,2,7,Casual Users
14162,83,47,202,4,5,5,14,Champions
14258,1269,8,23,1,2,2,5,Lost
14691,1288,16,84,1,3,4,8,Casual Users
14738,417,14,44,3,3,3,9,Loyal Users
15198,502,12,59,2,3,3,8,Casual Users
15690,353,46,152,3,5,5,13,Loyal Users
15900,108,5,48,4,1,3,8,Promising
16320,112,9,55,4,2,3,9,Promising
16354,2,97,282,5,5,5,15,Champions
16521,248,55,284,3,5,5,13,Loyal Users
16559,679,14,18,2,3,2,7,Casual Users
16763,14,107,452,5,5,5,15,Champions
17118,2,154,659,5,5,5,15,Champions
17163,2466,34,45,1,4,3,8,At Risk
17208,124,71,486,4,5,5,14,Champions
17329,144,27,175,4,4,5,13,Champions
17367,69,8,8,5,2,1,8,Promising
17748,122,82,305,4,5,5,14,Champions
18182,4975,6,21,1,1,2,4,Lost
18318,9,56,285,5,5,5,15,Champions
18893,588,6,6,2,1,1,4,Lost
19408,1,134,382,5,5,5,15,Champions
19454,425,7,19,3,2,2,7,Casual Users
19580,3044,5,21,1,1,2,4,Lost
19649,1565,5,6,1,1,1,3,Lost
19717,416,6,15,3,1,1,5,Casual Users
19871,253,23,58,3,4,3,10,Loyal Users
20285,55,98,298,5,5,5,15,Champions
20295,15,49,208,5,5,5,15,Champions
20546,2112,7,23,1,2,2,5,Lost
20608,32,57,217,5,5,5,15,Champions
20778,329,34,47,3,4,3,10,Loyal Users
20909,398,87,208,3,5,5,13,Loyal Users
21236,539,6,15,2,1,1,4,Lost
21263,598,21,33,2,3,3,8,Casual Users
21568,4410,6,19,1,1,2,4,Lost
21664,53,18,37,5,3,3,11,Loyal Users
22175,1168,12,20,2,3,2,7,Casual Users
22357,510,6,8,2,1,1,4,Lost
22369,153,41,102,4,4,4,12,Champions
22635,1690,20,53,1,3,3,7,Casual Users
23044,116,30,98,4,4,4,12,Champions
23184,1423,5,6,1,1,1,3,Lost
23256,95,30,41,4,4,3,11,Loyal Users
23520,736,7,36,2,2,3,7,Lost
23587,117,43,179,4,4,5,13,Champions
23824,135,12,18,4,3,2,9,Loyal Users
24501,68,190,436,5,5,5,15,Champions
24812,303,103,328,3,5,5,13,Loyal Users
25008,3564,7,33,1,2,3,6,Lost
25042,1576,13,64,1,3,4,8,Casual Users
25187,266,99,392,3,5,5,13,Loyal Users
25245,518,14,87,2,3,4,9,Casual Users
25418,132,11,25,4,2,2,8,Promising
25783,38,196,666,5,5,5,15,Champions
26101,4424,10,20,1,2,2,5,Lost
26215,331,22,88,3,4,4,11,Loyal Users
26326,942,8,11,2,2,1,5,Lost
26336,21,67,245,5,5,5,15,Champions
26435,155,15,73,4,3,4,11,Loyal Users
13773,889,5,7,2,1,1,4,Lost
13990,352,10,15,3,2,1,6,Casual Users
14167,279,16,49,3,3,3,9,Loyal Users
14456,792,6,18,2,1,2,5,Lost
14529,254,32,79,3,4,4,11,Loyal Users
14749,830,6,17,2,1,2,5,Lost
14789,33,48,150,5,5,5,15,Champions
15147,17,42,160,5,4,5,14,Champions
15205,2847,7,9,1,2,1,4,Lost
15272,100,6,17,4,1,2,7,Promising
15456,1568,9,12,1,2,1,4,Lost
15564,2207,8,30,1,2,2,5,Lost
15643,1400,7,25,1,2,2,5,Lost
15875,1123,8,14,2,2,1,5,Lost
15921,245,24,50,3,4,3,10,Loyal Users
16121,128,10,42,4,2,3,9,Promising
16630,159,18,32,4,3,3,10,Loyal Users
16718,292,29,95,3,4,4,11,Loyal Users
16845,102,16,98,4,3,4,11,Loyal Users
16950,2037,7,53,1,2,3,6,Lost
17117,270,5,38,3,1,3,7,Casual Users
17284,4661,9,11,1,2,1,4,Lost
17355,1697,10,14,1,2,1,4,Lost
17761,13,16,45,5,3,3,11,Loyal Users
17951,468,6,21,3,1,2,6,Casual Users
18158,730,21,55,2,3,3,8,Casual Users
18172,2492,5,8,1,1,1,3,Lost
18239,2226,7,12,1,2,1,4,Lost
18335,705,9,13,2,2,1,5,Lost
18345,144,10,11,4,2,1,7,Promising
18581,704,11,47,2,2,3,7,Lost
18641,139,17,33,4,3,3,10,Loyal Users
18690,2025,15,42,1,3,3,7,Casual Users
18856,6,20,35,5,3,3,11,Loyal Users
19040,457,24,129,3,4,4,11,Loyal Users
19185,126,5,18,4,1,2,7,Promising
19356,5,85,188,5,5,5,15,Champions
19380,127,9,20,4,2,2,8,Promising
20002,1560,16,22,1,3,2,6,Casual Users
20324,652,5,9,2,1,1,4,Lost
20416,92,15,37,4,3,3,10,Loyal Users
20457,309,62,163,3,5,5,13,Loyal Users
20524,10,186,399,5,5,5,15,Champions
20549,4329,8,12,1,2,1,4,Lost
20661,59,63,217,5,5,5,15,Champions
20963,116,5,11,4,1,1,6,Promising
21115,71,53,172,4,5,5,14,Champions
21192,107,16,45,4,3,3,10,Loyal Users
21323,379,38,243,3,4,5,12,Loyal Users
21668,14,129,285,5,5,5,15,Champions
21681,383,6,44,3,1,3,7,Casual Users
21713,4084,9,14,1,2,1,4,Lost
22109,1380,46,75,1,5,4,10,At Risk
22201,588,8,54,2,2,3,7,Lost
22614,421,14,66,3,3,4,10,Loyal Users
23058,55,120,206,5,5,5,15,Champions
23102,1279,6,33,1,1,3,5,Lost
23921,1364,7,8,1,2,1,4,Lost
24101,602,17,33,2,3,3,8,Casual Users
24245,94,37,64,4,4,4,12,Champions
24251,63,208,550,5,5,5,15,Champions
24370,566,22,68,2,4,4,10,At Risk
24435,424,14,53,3,3,3,9,Loyal Users
24465,298,19,46,3,3,3,9,Loyal Users
24987,159,25,60,4,4,3,11,Loyal Users
25011,413,14,49,3,3,3,9,Loyal Users
25067,1120,9,29,2,2,2,6,Lost
25692,443,54,148,3,5,5,13,Loyal Users
25942,1537,6,15,1,1,1,3,Lost
26012,9,40,319,5,4,5,14,Champions
26020,1342,5,14,1,1,1,3,Lost
26118,132,8,26,4,2,2,8,Promising
13970,17,59,116,5,5,4,14,Champions
14090,134,8,39,4,2,3,9,Promising
14380,588,11,18,2,2,2,6,Lost
14759,98,5,9,4,1,1,6,Promising
14797,354,53,141,3,5,4,12,Loyal Users
15279,876,10,33,2,2,3,7,Lost
15596,129,6,10,4,1,1,6,Promising
15836,165,6,42,4,1,3,8,Promising
16478,286,6,10,3,1,1,5,Casual Users
16619,1412,7,60,1,2,3,6,Lost
16963,488,6,24,2,1,2,5,Lost
17072,114,118,298,4,5,5,14,Champions
17642,125,53,128,4,5,4,13,Champions
17689,384,43,75,3,4,4,11,Loyal Users
18031,1578,8,13,1,2,1,4,Lost
18354,1325,47,92,1,5,4,10,At Risk
18504,596,45,208,2,4,5,11,At Risk
18591,2240,17,98,1,3,4,8,Casual Users
18640,75,31,131,4,4,4,12,Champions
18870,121,43,119,4,4,4,12,Champions
18953,1196,9,11,2,2,1,5,Lost
19281,199,76,331,3,5,5,13,Loyal Users
19321,35,9,29,5,2,2,9,Promising
19431,1281,5,29,1,1,2,4,Lost
19535,123,122,424,4,5,5,14,Champions
19576,92,19,26,4,3,2,9,Loyal Users
19585,2994,5,13,1,1,1,3,Lost
19663,1,60,105,5,5,4,14,Champions
20061,112,37,70,4,4,4,12,Champions
20130,1691,6,42,1,1,3,5,Lost
20703,4,45,91,5,4,4,13,Champions
20795,436,31,104,3,4,4,11,Loyal Users
20888,148,18,69,4,3,4,11,Loyal Users
21043,424,85,361,3,5,5,13,Loyal Users
21441,107,23,149,4,4,5,13,Champions
21492,2171,10,39,1,2,3,6,Lost
21745,520,9,34,2,2,3,7,Lost
21778,97,12,15,4,3,1,8,Loyal Users
22137,4814,5,10,1,1,1,3,Lost
22333,982,10,22,2,2,2,6,Lost
22493,2143,6,6,1,1,1,3,Lost
22533,723,6,30,2,1,2,5,Lost
22738,834,5,29,2,1,2,5,Lost
23481,276,14,21,3,3,2,8,Loyal Users
24083,6,36,83,5,4,4,13,Champions
24411,170,12,71,3,3,4,10,Loyal Users
24707,283,43,212,3,4,5,12,Loyal Users
24912,335,14,17,3,3,2,8,Loyal Users
24934,874,25,60,2,4,3,9,At Risk
25062,152,8,18,4,2,2,8,Promising
25109,1214,12,19,2,3,2,7,Casual Users
25572,239,7,69,3,2,4,9,Casual Users
25801,7,5,9,5,1,1,7,Promising
25921,90,40,58,4,4,3,11,Loyal Users
25967,508,60,98,2,5,4,11,At Risk
26018,17,85,210,5,5,5,15,Champions
26056,147,106,362,4,5,5,14,Champions
26278,3549,18,52,1,3,3,7,Casual Users
13603,1421,9,13,1,2,1,4,Lost
13771,44,8,28,5,2,2,9,Promising
13973,30,55,134,5,5,4,14,Champions
14481,11,39,244,5,4,5,14,Champions
14674,426,22,105,3,4,4,11,Loyal Users
14819,1017,7,7,2,2,1,5,Lost
15180,667,20,61,2,3,3,8,Casual Users
15763,1804,5,8,1,1,1,3,Lost
15803,29,6,72,5,1,4,10,Promising
15899,437,22,83,3,4,4,11,Loyal Users
15943,27,37,64,5,4,4,13,Champions
16026,30,16,141,5,3,4,12,Loyal Users
16111,10,28,61,5,4,3,12,Loyal Users
16213,146,78,516,4,5,5,14,Champions
16689,154,7,12,4,2,1,7,Promising
16797,1690,15,17,1,3,2,6,Casual Users
17317,6,38,189,5,4,5,14,Champions
17582,749,10,12,2,2,1,5,Lost
17631,4516,5,5,1,1,1,3,Lost
17673,69,15,100,5,3,4,12,Loyal Users
17818,236,131,706,3,5,5,13,Loyal Users
18159,2115,22,81,1,4,4,9,At Risk
18206,434,64,104,3,5,4,12,Loyal Users
18275,293,7,8,3,2,1,6,Casual Users
18413,6,124,381,5,5,5,15,Champions
18449,4,35,66,5,4,4,13,Champions
18536,68,18,56,5,3,3,11,Loyal Users
19231,811,7,22,2,2,2,6,Lost
19558,119,26,116,4,4,4,12,Champions
20521,558,17,29,2,3,2,7,Casual Users
20629,726,29,155,2,4,5,11,At Risk
21167,3679,12,39,1,3,3,7,Casual Users
21208,1825,21,42,1,3,3,7,Casual Users
21318,2969,6,8,1,1,1,3,Lost
21495,1734,5,65,1,1,4,6,Lost
21506,132,20,45,4,3,3,10,Loyal Users
21830,571,42,55,2,4,3,9,At Risk
22168,250,12,30,3,3,2,8,Loyal Users
22321,11,19,49,5,3,3,11,Loyal Users
22747,1267,12,24,1,3,2,6,Casual Users
22821,90,15,33,4,3,3,10,Loyal Users
23054,7,31,73,5,4,4,13,Champions
23687,100,33,94,4,4,4,12,Champions
23958,92,65,157,4,5,5,14,Champions
24009,1269,12,25,1,3,2,6,Casual Users
24260,71,23,69,4,4,4,12,Champions
24541,786,47,174,2,5,5,12,At Risk
24843,97,8,15,4,2,1,7,Promising
24880,1135,6,18,2,1,2,5,Lost
25206,4082,7,8,1,2,1,4,Lost
25498,213,16,33,3,3,3,9,Loyal Users
26179,140,6,12,4,1,1,6,Promising
26314,2683,5,22,1,1,2,4,Lost
26389,152,81,286,4,5,5,14,Champions
13763,6144,27,27,1,4,2,7,At Risk
14729,359,11,41,3,2,3,8,Casual Users
15144,242,6,18,3,1,2,6,Casual Users
15148,442,26,105,3,4,4,11,Loyal Users
15255,422,11,56,3,2,3,8,Casual Users
15315,119,31,65,4,4,4,12,Champions
15395,286,20,26,3,3,2,8,Loyal Users
15427,102,40,65,4,4,4,12,Champions
15775,0,18,60,5,3,3,11,Loyal Users
15982,357,7,12,3,2,1,6,Casual Users
15990,29,16,22,5,3,2,10,Loyal Users
15998,2668,26,40,1,4,3,8,At Risk
16241,96,51,74,4,5,4,13,Champions
16488,152,11,31,4,2,2,8,Promising
16575,113,14,27,4,3,2,9,Loyal Users
16651,819,5,11,2,1,1,4,Lost
16946,273,22,70,3,4,4,11,Loyal Users
17459,106,13,32,4,3,3,10,Loyal Users
17854,569,7,27,2,2,2,6,Lost
17956,4763,7,9,1,2,1,4,Lost
17989,841,19,52,2,3,3,8,Casual Users
18363,1013,12,35,2,3,3,8,Casual Users
18772,809,6,10,2,1,1,4,Lost
18930,3391,11,13,1,2,1,4,Lost
19147,7,84,324,5,5,5,15,Champions
19163,691,63,262,2,5,5,12,At Risk
19340,1045,11,19,2,2,2,6,Lost
19698,103,121,640,4,5,5,14,Champions
19955,2,16,38,5,3,3,11,Loyal Users
20444,2,49,233,5,5,5,15,Champions
20492,940,21,31,2,3,2,7,Casual Users
20556,217,18,25,3,3,2,8,Loyal Users
20872,49,48,63,5,5,4,14,Champions
21096,160,10,11,4,2,1,7,Promising
21774,1141,10,16,2,2,2,6,Lost
21776,794,17,68,2,3,4,9,Casual Users
21932,5498,5,6,1,1,1,3,Lost
22194,12,9,25,5,2,2,9,Promising
22233,204,5,11,3,1,1,5,Casual Users
22482,873,14,35,2,3,3,8,Casual Users
22694,0,16,87,5,3,4,12,Loyal Users
22886,118,17,22,4,3,2,9,Loyal Users
22981,956,16,28,2,3,2,7,Casual Users
23143,240,7,57,3,2,3,8,Casual Users
23178,838,5,25,2,1,2,5,Lost
23489,256,6,20,3,1,2,6,Casual Users
23741,1,71,157,5,5,5,15,Champions
23750,2585,11,11,1,2,1,4,Lost
24262,676,11,24,2,2,2,6,Lost
24827,84,6,11,4,1,1,6,Promising
24981,1861,38,65,1,4,4,9,At Risk
25048,698,12,29,2,3,2,7,Casual Users
25124,44,20,75,5,3,4,12,Loyal Users
25137,45,19,112,5,3,4,12,Loyal Users
25361,892,8,13,2,2,1,5,Lost
25489,126,64,118,4,5,4,13,Champions
25674,182,8,23,3,2,2,7,Casual Users
25689,266,19,38,3,3,3,9,Loyal Users
25841,280,110,137,3,5,4,12,Loyal Users
25872,1438,6,13,1,1,1,3,Lost
26366,123,34,59,4,4,3,11,Loyal Users
26387,1005,10,11,2,2,1,5,Lost
14007,63,14,196,5,3,5,13,Loyal Users
14045,400,46,149,3,5,5,13,Loyal Users
14401,2663,5,6,1,1,1,3,Lost
15055,2638,28,140,1,4,4,9,At Risk
15225,1577,10,28,1,2,2,5,Lost
15318,435,6,52,3,1,3,7,Casual Users
15622,1696,5,20,1,1,2,4,Lost
15907,1578,13,54,1,3,3,7,Casual Users
16332,12,86,629,5,5,5,15,Champions
16463,214,99,267,3,5,5,13,Loyal Users
16815,219,7,37,3,2,3,8,Casual Users
16825,72,105,329,4,5,5,14,Champions
17136,515,12,40,2,3,3,8,Casual Users
17829,32,13,30,5,3,2,10,Loyal Users
17961,232,59,141,3,5,4,12,Loyal Users
17962,18,5,5,5,1,1,7,Promising
18065,119,46,147,4,5,5,14,Champions
18216,434,15,51,3,3,3,9,Loyal Users
18269,2083,11,22,1,2,2,5,Lost
18457,369,12,46,3,3,3,9,Loyal Users
18470,824,27,92,2,4,4,10,At Risk
18813,229,5,6,3,1,1,5,Casual Users
18926,184,12,30,3,3,2,8,Loyal Users
18934,5,34,50,5,4,3,12,Loyal Users
19167,2791,10,28,1,2,2,5,Lost
19405,290,34,95,3,4,4,11,Loyal Users
19710,571,11,18,2,2,2,6,Lost
19792,48,63,87,5,5,4,14,Champions
19804,12,11,11,5,2,1,8,Promising
19890,241,12,15,3,3,1,7,Loyal Users
19904,576,83,100,2,5,4,11,At Risk
19990,1705,8,14,1,2,1,4,Lost
20171,18,25,187,5,4,5,14,Champions
20389,117,16,63,4,3,4,11,Loyal Users
20512,121,121,270,4,5,5,14,Champions
20799,421,11,25,3,2,2,7,Casual Users
20848,49,49,78,5,5,4,14,Champions
21106,1424,12,43,1,3,3,7,Casual Users
21218,4569,5,24,1,1,2,4,Lost
21360,1438,7,7,1,2,1,4,Lost
21435,289,9,14,3,2,1,6,Casual Users
21837,590,7,21,2,2,2,6,Lost
22061,196,7,15,3,2,1,6,Casual Users
22121,153,7,10,4,2,1,7,Promising
22127,29,21,46,5,3,3,11,Loyal Users
22517,1,70,207,5,5,5,15,Champions
22750,1660,5,13,1,1,1,3,Lost
23064,114,109,311,4,5,5,14,Champions
23152,3926,5,5,1,1,1,3,Lost
23225,3098,5,12,1,1,1,3,Lost
23353,965,15,120,2,3,4,9,Casual Users
23379,935,32,243,2,4,5,11,At Risk
23778,203,16,33,3,3,3,9,Loyal Users
23781,138,5,5,4,1,1,6,Promising
24488,270,23,142,3,4,4,11,Loyal Users
24896,1342,10,31,1,2,2,5,Lost
25071,238,14,20,3,3,2,8,Loyal Users
25191,1,28,169,5,4,5,14,Champions
25371,0,80,164,5,5,5,15,Champions
25745,108,32,200,4,4,5,13,Champions
25753,1413,6,13,1,1,1,3,Lost
26073,437,29,33,3,4,3,10,Loyal Users
26294,3144,29,64,1,4,4,9,At Risk
26362,2010,9,18,1,2,2,5,Lost
26377,12,92,247,5,5,5,15,Champions
13938,3165,10,11,1,2,1,4,Lost
13964,2353,11,17,1,2,2,5,Lost
13972,74,61,210,4,5,5,14,Champions
14091,11,76,172,5,5,5,15,Champions
14161,479,11,56,2,2,3,7,Lost
14543,20,156,452,5,5,5,15,Champions
14965,451,7,14,3,2,1,6,Casual Users
15037,23,12,14,5,3,1,9,Loyal Users
15101,586,7,63,2,2,4,8,Lost
15502,280,17,72,3,3,4,10,Loyal Users
15955,466,6,11,3,1,1,5,Casual Users
16196,74,152,667,4,5,5,14,Champions
16417,131,85,201,4,5,5,14,Champions
16525,83,55,73,4,5,4,13,Champions
16582,11,11,23,5,2,2,9,Promising
16652,314,12,21,3,3,2,8,Loyal Users
16672,112,112,147,4,5,5,14,Champions
16851,2145,9,21,1,2,2,5,Lost
16977,7,61,271,5,5,5,15,Champions
17078,540,33,64,2,4,4,10,At Risk
17206,5336,29,29,1,4,2,7,At Risk
17380,510,15,47,2,3,3,8,Casual Users
17632,1013,11,23,2,2,2,6,Lost
17723,1092,11,56,2,2,3,7,Lost
17841,72,107,144,4,5,4,13,Champions
17849,981,7,24,2,2,2,6,Lost
18573,32,14,25,5,3,2,10,Loyal Users
18752,3,67,142,5,5,4,14,Champions
18970,83,6,6,4,1,1,6,Promising
18976,7,128,278,5,5,5,15,Champions
19034,939,19,23,2,3,2,7,Casual Users
19536,2447,7,12,1,2,1,4,Lost
19626,7,38,47,5,4,3,12,Loyal Users
19696,75,38,188,4,4,5,13,Champions
19767,92,8,23,4,2,2,8,Promising
19946,29,27,80,5,4,4,13,Champions
19961,5917,5,5,1,1,1,3,Lost
20017,289,10,26,3,2,2,7,Casual Users
20109,133,7,16,4,2,2,8,Promising
20282,180,11,25,3,2,2,7,Casual Users
20691,429,34,128,3,4,4,11,Loyal Users
20754,371,40,186,3,4,5,12,Loyal Users
20759,308,7,20,3,2,2,7,Casual Users
20943,127,9,23,4,2,2,8,Promising
21371,220,7,12,3,2,1,6,Casual Users
21547,270,20,29,3,3,2,8,Loyal Users
21811,730,5,18,2,1,2,5,Lost
22263,2146,31,142,1,4,4,9,At Risk
22285,105,83,537,4,5,5,14,Champions
22790,530,28,44,2,4,3,9,At Risk
23070,1665,6,8,1,1,1,3,Lost
23317,40,127,507,5,5,5,15,Champions
24217,201,13,44,3,3,3,9,Loyal Users
24544,251,10,28,3,2,2,7,Casual Users
24590,839,11,30,2,2,2,6,Lost
25089,39,86,259,5,5,5,15,Champions
25210,24,54,100,5,5,4,14,Champions
25468,4183,8,16,1,2,2,5,Lost
25587,14,135,279,5,5,5,15,Champions
26031,3325,93,111,1,5,4,10,At Risk
26261,536,11,11,2,2,1,5,Lost
13607,920,22,149,2,4,5,11,At Risk
13760,965,49,158,2,5,5,12,At Risk
13820,4141,6,28,1,1,2,4,Lost
13894,76,13,27,4,3,2,9,Loyal Users
14239,113,115,174,4,5,5,14,Champions
14393,2062,6,15,1,1,1,3,Lost
14742,267,96,146,3,5,4,12,Loyal Users
14865,127,20,53,4,3,3,10,Loyal Users
15104,3170,14,29,1,3,2,6,Casual Users
15650,5,53,155,5,5,5,15,Champions
15660,129,75,218,4,5,5,14,Champions
15807,357,10,17,3,2,2,7,Casual Users
15952,2527,5,44,1,1,3,5,Lost
16045,318,23,103,3,4,4,11,Loyal Users
16184,416,5,19,3,1,2,6,Casual Users
16344,321,50,73,3,5,4,12,Loyal Users
16832,2946,5,29,1,1,2,4,Lost
17125,265,14,117,3,3,4,10,Loyal Users
17302,245,29,62,3,4,3,10,Loyal Users
17401,392,27,137,3,4,4,11,Loyal Users
17410,124,7,35,4,2,3,9,Promising
17557,414,6,34,3,1,3,7,Casual Users
17693,30,30,88,5,4,4,13,Champions
18005,118,135,460,4,5,5,14,Champions
18104,391,15,23,3,3,2,8,Loyal Users
18165,612,7,8,2,2,1,5,Lost
18198,30,83,466,5,5,5,15,Champions
18552,15,27,44,5,4,3,12,Loyal Users
18814,1423,8,9,1,2,1,4,Lost
19013,147,16,72,4,3,4,11,Loyal Users
19367,275,32,152,3,4,5,12,Loyal Users
19434,299,12,33,3,3,3,9,Loyal Users
19444,4,7,29,5,2,2,9,Promising
19461,151,6,32,4,1,3,8,Promising
19637,718,8,11,2,2,1,5,Lost
19652,193,10,15,3,2,1,6,Casual Users
19854,5148,8,14,1,2,1,4,Lost
20557,1709,15,31,1,3,2,6,Casual Users
20576,600,8,11,2,2,1,5,Lost
20585,102,118,485,4,5,5,14,Champions
20895,74,14,69,4,3,4,11,Loyal Users
21008,45,63,437,5,5,5,15,Champions
21090,714,8,13,2,2,1,5,Lost
21147,1526,21,115,1,3,4,8,Casual Users
21421,279,34,96,3,4,4,11,Loyal Users
21581,11,75,230,5,5,5,15,Champions
21962,1138,7,7,2,2,1,5,Lost
22890,327,26,38,3,4,3,10,Loyal Users
22894,452,18,139,3,3,4,10,Loyal Users
23057,131,10,67,4,2,4,10,Promising
23185,115,130,367,4,5,5,14,Champions
23381,421,18,57,3,3,3,9,Loyal Users
23471,34,26,56,5,4,3,12,Loyal Users
23672,157,9,37,4,2,3,9,Promising
24340,1302,11,53,1,2,3,6,Lost
24350,896,5,19,2,1,2,5,Lost
24674,1238,7,37,2,2,3,7,Lost
24901,167,87,122,3,5,4,12,Loyal Users
24904,128,61,210,4,5,5,14,Champions
24922,327,38,67,3,4,4,11,Loyal Users
24982,1,25,115,5,4,4,13,Champions
25054,159,85,174,4,5,5,14,Champions
25302,731,7,30,2,2,2,6,Lost
25429,165,20,26,4,3,2,9,Loyal Users
25469,5394,5,10,1,1,1,3,Lost
25524,425,11,11,3,2,1,6,Casual Users
26409,161,16,31,4,3,2,9,Loyal Users
13639,1146,13,18,2,3,2,7,Casual Users
13949,304,24,44,3,4,3,10,Loyal Users
14043,567,5,7,2,1,1,4,Lost
14098,1529,6,31,1,1,2,4,Lost
14632,297,6,10,3,1,1,5,Casual Users
14721,130,44,133,4,4,4,12,Champions
14741,566,23,93,2,4,4,10,At Risk
14869,370,13,33,3,3,3,9,Loyal Users
15009,2140,11,32,1,2,3,6,Lost
15577,220,10,32,3,2,3,8,Casual Users
15612,77,32,141,4,4,4,12,Champions
15883,380,147,480,3,5,5,13,Loyal Users
16179,34,150,199,5,5,5,15,Champions
16600,111,14,30,4,3,2,9,Loyal Users
16816,653,6,18,2,1,2,5,Lost
17004,492,42,218,2,4,5,11,At Risk
17116,1992,7,29,1,2,2,5,Lost
17489,33,122,354,5,5,5,15,Champions
17491,271,7,58,3,2,3,8,Casual Users
17555,66,35,82,5,4,4,13,Champions
17592,986,7,9,2,2,1,5,Lost
17617,111,24,61,4,4,3,11,Loyal Users
17622,567,12,61,2,3,3,8,Casual Users
17653,1854,9,12,1,2,1,4,Lost
17731,1008,7,13,2,2,1,5,Lost
18072,1432,6,27,1,1,2,4,Lost
18689,534,26,110,2,4,4,10,At Risk
18961,424,38,93,3,4,4,11,Loyal Users
19144,178,33,128,3,4,4,11,Loyal Users
19463,3,73,182,5,5,5,15,Champions
19628,839,15,67,2,3,4,9,Casual Users
19751,53,16,56,5,3,3,11,Loyal Users
19846,157,55,88,4,5,4,13,Champions
20525,581,25,109,2,4,4,10,At Risk
20887,559,20,29,2,3,2,7,Casual Users
21025,102,62,314,4,5,5,14,Champions
21393,139,8,13,4,2,1,7,Promising
22204,4851,6,12,1,1,1,3,Lost
22290,335,27,39,3,4,3,10,Loyal Users
22636,121,28,164,4,4,5,13,Champions
22655,130,130,634,4,5,5,14,Champions
22732,776,44,155,2,4,5,11,At Risk
22935,10,16,108,5,3,4,12,Loyal Users
23242,376,156,432,3,5,5,13,Loyal Users
23623,46,61,464,5,5,5,15,Champions
23755,119,75,122,4,5,4,13,Champions
23925,281,12,19,3,3,2,8,Loyal Users
24004,77,12,21,4,3,2,9,Loyal Users
24067,155,14,33,4,3,3,10,Loyal Users
24241,47,43,85,5,4,4,13,Champions
24336,402,14,29,3,3,2,8,Loyal Users
24455,532,5,8,2,1,1,4,Lost
24610,920,14,28,2,3,2,7,Casual Users
25074,1997,10,10,1,2,1,4,Lost
25278,139,12,15,4,3,1,8,Loyal Users
25290,25,39,90,5,4,4,13,Champions
25416,398,38,63,3,4,4,11,Loyal Users
25578,1445,10,10,1,2,1,4,Lost
26096,397,71,259,3,5,5,13,Loyal Users
26114,315,10,18,3,2,2,7,Casual Users
26142,71,136,501,4,5,5,14,Champions
26321,257,35,310,3,4,5,12,Loyal Users
26354,136,18,248,4,3,5,12,Loyal Users
13653,849,7,9,2,2,1,5,Lost
13828,101,80,467,4,5,5,14,Champions
13862,948,7,25,2,2,2,6,Lost
13998,3552,5,26,1,1,2,4,Lost
14016,174,7,12,3,2,1,6,Casual Users
14092,2284,18,50,1,3,3,7,Casual Users
14136,39,23,32,5,4,3,12,Loyal Users
14293,0,68,192,5,5,5,15,Champions
14622,116,24,76,4,4,4,12,Champions
14790,137,90,205,4,5,5,14,Champions
15067,1,77,122,5,5,4,14,Champions
15324,850,21,73,2,3,4,9,Casual Users
15581,141,52,142,4,5,4,13,Champions
15600,122,52,84,4,5,4,13,Champions
15624,1407,5,7,1,1,1,3,Lost
15986,19,62,182,5,5,5,15,Champions
16160,155,13,47,4,3,3,10,Loyal Users
16246,718,13,23,2,3,2,7,Casual Users
16347,5,14,18,5,3,2,10,Loyal Users
16436,205,50,72,3,5,4,12,Loyal Users
16912,1803,10,11,1,2,1,4,Lost
17038,27,93,251,5,5,5,15,Champions
17516,89,33,75,4,4,4,12,Champions
17853,1728,5,14,1,1,1,3,Lost
18103,78,80,297,4,5,5,14,Champions
18116,52,6,6,5,1,1,7,Promising
18261,16,34,67,5,4,4,13,Champions
18432,24,23,45,5,4,3,12,Loyal Users
18644,131,5,7,4,1,1,6,Promising
18674,65,204,292,5,5,5,15,Champions
18717,64,74,658,5,5,5,15,Champions
18718,125,11,16,4,2,2,8,Promising
18726,1102,21,74,2,3,4,9,Casual Users
19374,19,80,162,5,5,5,15,Champions
19473,305,34,168,3,4,5,12,Loyal Users
19647,108,67,110,4,5,4,13,Champions
19979,543,13,75,2,3,4,9,Casual Users
20633,2952,17,65,1,3,4,8,Casual Users
21134,272,6,43,3,1,3,7,Casual Users
21293,428,5,6,3,1,1,5,Casual Users
21592,7,9,9,5,2,1,8,Promising
22039,121,35,152,4,4,5,13,Champions
22183,226,10,17,3,2,2,7,Casual Users
22504,75,63,154,4,5,5,14,Champions
22777,31,28,283,5,4,5,14,Champions
22819,157,17,30,4,3,2,9,Loyal Users
23177,396,16,19,3,3,2,8,Loyal Users
23494,73,21,50,4,3,3,10,Loyal Users
23823,1301,11,17,1,2,2,5,Lost
23953,602,24,41,2,4,3,9,At Risk
24117,1381,9,11,1,2,1,4,Lost
24242,530,15,69,2,3,4,9,Casual Users
24323,1803,5,28,1,1,2,4,Lost
24723,455,31,93,3,4,4,11,Loyal Users
24877,91,26,132,4,4,4,12,Champions
25126,549,8,37,2,2,3,7,Lost
25139,143,74,225,4,5,5,14,Champions
25149,2661,5,8,1,1,1,3,Lost
25319,1,9,13,5,2,1,8,Promising
25501,8,6,14,5,1,1,7,Promising
25518,938,9,16,2,2,2,6,Lost
25679,1710,7,35,1,2,3,6,Lost
26059,102,15,21,4,3,2,9,Loyal Users
26222,1142,7,26,2,2,2,6,Lost
26287,1830,5,14,1,1,1,3,Lost
26400,3161,9,9,1,2,1,4,Lost
26464,841,14,57,2,3,3,8,Casual Users
14221,383,9,35,3,2,3,8,Casual Users
14252,995,40,72,2,4,4,10,At Risk
14261,5,51,340,5,5,5,15,Champions
14583,602,46,168,2,5,5,12,At Risk
14773,277,7,15,3,2,1,6,Casual Users
14948,117,127,500,4,5,5,14,Champions
15177,2526,8,16,1,2,2,5,Lost
16222,90,66,302,4,5,5,14,Champions
16343,49,16,26,5,3,2,10,Loyal Users
16388,2973,5,33,1,1,3,5,Lost
16487,1262,7,9,1,2,1,4,Lost
16519,1289,9,14,1,2,1,4,Lost
16810,1177,5,10,2,1,1,4,Lost
16869,283,144,501,3,5,5,13,Loyal Users
17697,149,17,49,4,3,3,10,Loyal Users
17994,308,34,57,3,4,3,10,Loyal Users
18295,410,11,21,3,2,2,7,Casual Users
18339,147,90,339,4,5,5,14,Champions
18722,1818,5,8,1,1,1,3,Lost
18872,3611,10,10,1,2,1,4,Lost
18967,67,6,6,5,1,1,7,Promising
19156,1968,5,12,1,1,1,3,Lost
19173,694,8,16,2,2,2,6,Lost
19432,120,7,12,4,2,1,7,Promising
19672,828,27,61,2,4,3,9,At Risk
19723,400,57,403,3,5,5,13,Loyal Users
19822,15,9,9,5,2,1,8,Promising
19875,1279,6,19,1,1,2,4,Lost
20112,1131,43,98,2,4,4,10,At Risk
20468,215,56,99,3,5,4,12,Loyal Users
20518,198,40,103,3,4,4,11,Loyal Users
20562,114,58,291,4,5,5,14,Champions
20879,2873,5,5,1,1,1,3,Lost
20952,423,116,298,3,5,5,13,Loyal Users
21302,2868,7,11,1,2,1,4,Lost
21549,235,52,112,3,5,4,12,Loyal Users
21763,140,61,78,4,5,4,13,Champions
22153,146,23,49,4,4,3,11,Loyal Users
22251,207,57,197,3,5,5,13,Loyal Users
22318,39,36,87,5,4,4,13,Champions
22367,1440,8,12,1,2,1,4,Lost
22525,184,58,82,3,5,4,12,Loyal Users
22693,104,60,210,4,5,5,14,Champions
22711,67,37,60,5,4,3,12,Loyal Users
22800,941,8,28,2,2,2,6,Lost
22823,239,23,42,3,4,3,10,Loyal Users
23389,4397,5,7,1,1,1,3,Lost
23636,2569,6,19,1,1,2,4,Lost
23946,28,23,91,5,4,4,13,Champions
23971,2864,7,18,1,2,2,5,Lost
24208,2052,6,6,1,1,1,3,Lost
24365,71,89,206,4,5,5,14,Champions
24672,15,17,32,5,3,3,11,Loyal Users
24683,988,6,8,2,1,1,4,Lost
24691,569,16,26,2,3,2,7,Casual Users
25648,843,8,14,2,2,1,5,Lost
26021,125,54,258,4,5,5,14,Champions
13754,1945,6,13,1,1,1,3,Lost
13864,91,7,8,4,2,1,7,Promising
13876,284,21,30,3,3,2,8,Loyal Users
13936,4776,9,25,1,2,2,5,Lost
14149,1129,10,40,2,2,3,7,Lost
14323,1240,9,13,2,2,1,5,Lost
14652,3,75,255,5,5,5,15,Champions
14670,736,28,58,2,4,3,9,At Risk
14699,346,54,262,3,5,5,13,Loyal Users
14894,464,5,8,3,1,1,5,Casual Users
14963,214,62,131,3,5,4,12,Loyal Users
15080,43,81,246,5,5,5,15,Champions
15170,44,57,147,5,5,5,15,Champions
15303,1003,7,14,2,2,1,5,Lost
15312,78,18,63,4,3,4,11,Loyal Users
15360,425,56,235,3,5,5,13,Loyal Users
15565,48,27,46,5,4,3,12,Loyal Users
15730,791,47,94,2,5,4,11,At Risk
15819,55,17,51,5,3,3,11,Loyal Users
15915,430,21,100,3,3,4,10,Loyal Users
15937,2423,9,16,1,2,2,5,Lost
16228,121,78,128,4,5,4,13,Champions
16259,48,39,73,5,4,4,13,Champions
16453,129,8,25,4,2,2,8,Promising
16524,0,133,898,5,5,5,15,Champions
16621,232,7,16,3,2,2,7,Casual Users
16748,90,122,198,4,5,5,14,Champions
16818,4,85,332,5,5,5,15,Champions
16943,136,11,24,4,2,2,8,Promising
17412,127,48,87,4,5,4,13,Champions
17441,208,34,76,3,4,4,11,Loyal Users
17470,1090,6,6,2,1,1,4,Lost
17479,369,10,60,3,2,3,8,Casual Users
17648,87,37,88,4,4,4,12,Champions
17770,119,27,60,4,4,3,11,Loyal Users
17907,684,14,21,2,3,2,7,Casual Users
18125,878,15,35,2,3,3,8,Casual Users
18151,383,19,26,3,3,2,8,Loyal Users
18981,114,29,68,4,4,4,12,Champions
19003,714,21,44,2,3,3,8,Casual Users
19234,16,67,352,5,5,5,15,Champions
19243,4,21,84,5,3,4,12,Loyal Users
19564,948,8,10,2,2,1,5,Lost
19893,37,100,771,5,5,5,15,Champions
19983,708,6,28,2,1,2,5,Lost
20269,5281,12,28,1,3,2,6,Casual Users
20584,49,33,56,5,4,3,12,Loyal Users
20636,445,39,66,3,4,4,11,Loyal Users
20668,1782,58,67,1,5,4,10,At Risk
21186,596,40,198,2,4,5,11,At Risk
21286,91,141,402,4,5,5,14,Champions
21744,38,49,391,5,5,5,15,Champions
21762,100,23,119,4,4,4,12,Champions
22231,1104,21,74,2,3,4,9,Casual Users
22370,267,6,18,3,1,2,6,Casual Users
22394,8,53,123,5,5,4,14,Champions
22440,1,62,197,5,5,5,15,Champions
22896,272,7,21,3,2,2,7,Casual Users
22910,14,154,968,5,5,5,15,Champions
22913,10,69,232,5,5,5,15,Champions
22948,14,175,494,5,5,5,15,Champions
23167,2751,6,6,1,1,1,3,Lost
23463,3145,5,22,1,1,2,4,Lost
23522,428,6,13,3,1,1,5,Casual Users
23591,2400,5,8,1,1,1,3,Lost
23618,19,7,10,5,2,1,8,Promising
24130,7,27,38,5,4,3,12,Loyal Users
24172,194,19,55,3,3,3,9,Loyal Users
24188,4819,10,30,1,2,2,5,Lost
24605,48,71,266,5,5,5,15,Champions
24622,100,52,159,4,5,5,14,Champions
25268,245,11,20,3,2,2,7,Casual Users
25603,879,11,33,2,2,3,7,Lost
25633,1287,7,8,1,2,1,4,Lost
26038,107,54,186,4,5,5,14,Champions
13909,513,10,18,2,2,2,6,Lost
13974,271,6,9,3,1,1,5,Casual Users
13995,1670,7,7,1,2,1,4,Lost
14055,26,13,40,5,3,3,11,Loyal Users
14466,335,60,207,3,5,5,13,Loyal Users
14692,1212,21,43,2,3,3,8,Casual Users
15601,273,77,230,3,5,5,13,Loyal Users
15774,418,31,88,3,4,4,11,Loyal Users
16149,109,25,58,4,4,3,11,Loyal Users
16237,494,7,19,2,2,2,6,Lost
16523,136,59,132,4,5,4,13,Champions
16665,3841,12,13,1,3,1,5,Casual Users
17010,379,5,33,3,1,3,7,Casual Users
17064,2011,7,8,1,2,1,4,Lost
17073,4739,13,89,1,3,4,8,Casual Users
17239,4488,17,99,1,3,4,8,Casual Users
18415,5,129,391,5,5,5,15,Champions
18463,446,31,62,3,4,3,10,Loyal Users
18665,321,24,38,3,4,3,10,Loyal Users
18686,84,32,85,4,4,4,12,Champions
18766,138,68,170,4,5,5,14,Champions
18802,260,33,57,3,4,3,10,Loyal Users
18897,3098,8,32,1,2,3,6,Lost
19438,31,26,138,5,4,4,13,Champions
19891,5,82,112,5,5,4,14,Champions
19957,1146,10,14,2,2,1,5,Lost
20094,4249,13,20,1,3,2,6,Casual Users
20387,995,9,32,2,2,3,7,Lost
20516,23,56,265,5,5,5,15,Champions
20766,267,49,241,3,5,5,13,Loyal Users
20775,434,14,29,3,3,2,8,Loyal Users
21278,915,6,53,2,1,3,6,Lost
21465,1133,17,111,2,3,4,9,Casual Users
21498,263,51,84,3,5,4,12,Loyal Users
21693,129,13,32,4,3,3,10,Loyal Users
22072,44,13,48,5,3,3,11,Loyal Users
22181,291,27,63,3,4,4,11,Loyal Users
22402,2439,5,14,1,1,1,3,Lost
22486,140,47,104,4,5,4,13,Champions
22689,391,15,25,3,3,2,8,Loyal Users
23108,325,13,20,3,3,2,8,Loyal Users
23189,115,18,35,4,3,3,10,Loyal Users
23374,98,54,286,4,5,5,14,Champions
23380,2715,5,5,1,1,1,3,Lost
23397,7,44,66,5,4,4,13,Champions
23445,1463,11,19,1,2,2,5,Lost
23446,240,92,164,3,5,5,13,Loyal Users
23468,105,58,305,4,5,5,14,Champions
23737,128,5,5,4,1,1,6,Promising
24154,394,25,100,3,4,4,11,Loyal Users
24514,81,29,147,4,4,5,13,Champions
24716,2105,5,10,1,1,1,3,Lost
24744,949,5,10,2,1,1,4,Lost
24947,88,32,180,4,4,5,13,Champions
25965,946,7,18,2,2,2,6,Lost
26381,7,77,234,5,5,5,15,Champions
13609,506,46,187,2,5,5,12,At Risk
13932,4,76,448,5,5,5,15,Champions
14625,11,54,321,5,5,5,15,Champions
14728,2979,6,6,1,1,1,3,Lost
14895,2369,9,12,1,2,1,4,Lost
15258,1144,6,17,2,1,2,5,Lost
15592,943,7,30,2,2,2,6,Lost
15854,48,140,428,5,5,5,15,Champions
16019,406,18,46,3,3,3,9,Loyal Users
16102,554,11,15,2,2,1,5,Lost
16181,418,5,6,3,1,1,5,Casual Users
16206,165,84,245,4,5,5,14,Champions
16229,63,57,132,5,5,4,14,Champions
16294,261,77,236,3,5,5,13,Loyal Users
16444,298,56,335,3,5,5,13,Loyal Users
16675,237,18,52,3,3,3,9,Loyal Users
16847,4248,5,17,1,1,2,4,Lost
16858,1836,15,17,1,3,2,6,Casual Users
17233,1109,7,24,2,2,2,6,Lost
17321,248,7,14,3,2,1,6,Casual Users
17361,948,9,50,2,2,3,7,Lost
18021,19,55,194,5,5,5,15,Champions
18034,2660,8,29,1,2,2,5,Lost
18101,570,7,12,2,2,1,5,Lost
18758,568,10,20,2,2,2,6,Lost
18889,241,13,90,3,3,4,10,Loyal Users
19435,263,5,8,3,1,1,5,Casual Users
19470,241,12,13,3,3,1,7,Loyal Users
19656,558,16,28,2,3,2,7,Casual Users
19797,826,15,45,2,3,3,8,Casual Users
19980,601,35,57,2,4,3,9,At Risk
20099,1968,5,6,1,1,1,3,Lost
20568,833,41,72,2,4,4,10,At Risk
20743,141,65,185,4,5,5,14,Champions
20814,573,12,23,2,3,2,7,Casual Users
21189,4302,31,49,1,4,3,8,At Risk
21289,827,16,28,2,3,2,7,Casual Users
21291,1117,11,53,2,2,3,7,Lost
21362,1432,8,10,1,2,1,4,Lost
21443,17,45,160,5,4,5,14,Champions
21711,1082,6,11,2,1,1,4,Lost
21740,261,60,99,3,5,4,12,Loyal Users
21803,425,5,7,3,1,1,5,Casual Users
21860,377,8,21,3,2,2,7,Casual Users
21902,1076,8,10,2,2,1,5,Lost
22536,168,10,32,3,2,3,8,Casual Users
22593,33,13,35,5,3,3,11,Loyal Users
22933,5,14,53,5,3,3,11,Loyal Users
23011,3555,7,10,1,2,1,4,Lost
23056,874,7,13,2,2,1,5,Lost
23179,220,9,30,3,2,2,7,Casual Users
23394,577,13,17,2,3,2,7,Casual Users
23565,532,14,22,2,3,2,7,Casual Users
23613,682,17,60,2,3,3,8,Casual Users
24711,3074,6,16,1,1,2,4,Lost
24965,67,48,494,5,5,5,15,Champions
24991,174,39,172,3,4,5,12,Loyal Users
25471,29,61,209,5,5,5,15,Champions
25792,665,22,42,2,4,3,9,At Risk
26214,528,61,287,2,5,5,12,At Risk
26265,759,6,11,2,1,1,4,Lost
26274,230,52,234,3,5,5,13,Loyal Users
26344,80,98,280,4,5,5,14,Champions
14557,1364,20,66,1,3,4,8,Casual Users
14655,15,73,246,5,5,5,15,Champions
14875,2721,7,8,1,2,1,4,Lost
15017,408,15,23,3,3,2,8,Loyal Users
15103,29,100,321,5,5,5,15,Champions
15119,704,20,31,2,3,2,7,Casual Users
15239,1255,8,19,2,2,2,6,Lost
15289,48,16,35,5,3,3,11,Loyal Users
15376,15,19,38,5,3,3,11,Loyal Users
15421,65,59,167,5,5,5,15,Champions
16183,3413,5,5,1,1,1,3,Lost
16345,1,23,28,5,4,2,11,Loyal Users
16462,350,5,21,3,1,2,6,Casual Users
16474,700,6,19,2,1,2,5,Lost
16563,1982,6,15,1,1,1,3,Lost
16594,447,7,11,3,2,1,6,Casual Users
16787,1155,10,30,2,2,2,6,Lost
16807,1832,17,66,1,3,4,8,Casual Users
17092,79,110,618,4,5,5,14,Champions
17099,433,8,43,3,2,3,8,Casual Users
17273,71,11,28,4,2,2,8,Promising
17561,275,6,7,3,1,1,5,Casual Users
17862,303,44,129,3,4,4,11,Loyal Users
18290,574,7,12,2,2,1,5,Lost
18299,221,32,54,3,4,3,10,Loyal Users
18397,122,28,51,4,4,3,11,Loyal Users
18408,18,100,354,5,5,5,15,Champions
18558,544,9,19,2,2,2,6,Lost
18596,36,78,355,5,5,5,15,Champions
18603,103,21,37,4,3,3,10,Loyal Users
18781,5281,5,15,1,1,1,3,Lost
19047,136,29,35,4,4,3,11,Loyal Users
19107,275,33,80,3,4,4,11,Loyal Users
19252,103,5,5,4,1,1,6,Promising
19365,688,12,66,2,3,4,9,Casual Users
19375,2423,6,9,1,1,1,3,Lost
19816,186,40,341,3,4,5,12,Loyal Users
19952,1450,5,31,1,1,2,4,Lost
20092,2104,6,16,1,1,2,4,Lost
20121,264,36,315,3,4,5,12,Loyal Users
20267,10,133,285,5,5,5,15,Champions
20442,764,10,10,2,2,1,5,Lost
20736,1411,17,57,1,3,3,7,Casual Users
21267,1659,8,19,1,2,2,5,Lost
21562,332,8,11,3,2,1,6,Casual Users
22862,75,12,18,4,3,2,9,Loyal Users
23079,40,5,16,5,1,2,8,Promising
23432,25,28,170,5,4,5,14,Champions
23473,270,7,19,3,2,2,7,Casual Users
23502,983,95,146,2,5,4,11,At Risk
23825,89,7,14,4,2,1,7,Promising
24698,548,11,12,2,2,1,5,Lost
24910,396,39,108,3,4,4,11,Loyal Users
25282,108,40,87,4,4,4,12,Champions
25329,225,24,47,3,4,3,10,Loyal Users
25500,1841,9,18,1,2,2,5,Lost
25505,670,9,13,2,2,1,5,Lost
25650,278,10,36,3,2,3,8,Casual Users
26168,931,7,18,2,2,2,6,Lost
26201,0,61,165,5,5,5,15,Champions
26234,4715,6,14,1,1,1,3,Lost
26262,287,9,16,3,2,2,7,Casual Users
13598,16,54,117,5,5,4,14,Champions
13604,2509,5,7,1,1,1,3,Lost
13640,108,20,103,4,3,4,11,Loyal Users
14018,4837,5,16,1,1,2,4,Lost
14220,164,20,29,4,3,2,9,Loyal Users
14381,118,88,178,4,5,5,14,Champions
14409,31,15,82,5,3,4,12,Loyal Users
14432,489,19,59,2,3,3,8,Casual Users
14449,156,33,172,4,4,5,13,Champions
14711,2597,20,75,1,3,4,8,Casual Users
14766,111,108,429,4,5,5,14,Champions
15090,313,21,51,3,3,3,9,Loyal Users
15150,543,40,216,2,4,5,11,At Risk
15965,171,127,402,3,5,5,13,Loyal Users
16410,594,13,21,2,3,2,7,Casual Users
16530,1632,5,19,1,1,2,4,Lost
16809,541,23,53,2,4,3,9,At Risk
16901,668,6,19,2,1,2,5,Lost
17051,67,158,248,5,5,5,15,Champions
17075,195,10,20,3,2,2,7,Casual Users
17158,303,41,71,3,4,4,11,Loyal Users
17266,163,44,121,4,4,4,12,Champions
17839,109,62,177,4,5,5,14,Champions
17986,167,9,24,3,2,2,7,Casual Users
18370,3663,10,23,1,2,2,5,Lost
18705,1279,9,11,1,2,1,4,Lost
18748,713,49,275,2,5,5,12,At Risk
18844,1136,11,22,2,2,2,6,Lost
18907,2645,6,7,1,1,1,3,Lost
19018,583,5,32,2,1,3,6,Lost
19565,255,19,71,3,3,4,10,Loyal Users
19571,113,12,31,4,3,2,9,Loyal Users
19658,2,6,14,5,1,1,7,Promising
20113,26,100,589,5,5,5,15,Champions
20329,137,115,408,4,5,5,14,Champions
20723,292,15,22,3,3,2,8,Loyal Users
20908,5700,18,36,1,3,3,7,Casual Users
20925,2,114,304,5,5,5,15,Champions
21463,1688,10,28,1,2,2,5,Lost
21936,117,7,58,4,2,3,9,Promising
22271,27,47,143,5,5,4,14,Champions
22543,806,48,65,2,5,4,11,At Risk
22546,566,5,5,2,1,1,4,Lost
22746,197,42,74,3,4,4,11,Loyal Users
22940,144,34,39,4,4,3,11,Loyal Users
23139,104,11,44,4,2,3,9,Promising
23145,1122,14,25,2,3,2,7,Casual Users
23300,590,7,14,2,2,1,5,Lost
23600,255,36,86,3,4,4,11,Loyal Users
23612,123,7,16,4,2,2,8,Promising
23853,404,25,164,3,4,5,12,Loyal Users
23859,148,119,389,4,5,5,14,Champions
24054,4756,8,34,1,2,3,6,Lost
24184,37,13,43,5,3,3,11,Loyal Users
24244,1985,6,7,1,1,1,3,Lost
24457,107,50,67,4,5,4,13,Champions
24643,132,24,40,4,4,3,11,Loyal Users
24767,3,12,105,5,3,4,12,Loyal Users
24834,104,45,173,4,4,5,13,Champions
24971,915,14,104,2,3,4,9,Casual Users
25439,287,54,112,3,5,4,12,Loyal Users
25454,130,29,59,4,4,3,11,Loyal Users
26082,331,58,254,3,5,5,13,Loyal Users
13684,85,94,218,4,5,5,14,Champions
13833,1462,10,66,1,2,4,7,Lost
13842,122,5,5,4,1,1,6,Promising
14009,2987,6,11,1,1,1,3,Lost
14157,497,18,95,2,3,4,9,Casual Users
14294,116,7,14,4,2,1,7,Promising
14343,6115,10,10,1,2,1,4,Lost
14361,422,133,510,3,5,5,13,Loyal Users
14810,1362,8,23,1,2,2,5,Lost
14850,706,18,27,2,3,2,7,Casual Users
15240,257,8,47,3,2,3,8,Casual Users
15445,1068,6,41,2,1,3,6,Lost
15494,724,9,14,2,2,1,5,Lost
15723,62,12,36,5,3,3,11,Loyal Users
15831,12,72,89,5,5,4,14,Champions
16041,3641,23,59,1,4,3,8,At Risk
16087,390,7,17,3,2,2,7,Casual Users
16203,224,9,14,3,2,1,6,Casual Users
16227,51,39,268,5,4,5,14,Champions
16602,5801,8,35,1,2,3,6,Lost
16676,1210,7,9,2,2,1,5,Lost
16939,140,58,275,4,5,5,14,Champions
16953,12,72,387,5,5,5,15,Champions
17402,5844,5,10,1,1,1,3,Lost
17501,145,13,33,4,3,3,10,Loyal Users
17882,1235,8,29,2,2,2,6,Lost
17970,105,49,99,4,5,4,13,Champions
17973,74,6,15,4,1,1,6,Promising
17977,308,12,35,3,3,3,9,Loyal Users
18070,819,20,36,2,3,3,8,Casual Users
18220,721,7,13,2,2,1,5,Lost
18601,18,5,6,5,1,1,7,Promising
19251,138,105,401,4,5,5,14,Champions
19326,4565,5,7,1,1,1,3,Lost
19807,273,31,246,3,4,5,12,Loyal Users
19883,5291,6,18,1,1,2,4,Lost
19910,456,13,15,3,3,1,7,Loyal Users
20080,493,14,26,2,3,2,7,Casual Users
20233,101,32,51,4,4,3,11,Loyal Users
20271,1449,5,18,1,1,2,4,Lost
20437,243,8,12,3,2,1,6,Casual Users
20464,820,5,7,2,1,1,4,Lost
21654,14,66,173,5,5,5,15,Champions
21825,412,23,107,3,4,4,11,Loyal Users
22203,4432,15,17,1,3,2,6,Casual Users
22252,119,24,113,4,4,4,12,Champions
22551,428,20,27,3,3,2,8,Loyal Users
22590,186,30,53,3,4,3,10,Loyal Users
22735,553,13,37,2,3,3,8,Casual Users
23104,3087,14,23,1,3,2,6,Casual Users
23203,144,34,164,4,4,5,13,Champions
23283,19,41,69,5,4,4,13,Champions
23569,352,10,20,3,2,2,7,Casual Users
23590,119,51,112,4,5,4,13,Champions
23685,2318,5,9,1,1,1,3,Lost
23692,3569,9,58,1,2,3,6,Lost
23852,33,78,358,5,5,5,15,Champions
23933,1244,7,10,2,2,1,5,Lost
24092,19,25,40,5,4,3,12,Loyal Users
24214,194,28,62,3,4,3,10,Loyal Users
24219,42,33,127,5,4,4,13,Champions
24342,460,9,10,3,2,1,6,Casual Users
25805,1483,65,392,1,5,5,11,At Risk
25959,496,30,74,2,4,4,10,At Risk
26208,1368,24,55,1,4,3,8,At Risk
26263,343,6,25,3,1,2,6,Casual Users
26266,3,47,119,5,5,4,14,Champions
26299,1885,9,11,1,2,1,4,Lost
13733,90,96,237,4,5,5,14,Champions
13839,1100,9,22,2,2,2,6,Lost
13893,1791,8,21,1,2,2,5,Lost
14384,1532,10,10,1,2,1,4,Lost
14418,422,18,49,3,3,3,9,Loyal Users
14427,828,12,23,2,3,2,7,Casual Users
14650,1299,6,18,1,1,2,4,Lost
14723,6,9,12,5,2,1,8,Promising
14936,1557,8,12,1,2,1,4,Lost
15015,819,8,32,2,2,3,7,Lost
15321,425,22,77,3,4,4,11,Loyal Users
15499,2020,5,12,1,1,1,3,Lost
15517,274,16,32,3,3,3,9,Loyal Users
15744,105,12,101,4,3,4,11,Loyal Users
15848,49,26,61,5,4,3,12,Loyal Users
16008,10,97,601,5,5,5,15,Champions
16030,567,32,97,2,4,4,10,At Risk
16166,28,103,291,5,5,5,15,Champions
16313,275,35,204,3,4,5,12,Loyal Users
16392,94,22,145,4,4,4,12,Champions
16670,99,64,115,4,5,4,13,Champions
17344,1823,6,50,1,1,3,5,Lost
17494,1124,16,78,2,3,4,9,Casual Users
17611,648,7,12,2,2,1,5,Lost
17917,1122,9,19,2,2,2,6,Lost
18109,104,43,91,4,4,4,12,Champions
18562,5348,18,33,1,3,3,7,Casual Users
18937,18,75,318,5,5,5,15,Champions
18994,2662,5,18,1,1,2,4,Lost
19217,407,103,258,3,5,5,13,Loyal Users
19349,117,47,367,4,5,5,14,Champions
19492,84,32,102,4,4,4,12,Champions
19528,71,21,70,4,3,4,11,Loyal Users
19561,61,55,69,5,5,4,14,Champions
20176,21,24,82,5,4,4,13,Champions
20406,411,7,11,3,2,1,6,Casual Users
20678,2595,7,17,1,2,2,5,Lost
20864,596,8,31,2,2,2,6,Lost
21359,3023,5,5,1,1,1,3,Lost
21428,3134,8,20,1,2,2,5,Lost
21601,1168,17,28,2,3,2,7,Casual Users
21809,3262,7,20,1,2,2,5,Lost
21919,129,36,188,4,4,5,13,Champions
22166,638,5,21,2,1,2,5,Lost
22399,117,190,240,4,5,5,14,Champions
22825,79,48,135,4,5,4,13,Champions
22950,20,81,253,5,5,5,15,Champions
23048,700,5,79,2,1,4,7,Lost
23072,2854,5,10,1,1,1,3,Lost
23176,1595,6,10,1,1,1,3,Lost
23237,123,49,103,4,5,4,13,Champions
23584,1981,11,40,1,2,3,6,Lost
23657,576,21,62,2,3,3,8,Casual Users
23736,2252,5,8,1,1,1,3,Lost
23790,492,5,50,2,1,3,6,Lost
24124,545,5,8,2,1,1,4,Lost
24278,242,73,162,3,5,5,13,Loyal Users
24441,6,49,185,5,5,5,15,Champions
24606,729,10,15,2,2,1,5,Lost
24986,91,81,262,4,5,5,14,Champions
25163,858,18,24,2,3,2,7,Casual Users
25368,2395,6,8,1,1,1,3,Lost
25467,832,10,14,2,2,1,5,Lost
25528,687,27,36,2,4,3,9,At Risk
25766,1,63,131,5,5,4,14,Champions
25869,174,16,28,3,3,2,8,Loyal Users
26109,1996,7,9,1,2,1,4,Lost
13645,8,221,525,5,5,5,15,Champions
13906,1983,8,10,1,2,1,4,Lost
14118,8,172,347,5,5,5,15,Champions
14188,156,21,110,4,3,4,11,Loyal Users
14413,88,56,213,4,5,5,14,Champions
14546,399,13,41,3,3,3,9,Loyal Users
14892,75,45,121,4,4,4,12,Champions
15193,0,5,10,5,1,1,7,Promising
15425,137,14,36,4,3,3,10,Loyal Users
15455,2278,6,13,1,1,1,3,Lost
15644,424,8,13,3,2,1,6,Casual Users
15694,1563,23,68,1,4,4,9,At Risk
15888,469,8,8,3,2,1,6,Casual Users
16379,13,19,62,5,3,3,11,Loyal Users
16615,736,5,6,2,1,1,4,Lost
16740,590,16,94,2,3,4,9,Casual Users
16956,14,119,448,5,5,5,15,Champions
17860,1228,5,14,2,1,1,4,Lost
18097,586,12,16,2,3,2,7,Casual Users
18144,541,41,69,2,4,4,10,At Risk
18505,1247,14,31,2,3,2,7,Casual Users
18878,2339,11,18,1,2,2,5,Lost
18978,959,15,28,2,3,2,7,Casual Users
19164,107,22,61,4,4,3,11,Loyal Users
19348,117,60,209,4,5,5,14,Champions
19505,145,33,175,4,4,5,13,Champions
19521,23,207,745,5,5,5,15,Champions
19654,780,34,296,2,4,5,11,At Risk
19660,1422,6,34,1,1,3,5,Lost
19861,20,7,27,5,2,2,9,Promising
20193,27,59,224,5,5,5,15,Champions
20236,396,18,31,3,3,2,8,Loyal Users
20249,154,17,22,4,3,2,9,Loyal Users
20343,419,21,31,3,3,2,8,Loyal Users
20558,134,6,14,4,1,1,6,Promising
20570,162,100,330,4,5,5,14,Champions
20611,265,6,15,3,1,1,5,Casual Users
20802,576,8,31,2,2,2,6,Lost
21453,632,18,27,2,3,2,7,Casual Users
22205,39,100,317,5,5,5,15,Champions
22526,30,7,27,5,2,2,9,Promising
22905,967,38,205,2,4,5,11,At Risk
22999,110,13,68,4,3,4,11,Loyal Users
23090,116,16,28,4,3,2,9,Loyal Users
23319,172,68,411,3,5,5,13,Loyal Users
23341,345,37,112,3,4,4,11,Loyal Users
23646,5,36,121,5,4,4,13,Champions
24098,172,9,22,3,2,2,7,Casual Users
24157,1165,34,82,2,4,4,10,At Risk
24213,2052,22,189,1,4,5,10,At Risk
24549,118,88,134,4,5,4,13,Champions
24629,158,57,255,4,5,5,14,Champions
24765,568,25,49,2,4,3,9,At Risk
24964,16,52,171,5,5,5,15,Champions
24967,4,85,188,5,5,5,15,Champions
25138,23,43,87,5,4,4,13,Champions
25177,3963,12,17,1,3,2,6,Casual Users
25233,3927,12,25,1,3,2,6,Casual Users
25369,160,13,48,4,3,3,10,Loyal Users
25390,1282,6,6,1,1,1,3,Lost
26406,107,61,260,4,5,5,14,Champions
13611,5,6,17,5,1,2,8,Promising
13835,542,21,93,2,3,4,9,Casual Users
14229,631,8,100,2,2,4,8,Lost
14493,32,60,432,5,5,5,15,Champions
14679,14,75,121,5,5,4,14,Champions
14707,567,12,55,2,3,3,8,Casual Users
15209,66,58,158,5,5,5,15,Champions
15248,7,22,59,5,4,3,12,Loyal Users
15275,1402,6,43,1,1,3,5,Lost
15402,20,78,279,5,5,5,15,Champions
15780,6,34,66,5,4,4,13,Champions
15816,122,7,13,4,2,1,7,Promising
16017,309,5,5,3,1,1,5,Casual Users
16063,829,53,293,2,5,5,12,At Risk
16199,137,27,42,4,4,3,11,Loyal Users
16322,455,31,62,3,4,3,10,Loyal Users
16529,61,48,131,5,5,4,14,Champions
16588,1458,6,25,1,1,2,4,Lost
16696,208,97,417,3,5,5,13,Loyal Users
16723,295,11,18,3,2,2,7,Casual Users
16972,409,9,36,3,2,3,8,Casual Users
17048,37,58,112,5,5,4,14,Champions
17089,35,40,137,5,4,4,13,Champions
17161,124,61,341,4,5,5,14,Champions
17180,423,15,29,3,3,2,8,Loyal Users
17287,444,6,24,3,1,2,6,Casual Users
17602,2111,5,12,1,1,1,3,Lost
17746,42,173,253,5,5,5,15,Champions
18515,371,50,311,3,5,5,13,Loyal Users
19085,4,46,149,5,5,5,15,Champions
19137,211,7,8,3,2,1,6,Casual Users
19527,526,18,45,2,3,3,8,Casual Users
19606,76,50,79,4,5,4,13,Champions
19640,8,87,174,5,5,5,15,Champions
20138,286,8,12,3,2,1,6,Casual Users
20209,84,18,36,4,3,3,10,Loyal Users
20535,11,79,148,5,5,5,15,Champions
20640,128,22,67,4,4,4,12,Champions
20715,1412,6,16,1,1,2,4,Lost
20956,390,14,33,3,3,3,9,Loyal Users
21099,155,53,153,4,5,5,14,Champions
21275,114,131,241,4,5,5,14,Champions
21300,304,90,430,3,5,5,13,Loyal Users
21432,128,48,165,4,5,5,14,Champions
22540,96,49,74,4,5,4,13,Champions
23163,126,107,249,4,5,5,14,Champions
23979,228,6,46,3,1,3,7,Casual Users
24055,985,15,33,2,3,3,8,Casual Users
24103,668,11,15,2,2,1,5,Lost
24190,102,12,13,4,3,1,8,Loyal Users
24408,227,8,9,3,2,1,6,Casual Users
24420,1645,7,32,1,2,3,6,Lost
24486,862,9,22,2,2,2,6,Lost
24701,427,55,156,3,5,5,13,Loyal Users
24783,1455,12,18,1,3,2,6,Casual Users
24978,40,44,79,5,4,4,13,Champions
25086,4,10,49,5,2,3,10,Promising
25372,15,6,8,5,1,1,7,Promising
25519,1803,5,6,1,1,1,3,Lost
25569,3266,12,19,1,3,2,6,Casual Users
25994,995,19,58,2,3,3,8,Casual Users
26107,5561,9,18,1,2,2,5,Lost
26190,251,12,44,3,3,3,9,Loyal Users
26311,8,86,184,5,5,5,15,Champions
13813,109,59,462,4,5,5,14,Champions
14028,285,11,26,3,2,2,7,Casual Users
14310,79,57,130,4,5,4,13,Champions
14668,35,88,309,5,5,5,15,Champions
14693,2408,10,12,1,2,1,4,Lost
14732,402,96,237,3,5,5,13,Loyal Users
14769,405,14,37,3,3,3,9,Loyal Users
14829,106,76,101,4,5,4,13,Champions
14921,139,14,39,4,3,3,10,Loyal Users
15056,79,41,103,4,4,4,12,Champions
15187,23,60,320,5,5,5,15,Champions
15290,17,134,386,5,5,5,15,Champions
15520,1693,5,25,1,1,2,4,Lost
15615,73,153,536,4,5,5,14,Champions
15705,76,18,73,4,3,4,11,Loyal Users
15713,3849,21,58,1,3,3,7,Casual Users
15912,2973,9,39,1,2,3,6,Lost
16071,795,9,21,2,2,2,6,Lost
16115,2,16,164,5,3,5,13,Loyal Users
16405,120,16,21,4,3,2,9,Loyal Users
16442,49,117,674,5,5,5,15,Champions
16497,740,65,122,2,5,4,11,At Risk
16585,220,17,47,3,3,3,9,Loyal Users
16703,683,7,14,2,2,1,5,Lost
16762,150,64,181,4,5,5,14,Champions
16918,259,27,38,3,4,3,10,Loyal Users
17007,0,34,45,5,4,3,12,Loyal Users
17108,985,6,9,2,1,1,4,Lost
17257,1415,5,8,1,1,1,3,Lost
17341,405,8,13,3,2,1,6,Casual Users
17404,681,6,13,2,1,1,4,Lost
17593,700,35,102,2,4,4,10,At Risk
17704,673,16,27,2,3,2,7,Casual Users
17788,2,129,723,5,5,5,15,Champions
18156,153,25,40,4,4,3,11,Loyal Users
18192,1274,11,64,1,2,4,7,Lost
18254,543,8,9,2,2,1,5,Lost
18561,506,26,38,2,4,3,9,At Risk
18607,153,10,16,4,2,2,8,Promising
19439,13,101,210,5,5,5,15,Champions
19516,726,22,72,2,4,4,10,At Risk
20621,1678,38,81,1,4,4,9,At Risk
20739,405,10,11,3,2,1,6,Casual Users
20830,1422,7,8,1,2,1,4,Lost
20855,281,5,46,3,1,3,7,Casual Users
21135,1436,14,40,1,3,3,7,Casual Users
21229,1289,6,23,1,1,2,4,Lost
21512,165,19,166,4,3,5,12,Loyal Users
21559,633,12,16,2,3,2,7,Casual Users
21913,3414,5,9,1,1,1,3,Lost
22148,28,177,302,5,5,5,15,Champions
22745,5,12,78,5,3,4,12,Loyal Users
22874,683,8,28,2,2,2,6,Lost
22883,652,18,200,2,3,5,10,Casual Users
22922,5359,9,9,1,2,1,4,Lost
23117,134,51,166,4,5,5,14,Champions
23322,465,12,19,3,3,2,8,Loyal Users
23427,265,44,107,3,4,4,11,Loyal Users
23477,107,45,180,4,4,5,13,Champions
23530,6,134,483,5,5,5,15,Champions
23885,254,43,249,3,4,5,12,Loyal Users
23968,3,5,11,5,1,1,7,Promising
24057,1414,16,22,1,3,2,6,Casual Users
24186,162,13,31,4,3,2,9,Loyal Users
24201,25,13,16,5,3,2,10,Loyal Users
24270,422,12,25,3,3,2,8,Loyal Users
24390,24,8,16,5,2,2,9,Promising
24731,28,88,452,5,5,5,15,Champions
24888,1028,16,32,2,3,3,8,Casual Users
25053,860,58,90,2,5,4,11,At Risk
25509,262,45,87,3,4,4,11,Loyal Users
25765,385,36,92,3,4,4,11,Loyal Users
25829,826,50,67,2,5,4,11,At Risk
26199,135,25,61,4,4,3,11,Loyal Users
13612,418,7,22,3,2,2,7,Casual Users
14110,65,15,88,5,3,4,12,Loyal Users
14593,1128,22,42,2,4,3,9,At Risk
14974,4228,21,123,1,3,4,8,Casual Users
15257,29,65,234,5,5,5,15,Champions
15703,4666,23,83,1,4,4,9,At Risk
15857,49,19,172,5,3,5,13,Loyal Users
15941,86,6,8,4,1,1,6,Promising
16013,4862,37,67,1,4,4,9,At Risk
16141,111,83,273,4,5,5,14,Champions
16153,547,9,16,2,2,2,6,Lost
16200,838,11,18,2,2,2,6,Lost
16562,285,22,45,3,4,3,10,Loyal Users
16927,1202,11,22,2,2,2,6,Lost
16959,235,16,38,3,3,3,9,Loyal Users
17041,8,74,205,5,5,5,15,Champions
17055,2158,5,8,1,1,1,3,Lost
17301,118,45,173,4,4,5,13,Champions
17562,1,27,52,5,4,3,12,Loyal Users
17855,1410,5,37,1,1,3,5,Lost
18045,12,181,354,5,5,5,15,Champions
18180,2012,6,18,1,1,2,4,Lost
18647,17,51,157,5,5,5,15,Champions
18655,114,13,59,4,3,3,10,Loyal Users
18794,1028,22,27,2,4,2,8,At Risk
18848,251,8,41,3,2,3,8,Casual Users
18857,78,101,216,4,5,5,14,Champions
19133,5047,8,12,1,2,1,4,Lost
19293,10,32,117,5,4,4,13,Champions
19311,414,13,14,3,3,1,7,Loyal Users
19414,121,28,34,4,4,3,11,Loyal Users
19634,491,11,12,2,2,1,5,Lost
19775,91,25,48,4,4,3,11,Loyal Users
19849,81,73,314,4,5,5,14,Champions
20184,237,29,64,3,4,4,11,Loyal Users
20306,636,9,35,2,2,3,7,Lost
20483,5,52,176,5,5,5,15,Champions
20493,26,36,98,5,4,4,13,Champions
20720,679,8,35,2,2,3,7,Lost
20807,0,79,270,5,5,5,15,Champions
20972,631,25,90,2,4,4,10,At Risk
21113,297,26,53,3,4,3,10,Loyal Users
21368,68,35,56,5,4,3,12,Loyal Users
21378,754,18,99,2,3,4,9,Casual Users
21459,36,39,120,5,4,4,13,Champions
21707,32,52,312,5,5,5,15,Champions
22066,241,83,183,3,5,5,13,Loyal Users
22280,15,78,319,5,5,5,15,Champions
22411,30,7,17,5,2,2,9,Promising
22637,1,14,76,5,3,4,12,Loyal Users
22773,1116,11,59,2,2,3,7,Lost
23076,1,25,88,5,4,4,13,Champions
23191,245,18,113,3,3,4,10,Loyal Users
23239,1275,5,5,1,1,1,3,Lost
23268,268,10,44,3,2,3,8,Casual Users
23526,116,30,108,4,4,4,12,Champions
24164,2677,10,21,1,2,2,5,Lost
24366,0,26,35,5,4,3,12,Loyal Users
24642,57,73,315,5,5,5,15,Champions
24778,141,43,78,4,4,4,12,Champions
24969,1788,10,13,1,2,1,4,Lost
25050,623,11,25,2,2,2,6,Lost
25260,1442,5,5,1,1,1,3,Lost
25342,69,164,519,5,5,5,15,Champions
25559,20,54,84,5,5,4,14,Champions
25619,379,7,7,3,2,1,6,Casual Users
25782,1547,8,8,1,2,1,4,Lost
25991,1530,5,9,1,1,1,3,Lost
26189,523,45,101,2,4,4,10,At Risk
13613,3,65,166,5,5,5,15,Champions
14049,232,66,293,3,5,5,13,Loyal Users
14344,452,13,23,3,3,2,8,Loyal Users
14461,5,13,24,5,3,2,10,Loyal Users
14909,1092,10,27,2,2,2,6,Lost
15069,408,5,12,3,1,1,5,Casual Users
15430,2980,7,16,1,2,2,5,Lost
15529,1015,22,59,2,4,3,9,At Risk
15820,171,27,148,3,4,5,12,Loyal Users
15851,98,23,53,4,4,3,11,Loyal Users
15868,595,9,18,2,2,2,6,Lost
16209,220,31,124,3,4,4,11,Loyal Users
16270,101,7,16,4,2,2,8,Promising
16751,125,69,112,4,5,4,13,Champions
16753,134,26,44,4,4,3,11,Loyal Users
16755,3,66,273,5,5,5,15,Champions
16878,28,31,123,5,4,4,13,Champions
17142,168,9,21,3,2,2,7,Casual Users
17211,881,11,29,2,2,2,6,Lost
17527,353,37,84,3,4,4,11,Loyal Users
18473,903,5,14,2,1,1,4,Lost
18507,836,28,99,2,4,4,10,At Risk
18589,583,17,25,2,3,2,7,Casual Users
18633,2914,21,78,1,3,4,8,Casual Users
18777,3530,6,10,1,1,1,3,Lost
18950,249,6,7,3,1,1,5,Casual Users
19296,2796,10,14,1,2,1,4,Lost
19357,39,95,197,5,5,5,15,Champions
19465,1988,5,13,1,1,1,3,Lost
20390,434,37,83,3,4,4,11,Loyal Users
20426,242,13,31,3,3,2,8,Loyal Users
20599,4031,5,14,1,1,1,3,Lost
20820,452,6,7,3,1,1,5,Casual Users
21054,527,24,87,2,4,4,10,At Risk
21230,141,16,30,4,3,2,9,Loyal Users
21554,1551,5,9,1,1,1,3,Lost
21870,548,104,271,2,5,5,12,At Risk
22020,177,10,17,3,2,2,7,Casual Users
22063,3627,11,12,1,2,1,4,Lost
22479,410,12,27,3,3,2,8,Loyal Users
22642,538,6,13,2,1,1,4,Lost
23830,874,6,15,2,1,1,4,Lost
23970,2953,10,20,1,2,2,5,Lost
24077,0,58,84,5,5,4,14,Champions
24081,4,7,25,5,2,2,9,Promising
24233,327,27,79,3,4,4,11,Loyal Users
24418,14,164,365,5,5,5,15,Champions
24589,117,24,74,4,4,4,12,Champions
24608,270,64,123,3,5,4,12,Loyal Users
24710,112,8,25,4,2,2,8,Promising
24864,538,11,74,2,2,4,8,Lost
13642,61,20,45,5,3,3,11,Loyal Users
13735,423,12,29,3,3,2,8,Loyal Users
13736,2259,5,7,1,1,1,3,Lost
13851,574,16,34,2,3,3,8,Casual Users
14190,130,6,19,4,1,2,7,Promising
14191,2742,17,17,1,3,2,6,Casual Users
14325,253,14,25,3,3,2,8,Loyal Users
14617,27,39,152,5,4,5,14,Champions
15377,302,11,13,3,2,1,6,Casual Users
15449,287,5,8,3,1,1,5,Casual Users
15483,463,20,49,3,3,3,9,Loyal Users
15720,5820,9,52,1,2,3,6,Lost
15745,5554,6,17,1,1,2,4,Lost
15808,715,10,52,2,2,3,7,Lost
15980,133,13,53,4,3,3,10,Loyal Users
16022,797,22,160,2,4,5,11,At Risk
16140,40,63,171,5,5,5,15,Champions
16144,21,7,27,5,2,2,9,Promising
16263,136,41,118,4,4,4,12,Champions
16991,635,5,11,2,1,1,4,Lost
17114,15,67,359,5,5,5,15,Champions
17195,419,8,32,3,2,3,8,Casual Users
17672,108,19,27,4,3,2,9,Loyal Users
17998,948,13,21,2,3,2,7,Casual Users
18130,23,5,10,5,1,1,7,Promising
18188,706,17,23,2,3,2,7,Casual Users
18442,1560,10,14,1,2,1,4,Lost
19019,1270,14,44,1,3,3,7,Casual Users
19446,51,19,51,5,3,3,11,Loyal Users
19688,2409,5,6,1,1,1,3,Lost
19843,5,89,457,5,5,5,15,Champions
20192,2618,14,26,1,3,2,6,Casual Users
20257,602,9,12,2,2,1,5,Lost
20472,110,17,35,4,3,3,10,Loyal Users
20665,939,45,81,2,4,4,10,At Risk
20669,247,12,21,3,3,2,8,Loyal Users
20695,35,146,812,5,5,5,15,Champions
21065,149,18,75,4,3,4,11,Loyal Users
21613,37,8,34,5,2,3,10,Promising
21878,501,24,41,2,4,3,9,At Risk
22187,21,10,40,5,2,3,10,Promising
22407,549,16,27,2,3,2,7,Casual Users
22683,46,117,501,5,5,5,15,Champions
22914,715,6,40,2,1,3,6,Lost
23077,421,11,69,3,2,4,9,Casual Users
23361,10,20,52,5,3,3,11,Loyal Users
23467,934,7,33,2,2,3,7,Lost
23509,164,72,508,4,5,5,14,Champions
23546,831,18,116,2,3,4,9,Casual Users
23557,2400,10,24,1,2,2,5,Lost
23634,156,28,92,4,4,4,12,Champions
23643,2375,6,6,1,1,1,3,Lost
23723,1547,5,52,1,1,3,5,Lost
23897,1385,11,24,1,2,2,5,Lost
23913,393,10,28,3,2,2,7,Casual Users
23962,3694,8,13,1,2,1,4,Lost
24223,4478,9,17,1,2,2,5,Lost
24277,122,45,75,4,4,4,12,Champions
24470,254,26,74,3,4,4,11,Loyal Users
24771,119,23,127,4,4,4,12,Champions
25012,855,210,613,2,5,5,12,At Risk
25016,132,63,158,4,5,5,14,Champions
25293,2481,7,24,1,2,2,5,Lost
25298,934,10,23,2,2,2,6,Lost
26452,493,13,54,2,3,3,8,Casual Users
13628,156,47,124,4,5,4,13,Champions
13798,273,125,272,3,5,5,13,Loyal Users
13874,1225,18,50,2,3,3,8,Casual Users
14194,242,8,15,3,2,1,6,Casual Users
14447,34,11,12,5,2,1,8,Promising
14528,7,34,53,5,4,3,12,Loyal Users
14597,307,18,50,3,3,3,9,Loyal Users
14611,288,47,91,3,5,4,12,Loyal Users
14848,29,97,547,5,5,5,15,Champions
14984,1,18,85,5,3,4,12,Loyal Users
15334,2450,6,11,1,1,1,3,Lost
15346,1935,5,16,1,1,2,4,Lost
15480,0,166,374,5,5,5,15,Champions
15598,373,16,23,3,3,2,8,Loyal Users
15645,118,15,36,4,3,3,10,Loyal Users
15789,1987,16,138,1,3,4,8,Casual Users
15794,707,15,57,2,3,3,8,Casual Users
16074,665,8,53,2,2,3,7,Lost
16077,287,5,6,3,1,1,5,Casual Users
16103,2145,10,27,1,2,2,5,Lost
16250,1837,5,12,1,1,1,3,Lost
16312,94,55,171,4,5,5,14,Champions
16889,1076,7,26,2,2,2,6,Lost
17299,1302,18,35,1,3,3,7,Casual Users
17415,714,14,30,2,3,2,7,Casual Users
17599,73,21,128,4,3,4,11,Loyal Users
17844,86,81,842,4,5,5,14,Champions
17931,161,8,8,4,2,1,7,Promising
18414,20,21,131,5,3,4,12,Loyal Users
18662,61,18,33,5,3,3,11,Loyal Users
18697,125,10,14,4,2,1,7,Promising
18892,4,50,69,5,5,4,14,Champions
19796,125,20,104,4,3,4,11,Loyal Users
21014,0,38,71,5,4,4,13,Champions
21136,372,20,51,3,3,3,9,Loyal Users
21188,12,13,15,5,3,1,9,Loyal Users
21244,47,73,210,5,5,5,15,Champions
21597,34,6,31,5,1,2,8,Promising
21760,5043,7,11,1,2,1,4,Lost
21839,2020,7,16,1,2,2,5,Lost
22149,60,137,627,5,5,5,15,Champions
22211,130,108,169,4,5,5,14,Champions
22420,504,12,42,2,3,3,8,Casual Users
22625,110,105,230,4,5,5,14,Champions
22771,856,6,96,2,1,4,7,Lost
23171,8,20,94,5,3,4,12,Loyal Users
23245,79,57,103,4,5,4,13,Champions
23358,28,75,178,5,5,5,15,Champions
23382,592,5,14,2,1,1,4,Lost
23444,600,6,18,2,1,2,5,Lost
23462,833,18,37,2,3,3,8,Casual Users
23822,241,24,98,3,4,4,11,Loyal Users
24339,1412,5,5,1,1,1,3,Lost
24402,100,12,32,4,3,3,10,Loyal Users
25070,5834,10,10,1,2,1,4,Lost
25473,563,9,50,2,2,3,7,Lost
25574,831,14,19,2,3,2,7,Casual Users
25585,1,90,154,5,5,5,15,Champions
25681,45,65,346,5,5,5,15,Champions
25954,113,35,62,4,4,3,11,Loyal Users
26145,423,18,27,3,3,2,8,Loyal Users
26243,213,13,22,3,3,2,8,Loyal Users
13637,44,65,113,5,5,4,14,Champions
13679,97,23,39,4,4,3,11,Loyal Users
13954,90,73,139,4,5,4,13,Champions
14265,79,9,17,4,2,2,8,Promising
14307,683,8,19,2,2,2,6,Lost
14479,3464,8,8,1,2,1,4,Lost
14592,134,15,26,4,3,2,9,Loyal Users
14993,49,6,10,5,1,1,7,Promising
15244,296,5,17,3,1,2,6,Casual Users
15691,1326,6,12,1,1,1,3,Lost
16097,123,89,207,4,5,5,14,Champions
16340,403,33,62,3,4,3,10,Loyal Users
16604,499,9,98,2,2,4,8,Lost
16623,3706,18,112,1,3,4,8,Casual Users
17201,163,189,390,4,5,5,14,Champions
17383,1832,41,77,1,4,4,9,At Risk
17446,113,5,11,4,1,1,6,Promising
17493,4845,5,6,1,1,1,3,Lost
17587,841,6,18,2,1,2,5,Lost
17610,2806,33,187,1,4,5,10,At Risk
17999,124,43,97,4,4,4,12,Champions
18048,103,30,66,4,4,4,12,Champions
18374,272,26,47,3,4,3,10,Loyal Users
18793,2396,5,7,1,1,1,3,Lost
18927,1133,11,38,2,2,3,7,Lost
19267,230,53,201,3,5,5,13,Loyal Users
19422,242,10,32,3,2,3,8,Casual Users
19694,5413,9,10,1,2,1,4,Lost
20767,1560,22,118,1,4,4,9,At Risk
20866,106,33,99,4,4,4,12,Champions
20922,420,18,32,3,3,3,9,Loyal Users
21093,1626,7,13,1,2,1,4,Lost
21133,1708,11,45,1,2,3,6,Lost
21203,1403,33,81,1,4,4,9,At Risk
21973,12,20,56,5,3,3,11,Loyal Users
22374,53,100,241,5,5,5,15,Champions
22737,103,17,155,4,3,5,12,Loyal Users
22784,11,73,446,5,5,5,15,Champions
22967,113,15,45,4,3,3,10,Loyal Users
22982,1512,15,92,1,3,4,8,Casual Users
23199,2622,6,12,1,1,1,3,Lost
23387,79,38,220,4,4,5,13,Champions
23483,139,106,576,4,5,5,14,Champions
23594,129,5,20,4,1,2,7,Promising
23631,148,93,458,4,5,5,14,Champions
23864,88,25,47,4,4,3,11,Loyal Users
23995,1035,7,11,2,2,1,5,Lost
24015,674,23,55,2,4,3,9,At Risk
24107,177,72,234,3,5,5,13,Loyal Users
24110,102,47,187,4,5,5,14,Champions
24160,405,14,38,3,3,3,9,Loyal Users
24682,832,6,24,2,1,2,5,Lost
25249,573,9,18,2,2,2,6,Lost
26000,2563,7,44,1,2,3,6,Lost
26131,3,8,23,5,2,2,9,Promising
26320,437,27,36,3,4,3,10,Loyal Users
13706,528,24,90,2,4,4,10,At Risk
13817,28,8,9,5,2,1,8,Promising
14100,103,168,411,4,5,5,14,Champions
15459,3095,8,11,1,2,1,4,Lost
15569,15,101,261,5,5,5,15,Champions
15573,2594,5,10,1,1,1,3,Lost
16049,264,77,224,3,5,5,13,Loyal Users
16164,684,5,8,2,1,1,4,Lost
16466,108,7,20,4,2,2,8,Promising
16883,131,47,105,4,5,4,13,Champions
16958,304,25,52,3,4,3,10,Loyal Users
16997,132,60,166,4,5,5,14,Champions
17127,523,8,87,2,2,4,8,Lost
17240,5085,8,14,1,2,1,4,Lost
17641,1931,5,18,1,1,2,4,Lost
17988,366,12,112,3,3,4,10,Loyal Users
18032,169,16,36,3,3,3,9,Loyal Users
18055,90,80,372,4,5,5,14,Champions
18404,1813,76,157,1,5,5,11,At Risk
18480,865,8,51,2,2,3,7,Lost
19099,4294,5,5,1,1,1,3,Lost
19115,149,30,39,4,4,3,11,Loyal Users
19747,33,116,216,5,5,5,15,Champions
19850,156,14,42,4,3,3,10,Loyal Users
20009,7,252,881,5,5,5,15,Champions
20039,87,114,345,4,5,5,14,Champions
20539,4609,24,47,1,4,3,8,At Risk
20969,1500,5,17,1,1,2,4,Lost
21345,9,68,158,5,5,5,15,Champions
21361,149,39,49,4,4,3,11,Loyal Users
22208,212,29,84,3,4,4,11,Loyal Users
22235,49,41,157,5,4,5,14,Champions
22360,1855,19,34,1,3,3,7,Casual Users
22647,30,16,30,5,3,2,10,Loyal Users
22855,433,12,15,3,3,1,7,Loyal Users
22952,567,17,35,2,3,3,8,Casual Users
23168,340,5,8,3,1,1,5,Casual Users
23181,52,59,116,5,5,4,14,Champions
23277,513,10,52,2,2,3,7,Lost
23419,606,22,55,2,4,3,9,At Risk
23608,2096,5,10,1,1,1,3,Lost
23892,1280,24,233,1,4,5,10,At Risk
24002,3109,7,21,1,2,2,5,Lost
24022,393,69,218,3,5,5,13,Loyal Users
24147,119,64,242,4,5,5,14,Champions
24279,128,47,286,4,5,5,14,Champions
24627,303,15,30,3,3,2,8,Loyal Users
24852,9,17,23,5,3,2,10,Loyal Users
25186,5690,5,5,1,1,1,3,Lost
25344,1248,24,41,2,4,3,9,At Risk
25412,28,34,105,5,4,4,13,Champions
25503,569,8,19,2,2,2,6,Lost
25579,429,14,65,3,3,4,10,Loyal Users
25789,485,22,161,2,4,5,11,At Risk
25853,110,25,81,4,4,4,12,Champions
13841,157,54,70,4,5,4,13,Champions
14712,704,6,8,2,1,1,4,Lost
14787,13,99,114,5,5,4,14,Champions
14863,298,19,28,3,3,2,8,Loyal Users
14881,875,8,53,2,2,3,7,Lost
15274,117,64,280,4,5,5,14,Champions
15356,124,11,46,4,2,3,9,Promising
15574,137,37,83,4,4,4,12,Champions
15793,1624,7,9,1,2,1,4,Lost
15881,14,34,71,5,4,4,13,Champions
15976,817,64,144,2,5,4,11,At Risk
16662,9,39,109,5,4,4,13,Champions
16714,377,11,23,3,2,2,7,Casual Users
16744,46,11,18,5,2,2,9,Promising
17337,98,84,216,4,5,5,14,Champions
17464,20,171,372,5,5,5,15,Champions
17683,1106,27,75,2,4,4,10,At Risk
18006,268,35,156,3,4,5,12,Loyal Users
19056,286,30,57,3,4,3,10,Loyal Users
19376,2985,6,6,1,1,1,3,Lost
19418,15,125,349,5,5,5,15,Champions
19611,147,66,113,4,5,4,13,Champions
19903,506,11,30,2,2,2,6,Lost
19970,115,16,22,4,3,2,9,Loyal Users
20158,5953,6,15,1,1,1,3,Lost
20315,167,6,8,3,1,1,5,Casual Users
20450,460,12,31,3,3,2,8,Loyal Users
20853,288,8,37,3,2,3,8,Casual Users
21031,1234,11,28,2,2,2,6,Lost
21226,1097,8,33,2,2,3,7,Lost
21344,1569,7,8,1,2,1,4,Lost
21518,35,5,15,5,1,1,7,Promising
22128,31,5,18,5,1,2,8,Promising
22151,2,39,277,5,4,5,14,Champions
22518,415,39,56,3,4,3,10,Loyal Users
22708,302,22,58,3,4,3,10,Loyal Users
22761,79,8,13,4,2,1,7,Promising
22809,117,84,168,4,5,5,14,Champions
23098,946,9,10,2,2,1,5,Lost
23161,524,38,135,2,4,4,10,At Risk
23187,538,14,19,2,3,2,7,Casual Users
23348,270,33,103,3,4,4,11,Loyal Users
23360,650,7,29,2,2,2,6,Lost
23383,3580,5,7,1,1,1,3,Lost
23568,123,16,39,4,3,3,10,Loyal Users
23655,1780,6,41,1,1,3,5,Lost
23708,483,6,13,2,1,1,4,Lost
23711,227,6,11,3,1,1,5,Casual Users
23843,118,10,17,4,2,2,8,Promising
23870,262,45,306,3,4,5,12,Loyal Users
24274,14,75,239,5,5,5,15,Champions
24415,1267,7,19,1,2,2,5,Lost
24489,152,5,11,4,1,1,6,Promising
24511,2,44,120,5,4,4,13,Champions
24637,1444,5,18,1,1,2,4,Lost
24720,285,119,656,3,5,5,13,Loyal Users
24748,533,19,38,2,3,3,8,Casual Users
24884,123,12,53,4,3,3,10,Loyal Users
24897,5,38,126,5,4,4,13,Champions
25258,159,5,8,4,1,1,6,Promising
25317,5,20,49,5,3,3,11,Loyal Users
25504,217,28,48,3,4,3,10,Loyal Users
25777,102,21,37,4,3,3,10,Loyal Users
25939,271,8,10,3,2,1,6,Casual Users
26023,102,17,80,4,3,4,11,Loyal Users
26360,232,11,76,3,2,4,9,Casual Users
26465,12,73,278,5,5,5,15,Champions
14015,102,45,56,4,4,3,11,Loyal Users
14744,1435,5,8,1,1,1,3,Lost
14856,44,37,71,5,4,4,13,Champions
14879,23,9,9,5,2,1,8,Promising
15651,22,91,483,5,5,5,15,Champions
15718,2,104,168,5,5,5,15,Champions
15860,1161,11,16,2,2,2,6,Lost
15908,24,26,73,5,4,4,13,Champions
15913,146,15,59,4,3,3,10,Loyal Users
16572,412,5,12,3,1,1,5,Casual Users
16596,541,7,35,2,2,3,7,Lost
17076,129,6,7,4,1,1,6,Promising
17121,121,15,28,4,3,2,9,Loyal Users
17270,166,38,198,3,4,5,12,Loyal Users
17277,4293,5,5,1,1,1,3,Lost
17391,11,62,199,5,5,5,15,Champions
17497,2684,7,36,1,2,3,6,Lost
17521,85,9,41,4,2,3,9,Promising
17538,126,28,68,4,4,4,12,Champions
17541,9,5,11,5,1,1,7,Promising
17565,1119,9,13,2,2,1,5,Lost
17600,523,17,73,2,3,4,9,Casual Users
18011,414,6,17,3,1,2,6,Casual Users
18178,274,79,206,3,5,5,13,Loyal Users
18400,106,16,66,4,3,4,11,Loyal Users
18443,418,81,166,3,5,5,13,Loyal Users
18555,207,9,25,3,2,2,7,Casual Users
18727,82,22,55,4,4,3,11,Loyal Users
18729,267,43,89,3,4,4,11,Loyal Users
18760,266,23,70,3,4,4,11,Loyal Users
19235,2471,23,47,1,4,3,8,At Risk
19248,425,9,31,3,2,2,7,Casual Users
19517,264,5,5,3,1,1,5,Casual Users
20076,269,12,95,3,3,4,10,Loyal Users
20091,687,7,11,2,2,1,5,Lost
20103,1275,13,18,1,3,2,6,Casual Users
20126,1694,10,20,1,2,2,5,Lost
20260,168,15,39,3,3,3,9,Loyal Users
20283,218,8,24,3,2,2,7,Casual Users
20294,21,112,207,5,5,5,15,Champions
20312,229,15,37,3,3,3,9,Loyal Users
20333,1,36,37,5,4,3,12,Loyal Users
20353,62,101,537,5,5,5,15,Champions
20386,0,74,192,5,5,5,15,Champions
20465,26,15,32,5,3,3,11,Loyal Users
20581,89,38,48,4,4,3,11,Loyal Users
20782,776,20,198,2,3,5,10,Casual Users
20837,2,46,142,5,5,4,14,Champions
20954,2,114,259,5,5,5,15,Champions
21388,13,103,318,5,5,5,15,Champions
21499,85,16,49,4,3,3,10,Loyal Users
21599,965,21,51,2,3,3,8,Casual Users
21819,485,35,124,2,4,4,10,At Risk
21945,11,139,514,5,5,5,15,Champions
22249,164,33,74,4,4,4,12,Champions
22530,45,138,472,5,5,5,15,Champions
22782,155,6,8,4,1,1,6,Promising
22796,113,27,30,4,4,2,10,Loyal Users
23109,2471,6,9,1,1,1,3,Lost
23279,541,12,31,2,3,2,7,Casual Users
23438,159,22,41,4,4,3,11,Loyal Users
23635,102,59,192,4,5,5,14,Champions
24038,55,8,14,5,2,1,8,Promising
24863,238,41,79,3,4,4,11,Loyal Users
24886,763,17,44,2,3,3,8,Casual Users
24932,1124,9,11,2,2,1,5,Lost
25119,108,16,22,4,3,2,9,Loyal Users
25158,501,5,11,2,1,1,4,Lost
25607,115,27,125,4,4,4,12,Champions
25806,4268,10,14,1,2,1,4,Lost
25873,263,22,41,3,4,3,10,Loyal Users
26431,17,18,109,5,3,4,12,Loyal Users
26804,160,11,14,4,2,1,7,Promising
27090,121,32,86,4,4,4,12,Champions
27368,139,12,26,4,3,2,9,Loyal Users
27405,2251,15,44,1,3,3,7,Casual Users
27432,2261,12,12,1,3,1,5,Casual Users
27433,539,16,42,2,3,3,8,Casual Users
27907,126,38,51,4,4,3,11,Loyal Users
28165,413,11,14,3,2,1,6,Casual Users
28614,9,15,31,5,3,2,10,Loyal Users
28988,35,136,301,5,5,5,15,Champions
29397,695,33,88,2,4,4,10,At Risk
29535,144,38,102,4,4,4,12,Champions
29644,128,16,97,4,3,4,11,Loyal Users
29721,79,7,106,4,2,4,10,Promising
29808,118,20,93,4,3,4,11,Loyal Users
29872,383,39,46,3,4,3,10,Loyal Users
30522,105,17,33,4,3,3,10,Loyal Users
30529,277,51,180,3,5,5,13,Loyal Users
30643,397,28,40,3,4,3,10,Loyal Users
30792,3031,8,8,1,2,1,4,Lost
31416,2412,5,9,1,1,1,3,Lost
31469,294,19,40,3,3,3,9,Loyal Users
31487,2689,6,6,1,1,1,3,Lost
31675,130,19,41,4,3,3,10,Loyal Users
31755,1288,11,35,1,2,3,6,Lost
31773,147,15,48,4,3,3,10,Loyal Users
32308,441,43,52,3,4,3,10,Loyal Users
32349,1967,30,197,1,4,5,10,At Risk
32579,114,23,55,4,4,3,11,Loyal Users
32590,728,11,14,2,2,1,5,Lost
32828,1288,22,30,1,4,2,7,At Risk
32977,279,15,37,3,3,3,9,Loyal Users
32983,198,34,83,3,4,4,11,Loyal Users
33220,1585,37,259,1,4,5,10,At Risk
33258,109,94,586,4,5,5,14,Champions
33357,2378,6,6,1,1,1,3,Lost
33536,163,62,76,4,5,4,13,Champions
34041,409,12,38,3,3,3,9,Loyal Users
34223,810,12,17,2,3,2,7,Casual Users
35072,116,68,246,4,5,5,14,Champions
35201,574,10,26,2,2,2,6,Lost
35656,124,23,47,4,4,3,11,Loyal Users
35717,120,84,471,4,5,5,14,Champions
35860,75,16,121,4,3,4,11,Loyal Users
36235,266,11,22,3,2,2,7,Casual Users
36417,68,72,456,5,5,5,15,Champions
36431,40,76,182,5,5,5,15,Champions
36578,662,30,169,2,4,5,11,At Risk
37055,176,97,219,3,5,5,13,Loyal Users
37079,370,69,284,3,5,5,13,Loyal Users
37138,13,23,91,5,4,4,13,Champions
37239,692,5,5,2,1,1,4,Lost
37641,295,47,69,3,5,4,12,Loyal Users
37752,121,40,256,4,4,5,13,Champions
37774,135,17,44,4,3,3,10,Loyal Users
37799,4783,6,9,1,1,1,3,Lost
38221,1010,8,14,2,2,1,5,Lost
38371,0,29,37,5,4,3,12,Loyal Users
38404,16,14,24,5,3,2,10,Loyal Users
38925,308,24,56,3,4,3,10,Loyal Users
38956,227,42,225,3,4,5,12,Loyal Users
39034,3591,6,10,1,1,1,3,Lost
39198,2997,5,24,1,1,2,4,Lost
26659,3144,5,5,1,1,1,3,Lost
26773,424,42,81,3,4,4,11,Loyal Users
26929,133,6,7,4,1,1,6,Promising
27025,3253,29,106,1,4,4,9,At Risk
27131,890,22,31,2,4,2,8,At Risk
27158,139,5,11,4,1,1,6,Promising
27326,1604,7,10,1,2,1,4,Lost
27481,5113,6,13,1,1,1,3,Lost
27531,2987,5,5,1,1,1,3,Lost
27869,25,22,48,5,4,3,12,Loyal Users
28290,1414,15,48,1,3,3,7,Casual Users
28345,641,12,26,2,3,2,7,Casual Users
28492,820,5,20,2,1,2,5,Lost
28496,286,10,10,3,2,1,6,Casual Users
28876,925,91,339,2,5,5,12,At Risk
29168,266,50,122,3,5,4,12,Loyal Users
29278,31,98,480,5,5,5,15,Champions
29332,581,9,64,2,2,4,8,Lost
29430,92,66,205,4,5,5,14,Champions
29468,531,19,88,2,3,4,9,Casual Users
29526,1805,5,17,1,1,2,4,Lost
29586,838,21,41,2,3,3,8,Casual Users
29610,61,75,469,5,5,5,15,Champions
29726,1197,5,19,2,1,2,5,Lost
29765,395,17,168,3,3,5,11,Loyal Users
30235,9,34,111,5,4,4,13,Champions
30393,127,27,61,4,4,3,11,Loyal Users
30560,54,159,717,5,5,5,15,Champions
30689,115,55,94,4,5,4,13,Champions
30999,120,19,100,4,3,4,11,Loyal Users
31340,426,12,47,3,3,3,9,Loyal Users
31387,413,8,16,3,2,2,7,Casual Users
31548,1767,18,55,1,3,3,7,Casual Users
31805,89,97,170,4,5,5,14,Champions
32653,12,10,51,5,2,3,10,Promising
32952,430,29,50,3,4,3,10,Loyal Users
33158,575,10,12,2,2,1,5,Lost
33287,1157,9,70,2,2,4,8,Lost
33389,342,5,6,3,1,1,5,Casual Users
33556,251,61,143,3,5,4,12,Loyal Users
33630,103,50,234,4,5,5,14,Champions
34145,709,42,75,2,4,4,10,At Risk
34507,26,57,529,5,5,5,15,Champions
34661,4476,11,14,1,2,1,4,Lost
34912,132,6,29,4,1,2,7,Promising
35328,163,7,37,4,2,3,9,Promising
35337,8,103,472,5,5,5,15,Champions
35620,428,91,282,3,5,5,13,Loyal Users
35707,252,29,70,3,4,4,11,Loyal Users
35858,508,47,153,2,5,5,12,At Risk
35882,574,11,16,2,2,2,6,Lost
35929,64,25,56,5,4,3,12,Loyal Users
36041,1483,6,21,1,1,2,4,Lost
36266,725,45,64,2,4,4,10,At Risk
36334,976,8,14,2,2,1,5,Lost
36550,85,62,213,4,5,5,14,Champions
36705,3590,8,33,1,2,3,6,Lost
37014,522,23,55,2,4,3,9,At Risk
37306,33,98,269,5,5,5,15,Champions
37413,125,22,42,4,4,3,11,Loyal Users
38337,209,41,132,3,4,4,11,Loyal Users
39091,104,8,10,4,2,1,7,Promising
39152,370,25,56,3,4,3,10,Loyal Users
26511,413,7,9,3,2,1,6,Casual Users
26622,1,31,86,5,4,4,13,Champions
26935,40,39,50,5,4,3,12,Loyal Users
26985,1172,6,6,2,1,1,4,Lost
27049,1250,25,41,2,4,3,9,At Risk
27149,431,132,164,3,5,5,13,Loyal Users
27210,1933,15,27,1,3,2,6,Casual Users
27304,716,8,9,2,2,1,5,Lost
27310,2970,5,11,1,1,1,3,Lost
27485,18,19,107,5,3,4,12,Loyal Users
27754,3128,12,15,1,3,1,5,Casual Users
28174,3555,5,9,1,1,1,3,Lost
28181,20,12,13,5,3,1,9,Loyal Users
28239,30,67,146,5,5,4,14,Champions
28391,2529,5,14,1,1,1,3,Lost
29108,64,19,104,5,3,4,12,Loyal Users
29327,88,26,58,4,4,3,11,Loyal Users
29391,2986,15,116,1,3,4,8,Casual Users
29528,123,5,5,4,1,1,6,Promising
30102,688,5,16,2,1,2,5,Lost
30349,458,5,7,3,1,1,5,Casual Users
30439,3337,5,16,1,1,2,4,Lost
30836,1676,5,9,1,1,1,3,Lost
31154,1928,5,17,1,1,2,4,Lost
31570,491,30,74,2,4,4,10,At Risk
31672,732,9,32,2,2,3,7,Lost
31721,60,9,21,5,2,2,9,Promising
31901,1475,15,21,1,3,2,6,Casual Users
32297,4905,11,33,1,2,3,6,Lost
32435,670,23,37,2,4,3,9,At Risk
33031,5337,7,19,1,2,2,5,Lost
33226,64,13,44,5,3,3,11,Loyal Users
33310,3159,5,14,1,1,1,3,Lost
33583,277,7,7,3,2,1,6,Casual Users
33812,678,47,97,2,5,4,11,At Risk
33834,108,54,104,4,5,4,13,Champions
33980,728,9,31,2,2,2,6,Lost
34364,65,81,102,5,5,4,14,Champions
34496,1715,5,15,1,1,1,3,Lost
34621,3264,5,6,1,1,1,3,Lost
35107,2869,8,9,1,2,1,4,Lost
35383,3,54,113,5,5,4,14,Champions
35476,2855,5,5,1,1,1,3,Lost
35993,420,13,16,3,3,2,8,Loyal Users
36169,783,36,106,2,4,4,10,At Risk
36195,8,144,315,5,5,5,15,Champions
36270,2689,6,21,1,1,2,4,Lost
36711,8,109,416,5,5,5,15,Champions
36978,2432,12,45,1,3,3,7,Casual Users
37076,282,26,114,3,4,4,11,Loyal Users
37100,65,132,452,5,5,5,15,Champions
37125,197,60,200,3,5,5,13,Loyal Users
37274,1155,5,9,2,1,1,4,Lost
37332,65,14,38,5,3,3,11,Loyal Users
37364,307,11,14,3,2,1,6,Casual Users
37459,16,74,109,5,5,4,14,Champions
37468,719,20,23,2,3,2,7,Casual Users
37875,1954,8,48,1,2,3,6,Lost
38587,407,37,68,3,4,4,11,Loyal Users
38589,10,152,650,5,5,5,15,Champions
38676,947,18,76,2,3,4,9,Casual Users
38793,835,9,29,2,2,2,6,Lost
38824,165,9,18,4,2,2,8,Promising
39160,1112,7,94,2,2,4,8,Lost
39206,226,27,38,3,4,3,10,Loyal Users
26523,371,7,18,3,2,2,7,Casual Users
26570,693,39,260,2,4,5,11,At Risk
26644,1143,7,16,2,2,2,6,Lost
27092,30,19,30,5,3,2,10,Loyal Users
27341,110,25,128,4,4,4,12,Champions
27671,1,27,113,5,4,4,13,Champions
27753,70,75,246,4,5,5,14,Champions
27771,423,19,68,3,3,4,10,Loyal Users
27944,764,15,37,2,3,3,8,Casual Users
28009,1649,10,32,1,2,3,6,Lost
28349,89,104,564,4,5,5,14,Champions
28458,2467,6,10,1,1,1,3,Lost
28463,5687,7,20,1,2,2,5,Lost
28557,438,18,130,3,3,4,10,Loyal Users
28780,1400,11,25,1,2,2,5,Lost
28781,121,6,36,4,1,3,8,Promising
28870,183,88,364,3,5,5,13,Loyal Users
28897,146,52,82,4,5,4,13,Champions
29184,659,13,37,2,3,3,8,Casual Users
29211,0,96,403,5,5,5,15,Champions
29296,584,78,153,2,5,5,12,At Risk
29321,855,15,77,2,3,4,9,Casual Users
29347,949,21,42,2,3,3,8,Casual Users
29473,974,6,7,2,1,1,4,Lost
29539,248,29,70,3,4,4,11,Loyal Users
29572,4678,5,7,1,1,1,3,Lost
29966,41,98,387,5,5,5,15,Champions
29987,212,6,10,3,1,1,5,Casual Users
30282,409,16,22,3,3,2,8,Loyal Users
30468,5326,8,39,1,2,3,6,Lost
30504,281,44,66,3,4,4,11,Loyal Users
30573,101,56,225,4,5,5,14,Champions
30640,1745,15,29,1,3,2,6,Casual Users
30757,110,10,13,4,2,1,7,Promising
30800,13,7,11,5,2,1,8,Promising
30861,368,25,63,3,4,4,11,Loyal Users
31040,259,12,57,3,3,3,9,Loyal Users
31090,413,19,73,3,3,4,10,Loyal Users
31324,569,13,27,2,3,2,7,Casual Users
31633,68,50,107,5,5,4,14,Champions
31674,36,114,194,5,5,5,15,Champions
32084,618,11,20,2,2,2,6,Lost
32332,108,36,62,4,4,3,11,Loyal Users
32363,1930,8,19,1,2,2,5,Lost
32488,32,106,331,5,5,5,15,Champions
32722,37,47,107,5,5,4,14,Champions
32919,1833,49,89,1,5,4,10,At Risk
32965,22,11,14,5,2,1,8,Promising
33017,723,20,45,2,3,3,8,Casual Users
33084,317,6,14,3,1,1,5,Casual Users
33085,1237,12,27,2,3,2,7,Casual Users
33235,4,52,293,5,5,5,15,Champions
33844,537,16,75,2,3,4,9,Casual Users
33906,37,28,78,5,4,4,13,Champions
34193,147,58,179,4,5,5,14,Champions
34465,539,14,34,2,3,3,8,Casual Users
34930,0,134,243,5,5,5,15,Champions
34953,1973,5,18,1,1,2,4,Lost
35011,135,7,11,4,2,1,7,Promising
35119,244,15,50,3,3,3,9,Loyal Users
35179,893,17,23,2,3,2,7,Casual Users
35250,240,56,82,3,5,4,12,Loyal Users
35533,1489,8,9,1,2,1,4,Lost
35789,135,27,36,4,4,3,11,Loyal Users
35834,159,70,258,4,5,5,14,Champions
35878,50,29,31,5,4,2,11,Loyal Users
35906,690,8,18,2,2,2,6,Lost
35967,23,30,56,5,4,3,12,Loyal Users
36311,4241,6,12,1,1,1,3,Lost
36359,292,7,7,3,2,1,6,Casual Users
36571,16,87,227,5,5,5,15,Champions
36925,76,53,151,4,5,5,14,Champions
37191,293,34,161,3,4,5,12,Loyal Users
37234,406,15,51,3,3,3,9,Loyal Users
37452,134,52,98,4,5,4,13,Champions
37662,299,33,96,3,4,4,11,Loyal Users
37829,154,95,280,4,5,5,14,Champions
37940,19,59,244,5,5,5,15,Champions
38576,864,16,27,2,3,2,7,Casual Users
26612,296,25,141,3,4,4,11,Loyal Users
26811,410,48,103,3,5,4,12,Loyal Users
26822,2311,5,15,1,1,1,3,Lost
26975,2666,6,18,1,1,2,4,Lost
27223,208,34,141,3,4,4,11,Loyal Users
27812,1411,19,75,1,3,4,8,Casual Users
27882,2281,18,26,1,3,2,6,Casual Users
27909,151,9,10,4,2,1,7,Promising
27930,462,9,13,3,2,1,6,Casual Users
27981,121,13,39,4,3,3,10,Loyal Users
28426,2404,5,16,1,1,2,4,Lost
28429,1990,7,31,1,2,2,5,Lost
28656,1,39,134,5,4,4,13,Champions
28799,92,43,72,4,4,4,12,Champions
28909,163,52,148,4,5,5,14,Champions
28921,688,5,10,2,1,1,4,Lost
28966,2525,8,18,1,2,2,5,Lost
29146,141,30,73,4,4,4,12,Champions
29432,20,69,126,5,5,4,14,Champions
29524,402,8,28,3,2,2,7,Casual Users
29800,468,9,21,3,2,2,7,Casual Users
30247,389,9,24,3,2,2,7,Casual Users
30373,4252,5,5,1,1,1,3,Lost
30427,21,63,172,5,5,5,15,Champions
30480,2456,7,20,1,2,2,5,Lost
30493,110,5,21,4,1,2,7,Promising
30742,1590,9,22,1,2,2,5,Lost
30840,2101,11,28,1,2,2,5,Lost
31186,19,49,82,5,5,4,14,Champions
31339,488,12,30,2,3,2,7,Casual Users
31560,4807,8,37,1,2,3,6,Lost
31607,993,10,25,2,2,2,6,Lost
31661,377,40,161,3,4,5,12,Loyal Users
32340,240,18,76,3,3,4,10,Loyal Users
32594,405,5,27,3,1,2,6,Casual Users
32638,159,49,102,4,5,4,13,Champions
32811,416,15,25,3,3,2,8,Loyal Users
33023,8,33,84,5,4,4,13,Champions
33309,741,51,216,2,5,5,12,At Risk
33738,227,30,172,3,4,5,12,Loyal Users
33979,1932,6,10,1,1,1,3,Lost
34356,3037,11,22,1,2,2,5,Lost
34484,257,34,70,3,4,4,11,Loyal Users
34540,48,8,22,5,2,2,9,Promising
34837,82,15,80,4,3,4,11,Loyal Users
34963,131,8,24,4,2,2,8,Promising
35277,432,21,32,3,3,3,9,Loyal Users
35350,1107,13,46,2,3,3,8,Casual Users
35357,75,8,17,4,2,2,8,Promising
35392,735,8,24,2,2,2,6,Lost
35548,117,81,240,4,5,5,14,Champions
35870,91,7,11,4,2,1,7,Promising
35873,2740,5,11,1,1,1,3,Lost
36189,2631,8,27,1,2,2,5,Lost
36637,1593,12,49,1,3,3,7,Casual Users
36735,240,39,309,3,4,5,12,Loyal Users
36737,39,5,5,5,1,1,7,Promising
36851,1288,6,21,1,1,2,4,Lost
37992,1309,6,21,1,1,2,4,Lost
38020,28,14,41,5,3,3,11,Loyal Users
38229,26,72,263,5,5,5,15,Champions
38283,175,7,35,3,2,3,8,Casual Users
38536,771,20,30,2,3,2,7,Casual Users
38691,4478,7,22,1,2,2,5,Lost
39136,90,15,30,4,3,2,9,Loyal Users
39138,234,15,19,3,3,2,8,Loyal Users
26611,856,6,18,2,1,2,5,Lost
27119,2,80,334,5,5,5,15,Champions
27183,1138,18,25,2,3,2,7,Casual Users
27376,26,77,139,5,5,4,14,Champions
27511,656,55,119,2,5,4,11,At Risk
28116,390,5,21,3,1,2,6,Casual Users
28665,2304,11,22,1,2,2,5,Lost
29300,1851,14,41,1,3,3,7,Casual Users
29922,398,7,14,3,2,1,6,Casual Users
30025,24,85,368,5,5,5,15,Champions
30156,15,14,93,5,3,4,12,Loyal Users
30253,1289,11,37,1,2,3,6,Lost
30279,1698,5,37,1,1,3,5,Lost
30317,1902,5,20,1,1,2,4,Lost
30404,23,75,148,5,5,5,15,Champions
30543,461,5,7,3,1,1,5,Casual Users
30635,1122,17,41,2,3,3,8,Casual Users
30697,92,7,25,4,2,2,8,Promising
30954,8,57,286,5,5,5,15,Champions
31112,108,36,159,4,4,5,13,Champions
31273,173,74,464,3,5,5,13,Loyal Users
31280,541,59,275,2,5,5,12,At Risk
31401,118,8,32,4,2,3,9,Promising
31670,671,5,22,2,1,2,5,Lost
31765,1993,6,27,1,1,2,4,Lost
31850,30,29,223,5,4,5,14,Champions
31978,18,30,121,5,4,4,13,Champions
32046,695,27,47,2,4,3,9,At Risk
32093,553,6,8,2,1,1,4,Lost
32331,4988,8,13,1,2,1,4,Lost
32830,10,37,324,5,4,5,14,Champions
32953,151,12,30,4,3,2,9,Loyal Users
32973,593,5,6,2,1,1,4,Lost
33057,545,44,144,2,4,4,10,At Risk
33649,147,40,127,4,4,4,12,Champions
33817,532,47,107,2,5,4,11,At Risk
33884,19,47,222,5,5,5,15,Champions
34228,8,91,154,5,5,5,15,Champions
34664,11,6,9,5,1,1,7,Promising
34751,247,41,45,3,4,3,10,Loyal Users
34854,153,48,80,4,5,4,13,Champions
35364,76,40,111,4,4,4,12,Champions
35872,3089,11,17,1,2,2,5,Lost
35983,238,22,60,3,4,3,10,Loyal Users
36043,657,35,127,2,4,4,10,At Risk
36097,240,7,15,3,2,1,6,Casual Users
36163,1125,6,10,2,1,1,4,Lost
36451,103,26,88,4,4,4,12,Champions
36877,2840,12,62,1,3,3,7,Casual Users
36971,30,43,156,5,4,5,14,Champions
37058,1069,19,43,2,3,3,8,Casual Users
37267,25,30,112,5,4,4,13,Champions
37753,31,88,198,5,5,5,15,Champions
37890,2700,29,73,1,4,4,9,At Risk
37954,1083,25,60,2,4,3,9,At Risk
38026,1,32,37,5,4,3,12,Loyal Users
38364,7,26,59,5,4,3,12,Loyal Users
38496,23,14,20,5,3,2,10,Loyal Users
38636,694,28,64,2,4,4,10,At Risk
38693,406,7,10,3,2,1,6,Casual Users
38805,1657,8,51,1,2,3,6,Lost
38826,134,46,194,4,5,5,14,Champions
38927,360,19,95,3,3,4,10,Loyal Users
38936,794,14,31,2,3,2,7,Casual Users
38938,2654,15,20,1,3,2,6,Casual Users
39185,18,39,145,5,4,4,13,Champions
26702,793,16,37,2,3,3,8,Casual Users
27287,123,55,171,4,5,5,14,Champions
27315,859,7,17,2,2,2,6,Lost
27468,4324,5,5,1,1,1,3,Lost
27621,13,13,25,5,3,2,10,Loyal Users
27674,87,16,42,4,3,3,10,Loyal Users
27702,121,7,32,4,2,3,9,Promising
27852,929,12,50,2,3,3,8,Casual Users
27962,291,9,13,3,2,1,6,Casual Users
28393,828,7,13,2,2,1,5,Lost
28562,3584,5,5,1,1,1,3,Lost
28651,267,35,96,3,4,4,11,Loyal Users
28938,15,24,100,5,4,4,13,Champions
29030,714,5,20,2,1,2,5,Lost
29072,2503,6,25,1,1,2,4,Lost
29143,11,22,83,5,4,4,13,Champions
29148,153,37,233,4,4,5,13,Champions
29202,275,66,106,3,5,4,12,Loyal Users
29366,86,21,91,4,3,4,11,Loyal Users
29378,1569,5,8,1,1,1,3,Lost
29515,299,70,108,3,5,4,12,Loyal Users
29931,16,22,76,5,4,4,13,Champions
30094,2612,5,7,1,1,1,3,Lost
30310,275,16,31,3,3,2,8,Loyal Users
30327,43,27,56,5,4,3,12,Loyal Users
30435,407,32,168,3,4,5,12,Loyal Users
30511,17,124,434,5,5,5,15,Champions
30704,933,11,37,2,2,3,7,Lost
30825,1417,20,83,1,3,4,8,Casual Users
31414,393,35,52,3,4,3,10,Loyal Users
31433,3,47,146,5,5,4,14,Champions
31462,3090,6,14,1,1,1,3,Lost
31713,544,6,9,2,1,1,4,Lost
31916,2505,30,144,1,4,4,9,At Risk
32578,441,10,35,3,2,3,8,Casual Users
32685,501,10,25,2,2,2,6,Lost
32701,2574,15,25,1,3,2,6,Casual Users
32764,1567,8,80,1,2,4,7,Lost
32899,580,9,10,2,2,1,5,Lost
32962,26,70,171,5,5,5,15,Champions
33096,67,56,88,5,5,4,14,Champions
33229,399,22,58,3,4,3,10,Loyal Users
33288,38,18,71,5,3,4,12,Loyal Users
33410,8,84,466,5,5,5,15,Champions
33880,1455,7,7,1,2,1,4,Lost
34060,3017,5,22,1,1,2,4,Lost
34106,12,96,155,5,5,5,15,Champions
34141,64,61,415,5,5,5,15,Champions
34390,3826,8,10,1,2,1,4,Lost
35186,2251,14,35,1,3,3,7,Casual Users
35257,2708,9,13,1,2,1,4,Lost
35346,6,54,206,5,5,5,15,Champions
35347,2518,47,56,1,5,3,9,At Risk
35769,91,72,546,4,5,5,14,Champions
35841,779,5,20,2,1,2,5,Lost
36007,603,10,37,2,2,3,7,Lost
36087,1943,8,13,1,2,1,4,Lost
36242,24,58,200,5,5,5,15,Champions
36261,83,158,259,4,5,5,14,Champions
36478,43,42,190,5,4,5,14,Champions
36658,3315,8,8,1,2,1,4,Lost
37089,1391,8,14,1,2,1,4,Lost
37106,1,32,117,5,4,4,13,Champions
37345,889,10,27,2,2,2,6,Lost
37347,421,7,33,3,2,3,8,Casual Users
37904,427,26,40,3,4,3,10,Loyal Users
37970,94,52,127,4,5,4,13,Champions
38187,1814,8,11,1,2,1,4,Lost
38380,1250,16,24,2,3,2,7,Casual Users
38807,29,17,59,5,3,3,11,Loyal Users
39087,2293,7,18,1,2,2,5,Lost
27110,467,16,37,3,3,3,9,Loyal Users
27143,227,31,144,3,4,4,11,Loyal Users
27202,1265,35,68,1,4,4,9,At Risk
27473,340,21,91,3,3,4,10,Loyal Users
28005,1668,5,8,1,1,1,3,Lost
28010,459,13,39,3,3,3,9,Loyal Users
28197,121,76,118,4,5,4,13,Champions
28379,4120,5,8,1,1,1,3,Lost
28383,4570,6,19,1,1,2,4,Lost
28498,309,24,37,3,4,3,10,Loyal Users
28621,3430,5,35,1,1,3,5,Lost
28625,1637,36,219,1,4,5,10,At Risk
29038,1070,8,45,2,2,3,7,Lost
29048,138,45,278,4,4,5,13,Champions
29217,634,31,53,2,4,3,9,At Risk
29326,272,10,11,3,2,1,6,Casual Users
29492,308,12,21,3,3,2,8,Loyal Users
29590,859,5,8,2,1,1,4,Lost
30017,17,6,9,5,1,1,7,Promising
30471,3122,7,25,1,2,2,5,Lost
30652,106,13,60,4,3,3,10,Loyal Users
30815,211,9,14,3,2,1,6,Casual Users
30925,236,7,10,3,2,1,6,Casual Users
31385,2,38,164,5,4,5,14,Champions
31692,334,6,35,3,1,3,7,Casual Users
31745,422,23,76,3,4,4,11,Loyal Users
32266,41,73,532,5,5,5,15,Champions
32399,155,61,318,4,5,5,14,Champions
32459,3532,5,6,1,1,1,3,Lost
32463,262,10,15,3,2,1,6,Casual Users
32498,887,21,89,2,3,4,9,Casual Users
32626,2637,7,20,1,2,2,5,Lost
32747,6,54,199,5,5,5,15,Champions
32904,83,193,331,4,5,5,14,Champions
32957,2007,6,8,1,1,1,3,Lost
33043,464,9,35,3,2,3,8,Casual Users
33097,880,32,54,2,4,3,9,At Risk
33320,592,19,24,2,3,2,7,Casual Users
33619,113,31,72,4,4,4,12,Champions
33705,298,19,37,3,3,3,9,Loyal Users
33741,218,67,106,3,5,4,12,Loyal Users
34318,356,44,73,3,4,4,11,Loyal Users
34384,853,14,43,2,3,3,8,Casual Users
34653,706,5,10,2,1,1,4,Lost
35065,38,29,172,5,4,5,14,Champions
35073,245,86,339,3,5,5,13,Loyal Users
35397,142,21,53,4,3,3,10,Loyal Users
35422,1,33,123,5,4,4,13,Champions
35944,757,20,46,2,3,3,8,Casual Users
36115,114,13,47,4,3,3,10,Loyal Users
36633,1409,5,7,1,1,1,3,Lost
37023,2,14,135,5,3,4,12,Loyal Users
37114,16,99,300,5,5,5,15,Champions
37294,153,46,119,4,5,4,13,Champions
37704,1641,16,54,1,3,3,7,Casual Users
37939,145,15,31,4,3,2,9,Loyal Users
38080,128,24,27,4,4,2,10,Loyal Users
38122,2266,5,17,1,1,2,4,Lost
38332,3007,38,127,1,4,4,9,At Risk
38383,1,128,206,5,5,5,15,Champions
38386,137,54,108,4,5,4,13,Champions
38477,4,97,218,5,5,5,15,Champions
38519,2,78,183,5,5,5,15,Champions
38563,544,22,69,2,4,4,10,At Risk
38575,3326,5,16,1,1,2,4,Lost
38672,2265,10,20,1,2,2,5,Lost
38962,3334,19,21,1,3,2,6,Casual Users
39043,307,70,230,3,5,5,13,Loyal Users
26499,1723,46,58,1,5,3,9,At Risk
26597,1581,5,11,1,1,1,3,Lost
27002,159,34,125,4,4,4,12,Champions
27187,2,39,91,5,4,4,13,Champions
27672,56,74,385,5,5,5,15,Champions
27863,30,75,242,5,5,5,15,Champions
28079,3,14,15,5,3,1,9,Loyal Users
28259,90,127,469,4,5,5,14,Champions
28272,1215,57,121,2,5,4,11,At Risk
28356,505,17,30,2,3,2,7,Casual Users
28432,116,22,84,4,4,4,12,Champions
28457,110,61,197,4,5,5,14,Champions
28486,493,9,12,2,2,1,5,Lost
28546,870,114,204,2,5,5,12,At Risk
28589,1806,14,52,1,3,3,7,Casual Users
28661,250,13,28,3,3,2,8,Loyal Users
28692,17,36,151,5,4,5,14,Champions
28931,330,9,22,3,2,2,7,Casual Users
29580,36,12,24,5,3,2,10,Loyal Users
29621,157,12,46,4,3,3,10,Loyal Users
30226,9,102,237,5,5,5,15,Champions
30243,70,50,207,4,5,5,14,Champions
30289,40,91,470,5,5,5,15,Champions
30304,10,31,70,5,4,4,13,Champions
30319,536,15,32,2,3,3,8,Casual Users
30485,240,25,64,3,4,4,11,Loyal Users
30535,149,7,30,4,2,2,8,Promising
30601,117,11,18,4,2,2,8,Promising
30693,2811,15,30,1,3,2,6,Casual Users
31011,3182,9,21,1,2,2,5,Lost
31429,496,7,20,2,2,2,6,Lost
31485,465,18,66,3,3,4,10,Loyal Users
31737,111,38,68,4,4,4,12,Champions
31786,264,43,155,3,4,5,12,Loyal Users
31875,1536,12,50,1,3,3,7,Casual Users
31997,11,27,127,5,4,4,13,Champions
32486,0,85,619,5,5,5,15,Champions
33300,718,30,106,2,4,4,10,At Risk
33365,156,43,189,4,4,5,13,Champions
33404,8,65,132,5,5,4,14,Champions
33757,68,7,11,5,2,1,8,Promising
33882,845,11,88,2,2,4,8,Lost
34109,13,44,64,5,4,4,13,Champions
34203,2822,6,53,1,1,3,5,Lost
34474,1135,12,13,2,3,1,6,Casual Users
34679,12,18,39,5,3,3,11,Loyal Users
34767,136,23,121,4,4,4,12,Champions
34848,154,146,482,4,5,5,14,Champions
34908,9,33,99,5,4,4,13,Champions
34920,280,11,35,3,2,3,8,Casual Users
35013,85,33,38,4,4,3,11,Loyal Users
35056,18,6,9,5,1,1,7,Promising
35057,189,16,18,3,3,2,8,Loyal Users
35203,11,9,12,5,2,1,8,Promising
35242,1841,16,102,1,3,4,8,Casual Users
35261,36,73,250,5,5,5,15,Champions
35344,899,5,7,2,1,1,4,Lost
35444,2,74,245,5,5,5,15,Champions
35542,1073,9,12,2,2,1,5,Lost
35575,9,31,45,5,4,3,12,Loyal Users
35599,170,53,140,3,5,4,12,Loyal Users
35629,297,8,19,3,2,2,7,Casual Users
35958,116,99,486,4,5,5,14,Champions
36234,4422,7,9,1,2,1,4,Lost
36446,255,8,41,3,2,3,8,Casual Users
37110,102,30,58,4,4,3,11,Loyal Users
37205,4,11,22,5,2,2,9,Promising
37243,372,89,140,3,5,4,12,Loyal Users
37697,4007,7,13,1,2,1,4,Lost
38013,99,56,141,4,5,4,13,Champions
38045,87,47,337,4,5,5,14,Champions
38051,1244,19,62,2,3,3,8,Casual Users
38118,106,13,45,4,3,3,10,Loyal Users
38125,267,18,34,3,3,3,9,Loyal Users
38289,1857,22,84,1,4,4,9,At Risk
38497,103,12,20,4,3,2,9,Loyal Users
38569,732,16,25,2,3,2,7,Casual Users
38685,256,26,93,3,4,4,11,Loyal Users
38797,686,32,49,2,4,3,9,At Risk
39172,186,13,15,3,3,1,7,Loyal Users
39199,96,6,8,4,1,1,6,Promising
39222,1381,5,13,1,1,1,3,Lost
26599,1198,30,51,2,4,3,9,At Risk
26784,548,23,59,2,4,3,9,At Risk
27821,74,17,94,4,3,4,11,Loyal Users
27859,39,87,261,5,5,5,15,Champions
28236,1106,14,25,2,3,2,7,Casual Users
28461,229,23,51,3,4,3,10,Loyal Users
28495,580,5,18,2,1,2,5,Lost
28591,585,5,6,2,1,1,4,Lost
28605,3579,5,24,1,1,2,4,Lost
28884,6,18,86,5,3,4,12,Loyal Users
29033,9,152,532,5,5,5,15,Champions
29622,1146,7,25,2,2,2,6,Lost
29908,3969,9,13,1,2,1,4,Lost
30157,696,8,11,2,2,1,5,Lost
30655,1,13,16,5,3,2,10,Loyal Users
30874,15,8,46,5,2,3,10,Promising
31193,2068,6,8,1,1,1,3,Lost
31276,65,55,294,5,5,5,15,Champions
31888,1482,7,13,1,2,1,4,Lost
31902,138,51,191,4,5,5,14,Champions
32122,833,8,14,2,2,1,5,Lost
33040,4,85,177,5,5,5,15,Champions
33174,1502,17,38,1,3,3,7,Casual Users
33326,259,6,18,3,1,2,6,Casual Users
33390,97,101,137,4,5,4,13,Champions
33468,421,34,47,3,4,3,10,Loyal Users
33486,130,49,262,4,5,5,14,Champions
33837,1718,6,12,1,1,1,3,Lost
33932,4,22,26,5,4,2,11,Loyal Users
34088,4,111,983,5,5,5,15,Champions
34198,11,93,404,5,5,5,15,Champions
34320,3615,5,5,1,1,1,3,Lost
34674,139,26,94,4,4,4,12,Champions
34786,457,34,58,3,4,3,10,Loyal Users
35005,569,43,212,2,4,5,11,At Risk
35020,5,36,145,5,4,4,13,Champions
35080,77,156,557,4,5,5,14,Champions
35562,771,5,5,2,1,1,4,Lost
35589,920,16,22,2,3,2,7,Casual Users
35598,1241,6,12,2,1,1,4,Lost
35646,101,27,59,4,4,3,11,Loyal Users
35755,507,7,30,2,2,2,6,Lost
36029,117,77,153,4,5,5,14,Champions
36249,1271,5,7,1,1,1,3,Lost
36485,1006,6,20,2,1,2,5,Lost
36780,1388,5,5,1,1,1,3,Lost
37833,1671,8,18,1,2,2,5,Lost
37865,15,85,138,5,5,4,14,Champions
37892,731,11,19,2,2,2,6,Lost
38248,3485,5,8,1,1,1,3,Lost
38367,423,22,41,3,4,3,10,Loyal Users
38372,126,23,57,4,4,3,11,Loyal Users
39056,1088,27,61,2,4,3,9,At Risk
26476,42,69,181,5,5,5,15,Champions
26571,131,7,20,4,2,2,8,Promising
26841,2438,12,14,1,3,1,5,Casual Users
26931,34,16,32,5,3,3,11,Loyal Users
27073,1723,10,11,1,2,1,4,Lost
27206,6,28,55,5,4,3,12,Loyal Users
27588,389,9,15,3,2,1,6,Casual Users
27700,270,83,325,3,5,5,13,Loyal Users
28109,1953,7,44,1,2,3,6,Lost
28161,32,21,31,5,3,2,10,Loyal Users
28205,1407,10,19,1,2,2,5,Lost
28572,28,53,242,5,5,5,15,Champions
29255,139,19,82,4,3,4,11,Loyal Users
29259,336,56,222,3,5,5,13,Loyal Users
29367,323,24,40,3,4,3,10,Loyal Users
29627,10,21,32,5,3,3,11,Loyal Users
29655,1223,16,18,2,3,2,7,Casual Users
29881,96,108,256,4,5,5,14,Champions
30158,823,9,23,2,2,2,6,Lost
30445,5185,5,6,1,1,1,3,Lost
30883,1998,13,34,1,3,3,7,Casual Users
31105,18,39,76,5,4,4,13,Champions
31313,2752,9,23,1,2,2,5,Lost
31389,24,34,40,5,4,3,12,Loyal Users
31411,398,27,89,3,4,4,11,Loyal Users
31776,747,5,5,2,1,1,4,Lost
31858,405,57,157,3,5,5,13,Loyal Users
31885,1653,10,32,1,2,3,6,Lost
31890,1779,8,26,1,2,2,5,Lost
32318,128,101,235,4,5,5,14,Champions
32597,1095,14,29,2,3,2,7,Casual Users
32888,783,6,64,2,1,4,7,Lost
33376,142,12,46,4,3,3,10,Loyal Users
33391,11,7,9,5,2,1,8,Promising
33527,118,8,23,4,2,2,8,Promising
34464,124,201,296,4,5,5,14,Champions
34600,64,75,162,5,5,5,15,Champions
34689,16,24,109,5,4,4,13,Champions
35126,268,25,32,3,4,3,10,Loyal Users
35322,170,107,463,3,5,5,13,Loyal Users
35390,245,23,38,3,4,3,10,Loyal Users
35393,13,33,231,5,4,5,14,Champions
35451,697,9,83,2,2,4,8,Lost
35470,871,8,9,2,2,1,5,Lost
35822,159,30,120,4,4,4,12,Champions
35843,1439,11,17,1,2,2,5,Lost
35946,97,58,217,4,5,5,14,Champions
36081,1410,7,7,1,2,1,4,Lost
36153,237,32,141,3,4,4,11,Loyal Users
36201,3,38,122,5,4,4,13,Champions
36301,233,9,55,3,2,3,8,Casual Users
36617,12,113,315,5,5,5,15,Champions
36675,1280,7,34,1,2,3,6,Lost
36820,2137,5,20,1,1,2,4,Lost
36836,1113,26,99,2,4,4,10,At Risk
36913,1778,7,10,1,2,1,4,Lost
36955,271,9,18,3,2,2,7,Casual Users
37157,95,94,244,4,5,5,14,Champions
37161,434,14,25,3,3,2,8,Loyal Users
37293,1328,21,57,1,3,3,7,Casual Users
37338,18,44,181,5,4,5,14,Champions
37909,446,29,115,3,4,4,11,Loyal Users
38201,3045,5,9,1,1,1,3,Lost
38488,48,29,76,5,4,4,13,Champions
38537,216,39,92,3,4,4,11,Loyal Users
38831,86,35,38,4,4,3,11,Loyal Users
39041,62,26,29,5,4,2,11,Loyal Users
39053,3124,15,15,1,3,1,5,Casual Users
26747,23,111,413,5,5,5,15,Champions
26791,163,8,19,4,2,2,8,Promising
27292,972,8,11,2,2,1,5,Lost
27325,1985,8,10,1,2,1,4,Lost
27330,424,23,82,3,4,4,11,Loyal Users
27461,17,18,44,5,3,3,11,Loyal Users
27807,1149,7,37,2,2,3,7,Lost
28097,3141,18,22,1,3,2,6,Casual Users
28307,996,19,77,2,3,4,9,Casual Users
28390,3575,5,5,1,1,1,3,Lost
28478,1265,7,16,1,2,2,5,Lost
28727,210,33,53,3,4,3,10,Loyal Users
28791,304,8,13,3,2,1,6,Casual Users
29020,24,47,112,5,5,4,14,Champions
29093,543,29,46,2,4,3,9,At Risk
29247,644,5,7,2,1,1,4,Lost
29824,414,29,75,3,4,4,11,Loyal Users
29988,3449,5,9,1,1,1,3,Lost
30125,2494,9,30,1,2,2,5,Lost
30164,31,5,23,5,1,2,8,Promising
30258,37,37,87,5,4,4,13,Champions
30409,28,75,274,5,5,5,15,Champions
30460,436,46,115,3,5,4,12,Loyal Users
30466,2866,10,15,1,2,1,4,Lost
30490,288,14,72,3,3,4,10,Loyal Users
30963,37,166,646,5,5,5,15,Champions
31119,138,163,405,4,5,5,14,Champions
31206,245,14,24,3,3,2,8,Loyal Users
31370,653,6,24,2,1,2,5,Lost
31837,138,7,12,4,2,1,7,Promising
32126,15,79,377,5,5,5,15,Champions
32211,492,5,8,2,1,1,4,Lost
32669,5,23,27,5,4,2,11,Loyal Users
33147,62,60,123,5,5,4,14,Champions
33338,452,30,39,3,4,3,10,Loyal Users
33453,517,31,42,2,4,3,9,At Risk
33538,124,47,262,4,5,5,14,Champions
33610,23,5,13,5,1,1,7,Promising
33642,143,22,126,4,4,4,12,Champions
33667,939,5,11,2,1,1,4,Lost
33768,4569,6,6,1,1,1,3,Lost
33793,270,69,88,3,5,4,12,Loyal Users
33925,113,17,176,4,3,5,12,Loyal Users
33996,549,25,41,2,4,3,9,At Risk
34519,143,5,7,4,1,1,6,Promising
34633,447,6,25,3,1,2,6,Casual Users
34882,545,121,217,2,5,5,12,At Risk
34957,1,31,56,5,4,3,12,Loyal Users
34983,1107,6,6,2,1,1,4,Lost
35178,41,191,426,5,5,5,15,Champions
35334,512,31,60,2,4,3,9,At Risk
35425,60,47,111,5,5,4,14,Champions
35751,1041,27,205,2,4,5,11,At Risk
35758,12,53,209,5,5,5,15,Champions
35856,111,47,99,4,5,4,13,Champions
35895,1,55,253,5,5,5,15,Champions
36085,36,105,256,5,5,5,15,Champions
36105,555,40,256,2,4,5,11,At Risk
36138,7,150,568,5,5,5,15,Champions
36174,419,51,72,3,5,4,12,Loyal Users
36197,140,33,160,4,4,5,13,Champions
36875,3258,10,10,1,2,1,4,Lost
37147,5658,5,7,1,1,1,3,Lost
37317,208,34,117,3,4,4,11,Loyal Users
37798,248,14,21,3,3,2,8,Loyal Users
37846,2117,5,7,1,1,1,3,Lost
37949,379,21,23,3,3,2,8,Loyal Users
38096,502,21,81,2,3,4,9,Casual Users
38204,94,8,31,4,2,2,8,Promising
38246,462,35,89,3,4,4,11,Loyal Users
38418,997,18,60,2,3,3,8,Casual Users
38428,431,23,47,3,4,3,10,Loyal Users
38655,218,29,268,3,4,5,12,Loyal Users
38784,167,14,68,3,3,4,10,Loyal Users
26777,134,14,18,4,3,2,9,Loyal Users
26862,940,14,24,2,3,2,7,Casual Users
26870,139,18,46,4,3,3,10,Loyal Users
26951,1140,17,52,2,3,3,8,Casual Users
26952,569,59,102,2,5,4,11,At Risk
27093,223,18,39,3,3,3,9,Loyal Users
27239,603,12,44,2,3,3,8,Casual Users
27280,3030,5,10,1,1,1,3,Lost
27457,3883,12,14,1,3,1,5,Casual Users
27510,2390,8,15,1,2,1,4,Lost
27565,2889,6,9,1,1,1,3,Lost
27639,170,72,152,3,5,5,13,Loyal Users
27767,206,5,9,3,1,1,5,Casual Users
27868,427,27,33,3,4,3,10,Loyal Users
27886,2294,12,17,1,3,2,6,Casual Users
28468,728,25,157,2,4,5,11,At Risk
28623,1681,10,14,1,2,1,4,Lost
28839,652,32,102,2,4,4,10,At Risk
29077,111,6,17,4,1,2,7,Promising
29233,25,7,13,5,2,1,8,Promising
29796,432,18,22,3,3,2,8,Loyal Users
30083,707,6,7,2,1,1,4,Lost
30203,278,24,60,3,4,3,10,Loyal Users
30853,4,16,166,5,3,5,13,Loyal Users
31358,125,58,254,4,5,5,14,Champions
31753,332,36,203,3,4,5,12,Loyal Users
31783,63,110,230,5,5,5,15,Champions
31925,32,23,131,5,4,4,13,Champions
32068,242,44,159,3,4,5,12,Loyal Users
32117,1106,5,7,2,1,1,4,Lost
32361,112,114,282,4,5,5,14,Champions
32909,2009,32,42,1,4,3,8,At Risk
33011,179,18,24,3,3,2,8,Loyal Users
33015,1443,14,42,1,3,3,7,Casual Users
33430,417,6,26,3,1,2,6,Casual Users
33612,424,20,41,3,3,3,9,Loyal Users
33893,381,40,69,3,4,4,11,Loyal Users
34119,469,22,111,3,4,4,11,Loyal Users
34127,201,7,14,3,2,1,6,Casual Users
34213,668,33,46,2,4,3,9,At Risk
34417,384,21,36,3,3,3,9,Loyal Users
34553,2569,7,8,1,2,1,4,Lost
34603,2,95,783,5,5,5,15,Champions
34638,94,67,125,4,5,4,13,Champions
34958,2025,6,10,1,1,1,3,Lost
35123,864,8,9,2,2,1,5,Lost
35302,935,6,17,2,1,2,5,Lost
35460,9,88,204,5,5,5,15,Champions
35558,2412,5,13,1,1,1,3,Lost
35623,780,25,61,2,4,3,9,At Risk
35651,1332,17,27,1,3,2,6,Casual Users
36010,417,6,62,3,1,3,7,Casual Users
36273,149,10,54,4,2,3,9,Promising
36375,125,25,75,4,4,4,12,Champions
36515,77,20,32,4,3,3,10,Loyal Users
36797,314,5,14,3,1,1,5,Casual Users
36840,8,9,34,5,2,3,10,Promising
36858,4592,6,43,1,1,3,5,Lost
36948,18,20,139,5,3,4,12,Loyal Users
37127,159,17,25,4,3,2,9,Loyal Users
37291,4,73,253,5,5,5,15,Champions
37650,420,24,35,3,4,3,10,Loyal Users
37823,203,25,70,3,4,4,11,Loyal Users
37922,12,14,34,5,3,3,11,Loyal Users
38044,94,27,52,4,4,3,11,Loyal Users
38223,6,8,16,5,2,2,9,Promising
38493,230,62,91,3,5,4,12,Loyal Users
38752,43,15,52,5,3,3,11,Loyal Users
39127,615,21,130,2,3,4,9,Casual Users
39156,407,6,28,3,1,2,6,Casual Users
26984,833,5,5,2,1,1,4,Lost
27029,121,38,75,4,4,4,12,Champions
27136,17,44,70,5,4,4,13,Champions
27178,116,18,30,4,3,2,9,Loyal Users
27203,19,128,473,5,5,5,15,Champions
27329,70,33,152,4,4,5,13,Champions
27460,1110,39,56,2,4,3,9,At Risk
27579,424,35,49,3,4,3,10,Loyal Users
27643,131,7,16,4,2,2,8,Promising
27649,536,10,26,2,2,2,6,Lost
27850,106,17,29,4,3,2,9,Loyal Users
27929,116,22,32,4,4,3,11,Loyal Users
27992,126,20,81,4,3,4,11,Loyal Users
27995,228,43,116,3,4,4,11,Loyal Users
28041,120,17,38,4,3,3,10,Loyal Users
28045,0,17,52,5,3,3,11,Loyal Users
28654,8,68,115,5,5,4,14,Champions
28743,32,35,49,5,4,3,12,Loyal Users
29290,196,19,29,3,3,2,8,Loyal Users
30108,56,94,202,5,5,5,15,Champions
30112,384,14,99,3,3,4,10,Loyal Users
30711,2265,5,11,1,1,1,3,Lost
31811,1166,29,83,2,4,4,10,At Risk
31924,133,32,81,4,4,4,12,Champions
31937,439,37,181,3,4,5,12,Loyal Users
32400,549,51,167,2,5,5,12,At Risk
32495,337,12,53,3,3,3,9,Loyal Users
32884,1926,7,37,1,2,3,6,Lost
32902,949,7,54,2,2,3,7,Lost
32913,3,97,162,5,5,5,15,Champions
32924,270,25,56,3,4,3,10,Loyal Users
33463,111,13,35,4,3,3,10,Loyal Users
33510,44,142,253,5,5,5,15,Champions
34043,84,67,174,4,5,5,14,Champions
34123,156,18,35,4,3,3,10,Loyal Users
34246,422,19,23,3,3,2,8,Loyal Users
34379,233,15,66,3,3,4,10,Loyal Users
34562,147,43,89,4,4,4,12,Champions
34613,1837,8,19,1,2,2,5,Lost
34885,920,25,125,2,4,4,10,At Risk
35204,125,43,190,4,4,5,13,Champions
35461,3,82,284,5,5,5,15,Champions
35674,296,25,97,3,4,4,11,Loyal Users
35785,262,18,28,3,3,2,8,Loyal Users
35934,8,118,151,5,5,5,15,Champions
36047,119,83,205,4,5,5,14,Champions
36049,65,112,697,5,5,5,15,Champions
36511,19,11,29,5,2,2,9,Promising
36645,131,18,24,4,3,2,9,Loyal Users
36746,160,22,31,4,4,2,10,Loyal Users
36908,699,5,6,2,1,1,4,Lost
37170,709,18,44,2,3,3,8,Casual Users
37231,211,104,175,3,5,5,13,Loyal Users
37236,116,54,179,4,5,5,14,Champions
37375,203,21,33,3,3,3,9,Loyal Users
37499,938,6,13,2,1,1,4,Lost
37500,221,15,40,3,3,3,9,Loyal Users
38348,30,25,39,5,4,3,12,Loyal Users
38416,1000,33,116,2,4,4,10,At Risk
38884,364,26,42,3,4,3,10,Loyal Users
38930,637,17,59,2,3,3,8,Casual Users
39237,89,6,23,4,1,2,7,Promising
39238,90,102,372,4,5,5,14,Champions
26479,38,117,178,5,5,5,15,Champions
26734,90,11,111,4,2,4,10,Promising
27289,736,20,23,2,3,2,7,Casual Users
27501,44,25,52,5,4,3,12,Loyal Users
27535,106,31,196,4,4,5,13,Champions
27744,825,18,52,2,3,3,8,Casual Users
28201,581,7,16,2,2,2,6,Lost
28285,13,48,97,5,5,4,14,Champions
28679,75,126,214,4,5,5,14,Champions
29028,104,23,45,4,4,3,11,Loyal Users
29090,218,18,85,3,3,4,10,Loyal Users
29106,3856,16,92,1,3,4,8,Casual Users
29356,102,8,10,4,2,1,7,Promising
29406,2531,5,6,1,1,1,3,Lost
30352,245,84,123,3,5,4,12,Loyal Users
30444,1384,31,106,1,4,4,9,At Risk
30787,238,32,110,3,4,4,11,Loyal Users
30803,256,32,138,3,4,4,11,Loyal Users
31170,138,5,82,4,1,4,9,Promising
31343,919,12,15,2,3,1,6,Casual Users
31374,116,52,115,4,5,4,13,Champions
31521,414,10,10,3,2,1,6,Casual Users
32085,1546,5,8,1,1,1,3,Lost
32233,285,48,81,3,5,4,12,Loyal Users
32485,232,41,128,3,4,4,11,Loyal Users
32618,430,105,379,3,5,5,13,Loyal Users
33231,33,8,12,5,2,1,8,Promising
33273,425,7,20,3,2,2,7,Casual Users
33706,420,129,272,3,5,5,13,Loyal Users
33723,450,5,7,3,1,1,5,Casual Users
33907,44,47,282,5,5,5,15,Champions
33916,117,14,55,4,3,3,10,Loyal Users
33930,39,97,238,5,5,5,15,Champions
34052,62,15,61,5,3,3,11,Loyal Users
34242,956,24,64,2,4,4,10,At Risk
34577,649,15,25,2,3,2,7,Casual Users
34884,763,9,20,2,2,2,6,Lost
35018,103,11,36,4,2,3,9,Promising
35492,548,18,48,2,3,3,8,Casual Users
35641,47,31,48,5,4,3,12,Loyal Users
35648,974,13,15,2,3,1,6,Casual Users
35764,2273,7,30,1,2,2,5,Lost
36145,1714,7,15,1,2,1,4,Lost
36179,2957,6,6,1,1,1,3,Lost
36275,115,37,214,4,4,5,13,Champions
36552,6,17,37,5,3,3,11,Loyal Users
36582,3324,13,28,1,3,2,6,Casual Users
36680,2943,5,7,1,1,1,3,Lost
36814,1231,5,13,2,1,1,4,Lost
36834,276,43,120,3,4,4,11,Loyal Users
37302,67,164,256,5,5,5,15,Champions
37647,4652,7,16,1,2,2,5,Lost
38064,308,31,34,3,4,3,10,Loyal Users
38203,87,138,439,4,5,5,14,Champions
38494,828,15,49,2,3,3,8,Casual Users
38643,858,6,13,2,1,1,4,Lost
38798,2853,8,12,1,2,1,4,Lost
38815,1,87,267,5,5,5,15,Champions
39148,140,41,152,4,4,5,13,Champions
26776,17,20,28,5,3,2,10,Loyal Users
27056,1374,5,5,1,1,1,3,Lost
27070,84,62,107,4,5,4,13,Champions
27163,1906,12,22,1,3,2,6,Casual Users
27269,776,14,35,2,3,3,8,Casual Users
27439,689,5,8,2,1,1,4,Lost
27693,1435,21,47,1,3,3,7,Casual Users
27861,1541,14,39,1,3,3,7,Casual Users
28545,4310,6,9,1,1,1,3,Lost
28645,102,5,11,4,1,1,6,Promising
28706,790,11,26,2,2,2,6,Lost
28912,2086,11,26,1,2,2,5,Lost
29081,3416,23,44,1,4,3,8,At Risk
29127,304,20,39,3,3,3,9,Loyal Users
29319,63,11,23,5,2,2,9,Promising
29513,102,30,109,4,4,4,12,Champions
29573,305,5,24,3,1,2,6,Casual Users
29958,1411,8,33,1,2,3,6,Lost
29982,2,119,347,5,5,5,15,Champions
30012,30,47,123,5,5,4,14,Champions
30595,531,5,12,2,1,1,4,Lost
30645,251,5,10,3,1,1,5,Casual Users
30900,830,7,9,2,2,1,5,Lost
30978,3115,5,13,1,1,1,3,Lost
31616,3553,58,155,1,5,5,11,At Risk
31941,10,40,104,5,4,4,13,Champions
31968,311,5,18,3,1,2,6,Casual Users
32092,610,36,86,2,4,4,10,At Risk
32610,121,86,477,4,5,5,14,Champions
32819,131,14,16,4,3,2,9,Loyal Users
32979,141,7,11,4,2,1,7,Promising
33299,576,51,331,2,5,5,12,At Risk
33508,1383,6,17,1,1,2,4,Lost
33661,6,28,140,5,4,4,13,Champions
33833,135,12,14,4,3,1,8,Loyal Users
33846,153,19,66,4,3,4,11,Loyal Users
33858,2143,32,204,1,4,5,10,At Risk
34022,435,43,116,3,4,4,11,Loyal Users
34120,1664,17,24,1,3,2,6,Casual Users
34282,3458,7,7,1,2,1,4,Lost
34338,3869,7,17,1,2,2,5,Lost
34557,46,40,73,5,4,4,13,Champions
34581,187,8,22,3,2,2,7,Casual Users
34596,406,5,9,3,1,1,5,Casual Users
34865,125,25,105,4,4,4,12,Champions
34962,53,43,140,5,4,4,13,Champions
35398,95,115,232,4,5,5,14,Champions
35844,185,19,36,3,3,3,9,Loyal Users
36368,3681,5,7,1,1,1,3,Lost
36473,7,55,91,5,5,4,14,Champions
36893,401,30,121,3,4,4,11,Loyal Users
37298,166,25,68,3,4,4,11,Loyal Users
37543,34,84,687,5,5,5,15,Champions
37621,958,6,8,2,1,1,4,Lost
37760,276,23,109,3,4,4,11,Loyal Users
37932,139,16,41,4,3,3,10,Loyal Users
37972,132,32,131,4,4,4,12,Champions
38210,842,10,17,2,2,2,6,Lost
38510,103,46,236,4,5,5,14,Champions
38894,877,10,22,2,2,2,6,Lost
27071,408,7,26,3,2,2,7,Casual Users
27564,1680,47,87,1,5,4,10,At Risk
27951,2441,6,8,1,1,1,3,Lost
28276,140,33,48,4,4,3,11,Loyal Users
28469,78,17,45,4,3,3,10,Loyal Users
28616,907,9,17,2,2,2,6,Lost
28777,1296,23,68,1,4,4,9,At Risk
29050,65,57,489,5,5,5,15,Champions
29099,1834,40,85,1,4,4,9,At Risk
29789,2146,20,24,1,3,2,6,Casual Users
29850,1080,116,521,2,5,5,12,At Risk
30644,110,36,86,4,4,4,12,Champions
31185,2539,5,77,1,1,4,6,Lost
31190,597,8,17,2,2,2,6,Lost
31221,974,6,8,2,1,1,4,Lost
31271,421,9,57,3,2,3,8,Casual Users
31420,101,5,35,4,1,3,8,Promising
31833,696,5,7,2,1,1,4,Lost
31842,2145,7,12,1,2,1,4,Lost
31845,134,26,57,4,4,3,11,Loyal Users
32111,318,14,32,3,3,3,9,Loyal Users
32240,3308,8,8,1,2,1,4,Lost
32338,200,14,43,3,3,3,9,Loyal Users
32671,2848,27,38,1,4,3,8,At Risk
32997,255,92,405,3,5,5,13,Loyal Users
33115,707,6,11,2,1,1,4,Lost
33499,67,28,139,5,4,4,13,Champions
33959,1421,5,7,1,1,1,3,Lost
34271,93,10,28,4,2,2,8,Promising
34929,1528,10,18,1,2,2,5,Lost
34954,1134,5,15,2,1,1,4,Lost
34965,1544,38,101,1,4,4,9,At Risk
34966,115,15,48,4,3,3,10,Loyal Users
34972,2147,9,16,1,2,2,5,Lost
35023,166,10,19,3,2,2,7,Casual Users
35327,4321,26,70,1,4,4,9,At Risk
35417,109,58,156,4,5,5,14,Champions
35556,1123,8,11,2,2,1,5,Lost
35572,1508,26,60,1,4,3,8,At Risk
35704,6,9,14,5,2,1,8,Promising
35853,36,101,596,5,5,5,15,Champions
35888,113,41,165,4,4,5,13,Champions
35937,314,11,24,3,2,2,7,Casual Users
36008,420,5,12,3,1,1,5,Casual Users
37028,82,118,239,4,5,5,14,Champions
37093,574,12,20,2,3,2,7,Casual Users
37266,632,8,32,2,2,3,7,Lost
38321,291,29,32,3,4,3,10,Loyal Users
38473,273,12,24,3,3,2,8,Loyal Users
38766,30,5,16,5,1,2,8,Promising
39075,0,21,103,5,3,4,12,Loyal Users
39204,3714,11,12,1,2,1,4,Lost
26730,48,41,173,5,4,5,14,Champions
26978,1,78,201,5,5,5,15,Champions
27022,1415,19,19,1,3,2,6,Casual Users
27147,106,101,168,4,5,5,14,Champions
27529,412,10,26,3,2,2,7,Casual Users
27536,1145,10,13,2,2,1,5,Lost
27705,537,11,51,2,2,3,7,Lost
27796,3079,11,47,1,2,3,6,Lost
27838,260,56,138,3,5,4,12,Loyal Users
27975,69,66,344,5,5,5,15,Champions
27976,792,9,40,2,2,3,7,Lost
28011,125,50,120,4,5,4,13,Champions
28256,176,79,157,3,5,5,13,Loyal Users
28731,1428,10,23,1,2,2,5,Lost
29021,496,39,272,2,4,5,11,At Risk
29208,5681,7,7,1,2,1,4,Lost
29219,132,41,116,4,4,4,12,Champions
29414,738,17,42,2,3,3,8,Casual Users
29747,8,115,471,5,5,5,15,Champions
29807,31,62,120,5,5,4,14,Champions
30133,7,53,587,5,5,5,15,Champions
30380,86,41,82,4,4,4,12,Champions
30405,1029,48,109,2,5,4,11,At Risk
30770,156,26,129,4,4,4,12,Champions
31125,2406,5,8,1,1,1,3,Lost
31169,111,32,268,4,4,5,13,Champions
31223,423,15,64,3,3,4,10,Loyal Users
31499,2559,18,27,1,3,2,6,Casual Users
31662,54,76,402,5,5,5,15,Champions
32172,120,45,154,4,4,5,13,Champions
32343,3707,9,21,1,2,2,5,Lost
32568,77,55,174,4,5,5,14,Champions
32583,1793,9,16,1,2,2,5,Lost
32674,341,8,31,3,2,2,7,Casual Users
33109,1423,9,13,1,2,1,4,Lost
33393,1998,8,18,1,2,2,5,Lost
33482,124,90,239,4,5,5,14,Champions
33675,265,23,37,3,4,3,10,Loyal Users
33685,514,9,27,2,2,2,6,Lost
34003,2214,13,25,1,3,2,6,Casual Users
34005,640,12,13,2,3,1,6,Casual Users
34007,80,27,93,4,4,4,12,Champions
34169,1814,6,53,1,1,3,5,Lost
34439,115,37,122,4,4,4,12,Champions
34773,1,112,281,5,5,5,15,Champions
35539,100,49,332,4,5,5,14,Champions
35618,385,66,221,3,5,5,13,Loyal Users
35920,254,16,62,3,3,3,9,Loyal Users
36364,34,17,186,5,3,5,13,Loyal Users
36379,855,37,68,2,4,4,10,At Risk
36653,2618,14,20,1,3,2,6,Casual Users
36792,311,11,55,3,2,3,8,Casual Users
36915,389,40,99,3,4,4,11,Loyal Users
36922,81,14,51,4,3,3,10,Loyal Users
37313,600,36,132,2,4,4,10,At Risk
37587,1715,8,12,1,2,1,4,Lost
37605,432,13,34,3,3,3,9,Loyal Users
37715,701,8,37,2,2,3,7,Lost
38079,302,20,50,3,3,3,9,Loyal Users
38375,5,123,414,5,5,5,15,Champions
38553,2,73,174,5,5,5,15,Champions
38763,127,11,48,4,2,3,9,Promising
39133,1,14,23,5,3,2,10,Loyal Users
39157,267,45,57,3,4,3,10,Loyal Users
39165,19,76,252,5,5,5,15,Champions
26582,1276,23,38,1,4,3,8,At Risk
26760,545,7,13,2,2,1,5,Lost
27200,48,14,81,5,3,4,12,Loyal Users
27316,1528,8,9,1,2,1,4,Lost
27369,5200,5,25,1,1,2,4,Lost
28136,1289,56,144,1,5,4,10,At Risk
28154,154,48,177,4,5,5,14,Champions
28410,29,149,967,5,5,5,15,Champions
28533,139,29,220,4,4,5,13,Champions
28717,35,73,116,5,5,4,14,Champions
28736,192,10,15,3,2,1,6,Casual Users
28737,53,91,462,5,5,5,15,Champions
28742,242,13,67,3,3,4,10,Loyal Users
29037,834,8,18,2,2,2,6,Lost
29123,282,36,52,3,4,3,10,Loyal Users
29341,3778,10,12,1,2,1,4,Lost
29725,539,39,81,2,4,4,10,At Risk
29755,534,8,21,2,2,2,6,Lost
29876,123,95,401,4,5,5,14,Champions
29941,131,25,33,4,4,3,11,Loyal Users
30225,8,93,459,5,5,5,15,Champions
30230,260,14,21,3,3,2,8,Loyal Users
30420,3277,5,6,1,1,1,3,Lost
30476,2850,18,117,1,3,4,8,Casual Users
30520,1890,7,28,1,2,2,5,Lost
30638,100,40,153,4,4,5,13,Champions
30772,2,86,144,5,5,4,14,Champions
30879,3818,5,44,1,1,3,5,Lost
30934,284,34,93,3,4,4,11,Loyal Users
31102,94,95,413,4,5,5,14,Champions
31299,127,133,715,4,5,5,14,Champions
31702,63,38,67,5,4,4,13,Champions
31724,154,90,227,4,5,5,14,Champions
31778,6,39,173,5,4,5,14,Champions
31931,287,46,65,3,5,4,12,Loyal Users
32014,279,18,59,3,3,3,9,Loyal Users
32477,1217,14,90,2,3,4,9,Casual Users
32527,3496,5,14,1,1,1,3,Lost
32754,101,49,219,4,5,5,14,Champions
33315,332,34,81,3,4,4,11,Loyal Users
33322,12,64,124,5,5,4,14,Champions
33596,122,82,134,4,5,4,13,Champions
33771,270,24,98,3,4,4,11,Loyal Users
33940,8,14,26,5,3,2,10,Loyal Users
33955,4399,5,8,1,1,1,3,Lost
34155,856,17,77,2,3,4,9,Casual Users
34274,142,25,48,4,4,3,11,Loyal Users
34280,644,11,26,2,2,2,6,Lost
34414,789,9,33,2,2,3,7,Lost
34420,1085,7,7,2,2,1,5,Lost
34438,526,16,45,2,3,3,8,Casual Users
34790,2707,5,12,1,1,1,3,Lost
35194,192,44,152,3,4,5,12,Loyal Users
35237,430,24,83,3,4,4,11,Loyal Users
35488,4800,11,23,1,2,2,5,Lost
35808,14,23,57,5,4,3,12,Loyal Users
35974,706,7,20,2,2,2,6,Lost
36183,1654,21,24,1,3,2,6,Casual Users
36595,1146,21,46,2,3,3,8,Casual Users
37126,149,42,148,4,4,5,13,Champions
37271,109,87,292,4,5,5,14,Champions
37276,40,19,42,5,3,3,11,Loyal Users
37370,1538,7,42,1,2,3,6,Lost
37664,155,14,20,4,3,2,9,Loyal Users
37736,825,13,17,2,3,2,7,Casual Users
37977,397,42,60,3,4,3,10,Loyal Users
38906,432,44,93,3,4,4,11,Loyal Users
38968,174,37,133,3,4,4,11,Loyal Users
38970,2817,8,21,1,2,2,5,Lost
39015,226,5,9,3,1,1,5,Casual Users
39228,139,10,53,4,2,3,9,Promising
26538,997,6,12,2,1,1,4,Lost
26558,1446,5,8,1,1,1,3,Lost
26780,605,15,64,2,3,4,9,Casual Users
26836,48,20,24,5,3,2,10,Loyal Users
26860,50,57,166,5,5,5,15,Champions
27359,58,184,289,5,5,5,15,Champions
27388,1266,20,57,1,3,3,7,Casual Users
27440,89,22,101,4,4,4,12,Champions
27878,134,13,114,4,3,4,11,Loyal Users
28171,566,27,59,2,4,3,9,At Risk
28431,755,29,60,2,4,3,9,At Risk
28479,128,5,6,4,1,1,6,Promising
28975,130,43,111,4,4,4,12,Champions
29173,117,17,18,4,3,2,9,Loyal Users
29205,2426,20,100,1,3,4,8,Casual Users
30022,4954,5,9,1,1,1,3,Lost
30043,1545,9,11,1,2,1,4,Lost
30248,25,42,79,5,4,4,13,Champions
30388,224,9,59,3,2,3,8,Casual Users
30780,27,30,51,5,4,3,12,Loyal Users
30804,1098,7,19,2,2,2,6,Lost
30915,24,42,289,5,4,5,14,Champions
31075,768,26,100,2,4,4,10,At Risk
31513,456,8,32,3,2,3,8,Casual Users
31557,19,58,224,5,5,5,15,Champions
31638,115,131,190,4,5,5,14,Champions
31939,1534,5,6,1,1,1,3,Lost
32013,75,73,152,4,5,5,14,Champions
32506,596,5,5,2,1,1,4,Lost
32878,1501,14,30,1,3,2,6,Casual Users
32961,140,41,65,4,4,4,12,Champions
33312,153,17,190,4,3,5,12,Loyal Users
33397,24,82,230,5,5,5,15,Champions
34551,828,7,14,2,2,1,5,Lost
35010,50,182,945,5,5,5,15,Champions
36205,120,8,18,4,2,2,8,Promising
36545,109,36,94,4,4,4,12,Champions
36766,707,25,70,2,4,4,10,At Risk
36803,372,65,111,3,5,4,12,Loyal Users
37475,443,8,36,3,2,3,8,Casual Users
37486,9,108,300,5,5,5,15,Champions
37603,600,36,222,2,4,5,11,At Risk
37807,553,21,48,2,3,3,8,Casual Users
38133,785,7,67,2,2,4,8,Lost
38597,2733,6,17,1,1,2,4,Lost
38710,4896,16,31,1,3,2,6,Casual Users
38848,91,85,323,4,5,5,14,Champions
26585,1490,20,22,1,3,2,6,Casual Users
27033,3192,13,42,1,3,3,7,Casual Users
27191,1850,12,23,1,3,2,6,Casual Users
27421,27,43,214,5,4,5,14,Champions
27690,2389,14,38,1,3,3,7,Casual Users
27714,1535,5,14,1,1,1,3,Lost
27836,1,77,341,5,5,5,15,Champions
27961,0,16,60,5,3,3,11,Loyal Users
28150,1845,8,51,1,2,3,6,Lost
28554,270,22,62,3,4,3,10,Loyal Users
29043,1151,19,29,2,3,2,7,Casual Users
29065,2128,30,35,1,4,3,8,At Risk
29169,629,39,91,2,4,4,10,At Risk
29192,88,17,131,4,3,4,11,Loyal Users
29234,144,13,16,4,3,2,9,Loyal Users
29384,1437,8,86,1,2,4,7,Lost
29499,429,34,73,3,4,4,11,Loyal Users
29568,129,45,81,4,4,4,12,Champions
29691,134,5,5,4,1,1,6,Promising
29799,649,11,13,2,2,1,5,Lost
29813,3710,16,29,1,3,2,6,Casual Users
29845,19,22,74,5,4,4,13,Champions
30019,121,75,403,4,5,5,14,Champions
30084,27,28,63,5,4,4,13,Champions
30395,54,26,51,5,4,3,12,Loyal Users
30473,85,124,298,4,5,5,14,Champions
30733,1843,5,18,1,1,2,4,Lost
30891,52,75,468,5,5,5,15,Champions
30993,2261,5,15,1,1,1,3,Lost
31083,145,5,12,4,1,1,6,Promising
31115,2603,6,23,1,1,2,4,Lost
31132,11,27,51,5,4,3,12,Loyal Users
31609,292,7,8,3,2,1,6,Casual Users
31643,140,31,94,4,4,4,12,Champions
31741,434,12,30,3,3,2,8,Loyal Users
31752,412,54,108,3,5,4,12,Loyal Users
31915,8,115,406,5,5,5,15,Champions
32099,1277,22,75,1,4,4,9,At Risk
32124,2268,14,107,1,3,4,8,Casual Users
32415,968,13,40,2,3,3,8,Casual Users
32717,275,8,24,3,2,2,7,Casual Users
33020,26,6,14,5,1,1,7,Promising
33181,111,11,27,4,2,2,8,Promising
33721,1103,7,7,2,2,1,5,Lost
34093,23,10,12,5,2,1,8,Promising
34138,831,20,57,2,3,3,8,Casual Users
34281,157,36,155,4,4,5,13,Champions
34475,62,66,569,5,5,5,15,Champions
34717,26,48,144,5,5,4,14,Champions
34796,184,5,14,3,1,1,5,Casual Users
34842,188,12,14,3,3,1,7,Loyal Users
34900,4,8,11,5,2,1,8,Promising
35093,324,7,15,3,2,1,6,Casual Users
35108,137,28,49,4,4,3,11,Loyal Users
35387,4612,6,6,1,1,1,3,Lost
35685,115,80,169,4,5,5,14,Champions
36500,1337,5,6,1,1,1,3,Lost
36602,1,138,267,5,5,5,15,Champions
36752,98,23,63,4,4,4,12,Champions
36920,1,120,237,5,5,5,15,Champions
37273,82,30,96,4,4,4,12,Champions
37329,1630,8,20,1,2,2,5,Lost
37552,7,20,125,5,3,4,12,Loyal Users
37606,169,43,137,3,4,4,11,Loyal Users
37651,1553,11,18,1,2,2,5,Lost
37745,136,22,43,4,4,3,11,Loyal Users
38264,35,52,315,5,5,5,15,Champions
38293,170,33,81,3,4,4,11,Loyal Users
38320,3931,17,26,1,3,2,6,Casual Users
38695,8,99,164,5,5,5,15,Champions
38703,156,33,161,4,4,5,13,Champions
38847,31,75,348,5,5,5,15,Champions
39207,3384,5,16,1,1,2,4,Lost
26724,745,5,13,2,1,1,4,Lost
26997,1405,6,9,1,1,1,3,Lost
27179,3580,5,12,1,1,1,3,Lost
27301,129,7,21,4,2,2,8,Promising
27311,164,17,65,4,3,4,11,Loyal Users
27384,3261,7,39,1,2,3,6,Lost
27577,2436,7,25,1,2,2,5,Lost
27658,71,39,142,4,4,4,12,Champions
27670,107,22,108,4,4,4,12,Champions
27764,399,5,9,3,1,1,5,Casual Users
27927,543,16,197,2,3,5,10,Casual Users
28309,102,32,58,4,4,3,11,Loyal Users
28579,36,38,73,5,4,4,13,Champions
28765,831,5,19,2,1,2,5,Lost
29330,1956,10,14,1,2,1,4,Lost
29656,2840,5,9,1,1,1,3,Lost
29838,574,6,11,2,1,1,4,Lost
30038,157,41,76,4,4,4,12,Champions
30064,546,21,31,2,3,2,7,Casual Users
30188,100,41,126,4,4,4,12,Champions
30254,312,12,72,3,3,4,10,Loyal Users
30775,101,15,25,4,3,2,9,Loyal Users
30823,65,36,92,5,4,4,13,Champions
31199,122,38,286,4,4,5,13,Champions
31465,5213,11,28,1,2,2,5,Lost
31715,101,10,18,4,2,2,8,Promising
31947,271,8,13,3,2,1,6,Casual Users
32144,847,9,10,2,2,1,5,Lost
32235,2033,10,24,1,2,2,5,Lost
32476,73,98,148,4,5,5,14,Champions
32990,1007,5,5,2,1,1,4,Lost
32995,1541,17,84,1,3,4,8,Casual Users
33244,261,14,43,3,3,3,9,Loyal Users
33289,61,73,311,5,5,5,15,Champions
33660,1253,8,10,2,2,1,5,Lost
33822,25,47,105,5,5,4,14,Champions
33877,150,18,97,4,3,4,11,Loyal Users
33911,732,13,29,2,3,2,7,Casual Users
33942,5776,5,16,1,1,2,4,Lost
34019,8,12,49,5,3,3,11,Loyal Users
34108,88,83,169,4,5,5,14,Champions
34110,77,177,664,4,5,5,14,Champions
34142,11,5,9,5,1,1,7,Promising
34308,136,60,255,4,5,5,14,Champions
35055,260,13,24,3,3,2,8,Loyal Users
35097,24,120,672,5,5,5,15,Champions
35168,398,10,10,3,2,1,6,Casual Users
35359,2972,9,22,1,2,2,5,Lost
35368,9,11,21,5,2,2,9,Promising
35664,2,137,242,5,5,5,15,Champions
35748,673,14,42,2,3,3,8,Casual Users
35810,120,6,7,4,1,1,6,Promising
35875,81,37,76,4,4,4,12,Champions
36003,3566,10,52,1,2,3,6,Lost
36059,130,25,70,4,4,4,12,Champions
36435,836,11,38,2,2,3,7,Lost
36718,1429,11,36,1,2,3,6,Lost
36897,1630,15,28,1,3,2,6,Casual Users
37022,804,15,50,2,3,3,8,Casual Users
37269,100,25,148,4,4,5,13,Champions
37408,126,8,13,4,2,1,7,Promising
37426,115,6,10,4,1,1,6,Promising
37483,2,24,149,5,4,5,14,Champions
37585,58,170,785,5,5,5,15,Champions
37694,1764,5,16,1,1,2,4,Lost
38408,1,33,90,5,4,4,13,Champions
38487,1641,6,9,1,1,1,3,Lost
38598,2639,9,18,1,2,2,5,Lost
39120,75,85,127,4,5,4,13,Champions
39230,15,25,53,5,4,3,12,Loyal Users
26628,130,96,308,4,5,5,14,Champions
26847,153,41,88,4,4,4,12,Champions
26868,101,19,82,4,3,4,11,Loyal Users
26894,477,7,32,2,2,3,7,Lost
27364,405,9,52,3,2,3,8,Casual Users
27623,2781,6,10,1,1,1,3,Lost
27785,668,20,41,2,3,3,8,Casual Users
28328,406,14,18,3,3,2,8,Loyal Users
28371,402,26,63,3,4,4,11,Loyal Users
28502,280,14,45,3,3,3,9,Loyal Users
28564,258,22,253,3,4,5,12,Loyal Users
28702,0,123,471,5,5,5,15,Champions
28833,2317,6,21,1,1,2,4,Lost
29040,6,54,252,5,5,5,15,Champions
29376,117,37,56,4,4,3,11,Loyal Users
29567,377,36,120,3,4,4,11,Loyal Users
29579,123,93,416,4,5,5,14,Champions
29584,274,14,17,3,3,2,8,Loyal Users
29615,14,66,269,5,5,5,15,Champions
29929,2024,6,11,1,1,1,3,Lost
29953,2867,5,9,1,1,1,3,Lost
29994,132,65,113,4,5,4,13,Champions
29995,1686,9,17,1,2,2,5,Lost
30028,979,6,12,2,1,1,4,Lost
30029,296,14,46,3,3,3,9,Loyal Users
30553,1175,9,12,2,2,1,5,Lost
30657,559,8,21,2,2,2,6,Lost
30722,330,6,6,3,1,1,5,Casual Users
31018,2,92,526,5,5,5,15,Champions
31318,955,13,144,2,3,4,9,Casual Users
31620,957,18,26,2,3,2,7,Casual Users
31750,2981,12,21,1,3,2,6,Casual Users
31816,145,12,28,4,3,2,9,Loyal Users
32097,111,117,291,4,5,5,14,Champions
32216,143,25,43,4,4,3,11,Loyal Users
32285,2147,5,5,1,1,1,3,Lost
32322,402,5,9,3,1,1,5,Casual Users
32355,102,65,166,4,5,5,14,Champions
32449,28,132,209,5,5,5,15,Champions
32586,796,17,66,2,3,4,9,Casual Users
32885,574,14,45,2,3,3,8,Casual Users
33386,1292,10,15,1,2,1,4,Lost
33446,18,11,12,5,2,1,8,Promising
33546,23,98,329,5,5,5,15,Champions
33593,531,17,20,2,3,2,7,Casual Users
34122,718,17,98,2,3,4,9,Casual Users
34227,178,75,300,3,5,5,13,Loyal Users
34426,2605,56,426,1,5,5,11,At Risk
34535,11,62,108,5,5,4,14,Champions
34733,15,57,85,5,5,4,14,Champions
34800,436,25,83,3,4,4,11,Loyal Users
34851,882,14,22,2,3,2,7,Casual Users
34863,30,45,187,5,4,5,14,Champions
34910,758,11,18,2,2,2,6,Lost
35517,123,154,336,4,5,5,14,Champions
35693,166,62,127,3,5,4,12,Loyal Users
36409,442,5,21,3,1,2,6,Casual Users
36686,3734,5,11,1,1,1,3,Lost
36800,2452,29,113,1,4,4,9,At Risk
37325,1655,7,11,1,2,1,4,Lost
37699,1788,7,7,1,2,1,4,Lost
37816,18,21,52,5,3,3,11,Loyal Users
37987,2898,6,6,1,1,1,3,Lost
38030,258,5,5,3,1,1,5,Casual Users
38077,2282,14,27,1,3,2,6,Casual Users
38140,579,13,31,2,3,2,7,Casual Users
38184,3767,66,202,1,5,5,11,At Risk
38273,850,7,9,2,2,1,5,Lost
26509,287,5,9,3,1,1,5,Casual Users
26971,2132,24,32,1,4,3,8,At Risk
27288,1084,8,16,2,2,2,6,Lost
27446,1,10,41,5,2,3,10,Promising
28006,530,6,23,2,1,2,5,Lost
28020,405,14,20,3,3,2,8,Loyal Users
28370,32,44,168,5,4,5,14,Champions
28404,268,43,65,3,4,4,11,Loyal Users
28606,749,18,22,2,3,2,7,Casual Users
28682,1029,81,379,2,5,5,12,At Risk
29045,77,79,317,4,5,5,14,Champions
29232,205,109,307,3,5,5,13,Loyal Users
29303,4,117,858,5,5,5,15,Champions
29485,16,26,147,5,4,5,14,Champions
29538,102,99,306,4,5,5,14,Champions
29730,1650,8,32,1,2,3,6,Lost
29734,23,29,113,5,4,4,13,Champions
29895,149,14,41,4,3,3,10,Loyal Users
29904,2635,20,98,1,3,4,8,Casual Users
30116,477,7,16,2,2,2,6,Lost
30285,514,5,11,2,1,1,4,Lost
30426,1126,5,9,2,1,1,4,Lost
30478,2868,8,15,1,2,1,4,Lost
30479,1392,6,6,1,1,1,3,Lost
30502,412,29,51,3,4,3,10,Loyal Users
30719,911,16,64,2,3,4,9,Casual Users
30958,92,66,111,4,5,4,13,Champions
31060,974,40,87,2,4,4,10,At Risk
31296,949,11,19,2,2,2,6,Lost
31426,432,14,34,3,3,3,9,Loyal Users
31597,5205,6,13,1,1,1,3,Lost
31601,1219,19,84,2,3,4,9,Casual Users
31911,227,16,28,3,3,2,8,Loyal Users
32028,536,20,101,2,3,4,9,Casual Users
32153,286,69,98,3,5,4,12,Loyal Users
32203,1744,6,11,1,1,1,3,Lost
32730,341,137,566,3,5,5,13,Loyal Users
32801,880,41,256,2,4,5,11,At Risk
33344,13,15,29,5,3,2,10,Loyal Users
33380,648,14,114,2,3,4,9,Casual Users
33417,78,37,183,4,4,5,13,Champions
33525,422,8,11,3,2,1,6,Casual Users
34033,6,12,86,5,3,4,12,Loyal Users
34269,4860,37,72,1,4,4,9,At Risk
34469,122,20,28,4,3,2,9,Loyal Users
34797,142,14,42,4,3,3,10,Loyal Users
34974,313,7,54,3,2,3,8,Casual Users
35576,0,37,94,5,4,4,13,Champions
35735,1600,17,26,1,3,2,6,Casual Users
35847,16,71,113,5,5,4,14,Champions
36030,215,19,39,3,3,3,9,Loyal Users
36140,173,34,105,3,4,4,11,Loyal Users
36422,423,6,9,3,1,1,5,Casual Users
36432,6,97,401,5,5,5,15,Champions
36490,103,13,40,4,3,3,10,Loyal Users
37012,478,5,9,2,1,1,4,Lost
37047,74,74,373,4,5,5,14,Champions
37139,25,74,361,5,5,5,15,Champions
37305,2004,15,48,1,3,3,7,Casual Users
37341,318,16,21,3,3,2,8,Loyal Users
37595,2712,10,21,1,2,2,5,Lost
37754,3286,8,44,1,2,3,6,Lost
38361,178,7,22,3,2,2,7,Casual Users
38469,149,10,18,4,2,2,8,Promising
38595,2073,11,41,1,2,3,6,Lost
38866,14,124,723,5,5,5,15,Champions
26535,384,5,11,3,1,1,5,Casual Users
26669,1098,83,187,2,5,5,12,At Risk
26956,688,12,63,2,3,4,9,Casual Users
27051,26,112,374,5,5,5,15,Champions
27213,137,60,170,4,5,5,14,Champions
27334,125,90,189,4,5,5,14,Champions
27826,81,59,325,4,5,5,14,Champions
27985,3109,5,8,1,1,1,3,Lost
28055,168,5,11,3,1,1,5,Casual Users
28070,4123,6,25,1,1,2,4,Lost
28319,2,62,247,5,5,5,15,Champions
28894,1557,6,13,1,1,1,3,Lost
28954,132,23,109,4,4,4,12,Champions
29001,81,64,460,4,5,5,14,Champions
29272,730,51,139,2,5,4,11,At Risk
29343,2585,5,7,1,1,1,3,Lost
29444,7,84,190,5,5,5,15,Champions
29613,153,7,14,4,2,1,7,Promising
29843,1020,9,24,2,2,2,6,Lost
30195,101,31,52,4,4,3,11,Loyal Users
30446,1022,12,24,2,3,2,7,Casual Users
30548,23,50,121,5,5,4,14,Champions
30642,4092,10,17,1,2,2,5,Lost
30662,14,95,246,5,5,5,15,Champions
30931,2274,46,62,1,5,3,9,At Risk
31256,2,71,125,5,5,4,14,Champions
31749,716,12,18,2,3,2,7,Casual Users
32552,47,11,26,5,2,2,9,Promising
32727,85,28,89,4,4,4,12,Champions
33024,831,10,10,2,2,1,5,Lost
33068,10,39,108,5,4,4,13,Champions
33325,2436,19,26,1,3,2,6,Casual Users
33362,1395,7,20,1,2,2,5,Lost
33395,806,118,323,2,5,5,12,At Risk
33638,410,8,23,3,2,2,7,Casual Users
33692,148,14,59,4,3,3,10,Loyal Users
33703,543,30,198,2,4,5,11,At Risk
33718,266,46,94,3,5,4,12,Loyal Users
33886,98,137,269,4,5,5,14,Champions
34231,277,5,34,3,1,3,7,Casual Users
34395,1771,17,19,1,3,2,6,Casual Users
34804,391,5,14,3,1,1,5,Casual Users
34821,7,18,41,5,3,3,11,Loyal Users
34853,102,7,15,4,2,1,7,Promising
34934,1694,7,64,1,2,4,7,Lost
35163,415,5,6,3,1,1,5,Casual Users
35292,85,64,114,4,5,4,13,Champions
35379,222,17,124,3,3,4,10,Loyal Users
35802,3687,6,33,1,1,3,5,Lost
36516,1407,22,35,1,4,3,8,At Risk
36909,585,14,22,2,3,2,7,Casual Users
37204,15,128,622,5,5,5,15,Champions
37296,847,18,27,2,3,2,7,Casual Users
37365,579,26,52,2,4,3,9,At Risk
37423,544,39,62,2,4,3,9,At Risk
37642,138,128,166,4,5,5,14,Champions
37876,88,52,257,4,5,5,14,Champions
37995,105,113,299,4,5,5,14,Champions
38061,360,22,134,3,4,4,11,Loyal Users
38085,1654,8,8,1,2,1,4,Lost
38144,9,113,201,5,5,5,15,Champions
38479,683,10,19,2,2,2,6,Lost
38546,5305,8,16,1,2,2,5,Lost
38804,5261,9,24,1,2,2,5,Lost
26707,1666,5,9,1,1,1,3,Lost
26888,105,32,76,4,4,4,12,Champions
27347,117,5,7,4,1,1,6,Promising
27504,1998,5,6,1,1,1,3,Lost
27553,53,23,51,5,4,3,12,Loyal Users
27828,1358,14,20,1,3,2,6,Casual Users
27832,1721,7,17,1,2,2,5,Lost
27970,419,17,36,3,3,3,9,Loyal Users
28038,660,7,20,2,2,2,6,Lost
28210,60,84,217,5,5,5,15,Champions
28519,1841,5,6,1,1,1,3,Lost
28740,428,5,77,3,1,4,8,Casual Users
28784,4420,8,30,1,2,2,5,Lost
29236,636,8,25,2,2,2,6,Lost
29396,25,33,52,5,4,3,12,Loyal Users
29446,5665,5,5,1,1,1,3,Lost
29563,275,10,13,3,2,1,6,Casual Users
29591,4745,5,7,1,1,1,3,Lost
29665,6,25,44,5,4,3,12,Loyal Users
29874,394,19,36,3,3,3,9,Loyal Users
29892,3547,15,57,1,3,3,7,Casual Users
29946,120,20,45,4,3,3,10,Loyal Users
30161,2276,5,17,1,1,2,4,Lost
30513,158,7,16,4,2,2,8,Promising
30561,785,5,5,2,1,1,4,Lost
30830,12,74,133,5,5,4,14,Champions
31030,1763,9,13,1,2,1,4,Lost
31628,126,9,17,4,2,2,8,Promising
31705,131,5,8,4,1,1,6,Promising
32164,126,29,81,4,4,4,12,Champions
32474,432,6,11,3,1,1,5,Casual Users
32702,777,7,20,2,2,2,6,Lost
32911,332,62,170,3,5,5,13,Loyal Users
32963,4,92,152,5,5,5,15,Champions
33157,5699,10,10,1,2,1,4,Lost
33167,125,6,8,4,1,1,6,Promising
33515,138,5,7,4,1,1,6,Promising
33735,12,94,673,5,5,5,15,Champions
33974,1444,21,34,1,3,3,7,Casual Users
34016,1587,9,10,1,2,1,4,Lost
34101,269,9,52,3,2,3,8,Casual Users
34490,1082,10,10,2,2,1,5,Lost
34630,229,10,11,3,2,1,6,Casual Users
34670,629,10,33,2,2,3,7,Lost
34818,86,8,47,4,2,3,9,Promising
34933,419,8,32,3,2,3,8,Casual Users
34939,4143,5,5,1,1,1,3,Lost
35666,2904,8,10,1,2,1,4,Lost
35939,26,24,46,5,4,3,12,Loyal Users
36544,116,32,110,4,4,4,12,Champions
36715,217,83,168,3,5,5,13,Loyal Users
37158,1218,6,9,2,1,1,4,Lost
37506,3023,6,13,1,1,1,3,Lost
37546,3,10,13,5,2,1,8,Promising
37709,818,5,9,2,1,1,4,Lost
37791,4604,28,42,1,4,3,8,At Risk
37936,463,6,14,3,1,1,5,Casual Users
38011,237,52,206,3,5,5,13,Loyal Users
38568,494,121,304,2,5,5,12,At Risk
38592,26,38,60,5,4,3,12,Loyal Users
26648,232,13,20,3,3,2,8,Loyal Users
26758,407,22,68,3,4,4,11,Loyal Users
27037,985,8,46,2,2,3,7,Lost
27120,3584,10,10,1,2,1,4,Lost
27274,820,43,61,2,4,3,9,At Risk
27276,89,118,710,4,5,5,14,Champions
27462,1826,9,16,1,2,2,5,Lost
27860,257,22,52,3,4,3,10,Loyal Users
28465,835,11,14,2,2,1,5,Lost
28713,94,13,41,4,3,3,10,Loyal Users
28846,63,93,178,5,5,5,15,Champions
29128,10,26,72,5,4,4,13,Champions
29455,713,19,65,2,3,4,9,Casual Users
29761,420,23,34,3,4,3,10,Loyal Users
30091,3697,7,9,1,2,1,4,Lost
30096,1724,13,73,1,3,4,8,Casual Users
30100,256,27,50,3,4,3,10,Loyal Users
30275,103,10,25,4,2,2,8,Promising
30740,438,13,163,3,3,5,11,Loyal Users
30801,69,58,205,5,5,5,15,Champions
30974,107,22,159,4,4,5,13,Champions
31177,3975,5,13,1,1,1,3,Lost
31974,261,8,20,3,2,2,7,Casual Users
32010,150,14,69,4,3,4,11,Loyal Users
32146,1715,60,220,1,5,5,11,At Risk
32326,5,33,47,5,4,3,12,Loyal Users
32364,70,41,183,4,4,5,13,Champions
32609,308,12,25,3,3,2,8,Loyal Users
32677,696,18,63,2,3,4,9,Casual Users
32748,25,18,81,5,3,4,12,Loyal Users
32756,664,7,28,2,2,2,6,Lost
32886,1421,6,17,1,1,2,4,Lost
33073,78,58,149,4,5,5,14,Champions
33079,938,13,42,2,3,3,8,Casual Users
33435,992,13,38,2,3,3,8,Casual Users
33643,5885,10,10,1,2,1,4,Lost
33792,571,31,85,2,4,4,10,At Risk
34099,874,16,31,2,3,2,7,Casual Users
34165,2186,12,41,1,3,3,7,Casual Users
34292,588,8,50,2,2,3,7,Lost
34327,312,32,108,3,4,4,11,Loyal Users
34659,120,38,46,4,4,3,11,Loyal Users
35016,258,18,80,3,3,4,10,Loyal Users
35430,1115,9,36,2,2,3,7,Lost
35686,3704,5,11,1,1,1,3,Lost
35775,34,107,534,5,5,5,15,Champions
35884,1528,33,58,1,4,3,8,At Risk
36188,825,22,38,2,4,3,9,At Risk
36326,224,50,69,3,5,4,12,Loyal Users
36385,882,6,13,2,1,1,4,Lost
36543,1642,15,17,1,3,2,6,Casual Users
37211,132,6,11,4,1,1,6,Promising
37220,5,13,32,5,3,3,11,Loyal Users
37518,834,6,10,2,1,1,4,Lost
37843,99,42,67,4,4,4,12,Champions
37844,2000,5,5,1,1,1,3,Lost
37882,398,6,7,3,1,1,5,Casual Users
37994,1533,5,27,1,1,2,4,Lost
38093,108,48,152,4,5,5,14,Champions
38161,5,5,27,5,1,2,8,Promising
38182,1148,13,20,2,3,2,7,Casual Users
38249,389,19,32,3,3,3,9,Loyal Users
38613,25,83,155,5,5,5,15,Champions
38682,65,37,60,5,4,3,12,Loyal Users
38725,290,30,74,3,4,4,11,Loyal Users
38783,417,8,20,3,2,2,7,Casual Users
38974,1621,7,8,1,2,1,4,Lost
38995,134,58,123,4,5,4,13,Champions
39013,2650,5,23,1,1,2,4,Lost
39240,119,89,452,4,5,5,14,Champions
26797,693,14,37,2,3,3,8,Casual Users
26829,62,21,34,5,3,3,11,Loyal Users
26916,1578,12,24,1,3,2,6,Casual Users
27607,2514,24,47,1,4,3,8,At Risk
27644,51,140,285,5,5,5,15,Champions
27830,286,30,52,3,4,3,10,Loyal Users
28252,765,58,117,2,5,4,11,At Risk
28395,800,21,35,2,3,3,8,Casual Users
28824,2094,9,11,1,2,1,4,Lost
28889,1286,7,66,1,2,4,7,Lost
28944,44,68,110,5,5,4,14,Champions
28995,151,60,143,4,5,4,13,Champions
29017,46,117,181,5,5,5,15,Champions
29068,2788,5,17,1,1,2,4,Lost
29110,43,116,455,5,5,5,15,Champions
29227,230,7,36,3,2,3,8,Casual Users
29593,99,60,105,4,5,4,13,Champions
29596,7,132,236,5,5,5,15,Champions
30412,119,18,104,4,3,4,11,Loyal Users
30537,666,6,42,2,1,3,6,Lost
30810,3117,15,34,1,3,3,7,Casual Users
30893,899,18,30,2,3,2,7,Casual Users
30910,653,20,27,2,3,2,7,Casual Users
31003,1104,19,79,2,3,4,9,Casual Users
31258,3,58,142,5,5,4,14,Champions
31403,258,59,191,3,5,5,13,Loyal Users
31484,838,10,61,2,2,3,7,Lost
31825,1,16,38,5,3,3,11,Loyal Users
31835,183,10,88,3,2,4,9,Casual Users
31836,778,6,7,2,1,1,4,Lost
31966,1121,6,27,2,1,2,5,Lost
31973,25,28,191,5,4,5,14,Champions
32002,433,28,73,3,4,4,11,Loyal Users
32327,327,59,135,3,5,4,12,Loyal Users
32465,427,6,12,3,1,1,5,Casual Users
33188,721,10,28,2,2,2,6,Lost
33444,4,26,37,5,4,3,12,Loyal Users
33701,723,8,15,2,2,1,5,Lost
33952,1011,5,8,2,1,1,4,Lost
34048,138,12,27,4,3,2,9,Loyal Users
34468,1292,7,12,1,2,1,4,Lost
34576,43,60,185,5,5,5,15,Champions
34632,1097,6,13,2,1,1,4,Lost
34637,142,12,102,4,3,4,11,Loyal Users
34783,32,14,49,5,3,3,11,Loyal Users
34975,1873,5,13,1,1,1,3,Lost
35176,4423,5,14,1,1,1,3,Lost
35465,699,8,8,2,2,1,5,Lost
35469,263,48,87,3,5,4,12,Loyal Users
35972,139,43,95,4,4,4,12,Champions
35978,95,20,24,4,3,2,9,Loyal Users
36676,588,8,21,2,2,2,6,Lost
36692,303,7,13,3,2,1,6,Casual Users
36938,2499,9,39,1,2,3,6,Lost
37254,122,5,7,4,1,1,6,Promising
37286,1152,10,12,2,2,1,5,Lost
37746,165,72,294,4,5,5,14,Champions
37763,864,13,56,2,3,3,8,Casual Users
38232,5,46,169,5,5,5,15,Champions
38262,951,14,20,2,3,2,7,Casual Users
38287,1692,29,75,1,4,4,9,At Risk
38453,406,12,45,3,3,3,9,Loyal Users
38567,138,42,72,4,4,4,12,Champions
26697,283,28,80,3,4,4,11,Loyal Users
26756,1407,9,89,1,2,4,7,Lost
26899,674,7,11,2,2,1,5,Lost
26987,287,31,70,3,4,4,11,Loyal Users
27478,91,55,213,4,5,5,14,Champions
27593,0,183,638,5,5,5,15,Champions
27611,0,25,121,5,4,4,13,Champions
27865,268,31,56,3,4,3,10,Loyal Users
28803,727,26,98,2,4,4,10,At Risk
29631,3822,5,6,1,1,1,3,Lost
30260,117,48,80,4,5,4,13,Champions
30324,1231,8,46,2,2,3,7,Lost
30661,2149,7,23,1,2,2,5,Lost
31555,5,37,100,5,4,4,13,Champions
31606,18,43,331,5,4,5,14,Champions
32052,2644,8,20,1,2,2,5,Lost
32221,523,9,13,2,2,1,5,Lost
32230,706,15,19,2,3,2,7,Casual Users
32324,91,6,43,4,1,3,8,Promising
32359,1665,10,40,1,2,3,6,Lost
32416,5281,6,14,1,1,1,3,Lost
32523,112,38,50,4,4,3,11,Loyal Users
32541,12,12,38,5,3,3,11,Loyal Users
32725,1234,11,15,2,2,1,5,Lost
32738,16,97,271,5,5,5,15,Champions
33286,236,52,260,3,5,5,13,Loyal Users
33991,804,13,32,2,3,3,8,Casual Users
33992,830,7,66,2,2,4,8,Lost
34556,146,74,215,4,5,5,14,Champions
34663,159,58,255,4,5,5,14,Champions
34727,2753,7,29,1,2,2,5,Lost
34967,30,31,51,5,4,3,12,Loyal Users
34981,1545,24,71,1,4,4,9,At Risk
35282,111,27,143,4,4,4,12,Champions
35671,41,55,107,5,5,4,14,Champions
36125,328,16,31,3,3,2,8,Loyal Users
36376,137,22,174,4,4,5,13,Champions
36812,105,29,41,4,4,3,11,Loyal Users
37065,1708,16,45,1,3,3,7,Casual Users
37067,29,29,125,5,4,4,13,Champions
37363,3132,8,47,1,2,3,6,Lost
37512,6008,7,7,1,2,1,4,Lost
37696,28,129,560,5,5,5,15,Champions
37851,41,24,29,5,4,2,11,Loyal Users
38177,20,93,432,5,5,5,15,Champions
38181,62,5,23,5,1,2,8,Promising
38542,1406,7,18,1,2,2,5,Lost
38675,23,128,190,5,5,5,15,Champions
38777,1990,7,9,1,2,1,4,Lost
38909,423,32,79,3,4,4,11,Loyal Users
38932,75,12,53,4,3,3,10,Loyal Users
38998,611,6,12,2,1,1,4,Lost
39102,20,26,65,5,4,4,13,Champions
26487,276,16,25,3,3,2,8,Loyal Users
26661,135,6,15,4,1,1,6,Promising
27045,267,13,32,3,3,3,9,Loyal Users
27069,856,13,103,2,3,4,9,Casual Users
27077,0,13,27,5,3,2,10,Loyal Users
27499,4304,47,159,1,5,5,11,At Risk
27781,1305,17,25,1,3,2,6,Casual Users
28178,1719,5,7,1,1,1,3,Lost
28508,541,38,49,2,4,3,9,At Risk
28603,850,14,29,2,3,2,7,Casual Users
28792,822,5,22,2,1,2,5,Lost
29104,1452,7,15,1,2,1,4,Lost
29471,119,37,77,4,4,4,12,Champions
29781,2723,22,51,1,4,3,8,At Risk
29916,419,8,14,3,2,1,6,Casual Users
30053,877,35,54,2,4,3,9,At Risk
30061,506,7,17,2,2,2,6,Lost
30151,123,9,41,4,2,3,9,Promising
30171,2,145,575,5,5,5,15,Champions
30674,2694,6,20,1,1,2,4,Lost
30766,150,8,9,4,2,1,7,Promising
30851,7,22,45,5,4,3,12,Loyal Users
30975,254,29,85,3,4,4,11,Loyal Users
31005,775,20,35,2,3,3,8,Casual Users
31448,277,25,40,3,4,3,10,Loyal Users
31565,128,8,29,4,2,2,8,Promising
31583,127,69,209,4,5,5,14,Champions
32035,318,81,237,3,5,5,13,Loyal Users
32356,147,41,94,4,4,4,12,Champions
32366,7,80,296,5,5,5,15,Champions
32422,583,28,112,2,4,4,10,At Risk
32613,61,70,218,5,5,5,15,Champions
32689,1853,5,26,1,1,2,4,Lost
32917,26,7,44,5,2,3,10,Promising
33377,2125,7,35,1,2,3,6,Lost
33452,138,15,23,4,3,2,9,Loyal Users
33537,5,9,22,5,2,2,9,Promising
33663,2518,6,26,1,1,2,4,Lost
33786,2664,5,6,1,1,1,3,Lost
33941,539,7,10,2,2,1,5,Lost
34144,137,39,68,4,4,4,12,Champions
34162,2638,10,32,1,2,3,6,Lost
34208,546,36,110,2,4,4,10,At Risk
34499,3425,6,11,1,1,1,3,Lost
34542,402,13,18,3,3,2,8,Loyal Users
34552,1118,5,5,2,1,1,4,Lost
34803,1671,10,23,1,2,2,5,Lost
35227,398,13,70,3,3,4,10,Loyal Users
35519,2795,10,14,1,2,1,4,Lost
35780,37,68,388,5,5,5,15,Champions
35981,1153,20,72,2,3,4,9,Casual Users
36240,272,26,38,3,4,3,10,Loyal Users
36390,178,15,38,3,3,3,9,Loyal Users
36556,37,27,96,5,4,4,13,Champions
36590,332,40,131,3,4,4,11,Loyal Users
36621,98,131,240,4,5,5,14,Champions
36656,2654,6,12,1,1,1,3,Lost
36688,3329,6,10,1,1,1,3,Lost
36884,245,8,84,3,2,4,9,Casual Users
37550,2170,6,13,1,1,1,3,Lost
37643,1534,7,43,1,2,3,6,Lost
37927,7,73,308,5,5,5,15,Champions
37993,88,9,20,4,2,2,8,Promising
38195,110,50,172,4,5,5,14,Champions
38265,436,5,7,3,1,1,5,Casual Users
38398,550,8,10,2,2,1,5,Lost
38531,0,11,42,5,2,3,10,Promising
38565,166,9,10,3,2,1,6,Casual Users
38584,1184,14,19,2,3,2,7,Casual Users
38838,213,12,80,3,3,4,10,Loyal Users
39024,428,34,64,3,4,4,11,Loyal Users
26717,1036,15,52,2,3,3,8,Casual Users
27024,1103,8,11,2,2,1,5,Lost
27082,0,98,455,5,5,5,15,Champions
27190,360,20,46,3,3,3,9,Loyal Users
27196,152,16,85,4,3,4,11,Loyal Users
27340,1124,14,24,2,3,2,7,Casual Users
27392,1123,6,10,2,1,1,4,Lost
27431,144,72,413,4,5,5,14,Champions
27879,257,57,95,3,5,4,12,Loyal Users
27915,1797,15,38,1,3,3,7,Casual Users
28142,1147,6,45,2,1,3,6,Lost
28223,1739,7,41,1,2,3,6,Lost
28297,4705,11,40,1,2,3,6,Lost
29212,285,63,204,3,5,5,13,Loyal Users
29214,1591,6,12,1,1,1,3,Lost
29364,398,7,9,3,2,1,6,Casual Users
29418,1513,19,43,1,3,3,7,Casual Users
29448,37,28,106,5,4,4,13,Champions
29463,150,32,53,4,4,3,11,Loyal Users
29482,46,11,35,5,2,3,10,Promising
29777,2042,6,12,1,1,1,3,Lost
30076,17,51,126,5,5,4,14,Champions
30207,0,39,225,5,4,5,14,Champions
30233,3346,31,156,1,4,5,10,At Risk
30252,417,21,91,3,3,4,10,Loyal Users
30270,203,47,87,3,5,4,12,Loyal Users
30294,125,41,96,4,4,4,12,Champions
31050,204,144,439,3,5,5,13,Loyal Users
31066,148,64,92,4,5,4,13,Champions
31470,1145,18,93,2,3,4,9,Casual Users
31623,7,67,101,5,5,4,14,Champions
31639,3415,8,16,1,2,2,5,Lost
31793,160,23,144,4,4,4,12,Champions
32108,1583,9,9,1,2,1,4,Lost
32228,405,37,64,3,4,4,11,Loyal Users
32258,1570,40,55,1,4,3,8,At Risk
32472,1413,18,73,1,3,4,8,Casual Users
32825,1399,13,22,1,3,2,6,Casual Users
32928,966,10,15,2,2,1,5,Lost
33237,246,128,272,3,5,5,13,Loyal Users
33438,4429,8,11,1,2,1,4,Lost
33790,266,30,85,3,4,4,11,Loyal Users
33957,9,150,373,5,5,5,15,Champions
34105,1261,5,28,1,1,2,4,Lost
34211,715,8,30,2,2,2,6,Lost
34456,1721,59,81,1,5,4,10,At Risk
34610,3963,38,244,1,4,5,10,At Risk
34631,4938,8,28,1,2,2,5,Lost
34770,11,27,120,5,4,4,13,Champions
34787,35,54,102,5,5,4,14,Champions
34904,153,13,41,4,3,3,10,Loyal Users
35048,115,62,563,4,5,5,14,Champions
35131,1432,6,9,1,1,1,3,Lost
35136,399,18,21,3,3,2,8,Loyal Users
35458,581,8,13,2,2,1,5,Lost
35561,869,23,46,2,4,3,9,At Risk
35730,2696,7,15,1,2,1,4,Lost
35919,4097,5,5,1,1,1,3,Lost
36157,549,86,181,2,5,5,12,At Risk
36402,43,129,299,5,5,5,15,Champions
36609,1437,8,22,1,2,2,5,Lost
36755,591,88,333,2,5,5,12,At Risk
36796,2572,7,20,1,2,2,5,Lost
36918,270,27,91,3,4,4,11,Loyal Users
37496,285,38,154,3,4,5,12,Loyal Users
37572,7,45,136,5,4,4,13,Champions
37682,159,30,90,4,4,4,12,Champions
37824,398,8,10,3,2,1,6,Casual Users
38175,1263,5,9,1,1,1,3,Lost
38179,1660,5,5,1,1,1,3,Lost
38224,90,84,224,4,5,5,14,Champions
38328,772,8,32,2,2,3,7,Lost
38351,51,25,46,5,4,3,12,Loyal Users
38572,104,86,130,4,5,4,13,Champions
38624,4561,5,12,1,1,1,3,Lost
39090,249,17,59,3,3,3,9,Loyal Users
39106,296,56,148,3,5,5,13,Loyal Users
39188,401,6,18,3,1,2,6,Casual Users
26542,2700,5,12,1,1,1,3,Lost
26749,132,65,131,4,5,4,13,Champions
27548,1257,7,34,2,2,3,7,Lost
27618,129,14,19,4,3,2,9,Loyal Users
27854,407,6,29,3,1,2,6,Casual Users
28101,28,10,91,5,2,4,11,Promising
28271,867,18,31,2,3,2,7,Casual Users
28618,107,9,24,4,2,2,8,Promising
28635,568,24,36,2,4,3,9,At Risk
28914,2,59,342,5,5,5,15,Champions
29294,5529,5,5,1,1,1,3,Lost
29778,14,63,106,5,5,4,14,Champions
29977,537,34,69,2,4,4,10,At Risk
30103,33,85,126,5,5,4,14,Champions
30140,222,28,36,3,4,3,10,Loyal Users
30262,102,23,64,4,4,4,12,Champions
30753,1977,13,45,1,3,3,7,Casual Users
31148,2130,5,8,1,1,1,3,Lost
31174,81,18,22,4,3,2,9,Loyal Users
31357,7,33,48,5,4,3,12,Loyal Users
31613,31,5,14,5,1,1,7,Promising
31840,167,7,15,3,2,1,6,Casual Users
31940,878,10,33,2,2,3,7,Lost
32369,304,12,24,3,3,2,8,Loyal Users
32646,324,12,39,3,3,3,9,Loyal Users
32667,227,6,13,3,1,1,5,Casual Users
32688,486,34,130,2,4,4,10,At Risk
33210,73,23,174,4,4,5,13,Champions
33509,63,19,22,5,3,2,10,Loyal Users
33519,13,41,127,5,4,4,13,Champions
33562,273,40,155,3,4,5,12,Loyal Users
33626,346,34,42,3,4,3,10,Loyal Users
33978,74,32,56,4,4,3,11,Loyal Users
34039,105,44,111,4,4,4,12,Champions
34337,1178,6,9,2,1,1,4,Lost
34386,165,17,34,4,3,3,10,Loyal Users
34480,653,6,7,2,1,1,4,Lost
34498,1981,8,18,1,2,2,5,Lost
34616,140,51,115,4,5,4,13,Champions
34987,1586,48,76,1,5,4,10,At Risk
35134,63,27,70,5,4,4,13,Champions
35499,1157,27,54,2,4,3,9,At Risk
35660,417,125,256,3,5,5,13,Loyal Users
35880,368,27,90,3,4,4,11,Loyal Users
35907,226,30,60,3,4,3,10,Loyal Users
35968,1349,13,21,1,3,2,6,Casual Users
35979,1006,11,36,2,2,3,7,Lost
35989,276,43,96,3,4,4,11,Loyal Users
35996,1065,53,72,2,5,4,11,At Risk
36109,0,92,198,5,5,5,15,Champions
36218,13,14,42,5,3,3,11,Loyal Users
36310,245,8,21,3,2,2,7,Casual Users
36378,727,5,17,2,1,2,5,Lost
36531,68,64,286,5,5,5,15,Champions
36593,163,29,59,4,4,3,11,Loyal Users
36742,256,54,238,3,5,5,13,Loyal Users
36823,956,6,12,2,1,1,4,Lost
37255,232,21,62,3,3,3,9,Loyal Users
37821,966,12,48,2,3,3,8,Casual Users
37984,119,53,445,4,5,5,14,Champions
38326,104,12,65,4,3,4,11,Loyal Users
38482,105,65,420,4,5,5,14,Champions
38502,4051,34,50,1,4,3,8,At Risk
39012,232,17,22,3,3,2,8,Loyal Users
39115,2560,5,5,1,1,1,3,Lost
39159,96,37,218,4,4,5,13,Champions
26498,1105,43,114,2,4,4,10,At Risk
26564,126,39,177,4,4,5,13,Champions
26696,1380,7,7,1,2,1,4,Lost
27375,1732,16,25,1,3,2,6,Casual Users
27419,185,18,43,3,3,3,9,Loyal Users
27597,503,13,71,2,3,4,9,Casual Users
27846,575,15,35,2,3,3,8,Casual Users
28054,1502,5,16,1,1,2,4,Lost
28260,83,85,337,4,5,5,14,Champions
28385,283,24,37,3,4,3,10,Loyal Users
28506,1663,5,12,1,1,1,3,Lost
28720,1970,5,7,1,1,1,3,Lost
29240,164,9,32,4,2,3,9,Promising
30045,879,8,44,2,2,3,7,Lost
30251,271,9,17,3,2,2,7,Casual Users
30477,444,7,8,3,2,1,6,Casual Users
30658,1005,11,33,2,2,3,7,Lost
30857,4097,8,8,1,2,1,4,Lost
31078,9,75,132,5,5,4,14,Champions
31219,278,19,37,3,3,3,9,Loyal Users
31283,4094,20,43,1,3,3,7,Casual Users
31544,150,72,130,4,5,4,13,Champions
31686,1086,22,44,2,4,3,9,At Risk
31938,3156,15,43,1,3,3,7,Casual Users
32067,121,54,94,4,5,4,13,Champions
32158,576,54,74,2,5,4,11,At Risk
32348,649,43,97,2,4,4,10,At Risk
32433,6,68,408,5,5,5,15,Champions
32447,122,8,8,4,2,1,7,Promising
32502,207,47,203,3,5,5,13,Loyal Users
32650,205,24,36,3,4,3,10,Loyal Users
32775,0,139,353,5,5,5,15,Champions
32981,104,82,198,4,5,5,14,Champions
33248,2326,10,33,1,2,3,6,Lost
33473,403,5,14,3,1,1,5,Casual Users
33573,30,29,50,5,4,3,12,Loyal Users
33826,35,113,166,5,5,5,15,Champions
34194,83,56,142,4,5,4,13,Champions
34471,69,91,319,5,5,5,15,Champions
35230,417,23,41,3,4,3,10,Loyal Users
35787,423,12,30,3,3,2,8,Loyal Users
35897,29,43,63,5,4,4,13,Champions
35955,29,48,275,5,5,5,15,Champions
36113,851,13,26,2,3,2,7,Casual Users
36272,3123,6,11,1,1,1,3,Lost
36291,5236,10,10,1,2,1,4,Lost
36406,974,23,82,2,4,4,10,At Risk
36630,127,14,43,4,3,3,10,Loyal Users
36660,5286,10,42,1,2,3,6,Lost
36774,6,6,9,5,1,1,7,Promising
36953,5,150,227,5,5,5,15,Champions
37244,68,51,103,5,5,4,14,Champions
37782,4960,7,33,1,2,3,6,Lost
37819,702,9,23,2,2,2,6,Lost
38545,5905,5,5,1,1,1,3,Lost
38626,1134,14,24,2,3,2,7,Casual Users
38989,448,32,99,3,4,4,11,Loyal Users
39020,363,13,14,3,3,1,7,Loyal Users
39068,101,7,28,4,2,2,8,Promising
26537,135,40,70,4,4,4,12,Champions
26545,2988,42,72,1,4,4,9,At Risk
26901,608,25,113,2,4,4,10,At Risk
26963,68,95,352,5,5,5,15,Champions
26999,153,25,148,4,4,5,13,Champions
27598,80,61,121,4,5,4,13,Champions
27913,2263,12,96,1,3,4,8,Casual Users
28059,366,9,11,3,2,1,6,Casual Users
28638,125,35,143,4,4,4,12,Champions
28845,2616,5,9,1,1,1,3,Lost
29731,2706,5,15,1,1,1,3,Lost
29749,257,53,109,3,5,4,12,Loyal Users
29934,70,17,39,4,3,3,10,Loyal Users
30149,64,43,119,5,4,4,13,Champions
30296,245,12,49,3,3,3,9,Loyal Users
30341,867,6,10,2,1,1,4,Lost
30845,101,24,137,4,4,4,12,Champions
31048,3512,11,31,1,2,2,5,Lost
31495,459,17,30,3,3,2,8,Loyal Users
31507,965,16,18,2,3,2,7,Casual Users
31691,18,32,95,5,4,4,13,Champions
31693,257,23,59,3,4,3,10,Loyal Users
31764,149,5,13,4,1,1,6,Promising
31910,2876,13,33,1,3,3,7,Casual Users
31935,17,13,27,5,3,2,10,Loyal Users
32275,212,20,72,3,3,4,10,Loyal Users
32798,838,51,76,2,5,4,11,At Risk
32937,31,32,112,5,4,4,13,Champions
33171,56,19,163,5,3,5,13,Loyal Users
33345,2104,6,6,1,1,1,3,Lost
33634,1034,8,11,2,2,1,5,Lost
33672,118,14,47,4,3,3,10,Loyal Users
33849,192,5,16,3,1,2,6,Casual Users
33891,2151,5,10,1,1,1,3,Lost
34319,22,8,21,5,2,2,9,Promising
34335,582,14,33,2,3,3,8,Casual Users
34771,1013,39,68,2,4,4,10,At Risk
35388,30,33,56,5,4,3,12,Loyal Users
35416,132,98,308,4,5,5,14,Champions
35549,402,13,21,3,3,2,8,Loyal Users
35624,67,30,64,5,4,4,13,Champions
35738,637,13,28,2,3,2,7,Casual Users
36608,482,8,19,2,2,2,6,Lost
36640,32,73,252,5,5,5,15,Champions
37141,624,11,23,2,2,2,6,Lost
37594,115,67,155,4,5,5,14,Champions
37660,585,7,17,2,2,2,6,Lost
37692,124,31,60,4,4,3,11,Loyal Users
37717,448,34,56,3,4,3,10,Loyal Users
37841,4546,7,25,1,2,2,5,Lost
38330,33,40,148,5,4,5,14,Champions
38338,387,7,15,3,2,1,6,Casual Users
38448,441,20,34,3,3,3,9,Loyal Users
38888,991,6,18,2,1,2,5,Lost
38899,3831,5,19,1,1,2,4,Lost
38982,72,14,42,4,3,3,10,Loyal Users
39066,2091,7,10,1,2,1,4,Lost
39184,122,46,356,4,5,5,14,Champions
27241,139,26,51,4,4,3,11,Loyal Users
27250,165,9,21,4,2,2,8,Promising
27701,645,7,17,2,2,2,6,Lost
27989,5500,10,18,1,2,2,5,Lost
28004,1944,12,25,1,3,2,6,Casual Users
28208,178,94,369,3,5,5,13,Loyal Users
28318,887,7,13,2,2,1,5,Lost
28534,298,19,193,3,3,5,11,Loyal Users
28734,2622,5,6,1,1,1,3,Lost
28860,97,44,120,4,4,4,12,Champions
28900,414,29,92,3,4,4,11,Loyal Users
28950,1848,7,14,1,2,1,4,Lost
28974,568,20,31,2,3,2,7,Casual Users
29322,110,53,231,4,5,5,14,Champions
29507,90,15,50,4,3,3,10,Loyal Users
29858,1015,10,59,2,2,3,7,Lost
30732,1983,8,56,1,2,3,6,Lost
31212,162,10,39,4,2,3,9,Promising
31300,2098,7,14,1,2,1,4,Lost
31649,135,11,14,4,2,1,7,Promising
31800,3533,25,40,1,4,3,8,At Risk
31860,32,9,11,5,2,1,8,Promising
31897,233,5,40,3,1,3,7,Casual Users
31945,1989,7,12,1,2,1,4,Lost
32704,5,12,19,5,3,2,10,Loyal Users
33144,95,5,9,4,1,1,6,Promising
33496,111,34,62,4,4,3,11,Loyal Users
33711,4,15,42,5,3,3,11,Loyal Users
33866,79,34,40,4,4,3,11,Loyal Users
34126,57,19,107,5,3,4,12,Loyal Users
34268,1273,14,21,1,3,2,6,Casual Users
34852,667,31,83,2,4,4,10,At Risk
34922,415,160,369,3,5,5,13,Loyal Users
35114,430,5,16,3,1,2,6,Casual Users
35874,282,9,9,3,2,1,6,Casual Users
36021,823,16,42,2,3,3,8,Casual Users
36329,457,20,29,3,3,2,8,Loyal Users
36428,80,109,469,4,5,5,14,Champions
37226,2133,17,29,1,3,2,6,Casual Users
37272,126,12,36,4,3,3,10,Loyal Users
37419,436,11,22,3,2,2,7,Casual Users
37495,3502,7,12,1,2,1,4,Lost
37531,227,21,60,3,3,3,9,Loyal Users
37562,3565,6,16,1,1,2,4,Lost
38016,384,8,20,3,2,2,7,Casual Users
38767,722,6,9,2,1,1,4,Lost
38788,307,83,116,3,5,4,12,Loyal Users
38996,124,25,149,4,4,5,13,Champions
39197,433,6,8,3,1,1,5,Casual Users
26753,104,29,266,4,4,5,13,Champions
26908,803,22,80,2,4,4,10,At Risk
27234,439,6,6,3,1,1,5,Casual Users
27300,541,16,20,2,3,2,7,Casual Users
27420,1411,7,16,1,2,2,5,Lost
27444,5011,8,10,1,2,1,4,Lost
27610,409,5,15,3,1,1,5,Casual Users
28139,399,8,9,3,2,1,6,Casual Users
28301,3,72,248,5,5,5,15,Champions
29203,1557,6,25,1,1,2,4,Lost
29606,2039,6,31,1,1,2,4,Lost
29687,428,23,29,3,4,2,9,Loyal Users
29733,1,9,15,5,2,1,8,Promising
29786,953,5,11,2,1,1,4,Lost
29930,693,6,7,2,1,1,4,Lost
30190,4992,11,19,1,2,2,5,Lost
30671,2134,5,7,1,1,1,3,Lost
30683,1,28,148,5,4,5,14,Champions
31093,315,12,32,3,3,3,9,Loyal Users
31098,1141,5,9,2,1,1,4,Lost
31593,23,69,158,5,5,5,15,Champions
32202,677,47,98,2,5,4,11,At Risk
32336,121,5,14,4,1,1,6,Promising
32484,90,49,171,4,5,5,14,Champions
32531,267,31,110,3,4,4,11,Loyal Users
32808,592,10,31,2,2,2,6,Lost
33155,5716,9,38,1,2,3,6,Lost
33396,3,61,113,5,5,4,14,Champions
33408,72,108,297,4,5,5,14,Champions
33608,215,66,295,3,5,5,13,Loyal Users
33865,58,7,14,5,2,1,8,Promising
34523,78,39,119,4,4,4,12,Champions
34532,101,36,86,4,4,4,12,Champions
34573,114,13,23,4,3,2,9,Loyal Users
34609,9,67,133,5,5,4,14,Champions
34841,5,86,138,5,5,4,14,Champions
34877,281,5,12,3,1,1,5,Casual Users
34994,11,137,318,5,5,5,15,Champions
35027,283,13,40,3,3,3,9,Loyal Users
35105,11,25,58,5,4,3,12,Loyal Users
35323,1576,5,16,1,1,2,4,Lost
35597,3,66,277,5,5,5,15,Champions
35770,1059,30,36,2,4,3,9,At Risk
35774,90,18,60,4,3,3,10,Loyal Users
35793,417,36,70,3,4,4,11,Loyal Users
35863,55,75,155,5,5,5,15,Champions
36091,430,12,70,3,3,4,10,Loyal Users
36349,491,17,31,2,3,2,7,Casual Users
36350,165,5,5,4,1,1,6,Promising
36415,15,45,108,5,4,4,13,Champions
36769,292,7,9,3,2,1,6,Casual Users
36841,1712,6,19,1,1,2,4,Lost
36912,272,13,26,3,3,2,8,Loyal Users
37027,252,6,10,3,1,1,5,Casual Users
37453,369,6,6,3,1,1,5,Casual Users
37513,3444,23,52,1,4,3,8,At Risk
37784,31,66,97,5,5,4,14,Champions
37921,5534,5,6,1,1,1,3,Lost
38167,82,32,61,4,4,3,11,Loyal Users
38382,112,76,314,4,5,5,14,Champions
38420,185,50,83,3,5,4,12,Loyal Users
38495,561,12,14,2,3,1,6,Casual Users
38698,387,53,171,3,5,5,13,Loyal Users
38720,814,21,55,2,3,3,8,Casual Users
38984,16,74,123,5,5,4,14,Champions
26674,295,99,130,3,5,4,12,Loyal Users
26689,298,7,11,3,2,1,6,Casual Users
27231,457,49,95,3,5,4,12,Loyal Users
27235,31,13,17,5,3,2,10,Loyal Users
27605,181,32,224,3,4,5,12,Loyal Users
27711,74,20,129,4,3,4,11,Loyal Users
28563,429,54,171,3,5,5,13,Loyal Users
28667,1555,14,18,1,3,2,6,Casual Users
28797,1690,11,27,1,2,2,5,Lost
28804,701,18,73,2,3,4,9,Casual Users
29085,2856,5,58,1,1,3,5,Lost
29394,214,9,16,3,2,2,7,Casual Users
29493,134,20,46,4,3,3,10,Loyal Users
29516,283,40,67,3,4,4,11,Loyal Users
29782,0,88,118,5,5,4,14,Champions
30078,4,69,246,5,5,5,15,Champions
30929,708,6,15,2,1,1,4,Lost
31277,2701,9,32,1,2,3,6,Lost
31436,192,5,14,3,1,1,5,Casual Users
31622,85,128,208,4,5,5,14,Champions
32091,6136,8,8,1,2,1,4,Lost
32167,2777,8,65,1,2,4,7,Lost
32521,155,6,24,4,1,2,7,Promising
32608,251,12,81,3,3,4,10,Loyal Users
32783,15,10,32,5,2,3,10,Promising
32946,398,9,34,3,2,3,8,Casual Users
33198,204,63,448,3,5,5,13,Loyal Users
33579,13,6,8,5,1,1,7,Promising
33814,1536,13,13,1,3,1,5,Casual Users
34235,1420,6,10,1,1,1,3,Lost
34340,14,29,100,5,4,4,13,Champions
34521,3005,5,5,1,1,1,3,Lost
34801,1225,11,32,2,2,3,7,Lost
34814,130,73,247,4,5,5,14,Champions
34845,194,45,101,3,4,4,11,Loyal Users
34916,410,5,51,3,1,3,7,Casual Users
35137,3764,5,12,1,1,1,3,Lost
35205,2560,6,9,1,1,1,3,Lost
35298,272,5,44,3,1,3,7,Casual Users
35307,437,8,10,3,2,1,6,Casual Users
35811,439,13,24,3,3,2,8,Loyal Users
35869,281,22,61,3,4,3,10,Loyal Users
36133,1165,11,13,2,2,1,5,Lost
36263,1519,13,16,1,3,2,6,Casual Users
36322,122,42,93,4,4,4,12,Champions
36575,1402,6,9,1,1,1,3,Lost
36684,12,77,372,5,5,5,15,Champions
36758,172,20,79,3,3,4,10,Loyal Users
36878,233,28,72,3,4,4,11,Loyal Users
37048,76,103,211,4,5,5,14,Champions
37479,78,88,430,4,5,5,14,Champions
37629,241,14,35,3,3,3,9,Loyal Users
37928,6,90,309,5,5,5,15,Champions
38059,24,63,373,5,5,5,15,Champions
38406,878,6,12,2,1,1,4,Lost
39018,139,20,84,4,3,4,11,Loyal Users
39073,798,5,8,2,1,1,4,Lost
39209,389,52,157,3,5,5,13,Loyal Users
26526,814,9,14,2,2,1,5,Lost
26550,126,42,278,4,4,5,13,Champions
26560,9,35,112,5,4,4,13,Champions
26603,1749,5,25,1,1,2,4,Lost
26658,138,55,238,4,5,5,14,Champions
27290,50,33,106,5,4,4,13,Champions
27437,241,26,40,3,4,3,10,Loyal Users
27500,34,37,96,5,4,4,13,Champions
27698,124,47,141,4,5,4,13,Champions
27918,402,16,59,3,3,3,9,Loyal Users
27953,2301,9,17,1,2,2,5,Lost
27963,1410,11,39,1,2,3,6,Lost
28135,1416,8,14,1,2,1,4,Lost
28143,265,6,6,3,1,1,5,Casual Users
28183,690,14,25,2,3,2,7,Casual Users
28516,29,161,266,5,5,5,15,Champions
28680,24,84,540,5,5,5,15,Champions
28967,129,39,158,4,4,5,13,Champions
28981,2156,8,18,1,2,2,5,Lost
29016,23,81,196,5,5,5,15,Champions
29976,6115,11,11,1,2,1,4,Lost
30077,7,28,76,5,4,4,13,Champions
30305,8,36,67,5,4,4,13,Champions
30451,6,19,28,5,3,2,10,Loyal Users
31349,33,25,52,5,4,3,12,Loyal Users
31584,1413,12,55,1,3,3,7,Casual Users
32088,2275,8,80,1,2,4,7,Lost
32334,30,27,71,5,4,4,13,Champions
32370,121,16,92,4,3,4,11,Loyal Users
32384,3015,5,8,1,1,1,3,Lost
32529,288,23,95,3,4,4,11,Loyal Users
32601,252,27,76,3,4,4,11,Loyal Users
32999,45,49,229,5,5,5,15,Champions
33067,770,6,31,2,1,2,5,Lost
33316,107,78,133,4,5,4,13,Champions
33374,1585,9,66,1,2,4,7,Lost
33416,708,46,62,2,5,3,10,At Risk
33899,2554,6,10,1,1,1,3,Lost
34312,663,12,81,2,3,4,9,Casual Users
34541,3305,5,18,1,1,2,4,Lost
34734,98,39,101,4,4,4,12,Champions
34738,1691,7,22,1,2,2,5,Lost
34856,479,6,9,2,1,1,4,Lost
35157,90,8,52,4,2,3,9,Promising
35295,3274,6,7,1,1,1,3,Lost
35708,248,7,9,3,2,1,6,Casual Users
35984,163,11,23,4,2,2,8,Promising
36344,13,34,63,5,4,4,13,Champions
36395,320,7,9,3,2,1,6,Casual Users
36603,2404,59,404,1,5,5,11,At Risk
37153,177,6,35,3,1,3,7,Casual Users
37378,668,7,12,2,2,1,5,Lost
37490,468,26,87,3,4,4,11,Loyal Users
37520,3383,9,13,1,2,1,4,Lost
37567,1,126,344,5,5,5,15,Champions
37973,1434,8,23,1,2,2,5,Lost
38207,81,44,292,4,4,5,13,Champions
38619,7,79,723,5,5,5,15,Champions
38641,133,29,34,4,4,3,11,Loyal Users
38686,1811,5,16,1,1,2,4,Lost
38688,2262,16,33,1,3,3,7,Casual Users
39025,508,16,45,2,3,3,8,Casual Users
26488,7,22,94,5,4,4,13,Champions
26552,1297,33,66,1,4,4,9,At Risk
26608,2728,8,11,1,2,1,4,Lost
27081,838,44,70,2,4,4,10,At Risk
27208,1174,13,59,2,3,3,8,Casual Users
27291,2577,13,48,1,3,3,7,Casual Users
27613,279,9,21,3,2,2,7,Casual Users
27659,145,86,550,4,5,5,14,Champions
28167,111,22,60,4,4,3,11,Loyal Users
28325,3344,15,32,1,3,3,7,Casual Users
28434,1529,6,44,1,1,3,5,Lost
28930,735,24,54,2,4,3,9,At Risk
29487,567,8,35,2,2,3,7,Lost
29490,23,219,536,5,5,5,15,Champions
29519,163,6,13,4,1,1,6,Promising
29561,133,48,107,4,5,4,13,Champions
29705,105,131,350,4,5,5,14,Champions
30160,779,7,8,2,2,1,5,Lost
30398,1160,8,26,2,2,2,6,Lost
30819,1395,12,12,1,3,1,5,Casual Users
30956,625,13,35,2,3,3,8,Casual Users
31059,618,15,30,2,3,2,7,Casual Users
31239,458,5,5,3,1,1,5,Casual Users
31536,13,8,38,5,2,3,10,Promising
31666,400,23,50,3,4,3,10,Loyal Users
31799,1406,5,9,1,1,1,3,Lost
32064,73,90,424,4,5,5,14,Champions
32081,91,51,144,4,5,4,13,Champions
32289,30,60,246,5,5,5,15,Champions
32293,118,6,9,4,1,1,6,Promising
32434,692,7,10,2,2,1,5,Lost
32792,1383,5,9,1,1,1,3,Lost
33227,3236,8,43,1,2,3,6,Lost
34067,145,78,160,4,5,5,14,Champions
34397,291,22,34,3,4,3,10,Loyal Users
34667,1191,9,20,2,2,2,6,Lost
34792,529,33,69,2,4,4,10,At Risk
34874,403,58,109,3,5,4,12,Loyal Users
35070,122,43,78,4,4,4,12,Champions
35234,2552,5,14,1,1,1,3,Lost
35684,540,7,21,2,2,2,6,Lost
35930,1437,9,15,1,2,1,4,Lost
36434,527,54,142,2,5,4,11,At Risk
36469,438,8,10,3,2,1,6,Casual Users
36610,70,89,196,4,5,5,14,Champions
36703,636,10,39,2,2,3,7,Lost
37080,23,36,57,5,4,3,12,Loyal Users
37102,866,5,13,2,1,1,4,Lost
37257,645,78,220,2,5,5,12,At Risk
37639,131,14,39,4,3,3,10,Loyal Users
37964,54,30,70,5,4,4,13,Champions
38577,4321,5,6,1,1,1,3,Lost
38722,672,19,27,2,3,2,7,Casual Users
39154,1118,8,14,2,2,1,5,Lost
26580,695,5,14,2,1,1,4,Lost
26601,34,88,297,5,5,5,15,Champions
26606,1984,13,20,1,3,2,6,Casual Users
26825,368,34,73,3,4,4,11,Loyal Users
27720,276,18,115,3,3,4,10,Loyal Users
27817,3036,8,16,1,2,2,5,Lost
27873,122,103,124,4,5,4,13,Champions
28012,406,32,82,3,4,4,11,Loyal Users
28186,3280,6,7,1,1,1,3,Lost
28277,92,23,55,4,4,3,11,Loyal Users
28281,74,21,67,4,3,4,11,Loyal Users
28386,1849,29,61,1,4,3,8,At Risk
28400,2805,9,81,1,2,4,7,Lost
28611,231,5,37,3,1,3,7,Casual Users
28851,4419,8,19,1,2,2,5,Lost
28961,91,150,432,4,5,5,14,Champions
29009,1273,10,29,1,2,2,5,Lost
29080,650,24,78,2,4,4,10,At Risk
29150,415,31,42,3,4,3,10,Loyal Users
29599,435,13,16,3,3,2,8,Loyal Users
29679,1954,18,32,1,3,3,7,Casual Users
29752,149,9,15,4,2,1,7,Promising
29776,151,14,32,4,3,3,10,Loyal Users
29794,32,22,49,5,4,3,12,Loyal Users
30390,837,10,28,2,2,2,6,Lost
30410,820,12,12,2,3,1,6,Casual Users
30423,285,13,85,3,3,4,10,Loyal Users
30616,262,7,21,3,2,2,7,Casual Users
30826,192,13,41,3,3,3,9,Loyal Users
31417,2312,5,21,1,1,2,4,Lost
31512,375,6,21,3,1,2,6,Casual Users
31516,267,20,27,3,3,2,8,Loyal Users
32011,299,34,58,3,4,3,10,Loyal Users
32179,4066,5,38,1,1,3,5,Lost
32306,133,123,510,4,5,5,14,Champions
32339,224,29,95,3,4,4,11,Loyal Users
32513,1145,13,33,2,3,3,8,Casual Users
32615,2131,7,13,1,2,1,4,Lost
33104,117,32,121,4,4,4,12,Champions
33332,8,50,138,5,5,4,14,Champions
33597,546,11,16,2,2,2,6,Lost
33645,1325,33,48,1,4,3,8,At Risk
33769,116,11,24,4,2,2,8,Promising
34383,826,10,22,2,2,2,6,Lost
34700,238,22,39,3,4,3,10,Loyal Users
34820,65,46,148,5,5,5,15,Champions
34909,278,22,62,3,4,3,10,Loyal Users
35066,311,60,241,3,5,5,13,Loyal Users
35279,43,56,209,5,5,5,15,Champions
35466,2526,7,9,1,2,1,4,Lost
35714,128,23,42,4,4,3,11,Loyal Users
36028,526,26,118,2,4,4,10,At Risk
36095,261,17,69,3,3,4,10,Loyal Users
36225,283,96,214,3,5,5,13,Loyal Users
36598,405,21,30,3,3,2,8,Loyal Users
36772,126,16,35,4,3,3,10,Loyal Users
37063,166,19,27,3,3,2,8,Loyal Users
37473,3118,7,7,1,2,1,4,Lost
37981,408,7,17,3,2,2,7,Casual Users
38599,857,17,38,2,3,3,8,Casual Users
38943,356,37,173,3,4,5,12,Loyal Users
26620,421,8,13,3,2,1,6,Casual Users
26662,109,32,64,4,4,4,12,Champions
26718,629,9,15,2,2,1,5,Lost
26745,679,8,19,2,2,2,6,Lost
26891,581,15,31,2,3,2,7,Casual Users
27087,286,8,21,3,2,2,7,Casual Users
27097,508,7,32,2,2,3,7,Lost
27497,287,17,32,3,3,3,9,Loyal Users
27972,19,56,104,5,5,4,14,Champions
28118,3941,6,6,1,1,1,3,Lost
28310,216,16,45,3,3,3,9,Loyal Users
28334,460,8,15,3,2,1,6,Casual Users
28521,158,6,10,4,1,1,6,Promising
28551,132,78,239,4,5,5,14,Champions
28751,241,19,73,3,3,4,10,Loyal Users
28815,293,12,70,3,3,4,10,Loyal Users
28926,875,6,6,2,1,1,4,Lost
29103,0,9,22,5,2,2,9,Promising
29301,18,17,29,5,3,2,10,Loyal Users
29454,47,107,664,5,5,5,15,Champions
29612,463,23,117,3,4,4,11,Loyal Users
29692,569,12,27,2,3,2,7,Casual Users
29833,6,38,87,5,4,4,13,Champions
30115,3589,13,23,1,3,2,6,Casual Users
30205,380,11,33,3,2,3,8,Casual Users
30240,150,51,155,4,5,5,14,Champions
30321,351,10,33,3,2,3,8,Casual Users
30554,203,19,65,3,3,4,10,Loyal Users
30672,8,9,21,5,2,2,9,Promising
30737,4746,30,104,1,4,4,9,At Risk
30909,832,33,158,2,4,5,11,At Risk
30919,971,8,23,2,2,2,6,Lost
31053,135,27,160,4,4,5,13,Champions
31160,0,70,196,5,5,5,15,Champions
31437,136,22,47,4,4,3,11,Loyal Users
32185,3891,6,8,1,1,1,3,Lost
32379,432,12,21,3,3,2,8,Loyal Users
32492,2387,18,59,1,3,3,7,Casual Users
32810,37,84,164,5,5,5,15,Champions
33341,146,56,85,4,5,4,13,Champions
33517,2559,9,45,1,2,3,6,Lost
33708,19,29,80,5,4,4,13,Champions
33765,117,162,658,4,5,5,14,Champions
33993,90,33,84,4,4,4,12,Champions
34524,682,6,6,2,1,1,4,Lost
34627,2786,12,37,1,3,3,7,Casual Users
34758,7,83,506,5,5,5,15,Champions
34864,406,45,110,3,4,4,11,Loyal Users
34936,425,50,97,3,5,4,12,Loyal Users
35308,455,12,19,3,3,2,8,Loyal Users
35333,1168,46,75,2,5,4,11,At Risk
35976,688,52,112,2,5,4,11,At Risk
36269,32,65,97,5,5,4,14,Champions
36324,186,53,151,3,5,5,13,Loyal Users
36338,273,34,56,3,4,3,10,Loyal Users
36560,103,15,74,4,3,4,11,Loyal Users
36866,0,28,129,5,4,4,13,Champions
36937,14,29,100,5,4,4,13,Champions
37278,17,96,390,5,5,5,15,Champions
37290,1307,9,12,1,2,1,4,Lost
37810,2417,21,52,1,3,3,7,Casual Users
37848,74,39,108,4,4,4,12,Champions
38014,2528,5,6,1,1,1,3,Lost
38031,154,32,61,4,4,3,11,Loyal Users
38171,1301,24,28,1,4,2,7,At Risk
38457,393,7,17,3,2,2,7,Casual Users
38466,134,13,89,4,3,4,11,Loyal Users
38532,3723,5,31,1,1,2,4,Lost
38560,40,92,163,5,5,5,15,Champions
38887,268,44,213,3,4,5,12,Loyal Users
26679,109,34,129,4,4,4,12,Champions
28145,347,9,27,3,2,2,7,Casual Users
28552,492,5,8,2,1,1,4,Lost
28646,1070,14,133,2,3,4,9,Casual Users
28959,21,29,140,5,4,4,13,Champions
29176,688,5,8,2,1,1,4,Lost
29380,96,92,222,4,5,5,14,Champions
29495,121,27,56,4,4,3,11,Loyal Users
29541,861,7,8,2,2,1,5,Lost
29598,445,7,7,3,2,1,6,Casual Users
29919,396,32,140,3,4,4,11,Loyal Users
29963,23,83,269,5,5,5,15,Champions
29998,74,30,60,4,4,3,11,Loyal Users
30031,261,49,127,3,5,4,12,Loyal Users
30129,105,61,184,4,5,5,14,Champions
30602,133,27,114,4,4,4,12,Champions
30820,4862,7,84,1,2,4,7,Lost
31028,2482,5,10,1,1,1,3,Lost
31425,2,40,417,5,4,5,14,Champions
31564,127,82,217,4,5,5,14,Champions
31803,1851,8,15,1,2,1,4,Lost
32073,160,33,67,4,4,4,12,Champions
32132,3,5,6,5,1,1,7,Promising
32475,276,12,19,3,3,2,8,Loyal Users
32585,356,5,22,3,1,2,6,Casual Users
32746,408,25,40,3,4,3,10,Loyal Users
32777,310,14,44,3,3,3,9,Loyal Users
33208,1,14,17,5,3,2,10,Loyal Users
33261,1857,5,13,1,1,1,3,Lost
33330,67,15,24,5,3,2,10,Loyal Users
33459,631,10,14,2,2,1,5,Lost
33850,2528,6,17,1,1,2,4,Lost
33950,742,23,58,2,4,3,9,At Risk
34196,2780,6,8,1,1,1,3,Lost
34446,90,18,68,4,3,4,11,Loyal Users
34564,112,72,112,4,5,4,13,Champions
34704,77,55,147,4,5,5,14,Champions
34937,6,152,202,5,5,5,15,Champions
35149,768,5,5,2,1,1,4,Lost
35372,447,5,11,3,1,1,5,Casual Users
35991,597,29,58,2,4,3,9,At Risk
36526,132,58,157,4,5,5,14,Champions
36606,128,62,148,4,5,5,14,Champions
37045,4388,5,7,1,1,1,3,Lost
37082,30,123,157,5,5,5,15,Champions
37163,211,10,39,3,2,3,8,Casual Users
37237,8,32,36,5,4,3,12,Loyal Users
37241,1985,17,50,1,3,3,7,Casual Users
37455,628,37,73,2,4,4,10,At Risk
37728,229,9,17,3,2,2,7,Casual Users
37758,209,5,7,3,1,1,5,Casual Users
38434,1351,13,100,1,3,4,8,Casual Users
38447,80,17,30,4,3,2,9,Loyal Users
38506,0,28,64,5,4,4,13,Champions
39032,1,38,87,5,4,4,13,Champions
39047,85,68,268,4,5,5,14,Champions
39088,356,9,67,3,2,4,9,Casual Users
26957,24,10,26,5,2,2,9,Promising
27026,292,10,26,3,2,2,7,Casual Users
27313,3738,6,11,1,1,1,3,Lost
27346,53,10,39,5,2,3,10,Promising
27813,1226,9,23,2,2,2,6,Lost
28084,3562,36,60,1,4,3,8,At Risk
28106,440,17,21,3,3,2,8,Loyal Users
28269,417,30,57,3,4,3,10,Loyal Users
28288,20,28,33,5,4,3,12,Loyal Users
28409,524,5,5,2,1,1,4,Lost
28419,0,162,347,5,5,5,15,Champions
28593,2961,6,35,1,1,3,5,Lost
28849,1,107,307,5,5,5,15,Champions
29005,140,65,248,4,5,5,14,Champions
29056,228,107,505,3,5,5,13,Loyal Users
29249,112,90,180,4,5,5,14,Champions
29297,771,18,41,2,3,3,8,Casual Users
29971,1329,9,67,1,2,4,7,Lost
30198,236,15,49,3,3,3,9,Loyal Users
30283,1824,11,49,1,2,3,6,Lost
30350,3397,8,64,1,2,4,7,Lost
31227,236,6,7,3,1,1,5,Casual Users
31323,81,49,331,4,5,5,14,Champions
31440,26,136,782,5,5,5,15,Champions
31578,182,36,89,3,4,4,11,Loyal Users
31595,0,137,472,5,5,5,15,Champions
31952,158,24,30,4,4,2,10,Loyal Users
32169,1963,5,8,1,1,1,3,Lost
32180,423,34,47,3,4,3,10,Loyal Users
32181,2111,17,96,1,3,4,8,Casual Users
32491,21,52,216,5,5,5,15,Champions
32507,575,10,30,2,2,2,6,Lost
32755,44,62,242,5,5,5,15,Champions
32836,1695,5,21,1,1,2,4,Lost
33401,55,23,134,5,4,4,13,Champions
33457,38,111,420,5,5,5,15,Champions
34027,1101,26,79,2,4,4,10,At Risk
34034,1583,6,29,1,1,2,4,Lost
34279,1430,7,13,1,2,1,4,Lost
34694,89,59,139,4,5,4,13,Champions
34726,394,10,19,3,2,2,7,Casual Users
34750,711,28,45,2,4,3,9,At Risk
35086,1440,6,12,1,1,1,3,Lost
35522,735,27,161,2,4,5,11,At Risk
36264,3427,5,5,1,1,1,3,Lost
36285,30,39,93,5,4,4,13,Champions
36303,1004,61,505,2,5,5,12,At Risk
37007,48,12,18,5,3,2,10,Loyal Users
37039,87,42,115,4,4,4,12,Champions
37216,1690,11,31,1,2,2,5,Lost
37401,334,13,42,3,3,3,9,Loyal Users
37501,2,61,121,5,5,4,14,Champions
37891,1068,60,148,2,5,5,12,At Risk
38158,125,53,115,4,5,4,13,Champions
39114,416,15,39,3,3,3,9,Loyal Users
39118,18,168,494,5,5,5,15,Champions
26892,1517,9,18,1,2,2,5,Lost
27207,40,112,282,5,5,5,15,Champions
27387,62,48,338,5,5,5,15,Champions
27520,10,24,93,5,4,4,13,Champions
27637,126,62,245,4,5,5,14,Champions
27641,2222,5,5,1,1,1,3,Lost
27762,249,6,9,3,1,1,5,Casual Users
27779,1843,11,17,1,2,2,5,Lost
28155,608,11,43,2,2,3,7,Lost
28380,318,5,9,3,1,1,5,Casual Users
29091,163,43,77,4,4,4,12,Champions
30216,5686,5,5,1,1,1,3,Lost
30372,978,6,8,2,1,1,4,Lost
30759,110,7,21,4,2,2,8,Promising
31131,2221,6,8,1,1,1,3,Lost
31217,7,71,152,5,5,5,15,Champions
31342,2842,5,9,1,1,1,3,Lost
31652,699,6,23,2,1,2,5,Lost
31806,55,67,156,5,5,5,15,Champions
32048,1288,5,16,1,1,2,4,Lost
32265,437,23,168,3,4,5,12,Loyal Users
32311,162,6,17,4,1,2,7,Promising
32354,2,179,411,5,5,5,15,Champions
32793,277,5,7,3,1,1,5,Casual Users
33199,150,60,158,4,5,5,14,Champions
34159,34,72,162,5,5,5,15,Champions
34190,42,96,147,5,5,5,15,Champions
34224,36,104,407,5,5,5,15,Champions
34352,1695,6,25,1,1,2,4,Lost
34353,2310,8,38,1,2,3,6,Lost
34380,924,16,49,2,3,3,8,Casual Users
34387,91,45,120,4,4,4,12,Champions
34566,3146,10,19,1,2,2,5,Lost
34846,112,104,465,4,5,5,14,Champions
34927,41,94,669,5,5,5,15,Champions
35251,29,78,143,5,5,4,14,Champions
35362,0,42,350,5,4,5,14,Champions
35365,119,23,28,4,4,2,10,Loyal Users
35842,409,86,121,3,5,4,12,Loyal Users
36233,7,121,163,5,5,5,15,Champions
36392,9,37,132,5,4,4,13,Champions
36496,1145,8,16,2,2,2,6,Lost
36743,309,7,14,3,2,1,6,Casual Users
36952,1268,9,23,1,2,2,5,Lost
37665,653,8,40,2,2,3,7,Lost
37702,24,39,128,5,4,4,13,Champions
37725,5556,7,12,1,2,1,4,Lost
37779,1141,8,19,2,2,2,6,Lost
38259,380,7,16,3,2,2,7,Casual Users
38559,1264,6,38,1,1,3,5,Lost
38586,11,19,37,5,3,3,11,Loyal Users
38791,248,23,58,3,4,3,10,Loyal Users
38879,79,82,280,4,5,5,14,Champions
38997,241,34,64,3,4,4,11,Loyal Users
39030,425,8,32,3,2,3,8,Casual Users
26887,154,5,7,4,1,1,6,Promising
27155,290,6,6,3,1,1,5,Casual Users
27173,89,56,273,4,5,5,14,Champions
27417,720,12,36,2,3,3,8,Casual Users
27451,1983,9,27,1,2,2,5,Lost
27916,89,49,240,4,5,5,14,Champions
28073,0,33,87,5,4,4,13,Champions
28240,29,196,356,5,5,5,15,Champions
28251,168,7,12,3,2,1,6,Casual Users
28637,1417,5,37,1,1,3,5,Lost
28676,1345,5,8,1,1,1,3,Lost
28783,5845,5,62,1,1,3,5,Lost
28805,2,149,461,5,5,5,15,Champions
28848,377,25,63,3,4,4,11,Loyal Users
29138,16,24,91,5,4,4,13,Champions
29204,125,41,118,4,4,4,12,Champions
29243,947,5,8,2,1,1,4,Lost
29310,406,16,29,3,3,2,8,Loyal Users
29674,128,12,17,4,3,2,9,Loyal Users
30003,810,9,13,2,2,1,5,Lost
30111,594,13,21,2,3,2,7,Casual Users
30223,142,67,200,4,5,5,14,Champions
30364,25,49,155,5,5,5,15,Champions
30795,676,16,108,2,3,4,9,Casual Users
31478,127,20,30,4,3,2,9,Loyal Users
31982,93,58,171,4,5,5,14,Champions
32004,119,7,26,4,2,2,8,Promising
32012,136,66,174,4,5,5,14,Champions
32759,510,13,18,2,3,2,7,Casual Users
32770,169,103,478,3,5,5,13,Loyal Users
33502,126,79,215,4,5,5,14,Champions
33576,27,39,166,5,4,5,14,Champions
33662,439,48,56,3,5,3,11,Loyal Users
33781,232,28,261,3,4,5,12,Loyal Users
33890,2696,36,65,1,4,4,9,At Risk
34252,2,59,92,5,5,4,14,Champions
34342,658,40,128,2,4,4,10,At Risk
34371,179,8,9,3,2,1,6,Casual Users
34393,63,25,142,5,4,4,13,Champions
34402,67,74,110,5,5,4,14,Champions
35604,52,107,316,5,5,5,15,Champions
35732,160,62,123,4,5,4,13,Champions
35766,131,10,31,4,2,2,8,Promising
35779,3737,31,190,1,4,5,10,At Risk
35959,126,77,286,4,5,5,14,Champions
36180,990,24,105,2,4,4,10,At Risk
36306,8,55,79,5,5,4,14,Champions
36599,114,73,140,4,5,4,13,Champions
36701,1990,10,67,1,2,4,7,Lost
37016,421,8,18,3,2,2,7,Casual Users
37134,9,88,158,5,5,5,15,Champions
37154,1380,6,9,1,1,1,3,Lost
37171,641,11,16,2,2,2,6,Lost
37284,19,22,39,5,4,3,12,Loyal Users
37527,729,9,32,2,2,3,7,Lost
37673,1964,10,24,1,2,2,5,Lost
37716,2989,24,36,1,4,3,8,At Risk
37731,2615,12,15,1,3,1,5,Casual Users
38226,260,200,488,3,5,5,13,Loyal Users
38362,669,6,10,2,1,1,4,Lost
38515,1790,5,6,1,1,1,3,Lost
38594,275,66,98,3,5,4,12,Loyal Users
38792,2722,5,6,1,1,1,3,Lost
38860,1797,14,39,1,3,3,7,Casual Users
38993,220,20,35,3,3,3,9,Loyal Users
27009,111,37,391,4,4,5,13,Champions
27053,9,9,11,5,2,1,8,Promising
27243,264,99,190,3,5,5,13,Loyal Users
27262,7,24,54,5,4,3,12,Loyal Users
27840,2315,9,13,1,2,1,4,Lost
27957,222,39,266,3,4,5,12,Loyal Users
28061,155,76,121,4,5,4,13,Champions
28377,3886,9,11,1,2,1,4,Lost
28515,1665,10,11,1,2,1,4,Lost
28529,991,8,59,2,2,3,7,Lost
28663,0,106,286,5,5,5,15,Champions
28837,213,61,325,3,5,5,13,Loyal Users
28879,124,34,47,4,4,3,11,Loyal Users
29004,16,137,410,5,5,5,15,Champions
29087,1136,30,32,2,4,3,9,At Risk
29352,990,7,33,2,2,3,7,Lost
29425,2672,6,18,1,1,2,4,Lost
29480,1911,5,59,1,1,3,5,Lost
29551,244,13,13,3,3,1,7,Loyal Users
30378,977,16,47,2,3,3,8,Casual Users
30669,128,62,99,4,5,4,13,Champions
30670,1433,7,7,1,2,1,4,Lost
30676,733,5,6,2,1,1,4,Lost
30842,126,48,80,4,5,4,13,Champions
31644,700,12,41,2,3,3,8,Casual Users
31706,4,119,640,5,5,5,15,Champions
31892,703,6,8,2,1,1,4,Lost
32036,114,62,247,4,5,5,14,Champions
32194,44,9,36,5,2,3,10,Promising
32208,96,12,18,4,3,2,9,Loyal Users
32226,3281,6,25,1,1,2,4,Lost
32344,142,7,68,4,2,4,10,Promising
32510,255,22,31,3,4,2,9,Loyal Users
32545,1345,6,21,1,1,2,4,Lost
32841,4887,12,25,1,3,2,6,Casual Users
33006,0,8,32,5,2,3,10,Promising
33106,698,14,28,2,3,2,7,Casual Users
33366,127,10,38,4,2,3,9,Promising
33409,933,5,10,2,1,1,4,Lost
33696,79,60,126,4,5,4,13,Champions
33737,270,11,67,3,2,4,9,Casual Users
33832,417,7,20,3,2,2,7,Casual Users
34013,1152,7,27,2,2,2,6,Lost
34624,414,34,50,3,4,3,10,Loyal Users
34794,107,20,98,4,3,4,11,Loyal Users
34798,278,8,12,3,2,1,6,Casual Users
34888,135,5,17,4,1,2,7,Promising
34926,1262,10,26,1,2,2,5,Lost
35028,1496,10,23,1,2,2,5,Lost
35064,243,7,14,3,2,1,6,Casual Users
35165,1017,9,11,2,2,1,5,Lost
35226,9,82,355,5,5,5,15,Champions
35315,46,96,488,5,5,5,15,Champions
35862,3816,7,11,1,2,1,4,Lost
36006,1147,6,8,2,1,1,4,Lost
36111,166,29,141,3,4,4,11,Loyal Users
36619,4545,16,38,1,3,3,7,Casual Users
36907,3079,14,21,1,3,2,6,Casual Users
37558,256,7,31,3,2,2,7,Casual Users
37659,113,83,135,4,5,4,13,Champions
37947,2650,5,9,1,1,1,3,Lost
38548,227,16,35,3,3,3,9,Loyal Users
38913,16,155,224,5,5,5,15,Champions
39134,134,17,181,4,3,5,12,Loyal Users
26837,27,67,283,5,5,5,15,Champions
26849,418,14,36,3,3,3,9,Loyal Users
27134,694,5,12,2,1,1,4,Lost
27139,96,23,40,4,4,3,11,Loyal Users
27237,127,14,85,4,3,4,11,Loyal Users
27294,3,73,244,5,5,5,15,Champions
27508,2829,8,28,1,2,2,5,Lost
27554,24,52,165,5,5,5,15,Champions
27687,267,49,106,3,5,4,12,Loyal Users
27774,1288,7,8,1,2,1,4,Lost
27794,155,6,14,4,1,1,6,Promising
28273,1558,8,52,1,2,3,6,Lost
28382,89,103,324,4,5,5,14,Champions
29112,2105,7,9,1,2,1,4,Lost
29126,3434,5,7,1,1,1,3,Lost
29548,127,59,385,4,5,5,14,Champions
29587,4292,11,36,1,2,3,6,Lost
29969,6,55,102,5,5,4,14,Champions
30220,274,44,100,3,4,4,11,Loyal Users
30284,113,22,74,4,4,4,12,Champions
30337,271,52,115,3,5,4,12,Loyal Users
30649,84,32,61,4,4,3,11,Loyal Users
31246,1622,8,16,1,2,2,5,Lost
31985,448,45,138,3,4,4,11,Loyal Users
32106,78,33,56,4,4,3,11,Loyal Users
32376,9,164,973,5,5,5,15,Champions
32765,222,6,18,3,1,2,6,Casual Users
33580,209,30,62,3,4,3,10,Loyal Users
33625,95,16,23,4,3,2,9,Loyal Users
33666,49,40,98,5,4,4,13,Champions
33712,3483,5,5,1,1,1,3,Lost
33724,428,18,35,3,3,3,9,Loyal Users
33871,42,58,219,5,5,5,15,Champions
34157,1274,6,27,1,1,2,4,Lost
34980,972,7,21,2,2,2,6,Lost
35002,2,115,268,5,5,5,15,Champions
35036,157,13,105,4,3,4,11,Loyal Users
35495,147,5,31,4,1,2,7,Promising
35703,2110,11,13,1,2,1,4,Lost
35965,280,6,8,3,1,1,5,Casual Users
36391,3175,7,14,1,2,1,4,Lost
36720,132,54,257,4,5,5,14,Champions
36751,596,24,61,2,4,3,9,At Risk
36786,6,14,44,5,3,3,11,Loyal Users
36900,3,171,590,5,5,5,15,Champions
37312,13,86,183,5,5,5,15,Champions
37610,1294,7,12,1,2,1,4,Lost
37708,2570,9,23,1,2,2,5,Lost
37741,470,9,23,3,2,2,7,Casual Users
38417,2195,8,10,1,2,1,4,Lost
38604,7,101,263,5,5,5,15,Champions
38690,392,25,56,3,4,3,10,Loyal Users
38981,418,14,51,3,3,3,9,Loyal Users
39010,123,11,50,4,2,3,9,Promising
26505,679,6,13,2,1,1,4,Lost
26567,255,50,262,3,5,5,13,Loyal Users
26673,162,6,24,4,1,2,7,Promising
26786,394,16,69,3,3,4,10,Loyal Users
26917,413,10,15,3,2,1,6,Casual Users
27032,125,21,154,4,3,5,12,Loyal Users
27474,167,5,50,3,1,3,7,Casual Users
27647,222,27,72,3,4,4,11,Loyal Users
27665,434,30,99,3,4,4,11,Loyal Users
27806,28,5,8,5,1,1,7,Promising
27848,282,50,137,3,5,4,12,Loyal Users
27855,10,79,333,5,5,5,15,Champions
27932,29,76,349,5,5,5,15,Champions
28304,544,14,27,2,3,2,7,Casual Users
28573,1,20,73,5,3,4,12,Loyal Users
28630,2240,13,32,1,3,3,7,Casual Users
28728,44,196,255,5,5,5,15,Champions
28861,131,35,103,4,4,4,12,Champions
28919,3464,7,32,1,2,3,6,Lost
29410,170,35,110,3,4,4,11,Loyal Users
29527,20,28,55,5,4,3,12,Loyal Users
30080,664,23,36,2,4,3,9,At Risk
30456,9,52,227,5,5,5,15,Champions
30727,30,44,72,5,4,4,13,Champions
30896,842,25,48,2,4,3,9,At Risk
31413,1103,6,8,2,1,1,4,Lost
31494,136,8,54,4,2,3,9,Promising
31707,0,35,95,5,4,4,13,Champions
32137,416,25,38,3,4,3,10,Loyal Users
32195,153,151,222,4,5,5,14,Champions
32222,1138,5,28,2,1,2,5,Lost
32454,278,21,36,3,3,3,9,Loyal Users
32679,479,34,143,2,4,4,10,At Risk
33558,2,31,66,5,4,4,13,Champions
34504,88,130,615,4,5,5,14,Champions
34811,109,23,116,4,4,4,12,Champions
34971,711,31,63,2,4,4,10,At Risk
35159,31,66,450,5,5,5,15,Champions
35232,299,16,30,3,3,2,8,Loyal Users
35557,292,14,19,3,3,2,8,Loyal Users
35584,426,8,13,3,2,1,6,Casual Users
36204,429,22,55,3,4,3,10,Loyal Users
36342,501,20,73,2,3,4,9,Casual Users
36647,27,10,58,5,2,3,10,Promising
36801,1597,30,96,1,4,4,9,At Risk
36852,136,6,13,4,1,1,6,Promising
36956,742,145,311,2,5,5,12,At Risk
37066,1379,5,16,1,1,2,4,Lost
37258,1616,6,40,1,1,3,5,Lost
37445,128,11,16,4,2,2,8,Promising
37510,458,8,11,3,2,1,6,Casual Users
37649,132,17,34,4,3,3,10,Loyal Users
37817,442,10,24,3,2,2,7,Casual Users
38076,124,8,26,4,2,2,8,Promising
38180,861,15,71,2,3,4,9,Casual Users
38391,56,77,364,5,5,5,15,Champions
38579,115,8,22,4,2,2,8,Promising
39006,245,53,216,3,5,5,13,Loyal Users
39089,356,9,38,3,2,3,8,Casual Users
27003,2615,11,27,1,2,2,5,Lost
27138,916,16,40,2,3,3,8,Casual Users
27164,12,36,162,5,4,5,14,Champions
27400,54,13,36,5,3,3,11,Loyal Users
27443,45,181,1072,5,5,5,15,Champions
27505,1828,5,21,1,1,2,4,Lost
27599,5,167,704,5,5,5,15,Champions
27691,6122,5,12,1,1,1,3,Lost
28324,74,13,27,4,3,2,9,Loyal Users
28466,265,55,232,3,5,5,13,Loyal Users
28835,11,103,155,5,5,5,15,Champions
29060,16,14,55,5,3,3,11,Loyal Users
29465,173,11,25,3,2,2,7,Casual Users
29477,1540,6,7,1,1,1,3,Lost
29497,1691,6,11,1,1,1,3,Lost
29925,266,9,10,3,2,1,6,Casual Users
30005,91,16,33,4,3,3,10,Loyal Users
30633,141,51,131,4,5,4,13,Champions
30848,417,16,118,3,3,4,10,Loyal Users
31041,912,16,84,2,3,4,9,Casual Users
31463,657,13,28,2,3,2,7,Casual Users
31527,310,9,9,3,2,1,6,Casual Users
31635,2944,9,18,1,2,2,5,Lost
31703,130,16,76,4,3,4,11,Loyal Users
31994,263,20,21,3,3,2,8,Loyal Users
32019,400,21,68,3,3,4,10,Loyal Users
32244,265,13,25,3,3,2,8,Loyal Users
32382,185,50,305,3,5,5,13,Loyal Users
32420,23,72,162,5,5,5,15,Champions
32483,50,13,39,5,3,3,11,Loyal Users
32620,113,70,222,4,5,5,14,Champions
32978,1277,15,37,1,3,3,7,Casual Users
33010,128,18,68,4,3,4,11,Loyal Users
33211,544,58,199,2,5,5,12,At Risk
33297,212,103,547,3,5,5,13,Loyal Users
33305,1,31,59,5,4,3,12,Loyal Users
33635,14,9,20,5,2,2,9,Promising
34283,285,8,21,3,2,2,7,Casual Users
34300,3622,32,59,1,4,3,8,At Risk
34314,6,61,114,5,5,4,14,Champions
34405,36,16,80,5,3,4,12,Loyal Users
34506,34,15,126,5,3,4,12,Loyal Users
34886,91,18,64,4,3,4,11,Loyal Users
34923,451,9,27,3,2,2,7,Casual Users
35326,2404,5,35,1,1,3,5,Lost
35501,146,15,36,4,3,3,10,Loyal Users
35510,264,16,149,3,3,5,11,Loyal Users
35605,268,21,39,3,3,3,9,Loyal Users
36194,157,17,38,4,3,3,10,Loyal Users
36354,548,13,14,2,3,1,6,Casual Users
36424,81,22,30,4,4,2,10,Loyal Users
36700,381,87,126,3,5,4,12,Loyal Users
37118,83,82,142,4,5,4,13,Champions
37275,130,30,114,4,4,4,12,Champions
37600,1,102,469,5,5,5,15,Champions
37630,84,6,13,4,1,1,6,Promising
38634,590,6,10,2,1,1,4,Lost
38639,50,61,157,5,5,5,15,Champions
38833,170,14,27,3,3,2,8,Loyal Users
39187,4581,6,12,1,1,1,3,Lost
39193,249,12,28,3,3,2,8,Loyal Users
39201,2135,6,32,1,1,3,5,Lost
39234,1467,8,10,1,2,1,4,Lost
26711,280,19,36,3,3,3,9,Loyal Users
26742,76,23,71,4,4,4,12,Champions
26845,94,74,289,4,5,5,14,Champions
26850,101,86,385,4,5,5,14,Champions
27027,1432,8,15,1,2,1,4,Lost
27046,200,77,359,3,5,5,13,Loyal Users
27305,133,14,28,4,3,2,9,Loyal Users
27737,1943,12,35,1,3,3,7,Casual Users
27818,3419,6,12,1,1,1,3,Lost
28053,1713,31,71,1,4,4,9,At Risk
28072,278,44,67,3,4,4,11,Loyal Users
28185,22,42,53,5,4,3,12,Loyal Users
28323,31,90,171,5,5,5,15,Champions
28338,16,82,177,5,5,5,15,Champions
28352,3,16,136,5,3,4,12,Loyal Users
28474,26,71,244,5,5,5,15,Champions
28524,263,9,99,3,2,4,9,Casual Users
28559,17,72,313,5,5,5,15,Champions
28647,75,32,105,4,4,4,12,Champions
29486,752,11,30,2,2,2,6,Lost
29649,105,80,136,4,5,4,13,Champions
29652,125,43,473,4,4,5,13,Champions
29774,807,10,30,2,2,2,6,Lost
29924,146,26,186,4,4,5,13,Champions
29939,531,36,169,2,4,5,11,At Risk
29999,1273,11,62,1,2,3,6,Lost
30461,433,8,9,3,2,1,6,Casual Users
30747,135,12,24,4,3,2,9,Loyal Users
30784,1413,12,39,1,3,3,7,Casual Users
31087,219,33,148,3,4,5,12,Loyal Users
31320,5310,8,10,1,2,1,4,Lost
31382,568,6,86,2,1,4,7,Lost
31547,3648,7,63,1,2,4,7,Lost
31812,25,18,40,5,3,3,11,Loyal Users
31917,12,115,479,5,5,5,15,Champions
32151,1695,8,9,1,2,1,4,Lost
32201,4676,12,60,1,3,3,7,Casual Users
32776,110,24,82,4,4,4,12,Champions
32951,271,31,169,3,4,5,12,Loyal Users
33102,1279,18,53,1,3,3,7,Casual Users
33294,1397,7,21,1,2,2,5,Lost
33555,303,17,23,3,3,2,8,Loyal Users
33693,3,5,17,5,1,2,8,Promising
33742,853,5,22,2,1,2,5,Lost
34354,1108,5,5,2,1,1,4,Lost
34604,2621,7,13,1,2,1,4,Lost
34628,174,6,8,3,1,1,5,Casual Users
34915,298,16,55,3,3,3,9,Loyal Users
35008,4244,5,6,1,1,1,3,Lost
35060,2935,5,20,1,1,2,4,Lost
35297,115,8,14,4,2,1,7,Promising
35436,2739,9,35,1,2,3,6,Lost
35497,35,217,503,5,5,5,15,Champions
35615,396,12,20,3,3,2,8,Loyal Users
36053,63,8,16,5,2,2,9,Promising
36196,462,12,49,3,3,3,9,Loyal Users
36829,276,41,295,3,4,5,12,Loyal Users
36868,651,9,42,2,2,3,7,Lost
37011,26,26,106,5,4,4,13,Champions
37090,461,11,11,3,2,1,6,Casual Users
37203,466,9,54,3,2,3,8,Casual Users
37726,2714,23,32,1,4,3,8,At Risk
38065,38,7,14,5,2,1,8,Promising
38394,466,17,64,3,3,4,10,Loyal Users
38517,103,61,221,4,5,5,14,Champions
38762,1989,5,8,1,1,1,3,Lost
39140,5408,9,9,1,2,1,4,Lost
39214,63,76,462,5,5,5,15,Champions
26632,2580,5,12,1,1,1,3,Lost
26692,60,105,563,5,5,5,15,Champions
26798,131,31,74,4,4,4,12,Champions
27013,6,82,219,5,5,5,15,Champions
27335,492,69,239,2,5,5,12,At Risk
27682,3,91,160,5,5,5,15,Champions
27696,305,60,194,3,5,5,13,Loyal Users
27841,694,5,6,2,1,1,4,Lost
27997,256,6,9,3,1,1,5,Casual Users
28267,117,106,246,4,5,5,14,Champions
28443,68,31,150,5,4,5,14,Champions
28983,90,9,17,4,2,2,8,Promising
29449,590,21,45,2,3,3,8,Casual Users
29819,426,13,32,3,3,3,9,Loyal Users
30474,3146,9,15,1,2,1,4,Lost
30499,14,106,188,5,5,5,15,Champions
30743,1123,6,11,2,1,1,4,Lost
30907,6,7,10,5,2,1,8,Promising
31310,855,6,9,2,1,1,4,Lost
31569,42,29,40,5,4,3,12,Loyal Users
31614,1123,20,30,2,3,2,7,Casual Users
31766,521,16,26,2,3,2,7,Casual Users
31960,124,21,101,4,3,4,11,Loyal Users
32020,607,57,218,2,5,5,12,At Risk
32026,479,5,5,2,1,1,4,Lost
32397,1717,6,9,1,1,1,3,Lost
32401,710,47,110,2,5,4,11,At Risk
32413,1068,12,26,2,3,2,7,Casual Users
32438,412,6,11,3,1,1,5,Casual Users
32700,431,41,57,3,4,3,10,Loyal Users
32926,1822,9,22,1,2,2,5,Lost
33169,1692,12,46,1,3,3,7,Casual Users
33225,3767,13,13,1,3,1,5,Casual Users
33633,97,10,45,4,2,3,9,Promising
33720,579,24,36,2,4,3,9,At Risk
34267,11,48,84,5,5,4,14,Champions
34294,1278,25,73,1,4,4,9,At Risk
34427,3563,7,21,1,2,2,5,Lost
34668,125,253,904,4,5,5,14,Champions
34737,724,23,46,2,4,3,9,At Risk
34889,4527,11,35,1,2,3,6,Lost
34906,20,53,83,5,5,4,14,Champions
35090,1439,17,39,1,3,3,7,Casual Users
35155,2419,9,49,1,2,3,6,Lost
35472,715,27,38,2,4,3,9,At Risk
35602,125,13,72,4,3,4,11,Loyal Users
35994,0,41,59,5,4,3,12,Loyal Users
36300,70,72,355,4,5,5,14,Champions
36370,801,8,23,2,2,2,6,Lost
36652,142,16,27,4,3,2,9,Loyal Users
36681,20,33,42,5,4,3,12,Loyal Users
36916,317,122,441,3,5,5,13,Loyal Users
37057,295,18,26,3,3,2,8,Loyal Users
37156,531,14,32,2,3,3,8,Casual Users
37371,98,21,55,4,3,3,10,Loyal Users
37416,7,36,221,5,4,5,14,Champions
37476,6,93,167,5,5,5,15,Champions
37575,1579,12,25,1,3,2,6,Casual Users
37744,117,38,186,4,4,5,13,Champions
38190,163,5,24,4,1,2,7,Promising
38390,940,61,355,2,5,5,12,At Risk
38397,264,8,24,3,2,2,7,Casual Users
38596,859,10,19,2,2,2,6,Lost
26472,210,50,61,3,5,3,11,Loyal Users
26934,13,27,80,5,4,4,13,Champions
27218,80,15,22,4,3,2,9,Loyal Users
27517,36,5,9,5,1,1,7,Promising
27870,3877,23,62,1,4,3,8,At Risk
27993,2210,27,65,1,4,4,9,At Risk
28120,2699,14,29,1,3,2,6,Casual Users
28378,250,14,30,3,3,2,8,Loyal Users
28649,122,99,372,4,5,5,14,Champions
28744,289,5,5,3,1,1,5,Casual Users
28773,325,47,221,3,5,5,13,Loyal Users
28908,3408,5,11,1,1,1,3,Lost
29062,106,49,212,4,5,5,14,Champions
29134,120,14,66,4,3,4,11,Loyal Users
29496,12,49,68,5,5,4,14,Champions
29546,839,10,11,2,2,1,5,Lost
29760,41,54,309,5,5,5,15,Champions
29955,2385,6,56,1,1,3,5,Lost
30119,1639,27,173,1,4,5,10,At Risk
30152,109,28,123,4,4,4,12,Champions
30234,135,16,26,4,3,2,9,Loyal Users
30340,928,36,73,2,4,4,10,At Risk
30448,619,12,15,2,3,1,6,Casual Users
30491,2010,10,14,1,2,1,4,Lost
30593,266,12,26,3,3,2,8,Loyal Users
30629,937,14,26,2,3,2,7,Casual Users
30822,1359,8,10,1,2,1,4,Lost
31117,261,20,27,3,3,2,8,Loyal Users
31250,125,5,22,4,1,2,7,Promising
31454,1276,6,11,1,1,1,3,Lost
31971,1414,7,29,1,2,2,5,Lost
32277,15,42,325,5,4,5,14,Champions
32411,1166,23,85,2,4,4,10,At Risk
32567,251,66,176,3,5,5,13,Loyal Users
33770,1374,6,17,1,1,2,4,Lost
33779,515,6,6,2,1,1,4,Lost
33839,103,12,22,4,3,2,9,Loyal Users
34076,66,50,172,5,5,5,15,Champions
34116,80,72,365,4,5,5,14,Champions
34161,688,6,13,2,1,1,4,Lost
34565,101,9,22,4,2,2,8,Promising
34593,2951,10,34,1,2,3,6,Lost
34832,688,9,10,2,2,1,5,Lost
34918,35,70,200,5,5,5,15,Champions
35068,2,39,78,5,4,4,13,Champions
35187,79,10,34,4,2,3,9,Promising
35582,278,19,56,3,3,3,9,Loyal Users
35904,7,10,46,5,2,3,10,Promising
36072,102,8,35,4,2,3,9,Promising
36142,74,12,34,4,3,3,10,Loyal Users
36160,279,9,19,3,2,2,7,Casual Users
36309,3568,6,7,1,1,1,3,Lost
36389,2648,6,9,1,1,1,3,Lost
36479,248,15,58,3,3,3,9,Loyal Users
36542,566,8,17,2,2,2,6,Lost
37091,385,5,10,3,1,1,5,Casual Users
37249,1332,5,5,1,1,1,3,Lost
37368,159,6,45,4,1,3,8,Promising
37502,48,78,754,5,5,5,15,Champions
37721,121,7,44,4,2,3,9,Promising
38069,3,105,581,5,5,5,15,Champions
38134,1144,5,12,2,1,1,4,Lost
38218,4014,6,6,1,1,1,3,Lost
38411,239,20,40,3,3,3,9,Loyal Users
38603,406,40,120,3,4,4,11,Loyal Users
38662,0,145,654,5,5,5,15,Champions
38684,240,40,194,3,4,5,12,Loyal Users
38715,1394,7,7,1,2,1,4,Lost
39162,255,18,35,3,3,3,9,Loyal Users
26609,12,169,513,5,5,5,15,Champions
26634,1998,9,21,1,2,2,5,Lost
26653,584,9,14,2,2,1,5,Lost
26990,57,27,72,5,4,4,13,Champions
27162,114,6,22,4,1,2,7,Promising
27204,1282,10,17,1,2,2,5,Lost
27423,3,106,678,5,5,5,15,Champions
27424,85,24,45,4,4,3,11,Loyal Users
27648,273,6,16,3,1,2,6,Casual Users
27815,594,6,13,2,1,1,4,Lost
27946,13,112,201,5,5,5,15,Champions
28044,1,121,469,5,5,5,15,Champions
28066,735,12,55,2,3,3,8,Casual Users
28284,2688,5,6,1,1,1,3,Lost
28612,161,10,30,4,2,2,8,Promising
29078,3,20,96,5,3,4,12,Loyal Users
29083,525,12,23,2,3,2,7,Casual Users
29291,18,49,72,5,5,4,14,Champions
29333,363,5,7,3,1,1,5,Casual Users
29803,35,10,25,5,2,2,9,Promising
29823,90,10,89,4,2,4,10,Promising
29839,2209,17,101,1,3,4,8,Casual Users
30608,2303,6,10,1,1,1,3,Lost
31321,5204,19,46,1,3,3,7,Casual Users
31346,751,5,8,2,1,1,4,Lost
31384,102,109,171,4,5,5,14,Champions
31524,3116,13,43,1,3,3,7,Casual Users
31546,669,8,17,2,2,2,6,Lost
31617,868,20,47,2,3,3,8,Casual Users
31943,26,63,231,5,5,5,15,Champions
32453,1257,5,8,2,1,1,4,Lost
32524,1322,7,19,1,2,2,5,Lost
32872,88,120,439,4,5,5,14,Champions
33139,68,11,26,5,2,2,9,Promising
33590,411,50,198,3,5,5,13,Loyal Users
33933,16,37,119,5,4,4,13,Champions
33968,1187,11,33,2,2,3,7,Lost
34244,293,12,64,3,3,4,10,Loyal Users
34350,146,51,157,4,5,5,14,Champions
34522,449,63,148,3,5,5,13,Loyal Users
34651,1175,22,48,2,4,3,9,At Risk
34898,2816,6,12,1,1,1,3,Lost
35049,60,20,38,5,3,3,11,Loyal Users
35687,1274,37,151,1,4,5,10,At Risk
35898,722,19,83,2,3,4,9,Casual Users
36293,4702,19,81,1,3,4,8,Casual Users
36740,44,43,132,5,4,4,13,Champions
36856,240,41,86,3,4,4,11,Loyal Users
37187,704,29,32,2,4,3,9,At Risk
37280,233,6,23,3,1,2,6,Casual Users
37420,34,14,61,5,3,3,11,Loyal Users
37580,39,61,234,5,5,5,15,Champions
37919,610,12,43,2,3,3,8,Casual Users
37937,1672,5,11,1,1,1,3,Lost
38110,1047,16,28,2,3,2,7,Casual Users
38149,117,21,140,4,3,4,11,Loyal Users
38266,204,14,21,3,3,2,8,Loyal Users
38317,90,167,537,4,5,5,14,Champions
38845,1127,13,25,2,3,2,7,Casual Users
38854,1170,6,8,2,1,1,4,Lost
38856,78,36,69,4,4,4,12,Champions
38933,106,5,19,4,1,2,7,Promising
39033,4011,8,14,1,2,1,4,Lost
39057,2712,5,8,1,1,1,3,Lost
26815,411,30,247,3,4,5,12,Loyal Users
26906,120,54,231,4,5,5,14,Champions
27018,48,9,28,5,2,2,9,Promising
27350,208,26,56,3,4,3,10,Loyal Users
27544,163,47,166,4,5,5,14,Champions
27656,15,76,296,5,5,5,15,Champions
27827,266,80,147,3,5,5,13,Loyal Users
28048,4418,6,8,1,1,1,3,Lost
28128,1055,9,11,2,2,1,5,Lost
28615,194,70,312,3,5,5,13,Loyal Users
28619,421,9,12,3,2,1,6,Casual Users
28864,210,9,11,3,2,1,6,Casual Users
28901,450,68,323,3,5,5,13,Loyal Users
28958,269,7,16,3,2,2,7,Casual Users
29118,434,46,184,3,5,5,13,Loyal Users
29179,210,7,13,3,2,1,6,Casual Users
29802,70,119,241,4,5,5,14,Champions
30172,1463,16,32,1,3,3,7,Casual Users
30533,19,60,204,5,5,5,15,Champions
30834,1521,39,64,1,4,4,9,At Risk
31255,271,12,29,3,3,2,8,Loyal Users
31532,601,16,56,2,3,3,8,Casual Users
31650,46,78,255,5,5,5,15,Champions
32101,276,5,5,3,1,1,5,Casual Users
32196,0,27,38,5,4,3,12,Loyal Users
32353,1,31,63,5,4,4,13,Champions
32466,160,5,31,4,1,2,7,Promising
32916,588,31,110,2,4,4,10,At Risk
33402,141,29,114,4,4,4,12,Champions
33458,6,84,257,5,5,5,15,Champions
33627,3709,8,10,1,2,1,4,Lost
33758,101,53,148,4,5,5,14,Champions
34018,394,17,39,3,3,3,9,Loyal Users
34094,2,121,230,5,5,5,15,Champions
34343,7,23,125,5,4,4,13,Champions
34766,2768,9,44,1,2,3,6,Lost
34850,101,70,237,4,5,5,14,Champions
35022,6,88,422,5,5,5,15,Champions
35122,82,44,78,4,4,4,12,Champions
35442,2283,14,41,1,3,3,7,Casual Users
35673,97,11,25,4,2,2,8,Promising
36090,169,37,92,3,4,4,11,Loyal Users
36256,118,61,91,4,5,4,13,Champions
36881,360,40,177,3,4,5,12,Loyal Users
37121,4266,5,9,1,1,1,3,Lost
37130,6,112,504,5,5,5,15,Champions
37159,154,14,31,4,3,2,9,Loyal Users
37177,37,121,299,5,5,5,15,Champions
37461,440,15,22,3,3,2,8,Loyal Users
37532,1808,10,13,1,2,1,4,Lost
37751,271,11,48,3,2,3,8,Casual Users
37775,3188,8,67,1,2,4,7,Lost
38100,706,11,22,2,2,2,6,Lost
38217,158,36,138,4,4,4,12,Champions
38478,436,5,17,3,1,2,6,Casual Users
38574,31,42,90,5,4,4,13,Champions
38772,14,44,266,5,4,5,14,Champions
38990,407,10,21,3,2,2,7,Casual Users
26651,1525,7,11,1,2,1,4,Lost
27541,212,71,240,3,5,5,13,Loyal Users
27751,4,151,922,5,5,5,15,Champions
28189,288,42,78,3,4,4,11,Loyal Users
28518,3,10,35,5,2,3,10,Promising
28588,300,12,32,3,3,3,9,Loyal Users
28992,2890,5,6,1,1,1,3,Lost
29695,599,8,12,2,2,1,5,Lost
29756,5396,5,9,1,1,1,3,Lost
30422,170,105,411,3,5,5,13,Loyal Users
30441,342,25,89,3,4,4,11,Loyal Users
30442,625,54,287,2,5,5,12,At Risk
31402,107,34,122,4,4,4,12,Champions
31471,2,8,39,5,2,3,10,Promising
31476,9,68,210,5,5,5,15,Champions
31779,23,12,43,5,3,3,11,Loyal Users
32931,270,23,31,3,4,2,9,Loyal Users
33026,32,23,92,5,4,4,13,Champions
33356,1861,17,40,1,3,3,7,Casual Users
33485,0,160,434,5,5,5,15,Champions
33570,451,21,97,3,3,4,10,Loyal Users
33776,0,94,110,5,5,4,14,Champions
33902,486,9,24,2,2,2,6,Lost
34115,5,69,133,5,5,4,14,Champions
34168,126,130,164,4,5,5,14,Champions
34181,51,38,135,5,4,4,13,Champions
34302,123,32,59,4,4,3,11,Loyal Users
34580,133,19,60,4,3,3,10,Loyal Users
34641,943,17,103,2,3,4,9,Casual Users
35098,162,14,28,4,3,2,9,Loyal Users
35772,569,17,64,2,3,4,9,Casual Users
35935,24,70,169,5,5,5,15,Champions
35938,397,51,302,3,5,5,13,Loyal Users
35998,2164,9,121,1,2,4,7,Lost
36118,38,27,154,5,4,5,14,Champions
36383,1233,5,9,2,1,1,4,Lost
36999,4,47,91,5,5,4,14,Champions
37611,7,50,85,5,5,4,14,Champions
37623,1665,7,30,1,2,2,5,Lost
37769,232,7,10,3,2,1,6,Casual Users
37801,70,71,92,4,5,4,13,Champions
37842,101,6,27,4,1,2,7,Promising
37905,362,44,214,3,4,5,12,Loyal Users
38053,276,6,6,3,1,1,5,Casual Users
38078,745,14,36,2,3,3,8,Casual Users
38189,2855,44,156,1,4,5,10,At Risk
38241,554,17,39,2,3,3,8,Casual Users
38455,920,13,27,2,3,2,7,Casual Users
38628,526,5,16,2,1,2,5,Lost
38948,116,60,178,4,5,5,14,Champions
38952,206,11,15,3,2,1,6,Casual Users
38953,799,20,79,2,3,4,9,Casual Users
39003,651,33,67,2,4,4,10,At Risk
26502,4006,7,23,1,2,2,5,Lost
26715,14,12,22,5,3,2,10,Loyal Users
26783,415,79,241,3,5,5,13,Loyal Users
26844,70,118,226,4,5,5,14,Champions
27012,253,22,67,3,4,4,11,Loyal Users
27114,468,40,66,3,4,4,11,Loyal Users
27153,423,164,393,3,5,5,13,Loyal Users
27723,1723,10,22,1,2,2,5,Lost
27747,103,59,101,4,5,4,13,Champions
27797,759,6,9,2,1,1,4,Lost
27805,566,12,15,2,3,1,6,Casual Users
28169,565,6,33,2,1,3,6,Lost
28245,3629,15,75,1,3,4,8,Casual Users
28939,138,58,158,4,5,5,14,Champions
29264,3856,7,7,1,2,1,4,Lost
29363,145,14,24,4,3,2,9,Loyal Users
29403,4707,14,15,1,3,1,5,Casual Users
29645,509,11,24,2,2,2,6,Lost
29672,1,84,296,5,5,5,15,Champions
29693,2571,5,8,1,1,1,3,Lost
29859,5682,23,26,1,4,2,7,At Risk
29864,13,38,122,5,4,4,13,Champions
29915,1840,9,42,1,2,3,6,Lost
30093,239,9,18,3,2,2,7,Casual Users
30346,713,8,16,2,2,2,6,Lost
30684,284,8,9,3,2,1,6,Casual Users
30715,410,9,9,3,2,1,6,Casual Users
31133,337,7,17,3,2,2,7,Casual Users
31181,430,17,25,3,3,2,8,Loyal Users
31189,559,7,9,2,2,1,5,Lost
31215,303,63,250,3,5,5,13,Loyal Users
31248,233,75,122,3,5,4,12,Loyal Users
31671,3902,7,12,1,2,1,4,Lost
32059,128,41,76,4,4,4,12,Champions
32939,58,35,177,5,4,5,14,Champions
32970,8,14,20,5,3,2,10,Loyal Users
33343,3593,5,13,1,1,1,3,Lost
33351,12,45,190,5,4,5,14,Champions
33646,1225,23,101,2,4,4,10,At Risk
34079,647,14,171,2,3,5,10,Casual Users
34199,23,77,434,5,5,5,15,Champions
34230,1000,7,12,2,2,1,5,Lost
34428,1174,18,46,2,3,3,8,Casual Users
34594,1084,12,31,2,3,2,7,Casual Users
34620,9,86,198,5,5,5,15,Champions
35262,139,14,41,4,3,3,10,Loyal Users
35479,47,7,8,5,2,1,8,Promising
35821,20,12,87,5,3,4,12,Loyal Users
35877,424,33,204,3,4,5,12,Loyal Users
35903,305,24,126,3,4,4,11,Loyal Users
35956,18,42,132,5,4,4,13,Champions
36149,527,7,45,2,2,3,7,Lost
36397,18,11,73,5,2,4,11,Promising
36450,142,11,72,4,2,4,10,Promising
36513,6,6,14,5,1,1,7,Promising
36749,405,44,74,3,4,4,11,Loyal Users
36815,1,51,188,5,5,5,15,Champions
36993,157,46,100,4,5,4,13,Champions
37573,815,10,12,2,2,1,5,Lost
38046,1832,6,6,1,1,1,3,Lost
38047,38,59,217,5,5,5,15,Champions
38191,4,26,54,5,4,3,12,Loyal Users
38524,264,37,66,3,4,4,11,Loyal Users
38571,3,81,107,5,5,4,14,Champions
38724,2846,8,41,1,2,3,6,Lost
38729,20,56,381,5,5,5,15,Champions
38755,3247,22,61,1,4,3,8,At Risk
38896,12,61,272,5,5,5,15,Champions
39129,122,11,31,4,2,2,8,Promising
39149,2145,8,34,1,2,3,6,Lost
26690,0,17,41,5,3,3,11,Loyal Users
26719,859,13,98,2,3,4,9,Casual Users
26782,700,14,25,2,3,2,7,Casual Users
27360,76,40,94,4,4,4,12,Champions
27901,56,9,16,5,2,2,9,Promising
27960,4394,15,20,1,3,2,6,Casual Users
28003,93,12,29,4,3,2,9,Loyal Users
28043,102,18,194,4,3,5,12,Loyal Users
28311,102,5,11,4,1,1,6,Promising
28415,2456,8,8,1,2,1,4,Lost
28440,421,18,33,3,3,3,9,Loyal Users
28442,408,28,75,3,4,4,11,Loyal Users
28488,152,23,50,4,4,3,11,Loyal Users
28747,2,82,603,5,5,5,15,Champions
28842,1310,6,7,1,1,1,3,Lost
28887,259,45,211,3,4,5,12,Loyal Users
28891,416,7,9,3,2,1,6,Casual Users
29348,2408,7,29,1,2,2,5,Lost
29395,17,125,506,5,5,5,15,Champions
29984,12,6,6,5,1,1,7,Promising
30072,148,16,72,4,3,4,11,Loyal Users
30622,1395,10,37,1,2,3,6,Lost
30788,561,44,169,2,4,5,11,At Risk
30805,2599,20,38,1,3,3,7,Casual Users
30814,1532,21,45,1,3,3,7,Casual Users
30847,53,52,303,5,5,5,15,Champions
30852,3290,5,11,1,1,1,3,Lost
31474,118,20,36,4,3,3,10,Loyal Users
31843,559,13,13,2,3,1,6,Casual Users
32186,28,18,107,5,3,4,12,Loyal Users
32269,178,50,143,3,5,4,12,Loyal Users
32457,1,13,60,5,3,3,11,Loyal Users
32496,2967,6,9,1,1,1,3,Lost
32526,676,30,51,2,4,3,9,At Risk
33269,1947,5,5,1,1,1,3,Lost
33594,668,5,15,2,1,1,4,Lost
33648,1866,14,57,1,3,3,7,Casual Users
33969,508,5,18,2,1,2,5,Lost
34028,317,18,71,3,3,4,10,Loyal Users
34222,176,63,93,3,5,4,12,Loyal Users
34289,2388,5,5,1,1,1,3,Lost
34355,226,11,90,3,2,4,9,Casual Users
34682,64,62,608,5,5,5,15,Champions
34696,15,59,267,5,5,5,15,Champions
34701,962,5,35,2,1,3,6,Lost
35175,73,88,348,4,5,5,14,Champions
35441,809,8,10,2,2,1,5,Lost
35573,2223,7,7,1,2,1,4,Lost
35591,848,5,5,2,1,1,4,Lost
35851,1098,7,17,2,2,2,6,Lost
35973,1,37,78,5,4,4,13,Champions
36244,2724,7,8,1,2,1,4,Lost
36289,1533,5,6,1,1,1,3,Lost
36404,2428,6,6,1,1,1,3,Lost
36405,2555,19,31,1,3,2,6,Casual Users
36872,92,118,245,4,5,5,14,Champions
36950,119,43,98,4,4,4,12,Champions
37109,643,13,32,2,3,3,8,Casual Users
37224,170,69,132,3,5,4,12,Loyal Users
37315,110,103,318,4,5,5,14,Champions
37342,3120,17,22,1,3,2,6,Casual Users
37346,616,16,20,2,3,2,7,Casual Users
37440,2130,7,7,1,2,1,4,Lost
37597,296,49,161,3,5,5,13,Loyal Users
37690,146,30,157,4,4,5,13,Champions
37700,110,101,386,4,5,5,14,Champions
37813,2547,70,215,1,5,5,11,At Risk
38129,2693,10,15,1,2,1,4,Lost
38414,282,19,40,3,3,3,9,Loyal Users
38694,22,5,46,5,1,3,9,Promising
38898,297,36,112,3,4,4,11,Loyal Users
39103,31,160,521,5,5,5,15,Champions
39105,91,8,12,4,2,1,7,Promising
39182,3162,5,27,1,1,2,4,Lost
26895,136,69,207,4,5,5,14,Champions
27067,118,22,32,4,4,3,11,Loyal Users
27322,384,55,123,3,5,4,12,Loyal Users
27488,1860,6,13,1,1,1,3,Lost
27578,289,54,99,3,5,4,12,Loyal Users
27620,8,64,243,5,5,5,15,Champions
27892,4401,6,36,1,1,3,5,Lost
28946,2075,6,84,1,1,4,6,Lost
29105,2430,6,12,1,1,1,3,Lost
29375,287,7,28,3,2,2,7,Casual Users
29445,592,17,133,2,3,4,9,Casual Users
29517,819,5,6,2,1,1,4,Lost
29739,451,39,54,3,4,3,10,Loyal Users
29902,80,64,379,4,5,5,14,Champions
30592,837,13,41,2,3,3,8,Casual Users
30760,384,38,74,3,4,4,11,Loyal Users
31576,2127,10,28,1,2,2,5,Lost
31709,0,79,284,5,5,5,15,Champions
31881,1,34,96,5,4,4,13,Champions
32066,615,16,26,2,3,2,7,Casual Users
32152,262,6,16,3,1,2,6,Casual Users
32712,1782,43,206,1,4,5,10,At Risk
33183,419,51,160,3,5,5,13,Loyal Users
33196,137,43,121,4,4,4,12,Champions
33293,1721,7,10,1,2,1,4,Lost
33422,1855,32,62,1,4,3,8,At Risk
33493,164,33,67,4,4,4,12,Champions
33540,37,40,76,5,4,4,13,Champions
33601,568,7,9,2,2,1,5,Lost
33639,108,13,29,4,3,2,9,Loyal Users
33750,240,9,9,3,2,1,6,Casual Users
33989,112,118,170,4,5,5,14,Champions
34388,301,61,80,3,5,4,12,Loyal Users
35193,695,7,17,2,2,2,6,Lost
35530,5840,6,24,1,1,2,4,Lost
35607,13,24,42,5,4,3,12,Loyal Users
35611,11,37,83,5,4,4,13,Champions
35628,418,21,47,3,3,3,9,Loyal Users
36011,12,37,198,5,4,5,14,Champions
36075,376,10,35,3,2,3,8,Casual Users
36707,63,26,86,5,4,4,13,Champions
36745,9,32,126,5,4,4,13,Champions
36936,5420,6,25,1,1,2,4,Lost
37248,26,79,519,5,5,5,15,Champions
37693,40,8,27,5,2,2,9,Promising
37723,1574,6,8,1,1,1,3,Lost
37966,109,32,61,4,4,3,11,Loyal Users
37991,504,17,71,2,3,4,9,Casual Users
38260,200,15,100,3,3,4,10,Loyal Users
38931,118,42,103,4,4,4,12,Champions
26508,75,24,34,4,4,3,11,Loyal Users
26626,46,102,547,5,5,5,15,Champions
26795,167,12,24,3,3,2,8,Loyal Users
27011,103,50,88,4,5,4,13,Champions
27215,140,9,33,4,2,3,9,Promising
27516,6,5,7,5,1,1,7,Promising
27569,435,7,11,3,2,1,6,Casual Users
27626,963,9,18,2,2,2,6,Lost
27717,819,5,7,2,1,1,4,Lost
28074,7,18,33,5,3,3,11,Loyal Users
28082,468,50,84,3,5,4,12,Loyal Users
28535,261,23,59,3,4,3,10,Loyal Users
28821,2732,96,170,1,5,5,11,At Risk
29120,420,5,12,3,1,1,5,Casual Users
29311,395,5,10,3,1,1,5,Casual Users
29344,538,57,118,2,5,4,11,At Risk
29428,132,12,24,4,3,2,9,Loyal Users
29514,531,97,290,2,5,5,12,At Risk
29740,1138,7,10,2,2,1,5,Lost
29771,71,68,269,4,5,5,14,Champions
29865,334,14,33,3,3,3,9,Loyal Users
29875,197,21,31,3,3,2,8,Loyal Users
30342,251,37,100,3,4,4,11,Loyal Users
30580,87,38,101,4,4,4,12,Champions
30651,92,12,26,4,3,2,9,Loyal Users
31240,81,13,66,4,3,4,11,Loyal Users
31659,20,84,276,5,5,5,15,Champions
31926,425,10,24,3,2,2,7,Casual Users
31977,278,13,49,3,3,3,9,Loyal Users
32029,1339,20,75,1,3,4,8,Casual Users
32136,1691,7,8,1,2,1,4,Lost
33567,2439,96,203,1,5,5,11,At Risk
34150,149,10,28,4,2,2,8,Promising
34276,625,12,19,2,3,2,7,Casual Users
34544,79,44,89,4,4,4,12,Champions
34601,402,12,24,3,3,2,8,Loyal Users
35006,601,15,31,2,3,2,7,Casual Users
35158,495,21,104,2,3,4,9,Casual Users
35161,135,44,106,4,4,4,12,Champions
35309,2563,24,47,1,4,3,8,At Risk
35525,577,11,34,2,2,3,7,Lost
35642,105,25,89,4,4,4,12,Champions
36280,58,44,77,5,4,4,13,Champions
36498,1868,5,6,1,1,1,3,Lost
36778,1,14,81,5,3,4,12,Loyal Users
37253,77,61,184,4,5,5,14,Champions
37465,412,32,43,3,4,3,10,Loyal Users
37535,2677,5,33,1,1,3,5,Lost
37604,126,33,62,4,4,3,11,Loyal Users
37757,293,15,55,3,3,3,9,Loyal Users
37792,233,16,70,3,3,4,10,Loyal Users
37917,128,25,66,4,4,4,12,Champions
37961,469,34,82,3,4,4,11,Loyal Users
38130,278,9,33,3,2,3,8,Casual Users
38304,631,5,7,2,1,1,4,Lost
38396,4631,7,15,1,2,1,4,Lost
38812,17,56,268,5,5,5,15,Champions
38823,264,17,66,3,3,4,10,Loyal Users
38839,83,16,19,4,3,2,9,Loyal Users
38947,866,7,12,2,2,1,5,Lost
39028,5352,6,29,1,1,2,4,Lost
26486,3,72,86,5,5,4,14,Champions
26530,861,13,43,2,3,3,8,Casual Users
26631,2131,12,51,1,3,3,7,Casual Users
27040,31,53,258,5,5,5,15,Champions
27121,72,29,58,4,4,3,11,Loyal Users
27193,406,5,45,3,1,3,7,Casual Users
27270,2954,5,6,1,1,1,3,Lost
27465,94,122,275,4,5,5,14,Champions
27778,93,156,290,4,5,5,14,Champions
28278,3302,10,35,1,2,3,6,Lost
28460,3769,5,8,1,1,1,3,Lost
28504,236,110,224,3,5,5,13,Loyal Users
28624,1979,11,77,1,2,4,7,Lost
28696,951,10,16,2,2,2,6,Lost
28985,955,12,127,2,3,4,9,Casual Users
29114,1172,9,10,2,2,1,5,Lost
29221,82,57,247,4,5,5,14,Champions
29434,13,12,28,5,3,2,10,Loyal Users
29475,1084,8,30,2,2,2,6,Lost
29532,15,134,279,5,5,5,15,Champions
29766,22,6,15,5,1,1,7,Promising
29767,10,18,34,5,3,3,11,Loyal Users
30332,97,16,35,4,3,3,10,Loyal Users
30818,4244,10,30,1,2,2,5,Lost
31187,372,7,27,3,2,2,7,Casual Users
31195,25,82,403,5,5,5,15,Champions
31522,151,16,23,4,3,2,9,Loyal Users
31582,138,18,135,4,3,4,11,Loyal Users
31970,120,19,30,4,3,2,9,Loyal Users
32543,358,15,170,3,3,5,11,Loyal Users
32744,795,6,9,2,1,1,4,Lost
32877,1395,34,46,1,4,3,8,At Risk
33027,235,29,56,3,4,3,10,Loyal Users
33028,1035,5,14,2,1,1,4,Lost
33161,185,118,229,3,5,5,13,Loyal Users
33179,111,63,214,4,5,5,14,Champions
33192,125,47,120,4,5,4,13,Champions
33385,73,47,375,4,5,5,14,Champions
33872,399,19,45,3,3,3,9,Loyal Users
34072,164,26,103,4,4,4,12,Champions
34077,5501,5,8,1,1,1,3,Lost
34173,35,8,14,5,2,1,8,Promising
35729,443,6,9,3,1,1,5,Casual Users
36004,5681,9,25,1,2,2,5,Lost
36137,7,11,18,5,2,2,9,Promising
36229,29,58,511,5,5,5,15,Champions
36855,74,32,60,4,4,3,11,Loyal Users
36896,2706,10,42,1,2,3,6,Lost
36914,101,42,122,4,4,4,12,Champions
37260,247,7,13,3,2,1,6,Casual Users
37304,142,40,96,4,4,4,12,Champions
37470,432,14,21,3,3,2,8,Loyal Users
37503,1227,5,6,2,1,1,4,Lost
37762,3720,5,25,1,1,2,4,Lost
37959,1715,13,21,1,3,2,6,Casual Users
38770,587,14,33,2,3,3,8,Casual Users
38820,1138,16,20,2,3,2,7,Casual Users
39077,5,7,18,5,2,2,9,Promising
26475,123,12,127,4,3,4,11,Loyal Users
26573,154,23,61,4,4,3,11,Loyal Users
26733,15,110,334,5,5,5,15,Champions
26817,696,33,122,2,4,4,10,At Risk
26835,1998,7,9,1,2,1,4,Lost
26865,136,78,164,4,5,5,14,Champions
27100,78,51,65,4,5,4,13,Champions
27365,2854,6,17,1,1,2,4,Lost
27411,122,35,93,4,4,4,12,Champions
27707,2136,7,8,1,2,1,4,Lost
27735,31,7,7,5,2,1,8,Promising
27761,411,26,39,3,4,3,10,Loyal Users
28312,110,121,238,4,5,5,14,Champions
28585,128,75,222,4,5,5,14,Champions
28660,373,7,13,3,2,1,6,Casual Users
28718,285,18,39,3,3,3,9,Loyal Users
29042,1591,17,20,1,3,2,6,Casual Users
29199,453,12,37,3,3,3,9,Loyal Users
29269,1008,5,5,2,1,1,4,Lost
29361,257,15,117,3,3,4,10,Loyal Users
29500,119,27,189,4,4,5,13,Champions
30042,422,5,28,3,1,2,6,Casual Users
30167,676,12,17,2,3,2,7,Casual Users
30949,3005,8,9,1,2,1,4,Lost
31551,1639,7,11,1,2,1,4,Lost
31673,454,9,16,3,2,2,7,Casual Users
31955,4492,9,16,1,2,2,5,Lost
32198,3181,90,209,1,5,5,11,At Risk
32207,4007,15,34,1,3,3,7,Casual Users
32271,6,133,373,5,5,5,15,Champions
32542,2201,12,75,1,3,4,8,Casual Users
32605,383,9,47,3,2,3,8,Casual Users
32850,1197,14,77,2,3,4,9,Casual Users
32921,40,57,197,5,5,5,15,Champions
32989,38,77,169,5,5,5,15,Champions
33432,536,5,14,2,1,1,4,Lost
33587,2718,9,38,1,2,3,6,Lost
33620,350,63,271,3,5,5,13,Loyal Users
34006,1265,6,6,1,1,1,3,Lost
34055,580,44,212,2,4,5,11,At Risk
34237,76,49,207,4,5,5,14,Champions
34372,74,113,707,4,5,5,14,Champions
34512,2473,5,6,1,1,1,3,Lost
34584,20,77,404,5,5,5,15,Champions
34755,559,5,14,2,1,1,4,Lost
35012,14,82,339,5,5,5,15,Champions
35202,195,33,64,3,4,4,11,Loyal Users
35259,419,19,29,3,3,2,8,Loyal Users
35662,73,43,152,4,4,5,13,Champions
35682,3830,7,11,1,2,1,4,Lost
36065,96,10,45,4,2,3,9,Promising
36084,721,7,20,2,2,2,6,Lost
36121,449,51,275,3,5,5,13,Loyal Users
36139,23,35,159,5,4,5,14,Champions
36156,282,12,23,3,3,2,8,Loyal Users
36202,506,17,50,2,3,3,8,Casual Users
36757,214,52,232,3,5,5,13,Loyal Users
36765,90,65,214,4,5,5,14,Champions
36781,109,95,320,4,5,5,14,Champions
36961,641,11,40,2,2,3,7,Lost
37071,50,58,224,5,5,5,15,Champions
37081,98,130,450,4,5,5,14,Champions
37235,29,11,21,5,2,2,9,Promising
37320,548,6,8,2,1,1,4,Lost
37383,0,73,197,5,5,5,15,Champions
37555,2,38,103,5,4,4,13,Champions
37635,614,22,73,2,4,4,10,At Risk
37800,258,32,76,3,4,4,11,Loyal Users
37914,91,88,281,4,5,5,14,Champions
37962,116,12,14,4,3,1,8,Loyal Users
38017,193,8,11,3,2,1,6,Casual Users
38120,493,7,9,2,2,1,5,Lost
38379,105,21,120,4,3,4,11,Loyal Users
38525,10,81,558,5,5,5,15,Champions
38640,1851,19,76,1,3,4,8,Casual Users
38814,1171,5,7,2,1,1,4,Lost
38841,402,19,84,3,3,4,10,Loyal Users
39074,5,45,90,5,4,4,13,Champions
39099,68,13,76,5,3,4,12,Loyal Users
26524,18,92,157,5,5,5,15,Champions
27034,8,36,57,5,4,3,12,Loyal Users
27062,2833,8,27,1,2,2,5,Lost
27201,277,13,69,3,3,4,10,Loyal Users
27245,2219,5,5,1,1,1,3,Lost
27398,169,64,197,3,5,5,13,Loyal Users
27900,430,6,11,3,1,1,5,Casual Users
27950,307,24,43,3,4,3,10,Loyal Users
27987,228,6,22,3,1,2,6,Casual Users
28190,270,30,96,3,4,4,11,Loyal Users
28397,264,60,277,3,5,5,13,Loyal Users
29529,1396,6,9,1,1,1,3,Lost
29686,221,29,73,3,4,4,11,Loyal Users
29883,126,63,269,4,5,5,14,Champions
29951,36,41,84,5,4,4,13,Champions
30277,1135,5,11,2,1,1,4,Lost
30347,1260,9,24,1,2,2,5,Lost
30748,1009,12,21,2,3,2,7,Casual Users
30768,2894,6,20,1,1,2,4,Lost
30994,2500,5,7,1,1,1,3,Lost
31128,276,19,60,3,3,3,9,Loyal Users
31188,14,68,263,5,5,5,15,Champions
31393,746,5,19,2,1,2,5,Lost
31449,1140,7,14,2,2,1,5,Lost
31980,400,8,12,3,2,1,6,Casual Users
32753,283,5,5,3,1,1,5,Casual Users
32966,240,6,7,3,1,1,5,Casual Users
33146,2633,9,31,1,2,2,5,Lost
33176,447,50,176,3,5,5,13,Loyal Users
33232,1730,6,18,1,1,2,4,Lost
33279,79,28,57,4,4,3,11,Loyal Users
33621,465,6,8,3,1,1,5,Casual Users
33848,379,22,56,3,4,3,10,Loyal Users
34020,1,45,178,5,4,5,14,Champions
34163,316,18,76,3,3,4,10,Loyal Users
34363,216,31,87,3,4,4,11,Loyal Users
34840,32,81,361,5,5,5,15,Champions
34911,1646,6,10,1,1,1,3,Lost
35293,77,27,90,4,4,4,12,Champions
35374,4286,7,27,1,2,2,5,Lost
35468,40,143,353,5,5,5,15,Champions
35681,33,5,27,5,1,2,8,Promising
35867,1392,14,27,1,3,2,6,Casual Users
36077,1509,5,5,1,1,1,3,Lost
36148,1725,7,22,1,2,2,5,Lost
36238,76,12,15,4,3,1,8,Loyal Users
36462,405,13,31,3,3,2,8,Loyal Users
36486,16,138,409,5,5,5,15,Champions
36497,73,54,90,4,5,4,13,Champions
36639,252,5,21,3,1,2,6,Casual Users
36670,161,10,28,4,2,2,8,Promising
37279,431,13,17,3,3,2,8,Loyal Users
37516,77,99,205,4,5,5,14,Champions
37590,3460,6,7,1,1,1,3,Lost
37687,54,39,240,5,4,5,14,Champions
37739,81,9,12,4,2,1,7,Promising
37888,1645,5,8,1,1,1,3,Lost
38023,1747,9,21,1,2,2,5,Lost
38869,4176,12,12,1,3,1,5,Casual Users
26843,85,94,403,4,5,5,14,Champions
26880,3132,5,12,1,1,1,3,Lost
26890,1522,5,5,1,1,1,3,Lost
27080,12,56,129,5,5,4,14,Champions
27177,1752,23,78,1,4,4,9,At Risk
27450,868,12,58,2,3,3,8,Casual Users
27773,526,5,5,2,1,1,4,Lost
27880,6,8,34,5,2,3,10,Promising
27968,1616,6,15,1,1,1,3,Lost
28080,486,11,16,2,2,2,6,Lost
28125,2246,8,19,1,2,2,5,Lost
28433,57,97,187,5,5,5,15,Champions
28755,393,14,52,3,3,3,9,Loyal Users
28840,306,17,26,3,3,2,8,Loyal Users
29187,415,6,7,3,1,1,5,Casual Users
29637,101,109,584,4,5,5,14,Champions
29680,3187,5,10,1,1,1,3,Lost
29696,406,20,60,3,3,3,9,Loyal Users
29754,59,42,45,5,4,3,12,Loyal Users
29848,3035,7,9,1,2,1,4,Lost
30009,85,59,113,4,5,4,13,Champions
30359,311,11,19,3,2,2,7,Casual Users
30414,383,11,21,3,2,2,7,Casual Users
30501,952,8,46,2,2,3,7,Lost
30556,134,10,43,4,2,3,9,Promising
30571,993,6,15,2,1,1,4,Lost
30872,4,98,523,5,5,5,15,Champions
31159,233,5,72,3,1,4,8,Casual Users
31329,502,16,55,2,3,3,8,Casual Users
31363,167,49,56,3,5,3,11,Loyal Users
31388,250,30,51,3,4,3,10,Loyal Users
31442,3,8,25,5,2,2,9,Promising
31488,531,6,19,2,1,2,5,Lost
31600,862,11,67,2,2,4,8,Lost
32041,517,10,13,2,2,1,5,Lost
32248,1467,6,8,1,1,1,3,Lost
32278,27,48,126,5,5,4,14,Champions
32508,3603,5,7,1,1,1,3,Lost
32576,538,36,55,2,4,3,9,At Risk
32740,115,77,129,4,5,4,13,Champions
32821,8,78,109,5,5,4,14,Champions
32959,1472,7,27,1,2,2,5,Lost
32986,104,8,11,4,2,1,7,Promising
33047,84,19,59,4,3,3,10,Loyal Users
33149,86,20,76,4,3,4,11,Loyal Users
33752,258,45,110,3,4,4,11,Loyal Users
34204,97,7,38,4,2,3,9,Promising
34329,33,34,71,5,4,4,13,Champions
34457,44,68,101,5,5,4,14,Champions
34625,1616,13,33,1,3,3,7,Casual Users
35276,2509,48,91,1,5,4,10,At Risk
35339,70,97,181,4,5,5,14,Champions
35434,223,10,39,3,2,3,8,Casual Users
35473,54,85,301,5,5,5,15,Champions
35690,701,7,37,2,2,3,7,Lost
35745,85,153,288,4,5,5,14,Champions
35923,296,11,18,3,2,2,7,Casual Users
36348,1,30,73,5,4,4,13,Champions
36433,2610,15,48,1,3,3,7,Casual Users
36444,101,24,102,4,4,4,12,Champions
36754,2083,21,26,1,3,2,6,Casual Users
36917,3962,6,13,1,1,1,3,Lost
37386,424,11,28,3,2,2,7,Casual Users
37654,557,11,23,2,2,2,6,Lost
37655,426,14,21,3,3,2,8,Loyal Users
37773,646,6,8,2,1,1,4,Lost
37926,582,17,35,2,3,3,8,Casual Users
38188,87,61,210,4,5,5,14,Champions
38209,849,11,21,2,2,2,6,Lost
38459,11,88,715,5,5,5,15,Champions
38505,259,6,8,3,1,1,5,Casual Users
38520,428,33,68,3,4,4,11,Loyal Users
38555,86,28,47,4,4,3,11,Loyal Users
38718,18,48,203,5,5,5,15,Champions
38780,1717,5,22,1,1,2,4,Lost
39124,532,35,94,2,4,4,10,At Risk
26521,1608,7,16,1,2,2,5,Lost
26569,184,19,21,3,3,2,8,Loyal Users
26748,79,105,270,4,5,5,14,Champions
27089,423,18,55,3,3,3,9,Loyal Users
27675,6,65,210,5,5,5,15,Champions
27924,271,11,30,3,2,2,7,Casual Users
27933,25,6,95,5,1,4,10,Promising
27956,1064,14,59,2,3,3,8,Casual Users
28148,1,36,62,5,4,3,12,Loyal Users
28299,116,110,571,4,5,5,14,Champions
28520,141,6,19,4,1,2,7,Promising
28725,13,6,11,5,1,1,7,Promising
29142,852,5,6,2,1,1,4,Lost
29248,5368,10,58,1,2,3,6,Lost
29502,1131,5,9,2,1,1,4,Lost
29581,843,9,12,2,2,1,5,Lost
29614,154,124,396,4,5,5,14,Champions
29641,4847,6,16,1,1,2,4,Lost
29651,116,13,17,4,3,2,9,Loyal Users
30256,97,166,338,4,5,5,14,Champions
30600,120,57,105,4,5,4,13,Champions
30609,1963,6,11,1,1,1,3,Lost
30713,106,21,92,4,3,4,11,Loyal Users
30726,2363,5,15,1,1,1,3,Lost
30729,644,16,81,2,3,4,9,Casual Users
30773,593,9,19,2,2,2,6,Lost
30947,522,8,12,2,2,1,5,Lost
30973,300,14,34,3,3,3,9,Loyal Users
31113,1231,6,20,2,1,2,5,Lost
31114,173,14,39,3,3,3,9,Loyal Users
31192,487,14,41,2,3,3,8,Casual Users
31226,271,20,34,3,3,3,9,Loyal Users
31526,1001,9,24,2,2,2,6,Lost
31554,5427,5,5,1,1,1,3,Lost
31751,38,68,234,5,5,5,15,Champions
31804,289,62,92,3,5,4,12,Loyal Users
31887,857,8,10,2,2,1,5,Lost
31898,530,48,103,2,5,4,11,At Risk
32497,945,6,24,2,1,2,5,Lost
33195,12,117,164,5,5,5,15,Champions
33571,270,7,26,3,2,2,7,Casual Users
33807,726,6,15,2,1,1,4,Lost
33920,1417,6,26,1,1,2,4,Lost
33961,1158,17,32,2,3,3,8,Casual Users
34447,887,84,128,2,5,4,11,At Risk
34453,488,7,7,2,2,1,5,Lost
34812,281,17,31,3,3,2,8,Loyal Users
34883,296,5,10,3,1,1,5,Casual Users
34917,292,14,27,3,3,2,8,Loyal Users
35154,244,9,40,3,2,3,8,Casual Users
35258,23,29,149,5,4,5,14,Champions
35386,3421,6,10,1,1,1,3,Lost
35464,0,71,323,5,5,5,15,Champions
35474,2466,7,35,1,2,3,6,Lost
35491,818,12,18,2,3,2,7,Casual Users
36456,137,13,155,4,3,5,12,Loyal Users
36767,142,11,17,4,2,2,8,Promising
37185,2437,6,11,1,1,1,3,Lost
37569,50,32,128,5,4,4,13,Champions
37598,401,39,84,3,4,4,11,Loyal Users
37869,127,8,13,4,2,1,7,Promising
37907,113,32,98,4,4,4,12,Champions
39189,159,6,26,4,1,2,7,Promising
26482,392,17,23,3,3,2,8,Loyal Users
26577,166,43,338,3,4,5,12,Loyal Users
26605,27,5,16,5,1,2,8,Promising
26624,1710,5,30,1,1,2,4,Lost
26766,567,13,15,2,3,1,6,Casual Users
26874,294,25,82,3,4,4,11,Loyal Users
27010,20,10,11,5,2,1,8,Promising
27168,149,64,416,4,5,5,14,Champions
27363,757,51,367,2,5,5,12,At Risk
27525,3,72,467,5,5,5,15,Champions
27589,1999,8,18,1,2,2,5,Lost
27959,3583,8,37,1,2,3,6,Lost
28211,605,6,8,2,1,1,4,Lost
28230,96,5,19,4,1,2,7,Promising
28238,56,5,5,5,1,1,7,Promising
28607,136,49,111,4,5,4,13,Champions
29019,14,14,34,5,3,3,11,Loyal Users
29122,590,12,20,2,3,2,7,Casual Users
29409,891,59,143,2,5,4,11,At Risk
29423,183,11,14,3,2,1,6,Casual Users
29650,3491,11,20,1,2,2,5,Lost
29683,1424,8,32,1,2,3,6,Lost
30104,37,5,15,5,1,1,7,Promising
30204,411,9,15,3,2,1,6,Casual Users
30212,7,78,367,5,5,5,15,Champions
30280,135,5,13,4,1,1,6,Promising
30607,425,8,37,3,2,3,8,Casual Users
31334,281,11,60,3,2,3,8,Casual Users
31515,520,13,46,2,3,3,8,Casual Users
31708,87,41,74,4,4,4,12,Champions
31757,3,62,325,5,5,5,15,Champions
31981,432,10,12,3,2,1,6,Casual Users
32123,1702,8,15,1,2,1,4,Lost
32665,119,6,13,4,1,1,6,Promising
32718,1617,20,42,1,3,3,7,Casual Users
32733,25,240,940,5,5,5,15,Champions
32865,1877,9,22,1,2,2,5,Lost
33336,50,89,243,5,5,5,15,Champions
33464,2191,37,200,1,4,5,10,At Risk
33488,47,40,117,5,4,4,13,Champions
33582,4432,7,11,1,2,1,4,Lost
33760,27,41,96,5,4,4,13,Champions
33929,2723,11,20,1,2,2,5,Lost
34035,230,58,88,3,5,4,12,Loyal Users
34053,1236,12,56,2,3,3,8,Casual Users
34245,5,21,110,5,3,4,12,Loyal Users
34429,77,56,151,4,5,5,14,Champions
34686,546,57,80,2,5,4,11,At Risk
34710,810,26,133,2,4,4,10,At Risk
34765,4682,10,60,1,2,3,6,Lost
35135,477,20,55,2,3,3,8,Casual Users
35396,2981,13,36,1,3,3,7,Casual Users
36159,1041,12,17,2,3,2,7,Casual Users
36320,102,12,204,4,3,5,12,Loyal Users
36607,95,18,25,4,3,2,9,Loyal Users
36779,52,106,160,5,5,5,15,Champions
36981,300,20,43,3,3,3,9,Loyal Users
37390,2878,14,46,1,3,3,7,Casual Users
37406,3864,5,40,1,1,3,5,Lost
37430,122,9,12,4,2,1,7,Promising
37559,418,21,45,3,3,3,9,Loyal Users
38705,125,20,41,4,3,3,10,Loyal Users
38802,155,10,13,4,2,1,7,Promising
39125,1122,7,24,2,2,2,6,Lost
26507,53,92,114,5,5,4,14,Champions
26757,2489,7,24,1,2,2,5,Lost
27331,414,11,18,3,2,2,7,Casual Users
27534,88,61,221,4,5,5,14,Champions
27725,3018,10,28,1,2,2,5,Lost
27795,349,25,69,3,4,4,11,Loyal Users
27798,1839,6,8,1,1,1,3,Lost
27923,1287,18,27,1,3,2,6,Casual Users
27943,1636,16,89,1,3,4,8,Casual Users
28418,72,31,183,4,4,5,13,Champions
28600,407,34,64,3,4,4,11,Loyal Users
28655,270,61,209,3,5,5,13,Loyal Users
28674,5439,9,36,1,2,3,6,Lost
28807,867,7,23,2,2,2,6,Lost
29035,3507,8,11,1,2,1,4,Lost
29145,5,149,464,5,5,5,15,Champions
29355,2187,19,50,1,3,3,7,Casual Users
29597,1257,13,17,2,3,2,7,Casual Users
29648,435,51,117,3,5,4,12,Loyal Users
29851,533,17,26,2,3,2,7,Casual Users
29898,1407,5,25,1,1,2,4,Lost
29940,163,106,287,4,5,5,14,Champions
30415,5,16,69,5,3,4,12,Loyal Users
30443,238,67,116,3,5,4,12,Loyal Users
30536,108,32,231,4,4,5,13,Champions
30628,380,26,44,3,4,3,10,Loyal Users
30695,531,18,85,2,3,4,9,Casual Users
30717,622,7,11,2,2,1,5,Lost
30776,232,11,126,3,2,4,9,Casual Users
31587,966,29,75,2,4,4,10,At Risk
31636,10,56,75,5,5,4,14,Champions
31665,3202,33,83,1,4,4,9,At Risk
32345,3465,43,77,1,4,4,9,At Risk
32600,4772,6,10,1,1,1,3,Lost
32681,37,201,394,5,5,5,15,Champions
32780,65,28,73,5,4,4,13,Champions
32824,448,7,7,3,2,1,6,Casual Users
33053,838,16,60,2,3,3,8,Casual Users
33234,90,52,313,4,5,5,14,Champions
33746,101,105,229,4,5,5,14,Champions
33788,1269,11,32,1,2,3,6,Lost
34023,152,19,78,4,3,4,11,Loyal Users
34063,148,5,8,4,1,1,6,Promising
34317,3130,8,15,1,2,1,4,Lost
34392,117,18,54,4,3,3,10,Loyal Users
34472,975,20,55,2,3,3,8,Casual Users
34684,1,24,47,5,4,3,12,Loyal Users
34781,443,7,11,3,2,1,6,Casual Users
34808,12,179,1041,5,5,5,15,Champions
34834,128,22,50,4,4,3,11,Loyal Users
34988,538,14,61,2,3,3,8,Casual Users
35095,637,5,8,2,1,1,4,Lost
35189,827,5,26,2,1,2,5,Lost
35217,2707,10,11,1,2,1,4,Lost
35225,186,17,24,3,3,2,8,Loyal Users
35423,108,97,766,4,5,5,14,Champions
35446,15,46,237,5,5,5,15,Champions
35797,594,9,20,2,2,2,6,Lost
36245,13,64,291,5,5,5,15,Champions
36365,23,62,307,5,5,5,15,Champions
36494,416,8,21,3,2,2,7,Casual Users
36785,47,33,153,5,4,5,14,Champions
36827,352,9,10,3,2,1,6,Casual Users
37035,3239,11,58,1,2,3,6,Lost
37233,429,6,16,3,1,2,6,Casual Users
37432,2,108,280,5,5,5,15,Champions
37933,981,18,66,2,3,4,9,Casual Users
38038,212,11,15,3,2,1,6,Casual Users
38054,77,19,80,4,3,4,11,Loyal Users
38399,2,204,479,5,5,5,15,Champions
38474,337,11,53,3,2,3,8,Casual Users
38677,0,95,416,5,5,5,15,Champions
39052,1277,10,16,1,2,2,5,Lost
39236,5021,5,7,1,1,1,3,Lost
26514,296,7,8,3,2,1,6,Casual Users
26764,3444,49,111,1,5,4,10,At Risk
26832,137,32,52,4,4,3,11,Loyal Users
27233,805,12,18,2,3,2,7,Casual Users
28056,115,12,16,4,3,2,9,Loyal Users
28268,3798,8,17,1,2,2,5,Lost
28761,424,6,7,3,1,1,5,Casual Users
28771,3891,5,7,1,1,1,3,Lost
29082,1695,5,9,1,1,1,3,Lost
29379,78,16,46,4,3,3,10,Loyal Users
29509,105,20,84,4,3,4,11,Loyal Users
29867,1781,8,21,1,2,2,5,Lost
29886,90,29,81,4,4,4,12,Champions
30328,5,67,147,5,5,5,15,Champions
30358,420,39,59,3,4,3,10,Loyal Users
30463,533,19,39,2,3,3,8,Casual Users
30514,2468,8,10,1,2,1,4,Lost
30568,272,18,45,3,3,3,9,Loyal Users
30731,122,89,140,4,5,4,13,Champions
30763,1556,8,21,1,2,2,5,Lost
30767,4,40,82,5,4,4,13,Champions
31238,135,16,48,4,3,3,10,Loyal Users
31676,3752,7,9,1,2,1,4,Lost
31954,587,15,26,2,3,2,7,Casual Users
32133,18,59,103,5,5,4,14,Champions
32243,92,32,115,4,4,4,12,Champions
32675,1318,14,20,1,3,2,6,Casual Users
32852,149,99,259,4,5,5,14,Champions
33698,30,48,546,5,5,5,15,Champions
33843,39,162,878,5,5,5,15,Champions
33845,528,7,57,2,2,3,7,Lost
34042,5728,5,10,1,1,1,3,Lost
34045,2290,9,12,1,2,1,4,Lost
34303,1548,16,20,1,3,2,6,Casual Users
34636,499,49,128,2,5,4,11,At Risk
34774,79,9,10,4,2,1,7,Promising
35054,112,20,32,4,3,3,10,Loyal Users
35500,61,74,122,5,5,4,14,Champions
36050,401,5,44,3,1,3,7,Casual Users
36102,4,85,307,5,5,5,15,Champions
36671,125,10,24,4,2,2,8,Promising
36768,1479,65,74,1,5,4,10,At Risk
36989,69,110,147,5,5,5,15,Champions
37054,113,47,140,4,5,4,13,Champions
38238,791,14,30,2,3,2,7,Casual Users
38343,2139,5,31,1,1,2,4,Lost
38588,14,34,63,5,4,4,13,Champions
38652,19,9,16,5,2,2,9,Promising
38877,679,12,22,2,3,2,7,Casual Users
38891,690,18,105,2,3,4,9,Casual Users
26489,134,25,43,4,4,3,11,Loyal Users
26600,30,7,19,5,2,2,9,Promising
26751,428,14,30,3,3,2,8,Loyal Users
26900,676,20,99,2,3,4,9,Casual Users
26993,2673,35,96,1,4,4,9,At Risk
27174,13,9,30,5,2,2,9,Promising
27275,1417,14,30,1,3,2,6,Casual Users
27453,1006,28,109,2,4,4,10,At Risk
27470,1076,6,7,2,1,1,4,Lost
27546,118,21,44,4,3,3,10,Loyal Users
27726,7,103,407,5,5,5,15,Champions
27772,17,41,209,5,4,5,14,Champions
27928,1266,7,19,1,2,2,5,Lost
27971,272,57,256,3,5,5,13,Loyal Users
28076,125,83,221,4,5,5,14,Champions
28275,117,8,101,4,2,4,10,Promising
28283,723,10,13,2,2,1,5,Lost
28306,67,34,57,5,4,3,12,Loyal Users
28341,274,19,56,3,3,3,9,Loyal Users
28384,191,32,76,3,4,4,11,Loyal Users
28690,102,90,371,4,5,5,14,Champions
28831,307,21,48,3,3,3,9,Loyal Users
28998,66,5,15,5,1,1,7,Promising
29144,464,42,98,3,4,4,11,Loyal Users
29230,293,6,8,3,1,1,5,Casual Users
29478,233,67,227,3,5,5,13,Loyal Users
30037,4849,8,17,1,2,2,5,Lost
30241,108,86,534,4,5,5,14,Champions
30581,1273,26,92,1,4,4,9,At Risk
30706,93,73,208,4,5,5,14,Champions
30797,19,94,274,5,5,5,15,Champions
30946,841,10,26,2,2,2,6,Lost
31175,127,10,46,4,2,3,9,Promising
31475,702,10,24,2,2,2,6,Lost
31530,20,5,71,5,1,4,10,Promising
31690,17,81,296,5,5,5,15,Champions
31975,883,12,21,2,3,2,7,Casual Users
32032,144,22,93,4,4,4,12,Champions
32174,93,73,249,4,5,5,14,Champions
32205,3111,11,33,1,2,3,6,Lost
32279,121,32,41,4,4,3,11,Loyal Users
33203,2568,7,20,1,2,2,5,Lost
33218,1525,13,82,1,3,4,8,Casual Users
33511,0,127,444,5,5,5,15,Champions
33513,287,32,52,3,4,3,10,Loyal Users
33544,1439,22,30,1,4,2,7,At Risk
34187,228,24,44,3,4,3,10,Loyal Users
34391,142,20,20,4,3,2,9,Loyal Users
34518,3876,12,80,1,3,4,8,Casual Users
35035,259,46,280,3,5,5,13,Loyal Users
35363,40,12,65,5,3,4,12,Loyal Users
35750,134,6,27,4,1,2,7,Promising
35952,64,24,43,5,4,3,12,Loyal Users
36033,94,67,261,4,5,5,14,Champions
36119,445,19,94,3,3,4,10,Loyal Users
36124,27,38,64,5,4,4,13,Champions
36384,809,37,101,2,4,4,10,At Risk
36666,132,9,14,4,2,1,7,Promising
36949,5818,10,16,1,2,2,5,Lost
36965,112,57,196,4,5,5,14,Champions
37360,416,6,8,3,1,1,5,Casual Users
37521,101,12,46,4,3,3,10,Loyal Users
37625,5045,12,70,1,3,4,8,Casual Users
38116,86,68,358,4,5,5,14,Champions
38378,9,28,156,5,4,5,14,Champions
38747,527,14,75,2,3,4,9,Casual Users
38901,18,33,97,5,4,4,13,Champions
38987,7,16,78,5,3,4,12,Loyal Users
39180,843,16,95,2,3,4,9,Casual Users
26574,2694,7,56,1,2,3,6,Lost
26940,272,87,288,3,5,5,13,Loyal Users
27272,435,5,5,3,1,1,5,Casual Users
27625,11,33,87,5,4,4,13,Champions
27697,159,26,95,4,4,4,12,Champions
27749,34,12,26,5,3,2,10,Loyal Users
27983,576,11,84,2,2,4,8,Lost
28175,3763,16,25,1,3,2,6,Casual Users
28358,1487,7,10,1,2,1,4,Lost
28475,153,56,78,4,5,4,13,Champions
28666,1291,16,16,1,3,2,6,Casual Users
29415,831,15,20,2,3,2,7,Casual Users
29837,90,13,42,4,3,3,10,Loyal Users
30562,1133,18,61,2,3,3,8,Casual Users
30806,57,98,477,5,5,5,15,Champions
30986,394,68,224,3,5,5,13,Loyal Users
31136,70,6,32,4,1,3,8,Promising
31228,34,14,21,5,3,2,10,Loyal Users
31820,880,5,7,2,1,1,4,Lost
32025,103,14,58,4,3,3,10,Loyal Users
32114,124,73,190,4,5,5,14,Champions
32115,101,25,61,4,4,3,11,Loyal Users
32119,104,8,10,4,2,1,7,Promising
32237,508,9,11,2,2,1,5,Lost
32470,2281,7,17,1,2,2,5,Lost
32519,119,12,22,4,3,2,9,Loyal Users
32558,97,112,287,4,5,5,14,Champions
32604,4839,8,28,1,2,2,5,Lost
32710,11,30,77,5,4,4,13,Champions
32864,252,8,18,3,2,2,7,Casual Users
33069,687,10,20,2,2,2,6,Lost
33272,130,13,18,4,3,2,9,Loyal Users
33427,427,41,55,3,4,3,10,Loyal Users
33487,9,6,12,5,1,1,7,Promising
33748,525,10,31,2,2,2,6,Lost
33773,9,43,121,5,4,4,13,Champions
33910,939,37,158,2,4,5,11,At Risk
34065,42,84,359,5,5,5,15,Champions
34074,48,6,11,5,1,1,7,Promising
34134,657,35,245,2,4,5,11,At Risk
34151,2,131,515,5,5,5,15,Champions
34321,975,17,23,2,3,2,7,Casual Users
34403,148,9,17,4,2,2,8,Promising
34731,32,7,21,5,2,2,9,Promising
34890,715,21,173,2,3,5,10,Casual Users
34944,2131,9,16,1,2,2,5,Lost
35299,14,22,41,5,4,3,12,Loyal Users
35340,416,6,12,3,1,1,5,Casual Users
35394,155,5,9,4,1,1,6,Promising
35400,29,5,7,5,1,1,7,Promising
35585,40,54,434,5,5,5,15,Champions
35647,405,13,24,3,3,2,8,Loyal Users
35777,15,76,100,5,5,4,14,Champions
36371,385,48,55,3,5,3,11,Loyal Users
36407,2776,6,10,1,1,1,3,Lost
36587,112,48,106,4,5,4,13,Champions
37219,508,18,57,2,3,3,8,Casual Users
37242,55,15,23,5,3,2,10,Loyal Users
37644,1280,15,37,1,3,3,7,Casual Users
37729,3430,5,15,1,1,1,3,Lost
37730,144,60,160,4,5,5,14,Champions
37855,144,54,146,4,5,4,13,Champions
37856,0,105,327,5,5,5,15,Champions
37884,239,7,19,3,2,2,7,Casual Users
38083,286,40,62,3,4,3,10,Loyal Users
38084,3465,5,21,1,1,2,4,Lost
38132,131,13,37,4,3,3,10,Loyal Users
38465,576,5,7,2,1,1,4,Lost
38871,2300,10,41,1,2,3,6,Lost
39176,1379,11,28,1,2,2,5,Lost
39226,847,5,14,2,1,1,4,Lost
26519,295,6,11,3,1,1,5,Casual Users
26671,593,8,12,2,2,1,5,Lost
27057,651,7,11,2,2,1,5,Lost
27318,374,8,15,3,2,1,6,Casual Users
27710,76,165,751,4,5,5,14,Champions
27739,24,7,14,5,2,1,8,Promising
27874,7,119,200,5,5,5,15,Champions
28026,274,13,20,3,3,2,8,Loyal Users
28451,420,8,43,3,2,3,8,Casual Users
28476,20,39,139,5,4,4,13,Champions
28746,1870,5,17,1,1,2,4,Lost
28823,12,72,304,5,5,5,15,Champions
28943,5291,7,9,1,2,1,4,Lost
29280,97,21,38,4,3,3,10,Loyal Users
29358,153,32,38,4,4,3,11,Loyal Users
29372,552,7,19,2,2,2,6,Lost
29466,1560,12,28,1,3,2,6,Casual Users
29764,1893,33,130,1,4,4,9,At Risk
29956,531,11,15,2,2,1,5,Lost
30110,5418,7,53,1,2,3,6,Lost
30255,155,50,219,4,5,5,14,Champions
30532,3015,30,33,1,4,3,8,At Risk
30782,481,10,33,2,2,3,7,Lost
31054,167,46,61,3,5,3,11,Loyal Users
31591,545,20,25,2,3,2,7,Casual Users
31626,5837,5,21,1,1,2,4,Lost
31717,2565,6,35,1,1,3,5,Lost
31725,5450,6,9,1,1,1,3,Lost
32044,312,12,16,3,3,2,8,Loyal Users
32408,522,5,5,2,1,1,4,Lost
32668,2251,16,71,1,3,4,8,Casual Users
32687,65,5,47,5,1,3,9,Promising
32737,2238,6,40,1,1,3,5,Lost
32809,7,37,74,5,4,4,13,Champions
33080,5493,6,6,1,1,1,3,Lost
33238,2888,12,77,1,3,4,8,Casual Users
35173,1309,16,83,1,3,4,8,Casual Users
35550,5,108,288,5,5,5,15,Champions
35762,3241,5,6,1,1,1,3,Lost
36536,159,12,32,4,3,3,10,Loyal Users
36722,0,91,466,5,5,5,15,Champions
36968,379,9,17,3,2,2,7,Casual Users
37051,49,6,26,5,1,2,8,Promising
37137,163,5,8,4,1,1,6,Promising
37196,355,23,33,3,4,3,10,Loyal Users
38368,120,103,430,4,5,5,14,Champions
38644,9,37,72,5,4,4,13,Champions
38692,4801,5,8,1,1,1,3,Lost
38945,121,5,12,4,1,1,6,Promising
39035,1455,6,14,1,1,1,3,Lost
39229,166,216,652,3,5,5,13,Loyal Users
26595,247,13,44,3,3,3,9,Loyal Users
27052,30,5,12,5,1,1,7,Promising
27394,118,45,153,4,4,5,13,Champions
27475,9,11,34,5,2,3,10,Promising
27662,1517,44,131,1,4,4,9,At Risk
27669,275,78,585,3,5,5,13,Loyal Users
27898,1413,6,6,1,1,1,3,Lost
28121,788,30,93,2,4,4,10,At Risk
28447,1167,12,19,2,3,2,7,Casual Users
28735,397,40,98,3,4,4,11,Loyal Users
29407,89,7,38,4,2,3,9,Promising
29798,274,23,65,3,4,4,11,Loyal Users
29970,2725,10,40,1,2,3,6,Lost
30509,96,155,383,4,5,5,14,Champions
30677,295,26,93,3,4,4,11,Loyal Users
31120,121,31,86,4,4,4,12,Champions
31404,164,24,94,4,4,4,12,Champions
31432,157,22,85,4,4,4,12,Champions
31604,19,55,370,5,5,5,15,Champions
31771,208,22,112,3,4,4,11,Loyal Users
31849,668,14,59,2,3,3,8,Casual Users
31895,2013,17,101,1,3,4,8,Casual Users
31946,156,6,14,4,1,1,6,Promising
32461,96,86,386,4,5,5,14,Champions
32640,635,5,37,2,1,3,6,Lost
32684,582,5,10,2,1,1,4,Lost
32879,579,16,36,2,3,3,8,Casual Users
32918,15,19,114,5,3,4,12,Loyal Users
33000,449,37,41,3,4,3,10,Loyal Users
33624,267,9,12,3,2,1,6,Casual Users
33805,1991,17,20,1,3,2,6,Casual Users
33860,2439,5,8,1,1,1,3,Lost
33962,140,26,104,4,4,4,12,Champions
34092,770,12,14,2,3,1,6,Casual Users
34113,1438,18,33,1,3,3,7,Casual Users
34156,620,8,37,2,2,3,7,Lost
34205,756,18,26,2,3,2,7,Casual Users
34433,27,157,474,5,5,5,15,Champions
34530,101,29,48,4,4,3,11,Loyal Users
35255,126,91,518,4,5,5,14,Champions
35332,3,51,102,5,5,4,14,Champions
35581,2321,5,5,1,1,1,3,Lost
36398,193,7,24,3,2,2,7,Casual Users
36698,1133,6,18,2,1,2,5,Lost
37128,620,8,21,2,2,2,6,Lost
37354,4,38,71,5,4,4,13,Champions
37806,127,10,11,4,2,1,7,Promising
37840,245,28,40,3,4,3,10,Loyal Users
37976,3700,8,25,1,2,2,5,Lost
38070,1266,7,18,1,2,2,5,Lost
38312,3,49,283,5,5,5,15,Champions
38412,74,72,163,4,5,5,14,Champions
38503,2829,11,39,1,2,3,6,Lost
38668,2116,6,25,1,1,2,4,Lost
38711,2478,5,7,1,1,1,3,Lost
38754,115,100,279,4,5,5,14,Champions
38967,3564,8,8,1,2,1,4,Lost
39083,182,24,78,3,4,4,11,Loyal Users
39131,143,6,7,4,1,1,6,Promising
26471,118,6,59,4,1,3,8,Promising
26864,97,34,135,4,4,4,12,Champions
27188,2947,11,13,1,2,1,4,Lost
27278,1325,10,21,1,2,2,5,Lost
27666,921,5,8,2,1,1,4,Lost
27718,157,18,39,4,3,3,10,Loyal Users
27801,263,9,18,3,2,2,7,Casual Users
27905,135,76,204,4,5,5,14,Champions
28317,724,7,23,2,2,2,6,Lost
28354,1144,7,12,2,2,1,5,Lost
28355,288,99,170,3,5,5,13,Loyal Users
28389,1994,7,64,1,2,4,7,Lost
28659,412,64,106,3,5,4,12,Loyal Users
28776,0,102,139,5,5,4,14,Champions
28936,84,9,19,4,2,2,8,Promising
29003,530,6,6,2,1,1,4,Lost
29074,3705,6,8,1,1,1,3,Lost
29222,408,30,44,3,4,3,10,Loyal Users
29295,8,104,670,5,5,5,15,Champions
29545,557,14,52,2,3,3,8,Casual Users
29564,1137,15,35,2,3,3,8,Casual Users
29933,1737,89,121,1,5,4,10,At Risk
29996,1261,8,25,1,2,2,5,Lost
30034,1707,5,21,1,1,2,4,Lost
30162,421,6,19,3,1,2,6,Casual Users
30402,2663,19,43,1,3,3,7,Casual Users
30403,447,17,29,3,3,2,8,Loyal Users
30515,337,15,53,3,3,3,9,Loyal Users
30843,0,25,35,5,4,3,12,Loyal Users
30955,1411,38,58,1,4,3,8,At Risk
31266,296,12,40,3,3,3,9,Loyal Users
31268,1668,33,70,1,4,4,9,At Risk
31746,159,7,38,4,2,3,9,Promising
31984,129,11,24,4,2,2,8,Promising
31992,119,65,134,4,5,4,13,Champions
32038,260,62,153,3,5,5,13,Loyal Users
32596,126,5,21,4,1,2,7,Promising
32813,5,30,154,5,4,5,14,Champions
33049,65,33,68,5,4,4,13,Champions
33056,1264,5,7,1,1,1,3,Lost
33394,2306,9,11,1,2,1,4,Lost
33798,277,8,11,3,2,1,6,Casual Users
33809,3539,10,12,1,2,1,4,Lost
34112,270,66,151,3,5,5,13,Loyal Users
34135,699,12,30,2,3,2,7,Casual Users
34206,645,21,115,2,3,4,9,Casual Users
34216,136,22,64,4,4,4,12,Champions
34894,670,14,18,2,3,2,7,Casual Users
34931,231,32,161,3,4,5,12,Loyal Users
35025,61,45,150,5,4,5,14,Champions
35147,12,43,219,5,4,5,14,Champions
36014,163,58,209,4,5,5,14,Champions
36052,1119,5,20,2,1,2,5,Lost
36068,10,17,153,5,3,5,13,Loyal Users
36509,3020,5,7,1,1,1,3,Lost
36719,270,12,56,3,3,3,9,Loyal Users
36886,7,52,138,5,5,4,14,Champions
37024,658,17,54,2,3,3,8,Casual Users
37303,158,40,81,4,4,4,12,Champions
37337,4151,13,35,1,3,3,7,Casual Users
37405,2994,14,112,1,3,4,8,Casual Users
37507,6,184,746,5,5,5,15,Champions
37570,887,6,46,2,1,3,6,Lost
37711,926,9,17,2,2,2,6,Lost
37780,278,5,13,3,1,1,5,Casual Users
38244,2646,5,10,1,1,1,3,Lost
38719,1586,10,17,1,2,2,5,Lost
38903,1589,13,33,1,3,3,7,Casual Users
39002,3119,7,7,1,2,1,4,Lost
26617,409,33,172,3,4,5,12,Loyal Users
26884,124,24,31,4,4,2,10,Loyal Users
27047,942,10,20,2,2,2,6,Lost
27212,2513,5,9,1,1,1,3,Lost
27627,190,63,241,3,5,5,13,Loyal Users
27699,1275,6,14,1,1,1,3,Lost
27864,5541,9,17,1,2,2,5,Lost
27982,233,9,34,3,2,3,8,Casual Users
28123,2407,21,179,1,3,5,9,Casual Users
28176,158,26,52,4,4,3,11,Loyal Users
28522,479,31,46,2,4,3,9,At Risk
29130,13,132,168,5,5,5,15,Champions
29195,747,12,34,2,3,3,8,Casual Users
29390,1,136,229,5,5,5,15,Champions
30486,298,22,64,3,4,4,11,Loyal Users
30984,1661,29,41,1,4,3,8,At Risk
31085,49,211,571,5,5,5,15,Champions
31592,49,45,236,5,4,5,14,Champions
32135,1844,10,31,1,2,2,5,Lost
32282,443,54,77,3,5,4,12,Loyal Users
32323,4497,24,42,1,4,3,8,At Risk
32352,65,24,72,5,4,4,13,Champions
32569,112,25,76,4,4,4,12,Champions
32603,353,11,29,3,2,2,7,Casual Users
32788,69,91,110,5,5,4,14,Champions
33099,14,60,290,5,5,5,15,Champions
33240,278,11,40,3,2,3,8,Casual Users
33348,1993,11,22,1,2,2,5,Lost
33772,9,60,97,5,5,4,14,Champions
33864,1123,5,13,2,1,1,4,Lost
34078,38,150,349,5,5,5,15,Champions
34091,486,20,30,2,3,2,7,Casual Users
34226,15,91,292,5,5,5,15,Champions
34516,1048,10,14,2,2,1,5,Lost
34941,1160,7,9,2,2,1,5,Lost
34949,219,8,11,3,2,1,6,Casual Users
34950,295,82,170,3,5,5,13,Loyal Users
35111,767,12,22,2,3,2,7,Casual Users
35121,446,8,12,3,2,1,6,Casual Users
35329,2,63,146,5,5,4,14,Champions
35502,308,6,9,3,1,1,5,Casual Users
35718,178,7,31,3,2,2,7,Casual Users
35724,5152,6,15,1,1,1,3,Lost
35773,2087,7,18,1,2,2,5,Lost
36339,1230,10,13,2,2,1,5,Lost
36874,3,88,282,5,5,5,15,Champions
36991,153,14,26,4,3,2,9,Loyal Users
37112,450,31,54,3,4,3,10,Loyal Users
37451,116,15,18,4,3,2,9,Loyal Users
37534,1958,7,17,1,2,2,5,Lost
37592,11,8,30,5,2,2,9,Promising
37764,128,50,99,4,5,4,13,Champions
37886,14,19,39,5,3,3,11,Loyal Users
37958,4,32,90,5,4,4,13,Champions
37963,3117,11,20,1,2,2,5,Lost
38631,2116,6,12,1,1,1,3,Lost
38756,29,24,46,5,4,3,12,Loyal Users
26627,233,39,131,3,4,4,11,Loyal Users
26678,851,5,28,2,1,2,5,Lost
26695,77,60,224,4,5,5,14,Champions
27017,64,35,74,5,4,4,13,Champions
27371,346,10,15,3,2,1,6,Casual Users
27491,1133,5,6,2,1,1,4,Lost
27612,406,62,236,3,5,5,13,Loyal Users
27769,2974,17,31,1,3,2,6,Casual Users
27783,201,68,181,3,5,5,13,Loyal Users
27857,128,19,44,4,3,3,10,Loyal Users
28019,108,82,283,4,5,5,14,Champions
28206,393,14,29,3,3,2,8,Loyal Users
28225,2252,20,25,1,3,2,6,Casual Users
28302,122,54,126,4,5,4,13,Champions
28406,797,8,12,2,2,1,5,Lost
28756,54,156,766,5,5,5,15,Champions
28800,277,99,242,3,5,5,13,Loyal Users
28812,604,6,9,2,1,1,4,Lost
28922,1436,9,45,1,2,3,6,Lost
29012,79,29,51,4,4,3,11,Loyal Users
29154,13,45,136,5,4,4,13,Champions
29163,114,9,66,4,2,4,10,Promising
29171,34,25,38,5,4,3,12,Loyal Users
29283,1729,6,6,1,1,1,3,Lost
29576,261,24,59,3,4,3,10,Loyal Users
29605,4,14,44,5,3,3,11,Loyal Users
29678,268,37,185,3,4,5,12,Loyal Users
29986,101,64,602,4,5,5,14,Champions
29989,90,5,5,4,1,1,6,Promising
30170,1116,5,7,2,1,1,4,Lost
31269,1527,6,14,1,1,1,3,Lost
31585,547,9,11,2,2,1,5,Lost
31656,282,48,72,3,5,4,12,Loyal Users
31874,65,15,44,5,3,3,11,Loyal Users
31891,2433,8,9,1,2,1,4,Lost
31976,2993,10,17,1,2,2,5,Lost
32023,826,53,103,2,5,4,11,At Risk
32083,2,7,8,5,2,1,8,Promising
32162,8,19,47,5,3,3,11,Loyal Users
32256,166,115,200,3,5,5,13,Loyal Users
32350,416,22,175,3,4,5,12,Loyal Users
32406,215,6,17,3,1,2,6,Casual Users
32651,2,44,220,5,4,5,14,Champions
32984,257,31,82,3,4,4,11,Loyal Users
33173,23,79,233,5,5,5,15,Champions
33360,24,26,239,5,4,5,14,Champions
33680,56,71,464,5,5,5,15,Champions
33681,252,64,248,3,5,5,13,Loyal Users
33743,261,33,61,3,4,3,10,Loyal Users
34068,5011,7,22,1,2,2,5,Lost
34170,10,29,34,5,4,3,12,Loyal Users
34266,121,25,43,4,4,3,11,Loyal Users
34346,20,8,8,5,2,1,8,Promising
34940,5,39,67,5,4,4,13,Champions
35316,1966,6,7,1,1,1,3,Lost
35710,2059,9,29,1,2,2,5,Lost
35814,853,19,27,2,3,2,7,Casual Users
35962,264,34,91,3,4,4,11,Loyal Users
36099,116,61,240,4,5,5,14,Champions
36307,411,16,47,3,3,3,9,Loyal Users
36429,111,116,365,4,5,5,14,Champions
36748,2217,5,18,1,1,2,4,Lost
37131,48,27,60,5,4,3,12,Loyal Users
37150,412,27,57,3,4,3,10,Loyal Users
37173,387,6,9,3,1,1,5,Casual Users
37230,1939,5,5,1,1,1,3,Lost
37429,867,9,18,2,2,2,6,Lost
37564,832,7,27,2,2,2,6,Lost
37672,1366,8,9,1,2,1,4,Lost
37748,1717,6,36,1,1,3,5,Lost
37831,543,9,44,2,2,3,7,Lost
38024,30,87,162,5,5,5,15,Champions
38090,121,8,22,4,2,2,8,Promising
38541,949,69,202,2,5,5,12,At Risk
38771,878,5,62,2,1,3,6,Lost
39050,127,16,78,4,3,4,11,Loyal Users
39079,67,30,72,5,4,4,13,Champions
26522,2134,8,14,1,2,1,4,Lost
26788,14,45,106,5,4,4,13,Champions
26819,3374,7,63,1,2,4,7,Lost
27101,35,39,273,5,4,5,14,Champions
27549,313,19,64,3,3,4,10,Loyal Users
27574,140,41,73,4,4,4,12,Champions
27590,29,28,78,5,4,4,13,Champions
27877,20,45,120,5,4,4,13,Champions
28296,3131,10,27,1,2,2,5,Lost
28507,2338,10,22,1,2,2,5,Lost
28531,3000,5,12,1,1,1,3,Lost
28550,74,178,466,4,5,5,14,Champions
28576,663,5,16,2,1,2,5,Lost
28644,120,157,707,4,5,5,14,Champions
28648,2680,5,8,1,1,1,3,Lost
28795,279,17,24,3,3,2,8,Loyal Users
29271,122,60,259,4,5,5,14,Champions
29299,452,8,32,3,2,3,8,Casual Users
29700,101,33,76,4,4,4,12,Champions
29736,1108,34,135,2,4,4,10,At Risk
29769,110,39,218,4,4,5,13,Champions
30020,76,34,106,4,4,4,12,Champions
30318,280,21,69,3,3,4,10,Loyal Users
30394,113,79,150,4,5,5,14,Champions
30450,28,74,329,5,5,5,15,Champions
30508,3544,5,6,1,1,1,3,Lost
30996,1457,42,77,1,4,4,9,At Risk
31213,1940,5,5,1,1,1,3,Lost
31368,1259,5,15,1,1,1,3,Lost
31369,238,7,8,3,2,1,6,Casual Users
31903,107,10,48,4,2,3,9,Promising
32404,384,41,99,3,4,4,11,Loyal Users
32423,77,25,250,4,4,5,13,Champions
32628,2676,5,5,1,1,1,3,Lost
32814,4555,11,22,1,2,2,5,Lost
33491,57,16,31,5,3,2,10,Loyal Users
33747,1074,6,10,2,1,1,4,Lost
33909,148,5,6,4,1,1,6,Promising
34160,23,59,122,5,5,4,14,Champions
34180,716,22,230,2,4,5,11,At Risk
34370,685,27,35,2,4,3,9,At Risk
34408,355,12,87,3,3,4,10,Loyal Users
34606,166,26,96,3,4,4,11,Loyal Users
35089,61,53,182,5,5,5,15,Champions
35414,2622,7,12,1,2,1,4,Lost
35526,693,9,13,2,2,1,5,Lost
35590,354,96,173,3,5,5,13,Loyal Users
35706,30,41,85,5,4,4,13,Champions
35990,431,66,158,3,5,5,13,Loyal Users
36388,722,54,303,2,5,5,12,At Risk
36471,2691,20,80,1,3,4,8,Casual Users
36514,366,5,22,3,1,2,6,Casual Users
36527,86,129,591,4,5,5,14,Champions
37225,429,49,78,3,5,4,12,Loyal Users
37427,227,42,102,3,4,4,11,Loyal Users
37540,539,22,90,2,4,4,10,At Risk
38025,37,13,48,5,3,3,11,Loyal Users
38033,271,27,47,3,4,3,10,Loyal Users
38074,2269,5,22,1,1,2,4,Lost
38143,116,30,84,4,4,4,12,Champions
38192,417,7,16,3,2,2,7,Casual Users
38267,96,19,52,4,3,3,10,Loyal Users
38269,2203,6,36,1,1,3,5,Lost
38295,3373,6,8,1,1,1,3,Lost
38325,520,13,17,2,3,2,7,Casual Users
38424,571,51,160,2,5,5,12,At Risk
38612,334,11,12,3,2,1,6,Casual Users
39096,677,6,15,2,1,1,4,Lost
39233,544,10,32,2,2,3,7,Lost
26532,17,141,197,5,5,5,15,Champions
26563,487,19,42,2,3,3,8,Casual Users
26821,103,35,179,4,4,5,13,Champions
26828,2785,6,15,1,1,1,3,Lost
27148,1175,5,6,2,1,1,4,Lost
27467,139,17,28,4,3,2,9,Loyal Users
27533,4,64,232,5,5,5,15,Champions
27570,122,56,135,4,5,4,13,Champions
27768,1101,14,17,2,3,2,7,Casual Users
28158,5,12,90,5,3,4,12,Loyal Users
28347,1689,10,19,1,2,2,5,Lost
29209,152,11,64,4,2,4,10,Promising
29250,14,73,122,5,5,4,14,Champions
29373,3489,5,36,1,1,3,5,Lost
29381,106,26,62,4,4,3,11,Loyal Users
29501,232,65,185,3,5,5,13,Loyal Users
29669,409,27,155,3,4,5,12,Loyal Users
30371,25,30,67,5,4,4,13,Champions
31065,293,11,91,3,2,4,9,Casual Users
31109,947,48,78,2,5,4,11,At Risk
31151,23,53,201,5,5,5,15,Champions
31289,1112,7,10,2,2,1,5,Lost
32095,3403,6,8,1,1,1,3,Lost
32896,379,5,9,3,1,1,5,Casual Users
33263,3321,6,9,1,1,1,3,Lost
33306,9,77,492,5,5,5,15,Champions
33734,92,47,108,4,5,4,13,Champions
33818,3,39,106,5,4,4,13,Champions
33828,101,80,159,4,5,5,14,Champions
33924,299,44,77,3,4,4,11,Loyal Users
34229,1103,5,20,2,1,2,5,Lost
34315,78,13,18,4,3,2,9,Loyal Users
34508,17,19,39,5,3,3,11,Loyal Users
34833,85,106,160,4,5,5,14,Champions
35026,874,5,5,2,1,1,4,Lost
35190,11,98,193,5,5,5,15,Champions
35296,90,9,18,4,2,2,8,Promising
35566,853,10,17,2,2,2,6,Lost
35712,95,48,171,4,5,5,14,Champions
36134,19,118,377,5,5,5,15,Champions
36254,416,78,171,3,5,5,13,Loyal Users
36341,2947,8,19,1,2,2,5,Lost
36474,53,20,73,5,3,4,12,Loyal Users
36532,671,10,12,2,2,1,5,Lost
36618,523,12,20,2,3,2,7,Casual Users
36842,246,25,41,3,4,3,10,Loyal Users
37640,789,5,6,2,1,1,4,Lost
37712,274,22,105,3,4,4,11,Loyal Users
37786,2597,12,39,1,3,3,7,Casual Users
37830,261,32,139,3,4,4,11,Loyal Users
37863,18,100,589,5,5,5,15,Champions
38253,2831,24,32,1,4,3,8,At Risk
38501,43,92,326,5,5,5,15,Champions
39126,18,104,275,5,5,5,15,Champions
39218,1514,20,29,1,3,2,6,Casual Users
26491,786,7,80,2,2,4,8,Lost
26722,129,45,83,4,4,4,12,Champions
26808,34,17,50,5,3,3,11,Loyal Users
27447,6053,8,8,1,2,1,4,Lost
27530,185,51,108,3,5,4,12,Loyal Users
27561,642,26,100,2,4,4,10,At Risk
27617,233,33,88,3,4,4,11,Loyal Users
27721,1,116,380,5,5,5,15,Champions
27849,1946,11,19,1,2,2,5,Lost
28078,168,29,88,3,4,4,11,Loyal Users
28105,91,50,156,4,5,5,14,Champions
28333,8,42,96,5,4,4,13,Champions
28553,33,29,106,5,4,4,13,Champions
28872,568,16,22,2,3,2,7,Casual Users
28957,139,22,34,4,4,3,11,Loyal Users
29157,2,36,109,5,4,4,13,Champions
29167,0,48,166,5,5,5,15,Champions
29183,863,8,10,2,2,1,5,Lost
29229,28,10,42,5,2,3,10,Promising
29450,2816,7,11,1,2,1,4,Lost
29668,3103,5,8,1,1,1,3,Lost
29990,75,35,68,4,4,4,12,Champions
30011,0,19,67,5,3,4,12,Loyal Users
30312,2408,9,17,1,2,2,5,Lost
30604,673,5,15,2,1,1,4,Lost
31036,24,34,54,5,4,3,12,Loyal Users
31108,414,9,28,3,2,2,7,Casual Users
31180,2039,6,28,1,1,2,4,Lost
31198,2940,9,11,1,2,1,4,Lost
31204,1848,9,58,1,2,3,6,Lost
31337,4,67,190,5,5,5,15,Champions
31356,15,233,823,5,5,5,15,Champions
31610,274,54,160,3,5,5,13,Loyal Users
31870,132,8,17,4,2,2,8,Promising
31961,13,74,158,5,5,5,15,Champions
32006,849,197,590,2,5,5,12,At Risk
32281,6,113,290,5,5,5,15,Champions
32803,276,5,29,3,1,2,6,Casual Users
33249,154,48,126,4,5,4,13,Champions
33613,539,7,17,2,2,2,6,Lost
33749,1294,6,27,1,1,2,4,Lost
33928,137,5,15,4,1,1,6,Promising
34191,653,6,34,2,1,3,6,Lost
34262,428,9,46,3,2,3,8,Casual Users
34311,753,19,63,2,3,4,9,Casual Users
34339,33,93,229,5,5,5,15,Champions
34399,3988,6,10,1,1,1,3,Lost
34424,2102,6,13,1,1,1,3,Lost
34511,398,9,10,3,2,1,6,Casual Users
34658,585,6,6,2,1,1,4,Lost
34722,161,26,47,4,4,3,11,Loyal Users
34745,154,78,321,4,5,5,14,Champions
34816,639,13,142,2,3,4,9,Casual Users
34836,584,18,29,2,3,2,7,Casual Users
35001,1250,11,22,2,2,2,6,Lost
35084,112,28,64,4,4,4,12,Champions
35139,1261,17,52,1,3,3,7,Casual Users
35463,4,50,167,5,5,5,15,Champions
35655,2853,13,41,1,3,3,7,Casual Users
36212,3467,5,7,1,1,1,3,Lost
36259,430,9,52,3,2,3,8,Casual Users
36466,3516,5,5,1,1,1,3,Lost
36597,19,68,101,5,5,4,14,Champions
36788,41,9,12,5,2,1,8,Promising
36957,1157,7,10,2,2,1,5,Lost
36988,407,8,50,3,2,3,8,Casual Users
37013,303,13,29,3,3,2,8,Loyal Users
37097,956,11,89,2,2,4,8,Lost
37172,667,14,41,2,3,3,8,Casual Users
37397,398,15,24,3,3,2,8,Loyal Users
37680,423,36,73,3,4,4,11,Loyal Users
37885,2279,7,68,1,2,4,7,Lost
38333,446,6,11,3,1,1,5,Casual Users
38744,852,5,10,2,1,1,4,Lost
38914,88,45,93,4,4,4,12,Champions
39216,2542,5,9,1,1,1,3,Lost
26534,92,25,35,4,4,3,11,Loyal Users
26781,239,16,19,3,3,2,8,Loyal Users
26907,51,90,236,5,5,5,15,Champions
27236,4523,5,7,1,1,1,3,Lost
27317,546,5,13,2,1,1,4,Lost
27438,1507,14,43,1,3,3,7,Casual Users
27790,2887,5,17,1,1,2,4,Lost
27808,1466,8,17,1,2,2,5,Lost
28222,637,7,26,2,2,2,6,Lost
28978,5,17,49,5,3,3,11,Loyal Users
29135,493,101,427,2,5,5,12,At Risk
29245,98,91,187,4,5,5,14,Champions
29607,1537,14,22,1,3,2,6,Casual Users
29718,429,33,48,3,4,3,10,Loyal Users
30062,569,7,27,2,2,2,6,Lost
30208,87,34,132,4,4,4,12,Champions
30237,23,98,275,5,5,5,15,Champions
30440,26,86,313,5,5,5,15,Champions
30505,1,49,89,5,5,4,14,Champions
30794,608,22,141,2,4,4,10,At Risk
30860,267,11,33,3,2,3,8,Casual Users
31061,37,10,20,5,2,2,9,Promising
31302,102,22,86,4,4,4,12,Champions
31361,263,9,25,3,2,2,7,Casual Users
31500,102,9,24,4,2,2,8,Promising
31648,587,51,149,2,5,5,12,At Risk
31655,11,37,140,5,4,4,13,Champions
31760,262,9,27,3,2,2,7,Casual Users
32027,2853,22,68,1,4,4,9,At Risk
32138,4251,35,56,1,4,3,8,At Risk
32171,121,8,10,4,2,1,7,Promising
32458,718,5,18,2,1,2,5,Lost
32606,1130,8,17,2,2,2,6,Lost
32664,1477,9,13,1,2,1,4,Lost
32938,2163,7,20,1,2,2,5,Lost
33364,89,19,132,4,3,4,11,Loyal Users
33506,62,71,344,5,5,5,15,Champions
33687,93,160,251,4,5,5,14,Champions
33767,32,25,74,5,4,4,13,Champions
33815,1143,6,11,2,1,1,4,Lost
33878,96,67,100,4,5,4,13,Champions
34004,200,98,321,3,5,5,13,Loyal Users
34012,1106,5,24,2,1,2,5,Lost
34062,127,16,18,4,3,2,9,Loyal Users
34373,1270,7,16,1,2,2,5,Lost
34579,2624,10,13,1,2,1,4,Lost
34652,1271,20,135,1,3,4,8,Casual Users
34740,2185,6,15,1,1,1,3,Lost
34902,5027,13,23,1,3,2,6,Casual Users
35600,1282,10,52,1,2,3,6,Lost
35754,1265,17,31,1,3,2,6,Casual Users
35850,433,31,114,3,4,4,11,Loyal Users
36071,2431,7,8,1,2,1,4,Lost
36493,18,69,303,5,5,5,15,Champions
36548,35,55,178,5,5,5,15,Champions
36563,240,109,324,3,5,5,13,Loyal Users
36614,68,118,477,5,5,5,15,Champions
36710,2129,88,281,1,5,5,11,At Risk
36782,5,66,256,5,5,5,15,Champions
36849,568,10,14,2,2,1,5,Lost
36902,1520,14,36,1,3,3,7,Casual Users
37049,448,5,26,3,1,2,6,Casual Users
37333,163,6,24,4,1,2,7,Promising
38104,1708,10,15,1,2,1,4,Lost
38145,173,11,41,3,2,3,8,Casual Users
38316,96,10,21,4,2,2,8,Promising
38740,22,47,173,5,5,5,15,Champions
38844,195,12,126,3,3,4,10,Loyal Users
38917,2415,6,28,1,1,2,4,Lost
26533,171,10,29,3,2,2,7,Casual Users
26575,1261,7,32,1,2,3,6,Lost
26878,0,22,39,5,4,3,12,Loyal Users
27677,252,39,68,3,4,4,11,Loyal Users
27766,1000,24,34,2,4,3,9,At Risk
27831,410,32,76,3,4,4,11,Loyal Users
28194,1983,5,10,1,1,1,3,Lost
28902,130,7,7,4,2,1,7,Promising
28949,273,26,154,3,4,5,12,Loyal Users
29010,582,5,28,2,1,2,5,Lost
29063,126,43,168,4,4,5,13,Champions
29111,334,9,11,3,2,1,6,Casual Users
29170,814,12,12,2,3,1,6,Casual Users
29253,8,39,198,5,4,5,14,Champions
29666,253,104,366,3,5,5,13,Loyal Users
29690,841,7,25,2,2,2,6,Lost
29804,2,16,91,5,3,4,12,Loyal Users
29817,17,138,255,5,5,5,15,Champions
29885,2445,10,13,1,2,1,4,Lost
30047,30,28,126,5,4,4,13,Champions
30081,124,18,61,4,3,3,10,Loyal Users
30356,5159,7,20,1,2,2,5,Lost
30367,452,36,94,3,4,4,11,Loyal Users
30494,166,27,41,3,4,3,10,Loyal Users
30932,698,22,34,2,4,3,9,At Risk
31205,2204,5,6,1,1,1,3,Lost
31263,7,84,298,5,5,5,15,Champions
31619,117,8,25,4,2,2,8,Promising
32302,759,12,21,2,3,2,7,Casual Users
32337,73,15,44,4,3,3,10,Loyal Users
32388,111,39,98,4,4,4,12,Champions
32446,414,8,17,3,2,2,7,Casual Users
32897,0,8,21,5,2,2,9,Promising
33568,4,48,110,5,5,4,14,Champions
33572,6,91,226,5,5,5,15,Champions
33622,1107,6,43,2,1,3,6,Lost
33713,27,194,285,5,5,5,15,Champions
33829,111,14,34,4,3,3,10,Loyal Users
33851,1507,10,10,1,2,1,4,Lost
34051,1640,11,20,1,2,2,5,Lost
34124,1986,22,104,1,4,4,9,At Risk
34442,1665,11,21,1,2,2,5,Lost
34547,651,10,13,2,2,1,5,Lost
34720,713,13,47,2,3,3,8,Casual Users
34896,12,6,11,5,1,1,7,Promising
35017,502,20,90,2,3,4,9,Casual Users
35081,145,23,305,4,4,5,13,Champions
35630,430,26,40,3,4,3,10,Loyal Users
35677,429,18,29,3,3,2,8,Loyal Users
35815,1067,58,91,2,5,4,11,At Risk
36268,1115,12,48,2,3,3,8,Casual Users
36419,4,22,48,5,4,3,12,Loyal Users
36596,291,16,42,3,3,3,9,Loyal Users
36673,150,15,44,4,3,3,10,Loyal Users
36679,3567,5,5,1,1,1,3,Lost
36683,117,26,54,4,4,3,11,Loyal Users
36962,390,35,69,3,4,4,11,Loyal Users
37061,864,19,27,2,3,2,7,Casual Users
37094,880,13,59,2,3,3,8,Casual Users
37227,652,23,38,2,4,3,9,At Risk
37674,789,12,20,2,3,2,7,Casual Users
37785,172,66,96,3,5,4,12,Loyal Users
37997,1522,10,65,1,2,4,7,Lost
38043,29,49,150,5,5,5,15,Champions
38109,23,145,411,5,5,5,15,Champions
38115,106,11,28,4,2,2,8,Promising
38141,1996,5,15,1,1,1,3,Lost
38163,347,8,64,3,2,4,9,Casual Users
38358,1493,23,68,1,4,4,9,At Risk
38660,179,18,139,3,3,4,10,Loyal Users
38832,115,7,13,4,2,1,7,Promising
39232,964,5,5,2,1,1,4,Lost
26540,861,8,13,2,2,1,5,Lost
26682,55,194,274,5,5,5,15,Champions
26827,8,79,385,5,5,5,15,Champions
26838,346,76,529,3,5,5,13,Loyal Users
26938,224,17,90,3,3,4,10,Loyal Users
27088,19,9,31,5,2,2,9,Promising
27260,1015,16,197,2,3,5,10,Casual Users
27372,548,20,64,2,3,4,9,Casual Users
27414,1449,9,10,1,2,1,4,Lost
27495,2,38,103,5,4,4,13,Champions
27668,130,13,131,4,3,4,11,Loyal Users
28144,121,5,9,4,1,1,6,Promising
28523,26,117,239,5,5,5,15,Champions
28697,157,25,91,4,4,4,12,Champions
28711,305,19,79,3,3,4,10,Loyal Users
28745,795,5,21,2,1,2,5,Lost
28977,1143,8,13,2,2,1,5,Lost
28987,1419,30,65,1,4,4,9,At Risk
29178,37,104,422,5,5,5,15,Champions
29200,1333,8,11,1,2,1,4,Lost
29577,144,74,100,4,5,4,13,Champions
29694,24,5,11,5,1,1,7,Promising
29713,4766,8,13,1,2,1,4,Lost
29914,1878,14,71,1,3,4,8,Casual Users
30132,77,12,47,4,3,3,10,Loyal Users
30185,2,20,38,5,3,3,11,Loyal Users
30273,33,6,32,5,1,3,9,Promising
30483,697,8,11,2,2,1,5,Lost
30620,3548,6,24,1,1,2,4,Lost
30724,444,10,18,3,2,2,7,Casual Users
30812,4581,11,14,1,2,1,4,Lost
30863,1112,5,22,2,1,2,5,Lost
30901,284,7,10,3,2,1,6,Casual Users
31002,737,17,30,2,3,2,7,Casual Users
31026,439,59,108,3,5,4,12,Loyal Users
31298,709,13,33,2,3,3,8,Casual Users
31575,3284,7,7,1,2,1,4,Lost
31695,2177,9,16,1,2,2,5,Lost
31770,661,8,10,2,2,1,5,Lost
31792,2839,5,11,1,1,1,3,Lost
31868,1400,5,5,1,1,1,3,Lost
32039,528,14,61,2,3,3,8,Casual Users
32070,19,12,23,5,3,2,10,Loyal Users
32210,11,178,481,5,5,5,15,Champions
32252,3103,50,167,1,5,5,11,At Risk
32480,790,22,46,2,4,3,9,At Risk
32676,291,34,193,3,4,5,12,Loyal Users
32784,132,13,17,4,3,2,9,Loyal Users
32844,1431,15,19,1,3,2,6,Casual Users
33046,134,43,77,4,4,4,12,Champions
33521,21,6,19,5,1,2,8,Promising
33528,993,17,178,2,3,5,10,Casual Users
33755,128,16,49,4,3,3,10,Loyal Users
34002,275,34,62,3,4,3,10,Loyal Users
34130,1240,10,10,2,2,1,5,Lost
34182,3306,10,29,1,2,2,5,Lost
34437,906,20,48,2,3,3,8,Casual Users
34534,71,56,191,4,5,5,14,Champions
34678,139,27,64,4,4,4,12,Champions
35117,91,17,111,4,3,4,11,Loyal Users
35269,71,28,48,4,4,3,11,Loyal Users
35354,539,5,21,2,1,2,5,Lost
35373,5276,8,45,1,2,3,6,Lost
35486,702,17,33,2,3,3,8,Casual Users
35639,1531,11,66,1,2,4,7,Lost
35740,406,41,226,3,4,5,12,Loyal Users
35760,312,11,12,3,2,1,6,Casual Users
35795,165,5,8,4,1,1,6,Promising
35997,66,130,383,5,5,5,15,Champions
36051,420,28,45,3,4,3,10,Loyal Users
36158,169,14,29,3,3,2,8,Loyal Users
36265,148,10,21,4,2,2,8,Promising
36826,7,81,398,5,5,5,15,Champions
36890,1396,10,17,1,2,2,5,Lost
37270,1021,10,15,2,2,1,5,Lost
37560,54,26,54,5,4,3,12,Loyal Users
37578,90,19,38,4,3,3,10,Loyal Users
37771,663,9,13,2,2,1,5,Lost
37910,138,30,149,4,4,5,13,Champions
38050,11,36,156,5,4,5,14,Champions
38086,294,6,23,3,1,2,6,Casual Users
38439,845,15,47,2,3,3,8,Casual Users
38808,386,24,112,3,4,4,11,Loyal Users
38842,2475,6,11,1,1,1,3,Lost
38892,142,9,19,4,2,2,8,Promising
38965,157,44,87,4,4,4,12,Champions
39110,1864,16,21,1,3,2,6,Casual Users
26598,3609,5,16,1,1,2,4,Lost
26762,738,5,9,2,1,1,4,Lost
26905,398,51,111,3,5,4,12,Loyal Users
27021,700,5,15,2,1,1,4,Lost
27074,2412,5,19,1,1,2,4,Lost
27124,0,143,649,5,5,5,15,Champions
27298,3530,16,42,1,3,3,7,Casual Users
27455,1808,32,49,1,4,3,8,At Risk
27884,138,26,51,4,4,3,11,Loyal Users
28035,90,55,213,4,5,5,14,Champions
28289,2876,9,15,1,2,1,4,Lost
28360,259,15,22,3,3,2,8,Loyal Users
28369,1568,5,16,1,1,2,4,Lost
28452,412,9,9,3,2,1,6,Casual Users
28634,15,103,179,5,5,5,15,Champions
28653,239,9,14,3,2,1,6,Casual Users
28854,14,137,342,5,5,5,15,Champions
29435,3,6,6,5,1,1,7,Promising
29441,28,7,7,5,2,1,8,Promising
30290,86,126,760,4,5,5,14,Champions
30596,161,5,25,4,1,2,7,Promising
30734,1239,7,19,2,2,2,6,Lost
30754,737,6,9,2,1,1,4,Lost
31173,2441,8,12,1,2,1,4,Lost
31178,312,7,7,3,2,1,6,Casual Users
31272,157,97,687,4,5,5,14,Champions
31355,411,19,54,3,3,3,9,Loyal Users
31896,102,11,42,4,2,3,9,Promising
32072,532,7,19,2,2,2,6,Lost
32234,1016,10,16,2,2,2,6,Lost
32868,1852,9,18,1,2,2,5,Lost
33450,4440,5,16,1,1,2,4,Lost
33787,4117,6,26,1,1,2,4,Lost
33838,515,10,19,2,2,2,6,Lost
34398,456,17,41,3,3,3,9,Loyal Users
34451,108,52,116,4,5,4,13,Champions
34649,10,15,20,5,3,2,10,Loyal Users
34680,697,10,19,2,2,2,6,Lost
34880,80,73,113,4,5,4,13,Champions
35222,27,12,33,5,3,3,11,Loyal Users
35238,257,27,96,3,4,4,11,Loyal Users
35325,1,155,209,5,5,5,15,Champions
35696,1121,5,10,2,1,1,4,Lost
36506,20,37,167,5,4,5,14,Champions
36638,94,10,12,4,2,1,7,Promising
36979,168,16,34,3,3,3,9,Loyal Users
37070,83,40,142,4,4,4,12,Champions
37733,83,37,80,4,4,4,12,Champions
37955,1989,6,22,1,1,2,4,Lost
38037,105,24,108,4,4,4,12,Champions
38219,62,12,47,5,3,3,11,Loyal Users
38225,3,196,528,5,5,5,15,Champions
38370,19,112,364,5,5,5,15,Champions
38527,1973,6,41,1,1,3,5,Lost
38708,2972,5,5,1,1,1,3,Lost
38737,1765,43,166,1,4,5,10,At Risk
38977,1706,5,5,1,1,1,3,Lost
39080,1844,5,7,1,1,1,3,Lost
39132,400,77,192,3,5,5,13,Loyal Users
26969,13,53,145,5,5,4,14,Champions
27323,1437,8,14,1,2,1,4,Lost
27463,23,135,635,5,5,5,15,Champions
28133,825,19,68,2,3,4,9,Casual Users
28362,273,15,23,3,3,2,8,Loyal Users
28798,850,9,11,2,2,1,5,Lost
28877,1655,8,18,1,2,2,5,Lost
28971,577,17,57,2,3,3,8,Casual Users
29640,73,20,32,4,3,3,10,Loyal Users
29855,2581,6,11,1,1,1,3,Lost
30370,0,47,131,5,5,4,14,Champions
30424,537,34,44,2,4,3,9,At Risk
30457,3240,11,21,1,2,2,5,Lost
30681,1123,24,35,2,4,3,9,At Risk
30750,2315,7,11,1,2,1,4,Lost
30833,234,34,151,3,4,5,12,Loyal Users
30944,14,19,91,5,3,4,12,Loyal Users
31104,127,25,66,4,4,4,12,Champions
31284,551,10,40,2,2,3,7,Lost
31466,55,128,449,5,5,5,15,Champions
31517,1515,16,26,1,3,2,6,Casual Users
31723,35,22,91,5,4,4,13,Champions
31780,232,67,279,3,5,5,13,Loyal Users
32170,127,26,32,4,4,3,11,Loyal Users
32325,374,17,34,3,3,3,9,Loyal Users
32555,598,10,17,2,2,2,6,Lost
32656,531,6,12,2,1,1,4,Lost
32721,228,81,121,3,5,4,12,Loyal Users
32795,79,25,30,4,4,2,10,Loyal Users
33001,50,77,174,5,5,5,15,Champions
33250,2553,9,68,1,2,4,7,Lost
33303,1228,5,14,2,1,1,4,Lost
33313,418,72,347,3,5,5,13,Loyal Users
33428,1535,7,13,1,2,1,4,Lost
33584,19,135,879,5,5,5,15,Champions
33984,724,5,17,2,1,2,5,Lost
34251,208,19,38,3,3,3,9,Loyal Users
34367,364,6,18,3,1,2,6,Casual Users
34826,128,9,21,4,2,2,8,Promising
34899,9,112,398,5,5,5,15,Champions
34948,2711,13,26,1,3,2,6,Casual Users
35045,2849,5,8,1,1,1,3,Lost
35109,446,6,8,3,1,1,5,Casual Users
35477,185,5,18,3,1,2,6,Casual Users
36036,826,14,16,2,3,2,7,Casual Users
36505,7,73,105,5,5,4,14,Champions
36986,17,53,109,5,5,4,14,Champions
37122,2268,5,29,1,1,2,4,Lost
37982,4,76,269,5,5,5,15,Champions
38075,49,105,401,5,5,5,15,Champions
38441,396,12,18,3,3,2,8,Loyal Users
38458,97,19,62,4,3,3,10,Loyal Users
38983,41,17,27,5,3,2,10,Loyal Users
39155,102,25,251,4,4,5,13,Champions
26723,2,97,603,5,5,5,15,Champions
26960,226,11,18,3,2,2,7,Casual Users
26962,2187,5,5,1,1,1,3,Lost
27132,181,38,75,3,4,4,11,Loyal Users
27167,141,7,8,4,2,1,7,Promising
27216,523,7,61,2,2,3,7,Lost
27545,128,29,166,4,4,5,13,Champions
27547,56,72,305,5,5,5,15,Champions
28213,130,9,23,4,2,2,8,Promising
28266,1501,7,41,1,2,3,6,Lost
28423,997,10,13,2,2,1,5,Lost
28923,428,9,17,3,2,2,7,Casual Users
28989,4,17,47,5,3,3,11,Loyal Users
29007,1375,5,13,1,1,1,3,Lost
29079,1669,78,198,1,5,5,11,At Risk
29324,2689,5,7,1,1,1,3,Lost
29553,291,13,22,3,3,2,8,Loyal Users
29628,2386,10,11,1,2,1,4,Lost
29830,2046,12,18,1,3,2,6,Casual Users
30488,423,45,140,3,4,4,11,Loyal Users
30496,399,9,36,3,2,3,8,Casual Users
30849,207,22,22,3,4,2,9,Loyal Users
30933,4785,5,9,1,1,1,3,Lost
31069,229,43,154,3,4,5,12,Loyal Users
31194,7,66,255,5,5,5,15,Champions
31303,416,8,25,3,2,2,7,Casual Users
31378,3947,5,28,1,1,2,4,Lost
31430,69,104,217,5,5,5,15,Champions
31519,1489,7,12,1,2,1,4,Lost
31883,1297,11,14,1,2,1,4,Lost
31942,186,45,131,3,4,4,11,Loyal Users
32096,27,51,195,5,5,5,15,Champions
32575,108,89,117,4,5,4,13,Champions
32645,98,21,46,4,3,3,10,Loyal Users
33071,1101,8,21,2,2,2,6,Lost
33121,1416,7,36,1,2,3,6,Lost
33124,659,5,6,2,1,1,4,Lost
33170,3,36,281,5,4,5,14,Champions
34578,241,28,69,3,4,4,11,Loyal Users
34869,1987,11,18,1,2,2,5,Lost
34907,31,90,300,5,5,5,15,Champions
34935,123,55,92,4,5,4,13,Champions
34946,2570,5,13,1,1,1,3,Lost
35100,3951,6,33,1,1,3,5,Lost
35106,837,15,30,2,3,2,7,Casual Users
35229,33,106,318,5,5,5,15,Champions
35515,811,6,10,2,1,1,4,Lost
35580,129,9,11,4,2,1,7,Promising
35719,1162,7,127,2,2,4,8,Lost
35824,3638,23,86,1,4,4,9,At Risk
36101,2702,11,19,1,2,2,5,Lost
36277,19,39,68,5,4,4,13,Champions
36340,47,147,883,5,5,5,15,Champions
36387,265,13,20,3,3,2,8,Loyal Users
36636,108,24,195,4,4,5,13,Champions
36891,652,5,7,2,1,1,4,Lost
37310,651,9,58,2,2,3,7,Lost
38242,1581,15,48,1,3,3,7,Casual Users
38288,935,6,8,2,1,1,4,Lost
38296,1412,13,56,1,3,3,7,Casual Users
38319,250,13,14,3,3,1,7,Loyal Users
38349,1959,21,40,1,3,3,7,Casual Users
38585,105,71,196,4,5,5,14,Champions
38689,1877,14,24,1,3,2,6,Casual Users
38835,2149,10,16,1,2,2,5,Lost
39221,370,44,135,3,4,4,11,Loyal Users
26826,204,28,55,3,4,3,10,Loyal Users
27001,747,19,31,2,3,2,7,Casual Users
27219,71,74,170,4,5,5,14,Champions
27220,5726,9,10,1,2,1,4,Lost
27366,794,8,48,2,2,3,7,Lost
27390,2042,6,6,1,1,1,3,Lost
27496,1128,8,32,2,2,3,7,Lost
27811,6,55,95,5,5,4,14,Champions
27945,191,8,55,3,2,3,8,Casual Users
27990,394,8,8,3,2,1,6,Casual Users
28300,132,9,64,4,2,4,10,Promising
28571,420,5,39,3,1,3,7,Casual Users
28827,273,17,34,3,3,3,9,Loyal Users
28979,44,63,146,5,5,4,14,Champions
29504,94,108,342,4,5,5,14,Champions
29770,1155,7,20,2,2,2,6,Lost
30566,3772,7,15,1,2,1,4,Lost
30964,2584,7,12,1,2,1,4,Lost
30989,1992,5,10,1,1,1,3,Lost
31094,13,137,415,5,5,5,15,Champions
32063,3846,6,6,1,1,1,3,Lost
32347,48,34,148,5,4,5,14,Champions
32537,254,23,52,3,4,3,10,Loyal Users
32619,424,13,24,3,3,2,8,Loyal Users
32649,5147,8,14,1,2,1,4,Lost
33022,3593,10,19,1,2,2,5,Lost
33136,441,26,78,3,4,4,11,Loyal Users
33254,566,24,34,2,4,3,9,At Risk
33977,9,5,20,5,1,2,8,Promising
34186,314,18,28,3,3,2,8,Loyal Users
34359,13,135,504,5,5,5,15,Champions
34400,1001,6,14,2,1,1,4,Lost
35037,88,90,352,4,5,5,14,Champions
35481,524,67,355,2,5,5,12,At Risk
35742,248,86,307,3,5,5,13,Loyal Users
35759,3559,9,9,1,2,1,4,Lost
36899,1469,5,9,1,1,1,3,Lost
37539,127,23,184,4,4,5,13,Champions
37541,317,29,67,3,4,4,11,Loyal Users
37895,237,10,27,3,2,2,7,Casual Users
37957,420,22,60,3,4,3,10,Loyal Users
38369,105,98,186,4,5,5,14,Champions
38514,4291,13,23,1,3,2,6,Casual Users
26645,2681,5,12,1,1,1,3,Lost
27130,1828,8,85,1,2,4,7,Lost
27211,101,111,284,4,5,5,14,Champions
27430,14,109,267,5,5,5,15,Champions
27624,305,45,228,3,4,5,12,Loyal Users
27650,999,9,10,2,2,1,5,Lost
28086,73,110,606,4,5,5,14,Champions
28104,284,9,17,3,2,2,7,Casual Users
28156,858,45,239,2,4,5,11,At Risk
28364,1749,7,18,1,2,2,5,Lost
28583,67,51,172,5,5,5,15,Champions
28739,148,8,10,4,2,1,7,Promising
28867,65,77,452,5,5,5,15,Champions
29096,37,23,60,5,4,3,12,Loyal Users
29286,432,66,211,3,5,5,13,Loyal Users
29708,421,5,7,3,1,1,5,Casual Users
29793,169,19,62,3,3,3,9,Loyal Users
30326,118,26,62,4,4,3,11,Loyal Users
30331,560,27,37,2,4,3,9,At Risk
30470,5,41,89,5,4,4,13,Champions
30482,2,69,302,5,5,5,15,Champions
31155,143,12,20,4,3,2,9,Loyal Users
31577,5975,10,33,1,2,3,6,Lost
31719,376,13,55,3,3,3,9,Loyal Users
32213,133,23,119,4,4,4,12,Champions
32834,113,7,9,4,2,1,7,Promising
32858,1599,5,7,1,1,1,3,Lost
32927,4365,8,8,1,2,1,4,Lost
33204,681,10,20,2,2,2,6,Lost
33388,220,35,248,3,4,5,12,Loyal Users
33532,20,87,406,5,5,5,15,Champions
33553,102,21,28,4,3,2,9,Loyal Users
33813,4503,5,36,1,1,3,5,Lost
34296,26,93,237,5,5,5,15,Champions
34454,1330,8,10,1,2,1,4,Lost
34901,10,80,298,5,5,5,15,Champions
34956,394,11,27,3,2,2,7,Casual Users
35125,2142,11,27,1,2,2,5,Lost
35140,82,25,47,4,4,3,11,Loyal Users
35148,79,54,219,4,5,5,14,Champions
35678,708,7,24,2,2,2,6,Lost
36927,2823,7,22,1,2,2,5,Lost
37212,113,139,440,4,5,5,14,Champions
37703,772,5,9,2,1,1,4,Lost
37804,2014,38,51,1,4,3,8,At Risk
38196,1297,49,123,1,5,4,10,At Risk
38300,13,40,113,5,4,4,13,Champions
38518,6,40,83,5,4,4,13,Champions
38533,680,26,138,2,4,4,10,At Risk
38852,1407,7,13,1,2,1,4,Lost
39060,576,13,100,2,3,4,9,Casual Users
27249,32,72,436,5,5,5,15,Champions
27408,423,30,63,3,4,4,11,Loyal Users
27824,7,14,28,5,3,2,10,Loyal Users
27920,68,40,149,5,4,5,14,Champions
27937,77,12,50,4,3,3,10,Loyal Users
28028,395,14,38,3,3,3,9,Loyal Users
28052,1,122,561,5,5,5,15,Champions
28191,3,114,409,5,5,5,15,Champions
28321,269,19,42,3,3,3,9,Loyal Users
28528,2607,8,12,1,2,1,4,Lost
28859,528,35,76,2,4,4,10,At Risk
29140,3285,30,52,1,4,3,8,At Risk
29258,2,21,30,5,3,2,10,Loyal Users
29317,427,90,240,3,5,5,13,Loyal Users
29360,422,32,60,3,4,3,10,Loyal Users
29411,2760,14,28,1,3,2,6,Casual Users
29675,415,7,8,3,2,1,6,Casual Users
29901,174,31,43,3,4,3,10,Loyal Users
29985,36,104,200,5,5,5,15,Champions
30299,273,15,17,3,3,2,8,Loyal Users
30634,172,41,61,3,4,3,10,Loyal Users
30659,3695,10,16,1,2,2,5,Lost
30829,724,19,41,2,3,3,8,Casual Users
32018,3581,14,91,1,3,4,8,Casual Users
32037,2165,6,11,1,1,1,3,Lost
32140,130,79,708,4,5,5,14,Champions
32394,170,14,76,3,3,4,10,Loyal Users
32716,549,36,116,2,4,4,10,At Risk
32785,41,74,203,5,5,5,15,Champions
32789,457,11,33,3,2,3,8,Casual Users
33074,2739,7,9,1,2,1,4,Lost
33455,4,12,49,5,3,3,11,Loyal Users
33700,4,13,23,5,3,2,10,Loyal Users
33967,3,33,143,5,4,4,13,Champions
34066,1104,15,104,2,3,4,9,Casual Users
34324,318,37,117,3,4,4,11,Loyal Users
34348,1257,12,21,2,3,2,7,Casual Users
34671,10,60,185,5,5,5,15,Champions
35356,2670,7,13,1,2,1,4,Lost
35376,2118,16,28,1,3,2,6,Casual Users
35447,444,43,113,3,4,4,11,Loyal Users
35485,14,100,227,5,5,5,15,Champions
35547,158,72,179,4,5,5,14,Champions
35697,662,8,14,2,2,1,5,Lost
36166,109,8,16,4,2,2,8,Promising
36227,2453,5,10,1,1,1,3,Lost
36477,2768,5,15,1,1,1,3,Lost
36970,426,9,23,3,2,2,7,Casual Users
37098,126,42,321,4,4,5,13,Champions
37167,389,13,60,3,3,3,9,Loyal Users
37617,143,107,183,4,5,5,14,Champions
37707,352,14,15,3,3,1,7,Loyal Users
37924,593,6,26,2,1,2,5,Lost
38233,219,19,121,3,3,4,10,Loyal Users
38240,174,5,8,3,1,1,5,Casual Users
38778,521,31,42,2,4,3,9,At Risk
38789,2128,6,21,1,1,2,4,Lost
38837,1613,5,8,1,1,1,3,Lost
38939,1258,41,162,1,4,5,10,At Risk
38949,1563,10,14,1,2,1,4,Lost
26803,9,15,49,5,3,3,11,Loyal Users
27076,214,10,48,3,2,3,8,Casual Users
27571,2088,6,13,1,1,1,3,Lost
28090,9,150,473,5,5,5,15,Champions
28430,191,8,21,3,2,2,7,Casual Users
28657,11,48,66,5,5,4,14,Champions
28826,694,77,127,2,5,4,11,At Risk
29935,574,31,73,2,4,4,10,At Risk
30082,37,63,134,5,5,4,14,Champions
30153,420,17,35,3,3,3,9,Loyal Users
30265,108,37,148,4,4,5,13,Champions
30475,1511,8,36,1,2,3,6,Lost
30487,603,26,56,2,4,3,9,At Risk
30507,16,45,79,5,4,4,13,Champions
30718,430,104,392,3,5,5,13,Loyal Users
30859,1023,23,130,2,4,4,10,At Risk
30895,102,8,10,4,2,1,7,Promising
31022,2672,6,29,1,1,2,4,Lost
31141,507,12,14,2,3,1,6,Casual Users
31668,421,9,27,3,2,2,7,Casual Users
32112,112,69,178,4,5,5,14,Champions
32276,156,11,14,4,2,1,7,Promising
32321,682,7,9,2,2,1,5,Lost
32386,1726,28,41,1,4,3,8,At Risk
32462,131,41,76,4,4,4,12,Champions
32639,533,6,12,2,1,1,4,Lost
32690,239,30,175,3,4,5,12,Loyal Users
32757,188,24,54,3,4,3,10,Loyal Users
32895,218,6,14,3,1,1,5,Casual Users
33005,1162,5,47,2,1,3,6,Lost
33163,583,36,138,2,4,4,10,At Risk
33490,295,31,59,3,4,3,10,Loyal Users
33507,105,24,219,4,4,5,13,Champions
33691,10,131,253,5,5,5,15,Champions
33778,61,72,203,5,5,5,15,Champions
33874,237,14,29,3,3,2,8,Loyal Users
34082,707,30,104,2,4,4,10,At Risk
34514,431,11,37,3,2,3,8,Casual Users
34538,128,22,169,4,4,5,13,Champions
34768,263,5,9,3,1,1,5,Casual Users
34959,1016,18,55,2,3,3,8,Casual Users
35146,3919,5,5,1,1,1,3,Lost
35166,12,15,22,5,3,2,10,Loyal Users
35267,95,46,172,4,5,5,14,Champions
35358,138,37,159,4,4,5,13,Champions
35900,1,28,114,5,4,4,13,Champions
36002,375,6,8,3,1,1,5,Casual Users
36045,2423,5,23,1,1,2,4,Lost
36067,591,15,29,2,3,2,7,Casual Users
36290,1635,14,42,1,3,3,7,Casual Users
36332,388,42,168,3,4,5,12,Loyal Users
36421,3994,6,11,1,1,1,3,Lost
36581,425,35,230,3,4,5,12,Loyal Users
36657,175,14,16,3,3,2,8,Loyal Users
36713,3005,26,52,1,4,3,8,At Risk
37043,653,13,73,2,3,4,9,Casual Users
37221,91,13,26,4,3,2,9,Loyal Users
37322,1250,12,15,2,3,1,6,Casual Users
37344,977,6,22,2,1,2,5,Lost
38021,156,41,87,4,4,4,12,Champions
38035,51,115,501,5,5,5,15,Champions
38327,48,29,69,5,4,4,13,Champions
38360,113,28,90,4,4,4,12,Champions
38384,906,20,23,2,3,2,7,Casual Users
38389,1349,14,19,1,3,2,6,Casual Users
38822,46,7,13,5,2,1,8,Promising
39164,1542,21,35,1,3,3,7,Casual Users
39171,807,53,167,2,5,5,12,At Risk
26665,2895,6,11,1,1,1,3,Lost
27006,263,6,6,3,1,1,5,Casual Users
27434,3376,20,42,1,3,3,7,Casual Users
27980,83,30,84,4,4,4,12,Champions
28188,118,8,23,4,2,2,8,Promising
28396,17,56,307,5,5,5,15,Champions
28510,79,13,108,4,3,4,11,Loyal Users
28662,406,29,64,3,4,4,11,Loyal Users
28715,1846,13,32,1,3,3,7,Casual Users
28750,91,6,50,4,1,3,8,Promising
29863,126,5,5,4,1,1,6,Promising
30052,4,185,633,5,5,5,15,Champions
30688,1436,11,14,1,2,1,4,Lost
30712,311,5,24,3,1,2,6,Casual Users
30967,1288,6,11,1,1,1,3,Lost
31233,626,25,152,2,4,5,11,At Risk
31297,569,62,311,2,5,5,12,At Risk
31862,340,40,65,3,4,4,11,Loyal Users
31869,722,16,23,2,3,2,7,Casual Users
31919,1809,11,13,1,2,1,4,Lost
32120,105,103,845,4,5,5,14,Champions
32156,719,11,16,2,2,2,6,Lost
32257,166,14,56,3,3,3,9,Loyal Users
32451,423,5,6,3,1,1,5,Casual Users
32467,2738,6,22,1,1,2,4,Lost
32735,2565,7,9,1,2,1,4,Lost
32791,35,123,768,5,5,5,15,Champions
32936,422,12,24,3,3,2,8,Loyal Users
33103,15,85,191,5,5,5,15,Champions
33307,15,75,208,5,5,5,15,Champions
33606,912,19,127,2,3,4,9,Casual Users
33901,18,98,313,5,5,5,15,Champions
33914,306,57,81,3,5,4,12,Loyal Users
34325,715,5,11,2,1,1,4,Lost
34477,2336,9,13,1,2,1,4,Lost
34536,448,10,48,3,2,3,8,Casual Users
34635,1947,8,50,1,2,3,6,Lost
34643,2303,7,107,1,2,4,7,Lost
34996,4030,20,132,1,3,4,8,Casual Users
35164,2650,10,18,1,2,2,5,Lost
36278,10,144,634,5,5,5,15,Champions
36325,2680,14,28,1,3,2,6,Casual Users
36873,255,8,11,3,2,1,6,Casual Users
37052,1,42,141,5,4,4,13,Champions
37117,4599,6,16,1,1,2,4,Lost
37403,20,7,22,5,2,2,9,Promising
37612,4001,9,11,1,2,1,4,Lost
37803,3588,7,12,1,2,1,4,Lost
38256,103,45,116,4,4,4,12,Champions
38277,385,25,131,3,4,4,11,Loyal Users
38324,2758,11,108,1,2,4,7,Lost
38667,3940,5,21,1,1,2,4,Lost
38742,505,36,67,2,4,4,10,At Risk
39111,539,19,77,2,3,4,9,Casual Users
39147,120,12,55,4,3,3,10,Loyal Users
26512,149,41,48,4,4,3,11,Loyal Users
26593,816,5,10,2,1,1,4,Lost
26596,5576,5,19,1,1,2,4,Lost
26818,518,6,7,2,1,1,4,Lost
26861,136,57,218,4,5,5,14,Champions
26902,115,91,127,4,5,4,13,Champions
26925,119,48,69,4,5,4,13,Champions
27008,4133,33,55,1,4,3,8,At Risk
27175,1262,25,53,1,4,3,8,At Risk
27336,19,102,381,5,5,5,15,Champions
27555,274,41,97,3,4,4,11,Loyal Users
27903,118,41,62,4,4,3,11,Loyal Users
27942,5,109,479,5,5,5,15,Champions
28029,75,83,428,4,5,5,14,Champions
28062,148,154,633,4,5,5,14,Champions
28218,17,51,179,5,5,5,15,Champions
28326,145,6,11,4,1,1,6,Promising
28421,864,12,18,2,3,2,7,Casual Users
28590,4738,7,32,1,2,3,6,Lost
28863,244,16,45,3,3,3,9,Loyal Users
29125,972,9,25,2,2,2,6,Lost
29331,137,6,6,4,1,1,6,Promising
29346,3223,6,8,1,1,1,3,Lost
29489,1533,6,31,1,1,2,4,Lost
29569,61,68,205,5,5,5,15,Champions
29594,423,8,14,3,2,1,6,Casual Users
29818,148,9,62,4,2,3,9,Promising
29959,1555,7,13,1,2,1,4,Lost
30194,32,9,13,5,2,1,8,Promising
30708,136,16,229,4,3,5,12,Loyal Users
31086,49,78,140,5,5,4,14,Champions
31097,147,17,227,4,3,5,12,Loyal Users
31183,403,53,168,3,5,5,13,Loyal Users
31243,720,12,16,2,3,2,7,Casual Users
31247,1787,13,42,1,3,3,7,Casual Users
31506,114,45,64,4,4,4,12,Champions
31729,96,67,299,4,5,5,14,Champions
31767,250,11,39,3,2,3,8,Casual Users
31774,9,8,23,5,2,2,9,Promising
31905,434,14,36,3,3,3,9,Loyal Users
32487,1845,7,9,1,2,1,4,Lost
32505,4635,9,24,1,2,2,5,Lost
32699,832,69,264,2,5,5,12,At Risk
32812,2523,30,105,1,4,4,9,At Risk
33282,1117,37,75,2,4,4,10,At Risk
33284,74,38,81,4,4,4,12,Champions
33342,124,66,163,4,5,5,14,Champions
33520,1,20,31,5,3,2,10,Loyal Users
33548,5219,30,41,1,4,3,8,At Risk
33775,31,51,139,5,5,4,14,Champions
34064,68,128,456,5,5,5,15,Champions
34285,674,14,62,2,3,3,8,Casual Users
34332,30,34,111,5,4,4,13,Champions
34366,94,10,11,4,2,1,7,Promising
34430,107,117,283,4,5,5,14,Champions
34571,159,5,5,4,1,1,6,Promising
34728,3578,5,7,1,1,1,3,Lost
35069,52,72,138,5,5,4,14,Champions
35405,113,113,175,4,5,5,14,Champions
35532,2027,5,9,1,1,1,3,Lost
35613,1534,6,14,1,1,1,3,Lost
35699,84,71,180,4,5,5,14,Champions
35705,18,67,166,5,5,5,15,Champions
36164,820,8,10,2,2,1,5,Lost
36838,274,5,31,3,1,2,6,Casual Users
37189,1882,5,5,1,1,1,3,Lost
37261,161,43,73,4,4,4,12,Champions
37653,234,12,26,3,3,2,8,Loyal Users
37887,273,5,31,3,1,2,6,Casual Users
38251,993,23,66,2,4,4,10,At Risk
38529,963,11,35,2,2,3,7,Lost
38550,675,29,57,2,4,3,9,At Risk
26857,1674,10,23,1,2,2,5,Lost
27875,976,6,12,2,1,1,4,Lost
27906,120,158,371,4,5,5,14,Champions
28195,26,57,144,5,5,4,14,Champions
28602,3036,11,19,1,2,2,5,Lost
28818,794,14,54,2,3,3,8,Casual Users
29164,105,39,162,4,4,5,13,Champions
29182,93,21,148,4,3,5,12,Loyal Users
29186,583,5,8,2,1,1,4,Lost
29307,394,18,37,3,3,3,9,Loyal Users
29393,118,103,271,4,5,5,14,Champions
29443,63,13,38,5,3,3,11,Loyal Users
29476,112,31,238,4,4,5,13,Champions
29821,32,144,428,5,5,5,15,Champions
30065,448,6,19,3,1,2,6,Casual Users
30163,24,7,8,5,2,1,8,Promising
30266,74,18,47,4,3,3,10,Loyal Users
30271,248,10,62,3,2,3,8,Casual Users
30528,232,10,32,3,2,3,8,Casual Users
30567,608,28,81,2,4,4,10,At Risk
30574,687,9,28,2,2,2,6,Lost
30796,260,17,25,3,3,2,8,Loyal Users
30846,300,8,21,3,2,2,7,Casual Users
31015,1040,9,28,2,2,2,6,Lost
31156,1275,5,7,1,1,1,3,Lost
31218,1515,14,19,1,3,2,6,Casual Users
31260,18,8,11,5,2,1,8,Promising
31634,719,8,16,2,2,2,6,Lost
31794,20,12,24,5,3,2,10,Loyal Users
31967,1145,8,15,2,2,1,5,Lost
32193,270,25,69,3,4,4,11,Loyal Users
32200,526,9,13,2,2,1,5,Lost
32368,106,27,131,4,4,4,12,Champions
32442,375,44,102,3,4,4,11,Loyal Users
32504,279,12,16,3,3,2,8,Loyal Users
32565,8,29,117,5,4,4,13,Champions
32771,4398,6,18,1,1,2,4,Lost
33128,1699,7,13,1,2,1,4,Lost
33295,100,22,37,4,4,3,11,Loyal Users
33321,166,11,11,3,2,1,6,Casual Users
33411,124,94,179,4,5,5,14,Champions
33481,589,112,311,2,5,5,12,At Risk
33715,672,13,34,2,3,3,8,Casual Users
34559,393,17,32,3,3,3,9,Loyal Users
34822,0,41,213,5,4,5,14,Champions
34830,822,6,22,2,1,2,5,Lost
34942,111,18,33,4,3,3,10,Loyal Users
34977,2046,16,19,1,3,2,6,Casual Users
35032,9,25,41,5,4,3,12,Loyal Users
35349,4343,15,30,1,3,2,6,Casual Users
35695,157,32,86,4,4,4,12,Champions
35728,4146,21,34,1,3,3,7,Casual Users
36015,420,71,155,3,5,5,13,Loyal Users
36044,137,28,42,4,4,3,11,Loyal Users
36110,99,30,146,4,4,4,12,Champions
36243,34,118,421,5,5,5,15,Champions
36413,136,26,47,4,4,3,11,Loyal Users
36502,8,35,266,5,4,5,14,Champions
36921,569,22,34,2,4,3,9,At Risk
36931,29,104,396,5,5,5,15,Champions
37129,487,85,92,2,5,4,11,At Risk
37287,44,135,393,5,5,5,15,Champions
37456,264,8,41,3,2,3,8,Casual Users
37945,2279,54,154,1,5,5,11,At Risk
38113,283,21,29,3,3,2,8,Loyal Users
38464,0,15,23,5,3,2,10,Loyal Users
38745,87,7,16,4,2,2,8,Promising
38787,725,5,19,2,1,2,5,Lost
39064,185,38,132,3,4,4,11,Loyal Users
39098,114,56,148,4,5,5,14,Champions
26643,15,10,51,5,2,3,10,Promising
26839,410,25,71,3,4,4,11,Loyal Users
26973,98,20,24,4,3,2,9,Loyal Users
26979,1689,14,80,1,3,4,8,Casual Users
27094,416,10,18,3,2,2,7,Casual Users
27152,1395,10,23,1,2,2,5,Lost
28008,860,12,22,2,3,2,7,Casual Users
28182,123,36,58,4,4,3,11,Loyal Users
28308,238,30,125,3,4,4,11,Loyal Users
28330,826,15,43,2,3,3,8,Casual Users
28388,390,14,98,3,3,4,10,Loyal Users
28885,2601,15,29,1,3,2,6,Casual Users
29276,244,8,13,3,2,1,6,Casual Users
29909,691,12,23,2,3,2,7,Casual Users
30040,704,8,14,2,2,1,5,Lost
30425,14,12,26,5,3,2,10,Loyal Users
30817,1257,8,21,2,2,2,6,Lost
30991,551,10,10,2,2,1,5,Lost
31216,5018,14,15,1,3,1,5,Casual Users
31998,2083,25,33,1,4,3,8,At Risk
32391,797,43,90,2,4,4,10,At Risk
32544,1525,14,49,1,3,3,7,Casual Users
32563,233,52,238,3,5,5,13,Loyal Users
32723,114,54,136,4,5,4,13,Champions
32768,1436,9,18,1,2,2,5,Lost
33035,511,37,87,2,4,4,10,At Risk
33133,1138,5,6,2,1,1,4,Lost
33470,1607,7,9,1,2,1,4,Lost
33533,861,17,22,2,3,2,7,Casual Users
33947,1008,5,18,2,1,2,5,Lost
34307,38,111,348,5,5,5,15,Champions
34747,150,29,149,4,4,5,13,Champions
35395,2578,8,14,1,2,1,4,Lost
35553,121,166,313,4,5,5,14,Champions
35857,2355,5,9,1,1,1,3,Lost
35913,2151,6,16,1,1,2,4,Lost
36096,5538,11,34,1,2,3,6,Lost
36207,794,5,16,2,1,2,5,Lost
36437,17,15,57,5,3,3,11,Loyal Users
36664,3402,11,12,1,2,1,4,Lost
37073,1517,12,17,1,3,2,6,Casual Users
37095,5,26,51,5,4,3,12,Loyal Users
37321,23,39,95,5,4,4,13,Champions
37462,124,49,117,4,5,4,13,Champions
38318,868,6,16,2,1,2,5,Lost
38618,3393,5,12,1,1,1,3,Lost
38650,462,14,31,3,3,2,8,Loyal Users
38819,24,15,73,5,3,4,12,Loyal Users
26592,967,14,35,2,3,3,8,Casual Users
26657,107,141,224,4,5,5,14,Champions
26941,123,12,40,4,3,3,10,Loyal Users
27279,249,15,45,3,3,3,9,Loyal Users
27409,2996,25,137,1,4,4,9,At Risk
27716,385,15,125,3,3,4,10,Loyal Users
27724,23,78,483,5,5,5,15,Champions
27814,130,18,67,4,3,4,11,Loyal Users
27833,3243,5,8,1,1,1,3,Lost
27955,1150,11,24,2,2,2,6,Lost
28095,0,44,94,5,4,4,13,Champions
28292,146,13,42,4,3,3,10,Loyal Users
28353,131,17,20,4,3,2,9,Loyal Users
28459,995,5,6,2,1,1,4,Lost
28484,162,95,364,4,5,5,14,Champions
28880,1849,13,33,1,3,3,7,Casual Users
29416,568,5,5,2,1,1,4,Lost
29616,91,139,335,4,5,5,14,Champions
29699,3707,5,15,1,1,1,3,Lost
30179,110,50,110,4,5,4,13,Champions
30323,827,13,55,2,3,3,8,Casual Users
31127,475,8,14,2,2,1,5,Lost
31242,88,8,11,4,2,1,7,Promising
31508,158,9,12,4,2,1,7,Promising
31608,389,8,18,3,2,2,7,Casual Users
31696,870,20,95,2,3,4,9,Casual Users
31775,1,38,68,5,4,4,13,Champions
31809,1,20,80,5,3,4,12,Loyal Users
32043,81,43,79,4,4,4,12,Champions
32732,16,10,34,5,2,3,10,Promising
32935,419,16,26,3,3,2,8,Loyal Users
33120,870,11,22,2,2,2,6,Lost
33185,224,27,94,3,4,4,11,Loyal Users
33190,135,44,105,4,4,4,12,Champions
33251,1539,6,15,1,1,1,3,Lost
33719,7,35,85,5,4,4,13,Champions
33847,1948,9,19,1,2,2,5,Lost
33970,2,80,198,5,5,5,15,Champions
34069,1455,8,15,1,2,1,4,Lost
34527,113,82,258,4,5,5,14,Champions
34629,285,32,39,3,4,3,10,Loyal Users
34673,27,83,301,5,5,5,15,Champions
34719,99,37,80,4,4,4,12,Champions
34982,1388,28,79,1,4,4,9,At Risk
35132,1086,17,53,2,3,3,8,Casual Users
35152,3936,7,12,1,2,1,4,Lost
35209,207,43,203,3,4,5,12,Loyal Users
35360,120,44,141,4,4,4,12,Champions
35537,12,55,98,5,5,4,14,Champions
35966,79,26,31,4,4,2,10,Loyal Users
36185,1152,9,13,2,2,1,5,Lost
36427,41,25,80,5,4,4,13,Champions
36519,175,20,55,3,3,3,9,Loyal Users
36546,23,31,86,5,4,4,13,Champions
36756,701,7,16,2,2,2,6,Lost
36831,13,5,16,5,1,2,8,Promising
37140,24,28,112,5,4,4,13,Champions
37877,2806,9,23,1,2,2,5,Lost
37943,657,5,6,2,1,1,4,Lost
37986,44,166,487,5,5,5,15,Champions
37988,96,37,82,4,4,4,12,Champions
38334,1706,7,12,1,2,1,4,Lost
38354,832,55,133,2,5,4,11,At Risk
38413,247,27,58,3,4,3,10,Loyal Users
38429,5,12,21,5,3,2,10,Loyal Users
38961,46,43,97,5,4,4,13,Champions
26852,1067,7,16,2,2,2,6,Lost
27095,1134,7,16,2,2,2,6,Lost
27127,42,110,420,5,5,5,15,Champions
27268,1951,8,9,1,2,1,4,Lost
27303,255,72,253,3,5,5,13,Loyal Users
27343,14,19,142,5,3,4,12,Loyal Users
27358,119,26,65,4,4,4,12,Champions
27566,35,21,35,5,3,3,11,Loyal Users
27614,6,49,88,5,5,4,14,Champions
27706,6,114,318,5,5,5,15,Champions
27810,1379,5,8,1,1,1,3,Lost
28193,531,19,50,2,3,3,8,Casual Users
28574,73,63,435,4,5,5,14,Champions
28785,2223,6,12,1,1,1,3,Lost
29137,1392,31,179,1,4,5,10,At Risk
29404,106,23,110,4,4,4,12,Champions
29750,130,32,174,4,4,5,13,Champions
29815,137,6,22,4,1,2,7,Promising
29880,654,6,10,2,1,1,4,Lost
30510,574,37,65,2,4,4,10,At Risk
30587,139,8,47,4,2,3,9,Promising
30790,3477,24,98,1,4,4,9,At Risk
30841,90,43,171,4,4,5,13,Champions
30876,2357,6,7,1,1,1,3,Lost
30906,248,9,9,3,2,1,6,Casual Users
31007,1077,23,96,2,4,4,10,At Risk
31294,122,18,38,4,3,3,10,Loyal Users
31450,15,137,317,5,5,5,15,Champions
31503,351,9,18,3,2,2,7,Casual Users
31642,976,7,19,2,2,2,6,Lost
31762,18,45,212,5,4,5,14,Champions
32017,1244,16,22,2,3,2,7,Casual Users
32078,2286,6,9,1,1,1,3,Lost
32223,992,8,15,2,2,1,5,Lost
32315,4,120,334,5,5,5,15,Champions
32779,707,7,38,2,2,3,7,Lost
33030,4033,5,8,1,1,1,3,Lost
33088,411,7,13,3,2,1,6,Casual Users
33407,160,70,236,4,5,5,14,Champions
33512,75,176,654,4,5,5,14,Champions
33766,837,7,99,2,2,4,8,Lost
33888,301,53,110,3,5,4,12,Loyal Users
34087,150,60,108,4,5,4,13,Champions
34326,397,12,19,3,3,2,8,Loyal Users
34415,263,20,50,3,3,3,9,Loyal Users
34546,2044,7,8,1,2,1,4,Lost
34558,1873,11,109,1,2,4,7,Lost
34669,2483,6,11,1,1,1,3,Lost
34855,148,73,164,4,5,5,14,Champions
35096,370,37,61,3,4,3,10,Loyal Users
35118,65,20,87,5,3,4,12,Loyal Users
35343,432,15,17,3,3,2,8,Loyal Users
35418,850,8,15,2,2,1,5,Lost
35521,3695,23,54,1,4,3,8,At Risk
35731,17,62,713,5,5,5,15,Champions
36246,2916,92,366,1,5,5,11,At Risk
36458,405,6,8,3,1,1,5,Casual Users
36669,885,17,33,2,3,3,8,Casual Users
36730,1280,12,23,1,3,2,6,Casual Users
37017,121,22,58,4,4,3,11,Loyal Users
37202,2546,27,158,1,4,5,10,At Risk
37264,467,5,5,3,1,1,5,Casual Users
37367,470,82,221,3,5,5,13,Loyal Users
37584,404,14,28,3,3,2,8,Loyal Users
37602,24,70,211,5,5,5,15,Champions
37809,610,6,6,2,1,1,4,Lost
38073,1119,10,51,2,2,3,7,Lost
38307,980,7,23,2,2,2,6,Lost
38374,284,21,50,3,3,3,9,Loyal Users
38449,459,8,30,3,2,2,7,Casual Users
38736,13,10,56,5,2,3,10,Promising
38881,408,9,29,3,2,2,7,Casual Users
39039,44,108,450,5,5,5,15,Champions
39210,1,65,111,5,5,4,14,Champions
26559,142,9,14,4,2,1,7,Promising
26656,3819,8,10,1,2,1,4,Lost
26666,79,39,229,4,4,5,13,Champions
26881,45,20,126,5,3,4,12,Loyal Users
27014,132,99,222,4,5,5,14,Champions
27448,309,30,57,3,4,3,10,Loyal Users
27507,2,88,441,5,5,5,15,Champions
27689,112,175,526,4,5,5,14,Champions
27911,85,42,103,4,4,4,12,Champions
28628,109,41,74,4,4,4,12,Champions
28888,2191,7,18,1,2,2,5,Lost
28965,1664,5,11,1,1,1,3,Lost
29073,1311,5,6,1,1,1,3,Lost
29318,3330,7,31,1,2,2,5,Lost
29506,1692,10,21,1,2,2,5,Lost
29617,273,13,33,3,3,3,9,Loyal Users
29792,128,28,91,4,4,4,12,Champions
30138,219,7,14,3,2,1,6,Casual Users
30213,163,8,10,4,2,1,7,Promising
30309,3,20,29,5,3,2,10,Loyal Users
30389,15,62,98,5,5,4,14,Champions
31009,443,7,47,3,2,3,8,Casual Users
31081,493,13,36,2,3,3,8,Casual Users
31446,1829,14,21,1,3,2,6,Casual Users
31598,3965,5,12,1,1,1,3,Lost
31629,63,38,54,5,4,3,12,Loyal Users
31699,2425,13,45,1,3,3,7,Casual Users
31726,130,29,57,4,4,3,11,Loyal Users
32045,158,27,66,4,4,4,12,Champions
32229,259,72,150,3,5,5,13,Loyal Users
32351,275,15,21,3,3,2,8,Loyal Users
32407,352,7,13,3,2,1,6,Casual Users
32944,223,28,51,3,4,3,10,Loyal Users
32949,203,11,84,3,2,4,9,Casual Users
32975,569,8,8,2,2,1,5,Lost
33216,126,52,102,4,5,4,13,Champions
33609,243,7,10,3,2,1,6,Casual Users
33656,421,9,37,3,2,3,8,Casual Users
33744,406,28,47,3,4,3,10,Loyal Users
34146,1059,7,42,2,2,3,7,Lost
34253,303,13,91,3,3,4,10,Loyal Users
34297,62,6,10,5,1,1,7,Promising
34376,84,36,146,4,4,4,12,Champions
34858,446,5,5,3,1,1,5,Casual Users
35199,403,14,27,3,3,2,8,Loyal Users
35200,116,24,77,4,4,4,12,Champions
35212,3659,38,265,1,4,5,10,At Risk
35377,3025,7,37,1,2,3,6,Lost
35404,3434,12,23,1,3,2,6,Casual Users
35617,1243,18,22,2,3,2,7,Casual Users
35749,0,121,527,5,5,5,15,Champions
36250,3,91,206,5,5,5,15,Champions
36297,1312,11,39,1,2,3,6,Lost
36455,3336,6,44,1,1,3,5,Lost
36777,100,13,24,4,3,2,9,Loyal Users
37335,285,21,87,3,3,4,10,Loyal Users
37336,973,5,11,2,1,1,4,Lost
37402,802,11,17,2,2,2,6,Lost
37607,493,8,17,2,2,2,6,Lost
37727,317,13,28,3,3,2,8,Loyal Users
37772,831,14,47,2,3,3,8,Casual Users
38200,1521,13,23,1,3,2,6,Casual Users
38381,758,39,80,2,4,4,10,At Risk
38540,5,14,31,5,3,2,10,Loyal Users
38605,1082,30,113,2,4,4,10,At Risk
38765,149,35,71,4,4,4,12,Champions
39049,25,131,363,5,5,5,15,Champions
26516,961,7,50,2,2,3,7,Lost
26556,2004,14,61,1,3,3,7,Casual Users
26641,263,19,45,3,3,3,9,Loyal Users
26813,125,14,83,4,3,4,11,Loyal Users
26834,132,53,163,4,5,5,14,Champions
27427,2426,8,31,1,2,2,5,Lost
27703,65,65,132,5,5,4,14,Champions
27809,281,8,20,3,2,2,7,Casual Users
27893,250,37,100,3,4,4,11,Loyal Users
27973,850,5,8,2,1,1,4,Lost
28209,3857,24,50,1,4,3,8,At Risk
28258,115,14,41,4,3,3,10,Loyal Users
28335,718,14,26,2,3,2,7,Casual Users
28435,153,10,27,4,2,2,8,Promising
28626,675,7,11,2,2,1,5,Lost
28685,1131,6,19,2,1,2,5,Lost
28920,35,61,96,5,5,4,14,Champions
29066,285,20,36,3,3,3,9,Loyal Users
29152,3745,5,10,1,1,1,3,Lost
29156,1,48,116,5,5,4,14,Champions
29421,1891,15,29,1,3,2,6,Casual Users
29433,93,53,107,4,5,4,13,Champions
30181,102,153,955,4,5,5,14,Champions
30338,2035,6,8,1,1,1,3,Lost
30527,49,32,110,5,4,4,13,Champions
30530,13,89,246,5,5,5,15,Champions
30630,455,15,59,3,3,3,9,Loyal Users
30696,109,6,45,4,1,3,8,Promising
30808,438,16,24,3,3,2,8,Loyal Users
30854,4880,18,18,1,3,2,6,Casual Users
31052,563,53,396,2,5,5,12,At Risk
31344,94,17,28,4,3,2,9,Loyal Users
31360,1966,10,14,1,2,1,4,Lost
31460,393,6,34,3,1,3,7,Casual Users
31831,56,51,195,5,5,5,15,Champions
32050,75,32,83,4,4,4,12,Champions
32104,51,36,54,5,4,3,12,Loyal Users
32238,469,69,269,3,5,5,13,Loyal Users
32402,13,105,348,5,5,5,15,Champions
32479,837,37,133,2,4,4,10,At Risk
32490,299,20,126,3,3,4,10,Loyal Users
32499,731,111,457,2,5,5,12,At Risk
32724,253,37,60,3,4,3,10,Loyal Users
32920,22,160,362,5,5,5,15,Champions
32932,123,180,347,4,5,5,14,Champions
33082,1252,26,89,2,4,4,10,At Risk
33168,1668,10,39,1,2,3,6,Lost
33304,121,44,266,4,4,5,13,Champions
33419,2416,16,103,1,3,4,8,Casual Users
33674,736,11,88,2,2,4,8,Lost
34434,697,15,50,2,3,3,8,Casual Users
34782,349,80,508,3,5,5,13,Loyal Users
34938,17,75,111,5,5,4,14,Champions
35030,203,38,81,3,4,4,11,Loyal Users
35077,844,8,75,2,2,4,8,Lost
35144,160,21,55,4,3,3,10,Loyal Users
35198,200,5,6,3,1,1,5,Casual Users
35493,2691,11,22,1,2,2,5,Lost
35813,203,22,37,3,4,3,10,Loyal Users
35885,2515,6,9,1,1,1,3,Lost
36032,434,49,131,3,5,4,12,Loyal Users
36057,824,27,82,2,4,4,10,At Risk
36089,470,8,36,3,2,3,8,Casual Users
36216,284,23,39,3,4,3,10,Loyal Users
36279,175,5,27,3,1,2,6,Casual Users
36316,453,14,39,3,3,3,9,Loyal Users
36518,1230,14,66,2,3,4,9,Casual Users
36663,1540,8,8,1,2,1,4,Lost
36708,606,12,27,2,3,2,7,Casual Users
36933,0,84,145,5,5,4,14,Champions
37030,136,124,221,4,5,5,14,Champions
37477,4961,5,8,1,1,1,3,Lost
37834,3340,7,31,1,2,2,5,Lost
37866,14,28,45,5,4,3,12,Loyal Users
37867,1697,12,23,1,3,2,6,Casual Users
37944,28,21,84,5,3,4,12,Loyal Users
38198,1197,11,14,2,2,1,5,Lost
38463,394,105,366,3,5,5,13,Loyal Users
39224,91,85,162,4,5,5,14,Champions
39235,2958,10,35,1,2,3,6,Lost
26738,18,37,135,5,4,4,13,Champions
26816,2016,11,44,1,2,3,6,Lost
26883,34,15,28,5,3,2,10,Loyal Users
26959,94,26,41,4,4,3,11,Loyal Users
27075,5473,11,21,1,2,2,5,Lost
27086,980,19,66,2,3,4,9,Casual Users
27320,3126,8,11,1,2,1,4,Lost
27575,1127,5,6,2,1,1,4,Lost
27586,865,7,24,2,2,2,6,Lost
27925,59,34,207,5,4,5,14,Champions
27926,10,160,455,5,5,5,15,Champions
28196,168,42,79,3,4,4,11,Loyal Users
28303,190,27,83,3,4,4,11,Loyal Users
28401,232,29,208,3,4,5,12,Loyal Users
28403,3135,17,49,1,3,3,7,Casual Users
28405,708,9,21,2,2,2,6,Lost
28444,162,35,128,4,4,4,12,Champions
28446,136,17,28,4,3,2,9,Loyal Users
28586,1378,27,36,1,4,3,8,At Risk
28668,485,17,56,2,3,3,8,Casual Users
29345,118,5,5,4,1,1,6,Promising
30124,738,15,41,2,3,3,8,Casual Users
30307,543,210,645,2,5,5,12,At Risk
30429,551,21,84,2,3,4,9,Casual Users
30682,5012,5,6,1,1,1,3,Lost
31058,685,34,75,2,4,4,10,At Risk
31099,21,21,44,5,3,3,11,Loyal Users
31497,685,21,106,2,3,4,9,Casual Users
31518,841,7,24,2,2,2,6,Lost
32212,384,9,15,3,2,1,6,Casual Users
32249,340,27,107,3,4,4,11,Loyal Users
32432,2477,5,5,1,1,1,3,Lost
33081,293,8,17,3,2,2,7,Casual Users
33392,181,90,595,3,5,5,13,Loyal Users
33522,0,55,111,5,5,4,14,Champions
33939,195,67,172,3,5,5,13,Loyal Users
33983,618,26,74,2,4,4,10,At Risk
34149,503,23,123,2,4,4,10,At Risk
34410,557,21,41,2,3,3,8,Casual Users
34462,189,5,20,3,1,2,6,Casual Users
35160,2728,5,11,1,1,1,3,Lost
35413,84,52,353,4,5,5,14,Champions
35421,1587,12,34,1,3,3,7,Casual Users
35644,1,44,86,5,4,4,13,Champions
35744,614,28,63,2,4,4,10,At Risk
35781,1221,6,44,2,1,3,6,Lost
35892,17,7,8,5,2,1,8,Promising
35987,514,42,86,2,4,4,10,At Risk
36141,475,27,57,2,4,3,9,At Risk
36760,322,17,50,3,3,3,9,Loyal Users
37042,30,9,83,5,2,4,11,Promising
37062,3886,6,14,1,1,1,3,Lost
37084,64,11,33,5,2,3,10,Promising
37105,461,22,50,3,4,3,10,Loyal Users
37358,241,48,177,3,5,5,13,Loyal Users
37553,70,155,247,4,5,5,14,Champions
37695,212,177,398,3,5,5,13,Loyal Users
38012,1751,8,33,1,2,3,6,Lost
38664,497,33,133,2,4,4,10,At Risk
38701,2373,7,33,1,2,3,6,Lost
38751,318,25,148,3,4,5,12,Loyal Users
38875,994,19,32,2,3,3,8,Casual Users
26920,25,100,200,5,5,5,15,Champions
26946,402,23,60,3,4,3,10,Loyal Users
27048,3,47,180,5,5,5,15,Champions
27068,1320,28,102,1,4,4,9,At Risk
27157,674,11,14,2,2,1,5,Lost
27416,116,18,52,4,3,3,10,Loyal Users
27679,534,6,14,2,1,1,4,Lost
28016,416,5,23,3,1,2,6,Casual Users
28081,621,6,13,2,1,1,4,Lost
28168,16,39,193,5,4,5,14,Champions
28322,803,24,52,2,4,3,9,At Risk
29032,105,60,122,4,5,4,13,Champions
29131,130,182,649,4,5,5,14,Champions
29405,561,5,16,2,1,2,5,Lost
29611,888,11,48,2,2,3,7,Lost
29806,390,14,27,3,3,2,8,Loyal Users
29869,859,20,57,2,3,3,8,Casual Users
30196,95,5,13,4,1,1,6,Promising
30365,9,15,22,5,3,2,10,Loyal Users
30997,86,13,83,4,3,4,11,Loyal Users
31333,8,70,272,5,5,5,15,Champions
31744,443,8,13,3,2,1,6,Casual Users
31844,355,32,161,3,4,5,12,Loyal Users
32105,238,71,287,3,5,5,13,Loyal Users
32631,183,52,69,3,5,4,12,Loyal Users
32797,265,44,94,3,4,4,11,Loyal Users
32874,376,69,115,3,5,4,12,Loyal Users
32887,375,26,194,3,4,5,12,Loyal Users
32996,9,48,173,5,5,5,15,Champions
33009,135,13,105,4,3,4,11,Loyal Users
33066,675,7,8,2,2,1,5,Lost
33119,306,9,14,3,2,1,6,Casual Users
33447,39,20,33,5,3,3,11,Loyal Users
33592,572,52,79,2,5,4,11,At Risk
33664,515,7,16,2,2,2,6,Lost
34702,2442,32,81,1,4,4,9,At Risk
35245,158,14,24,4,3,2,9,Loyal Users
35303,114,73,106,4,5,4,13,Champions
35559,1818,10,13,1,2,1,4,Lost
35727,78,138,499,4,5,5,14,Champions
35771,28,21,40,5,3,3,11,Loyal Users
35932,1944,25,59,1,4,3,8,At Risk
35949,1389,46,78,1,5,4,10,At Risk
35953,418,36,101,3,4,4,11,Loyal Users
36436,595,19,49,2,3,3,8,Casual Users
36557,220,19,74,3,3,4,10,Loyal Users
36612,396,15,48,3,3,3,9,Loyal Users
36799,235,87,129,3,5,4,12,Loyal Users
36871,965,9,20,2,2,2,6,Lost
37446,67,95,245,5,5,5,15,Champions
37574,86,88,172,4,5,5,14,Champions
37742,5,84,175,5,5,5,15,Champions
38243,5808,5,5,1,1,1,3,Lost
38263,262,21,56,3,3,3,9,Loyal Users
38285,1531,6,13,1,1,1,3,Lost
38818,268,21,49,3,3,3,9,Loyal Users
39072,104,55,153,4,5,5,14,Champions
39112,95,32,42,4,4,3,11,Loyal Users
39141,422,11,44,3,2,3,8,Casual Users
27224,258,8,17,3,2,2,7,Casual Users
27601,688,32,43,2,4,3,9,At Risk
27896,494,10,19,2,2,2,6,Lost
28149,155,89,105,4,5,4,13,Champions
28351,3531,6,65,1,1,4,6,Lost
28368,117,6,7,4,1,1,6,Promising
28399,800,17,27,2,3,2,7,Casual Users
28820,273,38,137,3,4,4,11,Loyal Users
28841,115,29,53,4,4,3,11,Loyal Users
28886,300,7,12,3,2,1,6,Casual Users
29071,813,29,50,2,4,3,9,At Risk
29636,435,10,76,3,2,4,9,Casual Users
29677,833,23,34,2,4,3,9,At Risk
29860,12,12,20,5,3,2,10,Loyal Users
30018,99,17,31,4,3,2,9,Loyal Users
30071,1428,9,11,1,2,1,4,Lost
30130,61,33,93,5,4,4,13,Champions
30142,569,6,27,2,1,2,5,Lost
30276,3540,10,11,1,2,1,4,Lost
30376,130,32,136,4,4,4,12,Champions
30489,14,42,148,5,4,5,14,Champions
30546,28,37,277,5,4,5,14,Champions
30679,120,23,36,4,4,3,11,Loyal Users
31051,301,27,45,3,4,3,10,Loyal Users
31944,164,41,57,4,4,3,11,Loyal Users
32441,278,18,22,3,3,2,8,Loyal Users
32450,537,14,45,2,3,3,8,Casual Users
32512,3262,28,152,1,4,5,10,At Risk
33363,13,112,370,5,5,5,15,Champions
33423,415,13,19,3,3,2,8,Loyal Users
33938,77,48,151,4,5,5,14,Champions
33944,735,17,137,2,3,4,9,Casual Users
34038,516,5,8,2,1,1,4,Lost
34057,110,40,62,4,4,3,11,Loyal Users
34080,312,16,36,3,3,3,9,Loyal Users
34209,4736,12,60,1,3,3,7,Casual Users
34351,166,25,54,3,4,3,10,Loyal Users
34444,3966,7,18,1,2,2,5,Lost
34646,272,50,85,3,5,4,12,Loyal Users
35062,582,11,29,2,2,2,6,Lost
35195,30,11,46,5,2,3,10,Promising
35484,138,121,242,4,5,5,14,Champions
35570,79,22,78,4,4,4,12,Champions
35837,4509,11,14,1,2,1,4,Lost
35871,41,41,163,5,4,5,14,Champions
36848,494,85,116,2,5,4,11,At Risk
37059,126,26,50,4,4,3,11,Loyal Users
37108,154,21,262,4,3,5,12,Loyal Users
37168,279,5,7,3,1,1,5,Casual Users
37182,0,35,137,5,4,4,13,Champions
37466,103,19,69,4,3,4,11,Loyal Users
37645,392,49,82,3,5,4,12,Loyal Users
37677,1349,31,86,1,4,4,9,At Risk
37873,416,7,16,3,2,2,7,Casual Users
37934,60,10,42,5,2,3,10,Promising
37975,153,85,205,4,5,5,14,Champions
38202,134,40,71,4,4,4,12,Champions
38314,273,31,59,3,4,3,10,Loyal Users
38538,3859,12,65,1,3,4,8,Casual Users
38543,378,29,112,3,4,4,11,Loyal Users
38583,829,20,33,2,3,3,8,Casual Users
38687,37,66,148,5,5,5,15,Champions
26686,4654,6,9,1,1,1,3,Lost
26871,291,15,32,3,3,3,9,Loyal Users
27321,919,6,8,2,1,1,4,Lost
27686,3561,16,28,1,3,2,6,Casual Users
28282,65,36,64,5,4,4,13,Champions
28402,103,40,158,4,4,5,13,Champions
28538,1,95,186,5,5,5,15,Champions
28633,3610,24,86,1,4,4,9,At Risk
28757,1822,39,48,1,4,3,8,At Risk
29036,29,112,402,5,5,5,15,Champions
29537,134,7,14,4,2,1,7,Promising
29723,830,5,12,2,1,1,4,Lost
29964,767,15,68,2,3,4,9,Casual Users
30192,433,19,59,3,3,3,9,Loyal Users
30758,5556,5,6,1,1,1,3,Lost
30921,587,8,70,2,2,4,8,Lost
32182,21,84,174,5,5,5,15,Champions
32448,1011,11,25,2,2,2,6,Lost
32720,26,98,410,5,5,5,15,Champions
32741,437,7,28,3,2,2,7,Casual Users
32876,41,162,1119,5,5,5,15,Champions
33262,2863,16,38,1,3,3,7,Casual Users
33314,8,65,252,5,5,5,15,Champions
33504,1551,16,79,1,3,4,8,Casual Users
33574,437,78,263,3,5,5,13,Loyal Users
33617,3,66,159,5,5,5,15,Champions
33949,214,8,13,3,2,1,6,Casual Users
33964,2,28,98,5,4,4,13,Champions
34026,2430,35,70,1,4,4,9,At Risk
34176,18,91,201,5,5,5,15,Champions
34623,611,7,21,2,2,2,6,Lost
34838,3271,7,7,1,2,1,4,Lost
34844,315,69,105,3,5,4,12,Loyal Users
35038,454,43,143,3,4,4,11,Loyal Users
35103,1097,6,21,2,1,2,5,Lost
35231,94,31,78,4,4,4,12,Champions
35278,3644,11,19,1,2,2,5,Lost
35761,1716,37,46,1,4,3,8,At Risk
35960,790,14,56,2,3,3,8,Casual Users
36504,112,6,20,4,1,2,7,Promising
36635,180,8,17,3,2,2,7,Casual Users
38068,365,8,12,3,2,1,6,Casual Users
38500,59,9,9,5,2,1,8,Promising
38657,5136,9,28,1,2,2,5,Lost
38813,531,39,217,2,4,5,11,At Risk
38922,1354,7,15,1,2,1,4,Lost
26503,208,16,52,3,3,3,9,Loyal Users
26932,916,52,154,2,5,5,12,At Risk
27061,833,28,55,2,4,3,9,At Risk
27102,9,70,342,5,5,5,15,Champions
27435,104,42,215,4,4,5,13,Champions
27844,110,60,95,4,5,4,13,Champions
28215,263,12,20,3,3,2,8,Loyal Users
29452,571,9,35,2,2,3,7,Lost
29900,327,16,40,3,3,3,9,Loyal Users
30575,962,5,5,2,1,1,4,Lost
30614,2,10,21,5,2,2,9,Promising
30926,4991,6,11,1,1,1,3,Lost
30950,166,20,180,3,3,5,11,Loyal Users
30959,221,22,135,3,4,4,11,Loyal Users
31019,146,25,94,4,4,4,12,Champions
31464,96,70,309,4,5,5,14,Champions
31496,7,14,32,5,3,3,11,Loyal Users
31701,225,9,25,3,2,2,7,Casual Users
31727,30,34,131,5,4,4,13,Champions
31772,324,16,27,3,3,2,8,Loyal Users
31828,1399,16,20,1,3,2,6,Casual Users
32283,76,5,13,4,1,1,6,Promising
32566,281,19,35,3,3,3,9,Loyal Users
32587,1047,5,8,2,1,1,4,Lost
32633,228,6,26,3,1,2,6,Casual Users
33025,111,45,113,4,4,4,12,Champions
33358,1992,6,27,1,1,2,4,Lost
33477,656,12,38,2,3,3,8,Casual Users
33541,41,7,10,5,2,1,8,Promising
33653,57,24,62,5,4,3,12,Loyal Users
34215,174,51,248,3,5,5,13,Loyal Users
34238,517,21,37,2,3,3,8,Casual Users
34257,2474,19,91,1,3,4,8,Casual Users
34396,139,25,157,4,4,5,13,Champions
34687,4604,32,53,1,4,3,8,At Risk
35197,24,61,171,5,5,5,15,Champions
35661,81,16,35,4,3,3,10,Loyal Users
35999,22,177,424,5,5,5,15,Champions
36369,1541,7,62,1,2,3,6,Lost
37169,1173,5,32,2,1,3,6,Lost
37186,1999,13,80,1,3,4,8,Casual Users
37232,157,19,32,4,3,3,10,Loyal Users
37433,870,31,112,2,4,4,10,At Risk
38106,17,23,44,5,4,3,12,Loyal Users
38170,443,5,5,3,1,1,5,Casual Users
38306,441,7,16,3,2,2,7,Casual Users
38405,45,58,130,5,5,4,14,Champions
38530,6,47,123,5,5,4,14,Champions
38561,2594,34,70,1,4,4,9,At Risk
38610,571,8,19,2,2,2,6,Lost
38825,600,8,112,2,2,4,8,Lost
26531,422,17,27,3,3,2,8,Loyal Users
26551,8,28,43,5,4,3,12,Loyal Users
27482,266,7,31,3,2,2,7,Casual Users
27550,421,9,13,3,2,1,6,Casual Users
28152,6046,5,18,1,1,2,4,Lost
28264,273,44,175,3,4,5,12,Loyal Users
28483,405,6,12,3,1,1,5,Casual Users
28703,49,69,157,5,5,5,15,Champions
28722,3,114,228,5,5,5,15,Champions
28748,1663,27,57,1,4,3,8,At Risk
28817,977,5,6,2,1,1,4,Lost
29201,2760,7,19,1,2,2,5,Lost
29216,1279,8,34,1,2,3,6,Lost
29638,247,30,44,3,4,3,10,Loyal Users
29657,20,54,135,5,5,4,14,Champions
29689,0,69,142,5,5,4,14,Champions
30224,309,67,161,3,5,5,13,Loyal Users
30245,121,94,522,4,5,5,14,Champions
30301,2841,13,47,1,3,3,7,Casual Users
30396,73,12,18,4,3,2,9,Loyal Users
30550,397,32,63,3,4,4,11,Loyal Users
30771,478,42,96,2,4,4,10,At Risk
30778,30,8,15,5,2,1,8,Promising
30924,43,114,175,5,5,5,15,Champions
31070,2599,6,28,1,1,2,4,Lost
31100,1542,6,15,1,1,1,3,Lost
31101,1568,8,19,1,2,2,5,Lost
31782,280,34,66,3,4,4,11,Loyal Users
32139,20,29,52,5,4,3,12,Loyal Users
32655,1161,24,46,2,4,3,9,At Risk
32763,384,43,120,3,4,4,11,Loyal Users
33094,293,27,94,3,4,4,11,Loyal Users
33810,133,27,141,4,4,4,12,Champions
33853,263,6,12,3,1,1,5,Casual Users
34260,256,7,9,3,2,1,6,Casual Users
34492,141,26,99,4,4,4,12,Champions
34626,657,29,69,2,4,4,10,At Risk
35428,1285,5,16,1,1,2,4,Lost
35440,24,24,71,5,4,4,13,Champions
35918,117,30,75,4,4,4,12,Champions
36193,59,33,38,5,4,3,12,Loyal Users
36835,2634,7,31,1,2,2,5,Lost
37352,166,70,266,3,5,5,13,Loyal Users
37385,1824,10,19,1,2,2,5,Lost
37568,125,9,39,4,2,3,9,Promising
39007,119,38,77,4,4,4,12,Champions
39063,80,5,15,4,1,1,6,Promising
39107,1826,6,10,1,1,1,3,Lost
39158,2844,12,34,1,3,3,7,Casual Users
39200,257,29,60,3,4,3,10,Loyal Users
26495,1236,21,35,2,3,3,8,Casual Users
26793,2,86,136,5,5,4,14,Champions
27028,4956,7,8,1,2,1,4,Lost
27486,35,107,226,5,5,5,15,Champions
27619,5,18,33,5,3,3,11,Loyal Users
28032,0,64,411,5,5,5,15,Champions
28179,303,72,94,3,5,4,12,Loyal Users
28279,1377,13,56,1,3,3,7,Casual Users
28565,29,18,115,5,3,4,12,Loyal Users
28620,5158,11,11,1,2,1,4,Lost
28683,8,20,41,5,3,3,11,Loyal Users
28940,81,159,361,4,5,5,14,Champions
29133,111,16,28,4,3,2,9,Loyal Users
29284,4633,7,24,1,2,2,5,Lost
29398,90,8,14,4,2,1,7,Promising
29928,1261,6,8,1,1,1,3,Lost
30099,541,13,26,2,3,2,7,Casual Users
30173,301,34,55,3,4,3,10,Loyal Users
30210,665,6,7,2,1,1,4,Lost
30774,1159,29,40,2,4,3,9,At Risk
31032,1807,10,10,1,2,1,4,Lost
31274,863,14,40,2,3,3,8,Casual Users
31427,691,5,5,2,1,1,4,Lost
31459,977,8,13,2,2,1,5,Lost
31658,333,43,117,3,4,4,11,Loyal Users
31742,29,8,19,5,2,2,9,Promising
31867,409,20,100,3,3,4,10,Loyal Users
32077,177,22,81,3,4,4,11,Loyal Users
32127,56,69,426,5,5,5,15,Champions
32280,49,94,300,5,5,5,15,Champions
32377,212,37,84,3,4,4,11,Loyal Users
32880,1710,5,8,1,1,1,3,Lost
33019,37,47,80,5,5,4,14,Champions
33585,418,22,76,3,4,4,11,Loyal Users
33699,881,8,13,2,2,1,5,Lost
34724,172,8,34,3,2,3,8,Casual Users
35061,458,55,141,3,5,4,12,Loyal Users
35101,1259,6,13,1,1,1,3,Lost
35301,2378,16,20,1,3,2,6,Casual Users
35429,445,6,24,3,1,2,6,Casual Users
35544,133,81,137,4,5,4,13,Champions
35819,39,14,19,5,3,2,10,Loyal Users
35835,15,86,234,5,5,5,15,Champions
35845,839,7,17,2,2,2,6,Lost
35881,34,137,333,5,5,5,15,Champions
36013,905,15,26,2,3,2,7,Casual Users
36122,13,94,232,5,5,5,15,Champions
36448,521,8,53,2,2,3,7,Lost
36806,1704,6,27,1,1,2,4,Lost
36837,64,61,130,5,5,4,14,Champions
37382,94,21,33,4,3,3,10,Loyal Users
37460,266,35,79,3,4,4,11,Loyal Users
37860,144,8,18,4,2,2,8,Promising
37999,838,26,51,2,4,3,9,At Risk
38454,223,6,6,3,1,1,5,Casual Users
38511,51,68,390,5,5,5,15,Champions
38799,242,19,22,3,3,2,8,Loyal Users
38870,8,24,135,5,4,4,13,Champions
38955,1174,7,7,2,2,1,5,Lost
38988,448,37,174,3,4,5,12,Loyal Users
39150,125,38,139,4,4,4,12,Champions
39223,691,8,16,2,2,2,6,Lost
26677,48,29,46,5,4,3,12,Loyal Users
26731,4141,7,21,1,2,2,5,Lost
26885,5447,5,6,1,1,1,3,Lost
27257,1072,22,48,2,4,3,9,At Risk
27458,826,14,97,2,3,4,9,Casual Users
27492,1431,45,72,1,4,4,9,At Risk
27592,394,45,103,3,4,4,11,Loyal Users
27676,709,6,10,2,1,1,4,Lost
27695,101,92,265,4,5,5,14,Champions
28013,694,33,46,2,4,3,9,At Risk
28046,3312,13,15,1,3,1,5,Casual Users
28512,52,9,13,5,2,1,8,Promising
28536,165,6,12,4,1,1,6,Promising
28629,1019,43,220,2,4,5,11,At Risk
28779,131,20,22,4,3,2,9,Loyal Users
28810,3116,21,102,1,3,4,8,Casual Users
29101,504,7,14,2,2,1,5,Lost
29682,271,14,62,3,3,3,9,Loyal Users
29702,1836,13,29,1,3,2,6,Casual Users
30068,3,19,92,5,3,4,12,Loyal Users
30391,63,105,157,5,5,5,15,Champions
30531,24,16,77,5,3,4,12,Loyal Users
30646,5118,6,19,1,1,2,4,Lost
31130,66,108,389,5,5,5,15,Champions
31492,397,18,58,3,3,3,9,Loyal Users
31879,87,23,69,4,4,4,12,Champions
32079,543,60,136,2,5,4,11,At Risk
32090,422,10,147,3,2,5,10,Casual Users
32148,387,23,72,3,4,4,11,Loyal Users
32178,833,14,41,2,3,3,8,Casual Users
32358,676,5,26,2,1,2,5,Lost
32602,1561,5,30,1,1,2,4,Lost
32612,111,9,10,4,2,1,7,Promising
32696,390,19,20,3,3,2,8,Loyal Users
32711,33,77,118,5,5,4,14,Champions
32731,1085,8,8,2,2,1,5,Lost
32925,1278,14,19,1,3,2,6,Casual Users
33002,2,129,173,5,5,5,15,Champions
33105,123,160,265,4,5,5,14,Champions
33318,658,14,40,2,3,3,8,Casual Users
33339,125,72,278,4,5,5,14,Champions
33439,353,16,29,3,3,2,8,Loyal Users
33461,1140,18,35,2,3,3,8,Casual Users
33543,418,7,18,3,2,2,7,Casual Users
33599,1415,5,8,1,1,1,3,Lost
34073,31,32,56,5,4,3,12,Loyal Users
34502,97,73,121,4,5,4,13,Champions
35563,31,59,218,5,5,5,15,Champions
35941,479,10,56,2,2,3,7,Lost
36182,44,56,646,5,5,5,15,Champions
36209,1942,8,17,1,2,2,5,Lost
36381,427,9,9,3,2,1,6,Casual Users
36414,152,20,37,4,3,3,10,Loyal Users
36634,208,34,127,3,4,4,11,Loyal Users
36702,7,87,140,5,5,4,14,Champions
37113,1463,8,18,1,2,2,5,Lost
37439,7,76,277,5,5,5,15,Champions
37442,3748,8,41,1,2,3,6,Lost
37797,1750,11,11,1,2,1,4,Lost
37815,4080,7,8,1,2,1,4,Lost
38056,66,21,26,5,3,2,10,Loyal Users
38062,180,22,45,3,4,3,10,Loyal Users
38091,36,101,221,5,5,5,15,Champions
38103,2,15,123,5,3,4,12,Loyal Users
38213,72,28,62,4,4,3,11,Loyal Users
38301,4255,6,10,1,1,1,3,Lost
38392,8,63,149,5,5,5,15,Champions
38440,167,5,7,3,1,1,5,Casual Users
38476,402,8,10,3,2,1,6,Casual Users
38716,1112,187,276,2,5,5,12,At Risk
26691,1,87,277,5,5,5,15,Champions
26800,28,18,49,5,3,3,11,Loyal Users
26807,1855,5,8,1,1,1,3,Lost
27038,5462,16,19,1,3,2,6,Casual Users
27059,45,13,21,5,3,2,10,Loyal Users
27169,115,18,35,4,3,3,10,Loyal Users
27436,425,37,123,3,4,4,11,Loyal Users
27469,1588,17,29,1,3,2,6,Casual Users
27572,2232,5,10,1,1,1,3,Lost
27712,388,14,50,3,3,3,9,Loyal Users
28042,449,8,38,3,2,3,8,Casual Users
28216,3281,15,18,1,3,2,6,Casual Users
28549,1361,33,57,1,4,3,8,At Risk
28828,1607,10,19,1,2,2,5,Lost
28832,282,15,25,3,3,2,8,Loyal Users
28862,6,57,141,5,5,4,14,Champions
29008,49,26,105,5,4,4,13,Champions
29193,59,14,40,5,3,3,11,Loyal Users
29383,280,59,194,3,5,5,13,Loyal Users
29536,163,31,56,4,4,3,11,Loyal Users
30088,2382,7,27,1,2,2,5,Lost
30169,4,31,193,5,4,5,14,Champions
30182,273,53,171,3,5,5,13,Loyal Users
30186,18,21,86,5,3,4,12,Loyal Users
30663,18,88,397,5,5,5,15,Champions
31057,81,32,114,4,4,4,12,Champions
31067,156,31,66,4,4,4,12,Champions
31201,1545,6,31,1,1,2,4,Lost
31375,887,7,16,2,2,2,6,Lost
31817,4688,9,14,1,2,1,4,Lost
31965,91,23,118,4,4,4,12,Champions
32005,1005,7,45,2,2,3,7,Lost
32215,300,17,162,3,3,5,11,Loyal Users
32227,132,38,99,4,4,4,12,Champions
32255,3405,5,55,1,1,3,5,Lost
32749,6,9,27,5,2,2,9,Promising
32833,5,24,68,5,4,4,13,Champions
33064,2,8,8,5,2,1,8,Promising
33075,3717,5,5,1,1,1,3,Lost
33110,876,10,16,2,2,2,6,Lost
33134,120,17,200,4,3,5,12,Loyal Users
33135,532,6,8,2,1,1,4,Lost
33756,2139,5,6,1,1,1,3,Lost
33783,1584,12,17,1,3,2,6,Casual Users
33998,5388,14,34,1,3,3,7,Casual Users
34089,102,7,17,4,2,2,8,Promising
34378,954,21,77,2,3,4,9,Casual Users
34409,256,123,321,3,5,5,13,Loyal Users
34563,584,8,22,2,2,2,6,Lost
34595,282,72,231,3,5,5,13,Loyal Users
34654,18,19,60,5,3,3,11,Loyal Users
35004,117,20,22,4,3,2,9,Loyal Users
35220,1460,13,22,1,3,2,6,Casual Users
35412,2274,5,16,1,1,2,4,Lost
35435,4957,6,6,1,1,1,3,Lost
35520,1209,30,57,2,4,3,9,At Risk
35531,145,21,89,4,3,4,11,Loyal Users
35612,605,10,20,2,2,2,6,Lost
35790,10,136,270,5,5,5,15,Champions
36000,110,39,121,4,4,4,12,Champions
36005,580,8,48,2,2,3,7,Lost
36027,161,46,83,4,5,4,13,Champions
36299,1406,6,20,1,1,2,4,Lost
36319,2863,14,130,1,3,4,8,Casual Users
36403,3,37,145,5,4,4,13,Champions
36541,59,64,254,5,5,5,15,Champions
36566,132,7,20,4,2,2,8,Promising
36951,3698,5,5,1,1,1,3,Lost
37387,286,50,131,3,5,4,12,Loyal Users
37394,4820,6,21,1,1,2,4,Lost
37683,13,68,110,5,5,4,14,Champions
37793,1301,13,21,1,3,2,6,Casual Users
37878,1436,10,22,1,2,2,5,Lost
38107,3913,11,11,1,2,1,4,Lost
38168,93,42,59,4,4,3,11,Loyal Users
38629,308,14,171,3,3,5,11,Loyal Users
38683,592,16,54,2,3,3,8,Casual Users
38764,4119,13,16,1,3,2,6,Casual Users
38878,456,31,164,3,4,5,12,Loyal Users
39194,4169,5,6,1,1,1,3,Lost
26587,34,29,111,5,4,4,13,Champions
26640,262,5,11,3,1,1,5,Casual Users
26655,1390,62,195,1,5,5,11,At Risk
26856,82,31,64,4,4,4,12,Champions
27192,554,13,18,2,3,2,7,Casual Users
27351,240,6,8,3,1,1,5,Casual Users
27562,5010,6,8,1,1,1,3,Lost
27616,11,41,47,5,4,3,12,Loyal Users
28394,118,10,17,4,2,2,8,Promising
28903,3,107,340,5,5,5,15,Champions
29018,267,12,67,3,3,4,10,Loyal Users
29325,833,6,6,2,1,1,4,Lost
29460,2885,9,26,1,2,2,5,Lost
29530,280,83,149,3,5,5,13,Loyal Users
29671,665,49,82,2,5,4,11,At Risk
29828,56,197,355,5,5,5,15,Champions
29972,91,75,443,4,5,5,14,Champions
29975,721,29,57,2,4,3,9,At Risk
30051,703,12,29,2,3,2,7,Casual Users
30386,57,8,29,5,2,2,9,Promising
30387,111,13,36,4,3,3,10,Loyal Users
30551,1639,7,9,1,2,1,4,Lost
30555,95,16,50,4,3,3,10,Loyal Users
30957,1760,5,23,1,1,2,4,Lost
30998,179,35,116,3,4,4,11,Loyal Users
31712,137,10,23,4,2,2,8,Promising
31852,383,51,69,3,5,4,12,Loyal Users
32161,694,19,30,2,3,2,7,Casual Users
32268,461,13,65,3,3,4,10,Loyal Users
32444,1956,6,6,1,1,1,3,Lost
32635,19,87,168,5,5,5,15,Champions
32820,174,19,49,3,3,3,9,Loyal Users
32933,256,35,162,3,4,5,12,Loyal Users
32934,1168,29,60,2,4,3,9,At Risk
33063,285,12,25,3,3,2,8,Loyal Users
33077,63,27,78,5,4,4,13,Champions
33268,5271,10,25,1,2,2,5,Lost
33623,239,5,13,3,1,1,5,Casual Users
33652,116,81,302,4,5,5,14,Champions
33825,156,5,6,4,1,1,6,Promising
33913,219,27,28,3,4,2,9,Loyal Users
34015,1004,18,55,2,3,3,8,Casual Users
34183,529,9,33,2,2,3,7,Lost
34517,561,24,40,2,4,3,9,At Risk
34721,435,11,20,3,2,2,7,Casual Users
34723,25,113,525,5,5,5,15,Champions
34897,1061,29,78,2,4,4,10,At Risk
35409,264,28,35,3,4,3,10,Loyal Users
35578,1,121,199,5,5,5,15,Champions
35784,460,7,18,3,2,2,7,Casual Users
35914,725,21,52,2,3,3,8,Casual Users
36219,30,38,50,5,4,3,12,Loyal Users
36336,456,23,173,3,4,5,12,Loyal Users
36461,568,6,6,2,1,1,4,Lost
36534,118,51,119,4,5,4,13,Champions
36994,340,11,32,3,2,3,8,Casual Users
37201,645,18,24,2,3,2,7,Casual Users
37749,1478,14,17,1,3,2,6,Casual Users
37826,158,28,198,4,4,5,13,Champions
37929,171,72,131,3,5,4,12,Loyal Users
38245,30,78,106,5,5,4,14,Champions
26714,544,13,53,2,3,3,8,Casual Users
26763,4,185,609,5,5,5,15,Champions
26961,4662,9,23,1,2,2,5,Lost
26980,972,10,17,2,2,2,6,Lost
27113,3112,10,13,1,2,1,4,Lost
27282,4,109,296,5,5,5,15,Champions
27319,2066,11,39,1,2,3,6,Lost
27337,3130,5,43,1,1,3,5,Lost
27395,973,10,16,2,2,2,6,Lost
27867,86,7,15,4,2,1,7,Promising
28407,2081,49,226,1,5,5,11,At Risk
28790,129,5,28,4,1,2,7,Promising
28868,273,34,84,3,4,4,11,Loyal Users
28973,421,67,337,3,5,5,13,Loyal Users
29165,755,5,13,2,1,1,4,Lost
29198,378,23,89,3,4,4,11,Loyal Users
29226,158,32,91,4,4,4,12,Champions
29231,2119,6,20,1,1,2,4,Lost
29238,133,60,215,4,5,5,14,Champions
29829,108,38,307,4,4,5,13,Champions
29846,826,19,50,2,3,3,8,Casual Users
29937,2609,8,21,1,2,2,5,Lost
30039,8,149,528,5,5,5,15,Champions
30199,1,69,277,5,5,5,15,Champions
30221,16,31,203,5,4,5,14,Champions
30242,14,13,21,5,3,2,10,Loyal Users
30351,24,148,589,5,5,5,15,Champions
30454,1737,9,25,1,2,2,5,Lost
30579,369,10,31,3,2,2,7,Casual Users
30685,3485,5,6,1,1,1,3,Lost
30741,1,171,297,5,5,5,15,Champions
31214,959,6,34,2,1,3,6,Lost
31312,775,7,30,2,2,2,6,Lost
31504,322,43,169,3,4,5,12,Loyal Users
31730,130,23,44,4,4,3,11,Loyal Users
31861,120,22,48,4,4,3,11,Loyal Users
32239,1,56,300,5,5,5,15,Champions
32372,646,40,146,2,4,4,10,At Risk
32468,847,6,11,2,1,1,4,Lost
32574,4284,7,11,1,2,1,4,Lost
32647,421,9,13,3,2,1,6,Casual Users
32998,209,5,15,3,1,1,5,Casual Users
33526,71,37,87,4,4,4,12,Champions
33789,1596,27,40,1,4,3,8,At Risk
34288,450,5,39,3,1,3,7,Casual Users
34412,4510,5,14,1,1,1,3,Lost
34597,2524,6,11,1,1,1,3,Lost
34688,238,37,86,3,4,4,11,Loyal Users
34868,118,38,141,4,4,4,12,Champions
34875,153,109,336,4,5,5,14,Champions
35120,2122,5,10,1,1,1,3,Lost
35167,1823,8,9,1,2,1,4,Lost
35221,2491,10,18,1,2,2,5,Lost
35427,29,8,36,5,2,3,10,Promising
35971,1264,15,35,1,3,3,7,Casual Users
36079,115,95,557,4,5,5,14,Champions
36086,413,7,17,3,2,2,7,Casual Users
36258,1082,5,5,2,1,1,4,Lost
36362,1899,21,25,1,3,2,6,Casual Users
36484,759,11,19,2,2,2,6,Lost
36535,842,17,30,2,3,2,7,Casual Users
36919,0,89,491,5,5,5,15,Champions
37197,74,16,29,4,3,2,9,Loyal Users
37548,147,27,73,4,4,4,12,Champions
37740,95,33,148,4,4,5,13,Champions
37781,246,34,243,3,4,5,12,Loyal Users
38239,3,22,90,5,4,4,13,Champions
38299,119,14,19,4,3,2,9,Loyal Users
38366,44,99,261,5,5,5,15,Champions
38590,3566,5,32,1,1,3,5,Lost
38731,176,7,8,3,2,1,6,Casual Users
38750,1939,6,9,1,1,1,3,Lost
38905,890,18,25,2,3,2,7,Casual Users
39205,298,12,23,3,3,2,8,Loyal Users
26527,30,32,104,5,4,4,13,Champions
26638,34,56,121,5,5,4,14,Champions
26639,1289,7,27,1,2,2,5,Lost
26694,137,29,66,4,4,4,12,Champions
27248,143,53,152,4,5,5,14,Champions
27415,255,47,128,3,5,4,12,Loyal Users
27788,1838,5,21,1,1,2,4,Lost
27842,5418,8,9,1,2,1,4,Lost
27890,1125,5,18,2,1,2,5,Lost
28131,5,49,120,5,5,4,14,Champions
28184,1414,34,37,1,4,3,8,At Risk
28270,577,10,67,2,2,4,8,Lost
28293,169,5,20,3,1,2,6,Casual Users
28802,1957,7,18,1,2,2,5,Lost
28838,543,17,20,2,3,2,7,Casual Users
28890,270,36,68,3,4,4,11,Loyal Users
28904,12,91,133,5,5,4,14,Champions
28935,420,58,186,3,5,5,13,Loyal Users
29162,70,33,78,4,4,4,12,Champions
29508,838,20,52,2,3,3,8,Casual Users
29510,954,21,36,2,3,3,8,Casual Users
29639,2098,7,10,1,2,1,4,Lost
29757,4279,5,24,1,1,2,4,Lost
29854,12,134,792,5,5,5,15,Champions
30200,281,23,32,3,4,3,10,Loyal Users
30314,835,30,55,2,4,3,9,At Risk
30611,123,6,8,4,1,1,6,Promising
30625,2621,10,48,1,2,3,6,Lost
30789,154,55,390,4,5,5,14,Champions
31412,1056,41,60,2,4,3,9,At Risk
31711,37,116,408,5,5,5,15,Champions
31877,1634,7,8,1,2,1,4,Lost
32242,123,12,20,4,3,2,9,Loyal Users
32371,69,119,906,5,5,5,15,Champions
32418,1439,15,31,1,3,2,6,Casual Users
32778,1440,6,14,1,1,1,3,Lost
33089,350,21,79,3,3,4,10,Loyal Users
33372,247,7,14,3,2,1,6,Casual Users
33671,780,14,22,2,3,2,7,Casual Users
33803,1787,8,24,1,2,2,5,Lost
33869,1069,6,27,2,1,2,5,Lost
33881,77,30,137,4,4,4,12,Champions
34347,44,151,287,5,5,5,15,Champions
34662,1702,9,20,1,2,2,5,Lost
34760,1,185,467,5,5,5,15,Champions
34762,4256,5,16,1,1,2,4,Lost
34809,526,12,84,2,3,4,9,Casual Users
34843,4132,6,8,1,1,1,3,Lost
35210,3087,6,24,1,1,2,4,Lost
35367,882,7,118,2,2,4,8,Lost
35657,547,45,90,2,4,4,10,At Risk
35668,69,17,43,5,3,3,11,Loyal Users
35768,1724,5,15,1,1,1,3,Lost
36173,954,19,32,2,3,3,8,Casual Users
36281,73,31,48,4,4,3,11,Loyal Users
36472,136,37,115,4,4,4,12,Champions
36480,68,19,70,5,3,4,12,Loyal Users
36642,1196,15,17,2,3,2,7,Casual Users
37050,1644,10,47,1,2,3,6,Lost
37165,8,62,327,5,5,5,15,Champions
37166,429,28,46,3,4,3,10,Loyal Users
37206,181,32,55,3,4,3,10,Loyal Users
37493,238,58,154,3,5,5,13,Loyal Users
37529,414,17,25,3,3,2,8,Loyal Users
37656,531,9,49,2,2,3,7,Lost
38174,275,20,50,3,3,3,9,Loyal Users
38280,2402,21,63,1,3,4,8,Casual Users
38521,20,124,167,5,5,5,15,Champions
38630,291,36,67,3,4,4,11,Loyal Users
38816,1291,11,108,1,2,4,7,Lost
39086,112,53,77,4,5,4,13,Champions
39523,48,9,37,5,2,3,10,Promising
39713,424,14,26,3,3,2,8,Loyal Users
39756,306,16,32,3,3,3,9,Loyal Users
39786,708,6,13,2,1,1,4,Lost
40207,848,6,25,2,1,2,5,Lost
40431,1023,6,42,2,1,3,6,Lost
41478,20,45,76,5,4,4,13,Champions
41503,4698,6,9,1,1,1,3,Lost
41782,15,21,29,5,3,2,10,Loyal Users
41915,316,39,94,3,4,4,11,Loyal Users
42037,1795,9,15,1,2,1,4,Lost
42127,358,18,30,3,3,2,8,Loyal Users
42370,7,44,126,5,4,4,13,Champions
42707,117,65,298,4,5,5,14,Champions
42742,6,259,361,5,5,5,15,Champions
42786,792,9,31,2,2,2,6,Lost
43176,306,41,204,3,4,5,12,Loyal Users
43320,93,47,212,4,5,5,14,Champions
43582,221,20,42,3,3,3,9,Loyal Users
43636,2246,15,47,1,3,3,7,Casual Users
43806,114,48,161,4,5,5,14,Champions
43848,2,53,211,5,5,5,15,Champions
43944,2356,8,13,1,2,1,4,Lost
43945,1517,8,24,1,2,2,5,Lost
44627,1139,18,88,2,3,4,9,Casual Users
44711,4447,7,20,1,2,2,5,Lost
44773,1205,9,28,2,2,2,6,Lost
44940,143,6,32,4,1,3,8,Promising
45268,83,56,154,4,5,5,14,Champions
45497,242,13,33,3,3,3,9,Loyal Users
45640,449,49,168,3,5,5,13,Loyal Users
45950,1199,18,51,2,3,3,8,Casual Users
46245,1304,5,19,1,1,2,4,Lost
46251,106,6,46,4,1,3,8,Promising
46457,736,22,72,2,4,4,10,At Risk
46877,101,82,257,4,5,5,14,Champions
47143,981,10,21,2,2,2,6,Lost
47467,427,14,97,3,3,4,10,Loyal Users
47519,402,35,141,3,4,4,11,Loyal Users
47849,574,11,16,2,2,2,6,Lost
48857,425,11,25,3,2,2,7,Casual Users
49477,715,5,34,2,1,3,6,Lost
49784,869,20,65,2,3,4,9,Casual Users
50476,347,7,27,3,2,2,7,Casual Users
50701,19,38,62,5,4,3,12,Loyal Users
50996,8,76,272,5,5,5,15,Champions
51180,1423,15,19,1,3,2,6,Casual Users
51419,4150,7,37,1,2,3,6,Lost
52059,1439,12,22,1,3,2,6,Casual Users
39256,56,10,26,5,2,2,9,Promising
39688,433,7,18,3,2,2,7,Casual Users
39897,833,11,76,2,2,4,8,Lost
40196,1820,8,13,1,2,1,4,Lost
40384,275,33,52,3,4,3,10,Loyal Users
40667,783,6,41,2,1,3,6,Lost
41155,429,27,48,3,4,3,10,Loyal Users
41302,103,41,189,4,4,5,13,Champions
41599,451,17,28,3,3,2,8,Loyal Users
41686,1,37,122,5,4,4,13,Champions
42512,3566,8,37,1,2,3,6,Lost
42816,829,27,58,2,4,3,9,At Risk
42980,18,14,45,5,3,3,11,Loyal Users
43080,3,9,22,5,2,2,9,Promising
43434,1410,69,143,1,5,4,10,At Risk
43568,123,26,55,4,4,3,11,Loyal Users
43602,530,11,13,2,2,1,5,Lost
43633,318,9,19,3,2,2,7,Casual Users
43642,822,15,36,2,3,3,8,Casual Users
43830,27,13,28,5,3,2,10,Loyal Users
44150,957,7,12,2,2,1,5,Lost
44414,383,31,154,3,4,5,12,Loyal Users
44629,1755,9,9,1,2,1,4,Lost
44866,1570,8,17,1,2,2,5,Lost
45075,303,5,17,3,1,2,6,Casual Users
45294,551,12,38,2,3,3,8,Casual Users
45541,149,8,50,4,2,3,9,Promising
45738,32,22,71,5,4,4,13,Champions
46225,2574,12,97,1,3,4,8,Casual Users
46751,853,5,11,2,1,1,4,Lost
47071,1958,7,9,1,2,1,4,Lost
47292,14,37,43,5,4,3,12,Loyal Users
47504,24,20,53,5,3,3,11,Loyal Users
47520,351,39,51,3,4,3,10,Loyal Users
47535,407,131,606,3,5,5,13,Loyal Users
47683,696,9,27,2,2,2,6,Lost
47969,426,16,22,3,3,2,8,Loyal Users
48221,126,27,138,4,4,4,12,Champions
48275,369,15,40,3,3,3,9,Loyal Users
48286,91,22,59,4,4,3,11,Loyal Users
48410,2853,9,15,1,2,1,4,Lost
48668,73,72,414,4,5,5,14,Champions
48682,14,55,219,5,5,5,15,Champions
48816,2284,11,50,1,2,3,6,Lost
49037,47,24,104,5,4,4,13,Champions
49285,1846,14,25,1,3,2,6,Casual Users
49309,859,5,8,2,1,1,4,Lost
50079,0,5,15,5,1,1,7,Promising
50104,310,23,46,3,4,3,10,Loyal Users
50221,1481,7,54,1,2,3,6,Lost
50561,102,35,78,4,4,4,12,Champions
50854,126,23,28,4,4,2,10,Loyal Users
51076,1424,9,14,1,2,1,4,Lost
51217,135,43,71,4,4,4,12,Champions
51606,835,13,33,2,3,3,8,Casual Users
51748,833,20,56,2,3,3,8,Casual Users
51883,95,59,114,4,5,4,13,Champions
52319,2622,5,14,1,1,1,3,Lost
52340,1542,35,35,1,4,3,8,At Risk
39258,313,11,30,3,2,2,7,Casual Users
39286,31,116,592,5,5,5,15,Champions
39467,106,29,180,4,4,5,13,Champions
39483,144,59,80,4,5,4,13,Champions
39699,55,26,52,5,4,3,12,Loyal Users
40133,735,11,22,2,2,2,6,Lost
40270,208,11,41,3,2,3,8,Casual Users
40744,127,113,771,4,5,5,14,Champions
40920,24,30,48,5,4,3,12,Loyal Users
40989,236,5,11,3,1,1,5,Casual Users
41117,199,7,96,3,2,4,9,Casual Users
41210,120,58,197,4,5,5,14,Champions
41225,171,27,69,3,4,4,11,Loyal Users
41304,145,41,55,4,4,3,11,Loyal Users
41695,3279,6,40,1,1,3,5,Lost
41877,510,5,10,2,1,1,4,Lost
41888,117,13,22,4,3,2,9,Loyal Users
41933,1343,5,16,1,1,2,4,Lost
42069,13,63,208,5,5,5,15,Champions
42120,113,39,206,4,4,5,13,Champions
42137,124,6,18,4,1,2,7,Promising
42470,714,15,27,2,3,2,7,Casual Users
42883,253,11,14,3,2,1,6,Casual Users
43233,118,7,8,4,2,1,7,Promising
43340,112,6,6,4,1,1,6,Promising
43430,147,110,222,4,5,5,14,Champions
43472,15,95,154,5,5,5,15,Champions
43737,2258,20,67,1,3,4,8,Casual Users
43752,1209,10,22,2,2,2,6,Lost
43895,0,14,24,5,3,2,10,Loyal Users
44158,133,124,361,4,5,5,14,Champions
44161,295,7,8,3,2,1,6,Casual Users
44487,523,16,148,2,3,5,10,Casual Users
44590,893,10,40,2,2,3,7,Lost
44592,333,35,60,3,4,3,10,Loyal Users
44658,380,9,29,3,2,2,7,Casual Users
44755,857,7,19,2,2,2,6,Lost
44826,158,28,68,4,4,4,12,Champions
45235,175,16,21,3,3,2,8,Loyal Users
45253,913,10,13,2,2,1,5,Lost
45310,954,43,135,2,4,4,10,At Risk
46006,8,15,24,5,3,2,10,Loyal Users
46129,3262,6,19,1,1,2,4,Lost
46156,60,79,185,5,5,5,15,Champions
46342,252,35,63,3,4,4,11,Loyal Users
46486,152,37,90,4,4,4,12,Champions
46753,2082,5,16,1,1,2,4,Lost
46941,298,31,119,3,4,4,11,Loyal Users
46999,36,61,330,5,5,5,15,Champions
47184,426,5,12,3,1,1,5,Casual Users
47191,63,38,348,5,4,5,14,Champions
47324,1017,9,28,2,2,2,6,Lost
47488,3636,6,27,1,1,2,4,Lost
47738,14,18,33,5,3,3,11,Loyal Users
47740,507,9,9,2,2,1,5,Lost
48064,9,11,19,5,2,2,9,Promising
48265,529,30,56,2,4,3,9,At Risk
48484,655,15,27,2,3,2,7,Casual Users
48566,2,50,175,5,5,5,15,Champions
48740,280,13,22,3,3,2,8,Loyal Users
48800,574,8,45,2,2,3,7,Lost
48988,851,24,27,2,4,2,8,At Risk
49344,218,28,76,3,4,4,11,Loyal Users
49744,703,6,22,2,1,2,5,Lost
49964,65,12,22,5,3,2,10,Loyal Users
50203,137,18,42,4,3,3,10,Loyal Users
50208,718,48,82,2,5,4,11,At Risk
50327,2026,12,30,1,3,2,6,Casual Users
50395,122,5,18,4,1,2,7,Promising
50667,62,117,596,5,5,5,15,Champions
50740,134,7,10,4,2,1,7,Promising
50762,96,146,689,4,5,5,14,Champions
50944,2817,10,14,1,2,1,4,Lost
51125,518,9,42,2,2,3,7,Lost
51185,35,17,22,5,3,2,10,Loyal Users
51275,5352,6,6,1,1,1,3,Lost
51293,1449,8,10,1,2,1,4,Lost
51449,825,20,157,2,3,5,10,Casual Users
51490,424,6,8,3,1,1,5,Casual Users
51580,3168,5,18,1,1,2,4,Lost
51666,408,16,33,3,3,3,9,Loyal Users
51904,450,9,19,3,2,2,7,Casual Users
51966,3087,5,13,1,1,1,3,Lost
52007,136,5,15,4,1,1,6,Promising
52310,668,21,76,2,3,4,9,Casual Users
52348,2436,13,20,1,3,2,6,Casual Users
39379,190,7,7,3,2,1,6,Casual Users
39466,9,92,614,5,5,5,15,Champions
39559,132,28,111,4,4,4,12,Champions
39643,674,19,28,2,3,2,7,Casual Users
39873,585,11,42,2,2,3,7,Lost
40128,5686,8,34,1,2,3,6,Lost
40309,278,7,7,3,2,1,6,Casual Users
40630,1417,5,12,1,1,1,3,Lost
40793,280,52,74,3,5,4,12,Loyal Users
41388,4594,19,77,1,3,4,8,Casual Users
41480,926,27,38,2,4,3,9,At Risk
41501,1200,11,49,2,2,3,7,Lost
42150,0,16,30,5,3,2,10,Loyal Users
42243,1166,5,9,2,1,1,4,Lost
42421,1590,6,30,1,1,2,4,Lost
42620,1562,5,7,1,1,1,3,Lost
43196,17,12,36,5,3,3,11,Loyal Users
43711,102,15,58,4,3,3,10,Loyal Users
43871,429,9,11,3,2,1,6,Casual Users
44048,1985,18,89,1,3,4,8,Casual Users
44067,2193,7,16,1,2,2,5,Lost
44278,122,17,58,4,3,3,10,Loyal Users
44667,694,16,115,2,3,4,9,Casual Users
45442,3493,15,49,1,3,3,7,Casual Users
45944,416,49,156,3,5,5,13,Loyal Users
45970,172,11,15,3,2,1,6,Casual Users
46071,25,51,101,5,5,4,14,Champions
46287,1177,7,11,2,2,1,5,Lost
46569,320,7,15,3,2,1,6,Casual Users
46626,161,28,93,4,4,4,12,Champions
46673,9,36,242,5,4,5,14,Champions
46747,11,76,376,5,5,5,15,Champions
47165,128,11,100,4,2,4,10,Promising
47196,401,71,252,3,5,5,13,Loyal Users
47356,408,7,55,3,2,3,8,Casual Users
47463,3005,96,169,1,5,5,11,At Risk
47572,124,60,245,4,5,5,14,Champions
47582,473,11,17,2,2,2,6,Lost
48128,837,15,73,2,3,4,9,Casual Users
48240,594,5,68,2,1,4,7,Lost
48417,2597,6,10,1,1,1,3,Lost
48478,10,68,296,5,5,5,15,Champions
48727,841,6,21,2,1,2,5,Lost
48822,62,26,106,5,4,4,13,Champions
48851,31,12,23,5,3,2,10,Loyal Users
48918,165,47,199,4,5,5,14,Champions
49610,390,22,34,3,4,3,10,Loyal Users
49852,291,7,16,3,2,2,7,Casual Users
49948,640,12,23,2,3,2,7,Casual Users
49958,104,24,91,4,4,4,12,Champions
50421,25,28,59,5,4,3,12,Loyal Users
50767,2072,13,19,1,3,2,6,Casual Users
51473,106,56,146,4,5,4,13,Champions
51747,405,38,78,3,4,4,11,Loyal Users
51857,97,28,102,4,4,4,12,Champions
39263,16,57,258,5,5,5,15,Champions
39556,2099,12,76,1,3,4,8,Casual Users
39632,128,15,141,4,3,4,11,Loyal Users
39683,535,5,12,2,1,1,4,Lost
39725,139,14,17,4,3,2,9,Loyal Users
39888,6,58,199,5,5,5,15,Champions
39923,2409,8,21,1,2,2,5,Lost
40149,2,146,677,5,5,5,15,Champions
40455,2579,7,12,1,2,1,4,Lost
41338,4,82,363,5,5,5,15,Champions
41511,137,23,96,4,4,4,12,Champions
41830,418,12,31,3,3,2,8,Loyal Users
41855,525,9,14,2,2,1,5,Lost
41967,24,33,50,5,4,3,12,Loyal Users
42097,13,109,229,5,5,5,15,Champions
42228,406,8,43,3,2,3,8,Casual Users
42230,305,46,237,3,5,5,13,Loyal Users
42326,36,101,152,5,5,5,15,Champions
42367,100,136,195,4,5,5,14,Champions
42554,82,14,57,4,3,3,10,Loyal Users
42597,68,6,29,5,1,2,8,Promising
43113,68,49,115,5,5,4,14,Champions
43145,47,40,58,5,4,3,12,Loyal Users
43186,5,28,31,5,4,2,11,Loyal Users
43742,266,19,35,3,3,3,9,Loyal Users
43917,430,20,55,3,3,3,9,Loyal Users
44376,28,13,32,5,3,3,11,Loyal Users
44513,16,82,147,5,5,5,15,Champions
44526,603,5,31,2,1,2,5,Lost
44533,2698,6,45,1,1,3,5,Lost
44730,102,59,94,4,5,4,13,Champions
44742,255,140,322,3,5,5,13,Loyal Users
44994,982,12,15,2,3,1,6,Casual Users
45003,2978,18,64,1,3,4,8,Casual Users
45315,136,10,55,4,2,3,9,Promising
45537,2563,10,28,1,2,2,5,Lost
45953,970,5,6,2,1,1,4,Lost
46937,484,31,65,2,4,4,10,At Risk
46992,1656,6,56,1,1,3,5,Lost
47578,375,54,105,3,5,4,12,Loyal Users
47916,162,11,19,4,2,2,8,Promising
47925,1723,27,42,1,4,3,8,At Risk
48039,1417,17,19,1,3,2,6,Casual Users
48386,991,5,5,2,1,1,4,Lost
48400,4499,7,12,1,2,1,4,Lost
48428,9,38,218,5,4,5,14,Champions
48720,25,67,230,5,5,5,15,Champions
49131,17,105,241,5,5,5,15,Champions
49222,425,7,15,3,2,1,6,Casual Users
49513,274,10,43,3,2,3,8,Casual Users
49603,43,5,39,5,1,3,9,Promising
49633,241,19,35,3,3,3,9,Loyal Users
49640,1962,7,8,1,2,1,4,Lost
49652,1269,9,14,1,2,1,4,Lost
50019,225,132,418,3,5,5,13,Loyal Users
50181,813,6,16,2,1,2,5,Lost
50255,127,76,139,4,5,4,13,Champions
50373,884,5,8,2,1,1,4,Lost
50502,293,13,23,3,3,2,8,Loyal Users
50552,1458,5,6,1,1,1,3,Lost
50626,144,12,20,4,3,2,9,Loyal Users
50670,2134,12,19,1,3,2,6,Casual Users
51050,3367,5,10,1,1,1,3,Lost
51199,234,69,167,3,5,5,13,Loyal Users
51633,2,11,23,5,2,2,9,Promising
52024,1174,12,18,2,3,2,7,Casual Users
52231,1,76,241,5,5,5,15,Champions
39245,116,145,211,4,5,5,14,Champions
39405,24,176,321,5,5,5,15,Champions
39461,241,16,85,3,3,4,10,Loyal Users
39720,110,106,519,4,5,5,14,Champions
39732,527,6,20,2,1,2,5,Lost
39973,19,110,416,5,5,5,15,Champions
40178,4116,6,7,1,1,1,3,Lost
40881,137,18,40,4,3,3,10,Loyal Users
40895,1314,10,34,1,2,3,6,Lost
41283,126,55,107,4,5,4,13,Champions
41320,1408,9,18,1,2,2,5,Lost
41353,827,11,41,2,2,3,7,Lost
41453,446,8,18,3,2,2,7,Casual Users
41459,35,97,359,5,5,5,15,Champions
41481,276,12,75,3,3,4,10,Loyal Users
41621,39,27,49,5,4,3,12,Loyal Users
41643,362,12,48,3,3,3,9,Loyal Users
41654,10,76,357,5,5,5,15,Champions
41825,9,24,25,5,4,2,11,Loyal Users
42053,92,121,298,4,5,5,14,Champions
42081,20,10,49,5,2,3,10,Promising
42448,123,139,503,4,5,5,14,Champions
42467,102,63,117,4,5,4,13,Champions
42784,487,18,25,2,3,2,7,Casual Users
42880,108,66,130,4,5,4,13,Champions
42908,42,72,381,5,5,5,15,Champions
43061,239,16,52,3,3,3,9,Loyal Users
43901,4395,12,24,1,3,2,6,Casual Users
44017,1553,18,46,1,3,3,7,Casual Users
44034,869,36,68,2,4,4,10,At Risk
44061,118,34,112,4,4,4,12,Champions
44501,806,5,7,2,1,1,4,Lost
44694,18,15,34,5,3,3,11,Loyal Users
44732,7,90,118,5,5,4,14,Champions
45051,431,11,16,3,2,2,7,Casual Users
45113,312,36,78,3,4,4,11,Loyal Users
45335,165,38,56,4,4,3,11,Loyal Users
46234,105,17,77,4,3,4,11,Loyal Users
46309,396,52,139,3,5,4,12,Loyal Users
46412,68,40,77,5,4,4,13,Champions
46571,581,14,23,2,3,2,7,Casual Users
46672,12,91,129,5,5,4,14,Champions
46847,436,14,18,3,3,2,8,Loyal Users
47022,145,26,70,4,4,4,12,Champions
47039,1280,16,26,1,3,2,6,Casual Users
47082,108,83,310,4,5,5,14,Champions
47259,240,14,22,3,3,2,8,Loyal Users
47321,747,7,9,2,2,1,5,Lost
47426,425,31,47,3,4,3,10,Loyal Users
47570,854,7,11,2,2,1,5,Lost
47642,1571,5,23,1,1,2,4,Lost
47786,8,157,343,5,5,5,15,Champions
48033,237,9,18,3,2,2,7,Casual Users
48093,586,37,170,2,4,5,11,At Risk
48679,91,65,118,4,5,4,13,Champions
48791,408,15,26,3,3,2,8,Loyal Users
48843,11,69,282,5,5,5,15,Champions
49110,482,52,248,2,5,5,12,At Risk
49134,1140,10,18,2,2,2,6,Lost
49158,1129,6,27,2,1,2,5,Lost
49277,159,14,38,4,3,3,10,Loyal Users
49439,142,6,17,4,1,2,7,Promising
49804,53,77,298,5,5,5,15,Champions
49808,84,41,210,4,4,5,13,Champions
49861,2239,8,8,1,2,1,4,Lost
49905,110,78,177,4,5,5,14,Champions
50020,674,6,9,2,1,1,4,Lost
50033,26,59,240,5,5,5,15,Champions
50078,267,11,45,3,2,3,8,Casual Users
50167,151,75,212,4,5,5,14,Champions
50355,15,48,327,5,5,5,15,Champions
50654,1272,23,79,1,4,4,9,At Risk
50677,249,5,14,3,1,1,5,Casual Users
50783,1519,9,12,1,2,1,4,Lost
51229,417,18,39,3,3,3,9,Loyal Users
51280,127,20,45,4,3,3,10,Loyal Users
51921,399,21,105,3,3,4,10,Loyal Users
52050,1429,12,17,1,3,2,6,Casual Users
52068,507,19,81,2,3,4,9,Casual Users
52087,25,98,328,5,5,5,15,Champions
52203,96,40,206,4,4,5,13,Champions
52247,6,65,230,5,5,5,15,Champions
39474,120,12,29,4,3,2,9,Loyal Users
39750,2552,5,8,1,1,1,3,Lost
39797,76,72,114,4,5,4,13,Champions
39970,119,75,178,4,5,5,14,Champions
40329,820,19,27,2,3,2,7,Casual Users
40396,753,9,15,2,2,1,5,Lost
40549,77,20,57,4,3,3,10,Loyal Users
40661,864,8,8,2,2,1,5,Lost
41019,1797,5,7,1,1,1,3,Lost
41060,5,7,191,5,2,5,12,Promising
41078,0,20,27,5,3,2,10,Loyal Users
41363,19,88,162,5,5,5,15,Champions
41414,749,18,52,2,3,3,8,Casual Users
41468,258,49,370,3,5,5,13,Loyal Users
41486,0,67,146,5,5,4,14,Champions
41565,123,34,179,4,4,5,13,Champions
41865,509,10,21,2,2,2,6,Lost
42113,23,66,126,5,5,4,14,Champions
42191,123,8,20,4,2,2,8,Promising
42830,995,13,49,2,3,3,8,Casual Users
42897,32,95,294,5,5,5,15,Champions
43199,4574,7,26,1,2,2,5,Lost
43303,1562,8,8,1,2,1,4,Lost
43554,1810,15,19,1,3,2,6,Casual Users
43609,129,40,108,4,4,4,12,Champions
43669,127,9,12,4,2,1,7,Promising
43684,91,14,31,4,3,2,9,Loyal Users
43793,170,12,48,3,3,3,9,Loyal Users
43861,2,134,325,5,5,5,15,Champions
43870,875,8,11,2,2,1,5,Lost
43918,645,14,25,2,3,2,7,Casual Users
43927,162,6,7,4,1,1,6,Promising
44119,139,90,460,4,5,5,14,Champions
44639,769,5,23,2,1,2,5,Lost
44737,375,5,15,3,1,1,5,Casual Users
44868,115,64,211,4,5,5,14,Champions
44880,474,5,26,2,1,2,5,Lost
45201,411,6,18,3,1,2,6,Casual Users
45218,803,6,30,2,1,2,5,Lost
45371,58,84,147,5,5,5,15,Champions
45390,149,17,33,4,3,3,10,Loyal Users
45489,418,12,64,3,3,4,10,Loyal Users
45525,1262,7,18,1,2,2,5,Lost
45616,263,43,57,3,4,3,10,Loyal Users
45709,1851,5,21,1,1,2,4,Lost
46526,17,6,16,5,1,2,8,Promising
46984,1078,12,26,2,3,2,7,Casual Users
47176,411,5,9,3,1,1,5,Casual Users
47450,3148,21,38,1,3,3,7,Casual Users
47478,445,21,53,3,3,3,9,Loyal Users
48053,62,6,44,5,1,3,9,Promising
48237,1695,9,9,1,2,1,4,Lost
48330,125,6,70,4,1,4,9,Promising
48436,1118,68,242,2,5,5,12,At Risk
48647,2418,6,7,1,1,1,3,Lost
48770,862,10,54,2,2,3,7,Lost
48952,4280,29,64,1,4,4,9,At Risk
49089,536,23,167,2,4,5,11,At Risk
49264,561,25,52,2,4,3,9,At Risk
49275,102,31,78,4,4,4,12,Champions
49564,104,84,278,4,5,5,14,Champions
49580,139,21,103,4,3,4,11,Loyal Users
49656,2889,6,8,1,1,1,3,Lost
49684,414,30,45,3,4,3,10,Loyal Users
49906,1126,6,29,2,1,2,5,Lost
50133,996,6,24,2,1,2,5,Lost
50175,161,27,89,4,4,4,12,Champions
50409,701,9,11,2,2,1,5,Lost
50859,1288,95,389,1,5,5,11,At Risk
51399,586,6,7,2,1,1,4,Lost
51662,444,74,259,3,5,5,13,Loyal Users
51719,3754,10,24,1,2,2,5,Lost
51721,2450,7,7,1,2,1,4,Lost
51735,542,22,67,2,4,4,10,At Risk
51795,796,37,175,2,4,5,11,At Risk
51932,1648,6,10,1,1,1,3,Lost
52219,4585,5,11,1,1,1,3,Lost
52244,291,25,83,3,4,4,11,Loyal Users
52295,69,12,42,5,3,3,11,Loyal Users
40340,124,33,137,4,4,4,12,Champions
40780,10,112,171,5,5,5,15,Champions
41324,1125,12,46,2,3,3,8,Casual Users
41391,8,105,487,5,5,5,15,Champions
41622,406,60,152,3,5,5,13,Loyal Users
41710,52,18,32,5,3,3,11,Loyal Users
41932,1809,8,18,1,2,2,5,Lost
43439,16,11,14,5,2,1,8,Promising
43581,2126,12,24,1,3,2,6,Casual Users
43605,153,62,217,4,5,5,14,Champions
43833,146,25,82,4,4,4,12,Champions
44197,247,21,47,3,3,3,9,Loyal Users
44386,688,7,16,2,2,2,6,Lost
45177,1868,37,152,1,4,5,10,At Risk
45794,165,73,463,4,5,5,14,Champions
45979,1060,27,110,2,4,4,10,At Risk
46007,2095,5,5,1,1,1,3,Lost
46829,21,25,43,5,4,3,12,Loyal Users
46898,1543,13,17,1,3,2,6,Casual Users
46940,177,75,242,3,5,5,13,Loyal Users
47020,3092,7,10,1,2,1,4,Lost
47173,176,17,46,3,3,3,9,Loyal Users
48517,293,30,148,3,4,5,12,Loyal Users
48617,3101,8,10,1,2,1,4,Lost
48960,2607,8,8,1,2,1,4,Lost
49232,104,22,56,4,4,3,11,Loyal Users
49392,406,24,50,3,4,3,10,Loyal Users
49782,3876,5,6,1,1,1,3,Lost
50433,30,9,17,5,2,2,9,Promising
50540,1019,7,7,2,2,1,5,Lost
50987,137,61,234,4,5,5,14,Champions
51009,5914,5,12,1,1,1,3,Lost
51115,59,9,22,5,2,2,9,Promising
51356,164,109,257,4,5,5,14,Champions
51366,191,18,29,3,3,2,8,Loyal Users
51859,568,9,58,2,2,3,7,Lost
52164,3551,5,6,1,1,1,3,Lost
39338,113,70,165,4,5,5,14,Champions
39568,1666,11,13,1,2,1,4,Lost
39573,417,26,42,3,4,3,10,Loyal Users
39655,556,26,99,2,4,4,10,At Risk
39809,3298,8,21,1,2,2,5,Lost
39954,748,22,84,2,4,4,10,At Risk
40036,3,83,447,5,5,5,15,Champions
40186,36,113,622,5,5,5,15,Champions
40341,285,6,22,3,1,2,6,Casual Users
40430,533,6,6,2,1,1,4,Lost
40534,384,27,136,3,4,4,11,Loyal Users
40695,16,59,159,5,5,5,15,Champions
40743,3575,8,9,1,2,1,4,Lost
40787,5177,8,12,1,2,1,4,Lost
40978,531,13,75,2,3,4,9,Casual Users
41140,154,51,169,4,5,5,14,Champions
41195,155,10,32,4,2,3,9,Promising
41570,745,24,178,2,4,5,11,At Risk
41787,3456,19,19,1,3,2,6,Casual Users
42010,24,64,101,5,5,4,14,Champions
42074,126,31,393,4,4,5,13,Champions
42148,2539,9,17,1,2,2,5,Lost
42473,252,22,48,3,4,3,10,Loyal Users
43066,11,5,5,5,1,1,7,Promising
43673,1806,6,19,1,1,2,4,Lost
43814,266,153,451,3,5,5,13,Loyal Users
43818,282,13,34,3,3,3,9,Loyal Users
43903,366,8,8,3,2,1,6,Casual Users
44004,2974,13,18,1,3,2,6,Casual Users
44281,444,38,82,3,4,4,11,Loyal Users
44393,137,8,9,4,2,1,7,Promising
44591,4071,11,30,1,2,2,5,Lost
44608,186,12,64,3,3,4,10,Loyal Users
44989,13,16,101,5,3,4,12,Loyal Users
45197,3709,5,12,1,1,1,3,Lost
45756,422,10,32,3,2,3,8,Casual Users
45775,105,35,100,4,4,4,12,Champions
45998,210,13,24,3,3,2,8,Loyal Users
46082,421,30,38,3,4,3,10,Loyal Users
46091,3484,5,7,1,1,1,3,Lost
46359,184,82,287,3,5,5,13,Loyal Users
46587,418,17,29,3,3,2,8,Loyal Users
46691,9,87,154,5,5,5,15,Champions
46721,1728,11,17,1,2,2,5,Lost
46864,306,44,60,3,4,3,10,Loyal Users
46868,673,20,28,2,3,2,7,Casual Users
47064,133,23,88,4,4,4,12,Champions
47106,14,21,60,5,3,3,11,Loyal Users
47118,47,7,24,5,2,2,9,Promising
47315,662,16,26,2,3,2,7,Casual Users
47338,58,28,59,5,4,3,12,Loyal Users
47581,523,9,23,2,2,2,6,Lost
47677,1868,17,43,1,3,3,7,Casual Users
47937,531,13,75,2,3,4,9,Casual Users
48569,1851,19,96,1,3,4,8,Casual Users
48683,337,12,43,3,3,3,9,Loyal Users
48748,324,21,259,3,3,5,11,Loyal Users
48830,29,5,7,5,1,1,7,Promising
48923,1423,7,11,1,2,1,4,Lost
49205,2185,9,21,1,2,2,5,Lost
50414,248,53,83,3,5,4,12,Loyal Users
50976,114,14,21,4,3,2,9,Loyal Users
51317,444,22,165,3,4,5,12,Loyal Users
51384,101,11,33,4,2,3,9,Promising
51650,313,33,227,3,4,5,12,Loyal Users
51789,805,8,38,2,2,3,7,Lost
51965,1969,5,16,1,1,2,4,Lost
52089,2361,19,94,1,3,4,8,Casual Users
52104,275,8,9,3,2,1,6,Casual Users
52234,446,51,105,3,5,4,12,Loyal Users
52317,964,14,22,2,3,2,7,Casual Users
39544,4813,9,13,1,2,1,4,Lost
39593,7,263,614,5,5,5,15,Champions
39661,1176,6,7,2,1,1,4,Lost
39942,203,43,316,3,4,5,12,Loyal Users
40432,2974,9,53,1,2,3,6,Lost
40527,67,42,139,5,4,4,13,Champions
40680,3049,6,12,1,1,1,3,Lost
40715,272,10,18,3,2,2,7,Casual Users
40747,12,36,91,5,4,4,13,Champions
40751,733,36,130,2,4,4,10,At Risk
40766,12,23,56,5,4,3,12,Loyal Users
40897,843,9,41,2,2,3,7,Lost
41079,2744,7,28,1,2,2,5,Lost
41228,109,10,26,4,2,2,8,Promising
41645,4,44,91,5,4,4,13,Champions
42234,117,91,471,4,5,5,14,Champions
42332,1480,5,15,1,1,1,3,Lost
42673,676,20,39,2,3,3,8,Casual Users
42979,660,7,8,2,2,1,5,Lost
43289,142,27,60,4,4,3,11,Loyal Users
43603,64,10,74,5,2,4,11,Promising
43648,246,9,57,3,2,3,8,Casual Users
43654,384,16,18,3,3,2,8,Loyal Users
43896,414,9,37,3,2,3,8,Casual Users
44103,3599,32,38,1,4,3,8,At Risk
44233,572,18,24,2,3,2,7,Casual Users
44275,1276,24,161,1,4,5,10,At Risk
44410,1270,9,19,1,2,2,5,Lost
44616,1729,16,19,1,3,2,6,Casual Users
44790,270,9,17,3,2,2,7,Casual Users
45002,146,7,7,4,2,1,7,Promising
45086,585,6,7,2,1,1,4,Lost
45123,5602,5,7,1,1,1,3,Lost
45259,39,5,5,5,1,1,7,Promising
45705,1395,6,30,1,1,2,4,Lost
45897,850,11,57,2,2,3,7,Lost
46008,727,14,18,2,3,2,7,Casual Users
46095,579,16,36,2,3,3,8,Casual Users
46115,2384,5,23,1,1,2,4,Lost
46196,1576,17,34,1,3,3,7,Casual Users
46242,158,35,172,4,4,5,13,Champions
46325,462,29,52,3,4,3,10,Loyal Users
46979,8,117,340,5,5,5,15,Champions
47019,1976,14,42,1,3,3,7,Casual Users
47048,755,15,130,2,3,4,9,Casual Users
48173,1393,12,14,1,3,1,5,Casual Users
48301,1591,5,12,1,1,1,3,Lost
48772,361,9,12,3,2,1,6,Casual Users
48867,364,27,106,3,4,4,11,Loyal Users
49054,723,6,19,2,1,2,5,Lost
49180,117,117,236,4,5,5,14,Champions
49363,43,24,164,5,4,5,14,Champions
49376,4,152,528,5,5,5,15,Champions
49715,60,6,6,5,1,1,7,Promising
49751,136,15,127,4,3,4,11,Loyal Users
50179,16,5,14,5,1,1,7,Promising
50230,128,10,14,4,2,1,7,Promising
50410,250,29,113,3,4,4,11,Loyal Users
51084,380,24,33,3,4,3,10,Loyal Users
51165,424,126,222,3,5,5,13,Loyal Users
51687,133,32,97,4,4,4,12,Champions
52228,655,5,17,2,1,2,5,Lost
39267,2989,11,13,1,2,1,4,Lost
39365,461,17,60,3,3,3,9,Loyal Users
39958,242,22,30,3,4,2,9,Loyal Users
39975,349,8,13,3,2,1,6,Casual Users
40083,2790,7,79,1,2,4,7,Lost
40097,99,7,8,4,2,1,7,Promising
40135,24,12,17,5,3,2,10,Loyal Users
40467,286,30,81,3,4,4,11,Loyal Users
40717,31,37,140,5,4,4,13,Champions
40728,515,5,13,2,1,1,4,Lost
40748,109,71,210,4,5,5,14,Champions
40944,2946,6,7,1,1,1,3,Lost
41314,18,18,33,5,3,3,11,Loyal Users
41492,108,21,43,4,3,3,10,Loyal Users
41505,6,141,466,5,5,5,15,Champions
41660,11,9,30,5,2,2,9,Promising
41823,689,13,45,2,3,3,8,Casual Users
42032,135,34,122,4,4,4,12,Champions
42052,1122,6,15,2,1,1,4,Lost
42071,434,41,84,3,4,4,11,Loyal Users
43445,1624,9,60,1,2,3,6,Lost
43726,230,22,94,3,4,4,11,Loyal Users
43779,693,17,69,2,3,4,9,Casual Users
43976,113,34,54,4,4,3,11,Loyal Users
44100,57,8,24,5,2,2,9,Promising
44213,91,39,181,4,4,5,13,Champions
44300,426,70,169,3,5,5,13,Loyal Users
44665,27,12,135,5,3,4,12,Loyal Users
44864,4552,12,23,1,3,2,6,Casual Users
44988,5,200,371,5,5,5,15,Champions
45117,1411,6,12,1,1,1,3,Lost
45209,218,40,84,3,4,4,11,Loyal Users
45237,1009,5,7,2,1,1,4,Lost
45415,15,61,176,5,5,5,15,Champions
45429,467,40,77,3,4,4,11,Loyal Users
45494,101,9,45,4,2,3,9,Promising
45685,260,16,45,3,3,3,9,Loyal Users
45782,137,148,573,4,5,5,14,Champions
45936,426,8,11,3,2,1,6,Casual Users
45956,6,79,186,5,5,5,15,Champions
45986,105,27,178,4,4,5,13,Champions
46197,795,7,7,2,2,1,5,Lost
46247,217,17,55,3,3,3,9,Loyal Users
46300,224,28,70,3,4,4,11,Loyal Users
46371,2703,5,8,1,1,1,3,Lost
46469,8,31,93,5,4,4,13,Champions
46663,31,9,24,5,2,2,9,Promising
46736,1713,6,9,1,1,1,3,Lost
47002,1366,14,17,1,3,2,6,Casual Users
47477,5049,8,9,1,2,1,4,Lost
47546,766,10,12,2,2,1,5,Lost
47795,1513,5,9,1,1,1,3,Lost
47797,2133,20,50,1,3,3,7,Casual Users
47875,3599,5,7,1,1,1,3,Lost
47911,141,15,55,4,3,3,10,Loyal Users
48288,159,6,7,4,1,1,6,Promising
48480,28,110,483,5,5,5,15,Champions
49155,781,30,43,2,4,3,9,At Risk
49238,853,5,7,2,1,1,4,Lost
49242,3238,25,53,1,4,3,8,At Risk
49384,440,23,37,3,4,3,10,Loyal Users
49516,427,10,40,3,2,3,8,Casual Users
49680,69,39,65,5,4,4,13,Champions
49866,271,8,55,3,2,3,8,Casual Users
49902,763,39,110,2,4,4,10,At Risk
50009,104,21,65,4,3,4,11,Loyal Users
50015,2257,6,7,1,1,1,3,Lost
50036,122,36,131,4,4,4,12,Champions
50172,8,33,145,5,4,4,13,Champions
50187,471,54,75,2,5,4,11,At Risk
50224,3240,7,21,1,2,2,5,Lost
51017,120,6,9,4,1,1,6,Promising
51406,4487,10,20,1,2,2,5,Lost
51511,2563,13,25,1,3,2,6,Casual Users
51520,123,20,57,4,3,3,10,Loyal Users
52274,44,20,80,5,3,4,12,Loyal Users
39372,2701,7,10,1,2,1,4,Lost
39673,1338,7,25,1,2,2,5,Lost
39760,185,33,55,3,4,3,10,Loyal Users
39892,227,28,45,3,4,3,10,Loyal Users
40027,369,7,8,3,2,1,6,Casual Users
40080,1206,25,40,2,4,3,9,At Risk
40120,265,9,61,3,2,3,8,Casual Users
40356,1038,6,21,2,1,2,5,Lost
40371,26,35,153,5,4,5,14,Champions
40470,797,13,23,2,3,2,7,Casual Users
40810,2117,5,34,1,1,3,5,Lost
40819,4,66,373,5,5,5,15,Champions
40936,141,7,24,4,2,2,8,Promising
41346,1386,7,9,1,2,1,4,Lost
42663,878,5,8,2,1,1,4,Lost
42664,258,116,508,3,5,5,13,Loyal Users
42808,94,27,47,4,4,3,11,Loyal Users
43047,1131,17,38,2,3,3,8,Casual Users
43273,214,10,74,3,2,4,9,Casual Users
43625,154,31,43,4,4,3,11,Loyal Users
43750,1106,7,8,2,2,1,5,Lost
44725,0,95,365,5,5,5,15,Champions
44925,2431,5,6,1,1,1,3,Lost
45134,19,148,386,5,5,5,15,Champions
45176,840,6,6,2,1,1,4,Lost
45385,0,41,142,5,4,4,13,Champions
45788,113,92,579,4,5,5,14,Champions
45845,23,38,147,5,4,5,14,Champions
45882,3225,5,19,1,1,2,4,Lost
46143,1441,8,13,1,2,1,4,Lost
46190,98,27,95,4,4,4,12,Champions
46332,13,16,23,5,3,2,10,Loyal Users
46790,62,85,94,5,5,4,14,Champions
46832,543,5,11,2,1,1,4,Lost
46926,3010,5,7,1,1,1,3,Lost
49015,109,75,175,4,5,5,14,Champions
49082,160,6,6,4,1,1,6,Promising
49254,0,16,40,5,3,3,11,Loyal Users
49489,138,25,57,4,4,3,11,Loyal Users
49694,886,28,39,2,4,3,9,At Risk
49857,124,32,126,4,4,4,12,Champions
50084,85,220,545,4,5,5,14,Champions
50276,1569,7,15,1,2,1,4,Lost
50363,84,49,230,4,5,5,14,Champions
50530,694,20,36,2,3,3,8,Casual Users
50562,231,6,13,3,1,1,5,Casual Users
50627,707,8,10,2,2,1,5,Lost
50888,145,49,98,4,5,4,13,Champions
51010,44,103,546,5,5,5,15,Champions
51397,5551,5,5,1,1,1,3,Lost
51649,1950,5,13,1,1,1,3,Lost
51822,9,14,47,5,3,3,11,Loyal Users
51951,969,22,74,2,4,4,10,At Risk
52238,95,24,108,4,4,4,12,Champions
52337,672,10,30,2,2,2,6,Lost
52347,463,6,20,3,1,2,6,Casual Users
39387,1686,5,34,1,1,3,5,Lost
39778,54,150,502,5,5,5,15,Champions
40281,113,13,51,4,3,3,10,Loyal Users
40362,75,114,310,4,5,5,14,Champions
40760,286,14,148,3,3,5,11,Loyal Users
40914,99,22,71,4,4,4,12,Champions
40922,101,115,353,4,5,5,14,Champions
41017,948,5,8,2,1,1,4,Lost
41023,0,33,67,5,4,4,13,Champions
41310,1007,7,10,2,2,1,5,Lost
41342,7,27,183,5,4,5,14,Champions
41377,9,132,294,5,5,5,15,Champions
41583,4668,6,7,1,1,1,3,Lost
41948,693,12,24,2,3,2,7,Casual Users
42731,38,77,541,5,5,5,15,Champions
43027,123,11,107,4,2,4,10,Promising
43102,377,8,20,3,2,2,7,Casual Users
43559,1289,10,11,1,2,1,4,Lost
45217,1263,10,15,1,2,1,4,Lost
45814,352,10,19,3,2,2,7,Casual Users
46034,240,89,197,3,5,5,13,Loyal Users
46118,752,12,42,2,3,3,8,Casual Users
46612,579,11,18,2,2,2,6,Lost
46712,314,60,128,3,5,4,12,Loyal Users
46890,92,21,53,4,3,3,10,Loyal Users
47290,124,18,33,4,3,3,10,Loyal Users
47532,1082,15,144,2,3,4,9,Casual Users
47857,1328,9,31,1,2,2,5,Lost
48152,96,20,78,4,3,4,11,Loyal Users
48154,2387,16,44,1,3,3,7,Casual Users
48207,542,6,21,2,1,2,5,Lost
48280,50,175,259,5,5,5,15,Champions
48333,308,25,38,3,4,3,10,Loyal Users
48881,265,17,43,3,3,3,9,Loyal Users
49005,0,11,85,5,2,4,11,Promising
49079,100,45,230,4,4,5,13,Champions
49190,940,5,9,2,1,1,4,Lost
49361,250,33,104,3,4,4,11,Loyal Users
49561,330,34,41,3,4,3,10,Loyal Users
49582,300,22,32,3,4,3,10,Loyal Users
49889,2435,9,9,1,2,1,4,Lost
50138,35,48,73,5,5,4,14,Champions
50369,727,5,7,2,1,1,4,Lost
50411,5179,7,9,1,2,1,4,Lost
50815,5,18,60,5,3,3,11,Loyal Users
50942,542,14,32,2,3,3,8,Casual Users
51141,1050,20,34,2,3,3,8,Casual Users
51166,139,11,12,4,2,1,7,Promising
51850,83,6,9,4,1,1,6,Promising
51863,897,7,11,2,2,1,5,Lost
52119,421,17,30,3,3,2,8,Loyal Users
39494,79,135,304,4,5,5,14,Champions
39528,857,10,11,2,2,1,5,Lost
39576,694,20,61,2,3,3,8,Casual Users
39640,119,9,21,4,2,2,8,Promising
40834,19,12,20,5,3,2,10,Loyal Users
41080,4,80,161,5,5,5,15,Champions
41183,160,14,22,4,3,2,9,Loyal Users
41417,2477,6,9,1,1,1,3,Lost
41678,637,21,84,2,3,4,9,Casual Users
41985,4,75,327,5,5,5,15,Champions
42075,58,120,560,5,5,5,15,Champions
42077,188,87,147,3,5,5,13,Loyal Users
42250,635,6,11,2,1,1,4,Lost
42295,19,5,5,5,1,1,7,Promising
42386,1170,8,10,2,2,1,5,Lost
42412,537,9,13,2,2,1,5,Lost
42572,3248,10,84,1,2,4,7,Lost
42860,135,26,130,4,4,4,12,Champions
42864,2437,8,14,1,2,1,4,Lost
42947,0,33,50,5,4,3,12,Loyal Users
43493,1573,6,8,1,1,1,3,Lost
43526,233,51,183,3,5,5,13,Loyal Users
43531,2942,11,51,1,2,3,6,Lost
43589,601,134,225,2,5,5,12,At Risk
43765,87,42,72,4,4,4,12,Champions
43794,697,5,21,2,1,2,5,Lost
43911,687,11,20,2,2,2,6,Lost
44025,1286,7,7,1,2,1,4,Lost
44050,21,113,319,5,5,5,15,Champions
44326,5,92,169,5,5,5,15,Champions
44464,1,71,94,5,5,4,14,Champions
44508,836,8,32,2,2,3,7,Lost
44573,7,146,270,5,5,5,15,Champions
44719,12,12,23,5,3,2,10,Loyal Users
44750,7,152,475,5,5,5,15,Champions
44795,383,46,95,3,5,4,12,Loyal Users
44870,19,60,305,5,5,5,15,Champions
44872,455,16,35,3,3,3,9,Loyal Users
44974,1006,5,30,2,1,2,5,Lost
45050,86,71,186,4,5,5,14,Champions
45061,500,62,166,2,5,5,12,At Risk
45221,243,52,262,3,5,5,13,Loyal Users
45273,3,86,117,5,5,4,14,Champions
45590,496,112,224,2,5,5,12,At Risk
45908,381,8,17,3,2,2,7,Casual Users
46127,2368,10,13,1,2,1,4,Lost
46263,4063,7,15,1,2,1,4,Lost
46292,817,14,57,2,3,3,8,Casual Users
46461,281,57,216,3,5,5,13,Loyal Users
46686,179,20,43,3,3,3,9,Loyal Users
46766,2,18,83,5,3,4,12,Loyal Users
47126,529,6,14,2,1,1,4,Lost
47307,1432,8,11,1,2,1,4,Lost
47331,17,26,91,5,4,4,13,Champions
47366,180,43,220,3,4,5,12,Loyal Users
47402,403,37,66,3,4,4,11,Loyal Users
47445,410,13,68,3,3,4,10,Loyal Users
47867,2450,9,47,1,2,3,6,Lost
48282,345,24,182,3,4,5,12,Loyal Users
48335,146,103,180,4,5,5,14,Champions
48396,1707,5,5,1,1,1,3,Lost
48397,5,23,136,5,4,4,13,Champions
48754,612,7,12,2,2,1,5,Lost
48802,674,31,73,2,4,4,10,At Risk
48827,826,6,13,2,1,1,4,Lost
48892,121,16,89,4,3,4,11,Loyal Users
48931,1191,36,181,2,4,5,11,At Risk
49152,125,21,94,4,3,4,11,Loyal Users
49260,134,117,244,4,5,5,14,Champions
49522,754,8,37,2,2,3,7,Lost
50025,878,12,25,2,3,2,7,Casual Users
50212,17,46,75,5,5,4,14,Champions
50959,220,62,172,3,5,5,13,Loyal Users
51065,1518,19,40,1,3,3,7,Casual Users
51132,77,20,55,4,3,3,10,Loyal Users
51263,4958,34,34,1,4,3,8,At Risk
51314,2847,6,12,1,1,1,3,Lost
51349,146,36,47,4,4,3,11,Loyal Users
51675,221,8,13,3,2,1,6,Casual Users
51929,15,16,22,5,3,2,10,Loyal Users
51941,0,10,43,5,2,3,10,Promising
39562,8,134,503,5,5,5,15,Champions
39783,80,6,8,4,1,1,6,Promising
39791,4452,10,15,1,2,1,4,Lost
39980,2268,10,22,1,2,2,5,Lost
40478,33,44,77,5,4,4,13,Champions
40569,368,12,39,3,3,3,9,Loyal Users
40818,280,20,83,3,3,4,10,Loyal Users
41040,875,16,31,2,3,2,7,Casual Users
41055,129,40,148,4,4,5,13,Champions
41803,378,19,58,3,3,3,9,Loyal Users
41904,18,13,30,5,3,2,10,Loyal Users
42110,4,13,62,5,3,3,11,Loyal Users
42171,15,24,69,5,4,4,13,Champions
42218,283,9,47,3,2,3,8,Casual Users
42511,300,13,63,3,3,4,10,Loyal Users
42845,681,14,25,2,3,2,7,Casual Users
43225,240,21,30,3,3,2,8,Loyal Users
43336,1790,17,43,1,3,3,7,Casual Users
43360,1196,22,206,2,4,5,11,At Risk
43792,261,37,63,3,4,4,11,Loyal Users
43912,150,31,53,4,4,3,11,Loyal Users
44335,789,12,13,2,3,1,6,Casual Users
44970,518,52,130,2,5,4,11,At Risk
45058,10,71,94,5,5,4,14,Champions
45140,51,41,118,5,4,4,13,Champions
45189,1735,11,37,1,2,3,6,Lost
45420,740,9,11,2,2,1,5,Lost
45439,708,13,24,2,3,2,7,Casual Users
45596,3198,5,19,1,1,2,4,Lost
45656,90,39,174,4,4,5,13,Champions
45689,1429,5,5,1,1,1,3,Lost
46010,3146,21,138,1,3,4,8,Casual Users
46295,549,13,18,2,3,2,7,Casual Users
46508,12,154,621,5,5,5,15,Champions
46529,880,41,281,2,4,5,11,At Risk
46680,590,12,24,2,3,2,7,Casual Users
46715,1738,5,100,1,1,4,6,Lost
47014,121,14,110,4,3,4,11,Loyal Users
47089,45,17,66,5,3,4,12,Loyal Users
47385,2277,5,7,1,1,1,3,Lost
48092,2713,7,30,1,2,2,5,Lost
48252,391,47,98,3,5,4,12,Loyal Users
48287,742,39,186,2,4,5,11,At Risk
48349,9,31,40,5,4,3,12,Loyal Users
48621,163,8,32,4,2,3,9,Promising
48694,296,30,58,3,4,3,10,Loyal Users
49208,213,15,79,3,3,4,10,Loyal Users
49378,3048,9,10,1,2,1,4,Lost
50018,4,65,109,5,5,4,14,Champions
50553,293,25,74,3,4,4,11,Loyal Users
50673,1,25,44,5,4,3,12,Loyal Users
50706,272,23,42,3,4,3,10,Loyal Users
50765,246,6,10,3,1,1,5,Casual Users
50878,1422,13,16,1,3,2,6,Casual Users
50941,1124,40,73,2,4,4,10,At Risk
51051,573,51,91,2,5,4,11,At Risk
51161,1410,5,8,1,1,1,3,Lost
51256,354,12,21,3,3,2,8,Loyal Users
51329,137,23,28,4,4,2,10,Loyal Users
51613,82,13,43,4,3,3,10,Loyal Users
51710,133,12,15,4,3,1,8,Loyal Users
51978,1424,10,29,1,2,2,5,Lost
39264,265,28,42,3,4,3,10,Loyal Users
39834,1103,5,9,2,1,1,4,Lost
40154,380,5,13,3,1,1,5,Casual Users
40206,393,59,117,3,5,4,12,Loyal Users
40509,280,18,31,3,3,2,8,Loyal Users
40930,5,35,122,5,4,4,13,Champions
41536,16,66,154,5,5,5,15,Champions
41795,63,18,35,5,3,3,11,Loyal Users
41923,56,224,940,5,5,5,15,Champions
42566,6,16,24,5,3,2,10,Loyal Users
42686,383,69,131,3,5,4,12,Loyal Users
42771,3563,8,45,1,2,3,6,Lost
42881,4569,18,30,1,3,2,6,Casual Users
42952,143,24,64,4,4,4,12,Champions
43049,801,5,46,2,1,3,6,Lost
43223,3299,7,28,1,2,2,5,Lost
43393,398,29,59,3,4,3,10,Loyal Users
43457,2844,5,11,1,1,1,3,Lost
43464,443,26,308,3,4,5,12,Loyal Users
43641,23,28,120,5,4,4,13,Champions
43824,87,86,157,4,5,5,14,Champions
44135,280,26,39,3,4,3,10,Loyal Users
44738,1116,5,19,2,1,2,5,Lost
44741,1678,15,25,1,3,2,6,Casual Users
45066,969,13,26,2,3,2,7,Casual Users
45378,42,8,99,5,2,4,11,Promising
45444,321,26,81,3,4,4,11,Loyal Users
45504,25,55,269,5,5,5,15,Champions
45779,12,46,113,5,5,4,14,Champions
45833,2127,12,25,1,3,2,6,Casual Users
46155,72,12,27,4,3,2,9,Loyal Users
46231,1699,9,16,1,2,2,5,Lost
46646,289,34,99,3,4,4,11,Loyal Users
46684,236,49,77,3,5,4,12,Loyal Users
46814,2416,11,115,1,2,4,7,Lost
46928,31,36,248,5,4,5,14,Champions
47000,2549,5,12,1,1,1,3,Lost
47260,13,8,29,5,2,2,9,Promising
47330,169,64,111,3,5,4,12,Loyal Users
47604,151,113,352,4,5,5,14,Champions
47653,2251,21,71,1,3,4,8,Casual Users
47769,142,42,78,4,4,4,12,Champions
47785,1694,14,22,1,3,2,6,Casual Users
47882,2746,6,6,1,1,1,3,Lost
48044,424,10,25,3,2,2,7,Casual Users
48319,1883,17,79,1,3,4,8,Casual Users
48359,700,20,102,2,3,4,9,Casual Users
48749,342,32,172,3,4,5,12,Loyal Users
48826,1433,9,17,1,2,2,5,Lost
48972,1432,6,8,1,1,1,3,Lost
49216,3010,6,8,1,1,1,3,Lost
49596,2976,10,16,1,2,2,5,Lost
49606,140,26,110,4,4,4,12,Champions
50041,4707,9,15,1,2,1,4,Lost
50294,534,62,308,2,5,5,12,At Risk
50447,79,14,33,4,3,3,10,Loyal Users
50832,719,5,9,2,1,1,4,Lost
51241,18,21,41,5,3,3,11,Loyal Users
51437,412,17,40,3,3,3,9,Loyal Users
51891,209,18,37,3,3,3,9,Loyal Users
51973,3,50,87,5,5,4,14,Champions
52204,45,99,402,5,5,5,15,Champions
39289,2128,7,19,1,2,2,5,Lost
39297,113,35,63,4,4,4,12,Champions
39370,1028,11,26,2,2,2,6,Lost
39627,136,26,119,4,4,4,12,Champions
40693,13,156,220,5,5,5,15,Champions
40776,141,19,36,4,3,3,10,Loyal Users
40955,1700,8,32,1,2,3,6,Lost
40960,4,37,108,5,4,4,13,Champions
40983,1010,7,9,2,2,1,5,Lost
41001,393,8,22,3,2,2,7,Casual Users
41138,508,8,14,2,2,1,5,Lost
41267,84,5,19,4,1,2,7,Promising
41632,118,6,53,4,1,3,8,Promising
41684,0,60,204,5,5,5,15,Champions
42142,361,7,11,3,2,1,6,Casual Users
42267,590,19,47,2,3,3,8,Casual Users
42327,704,22,89,2,4,4,10,At Risk
42342,1,104,373,5,5,5,15,Champions
42488,108,9,18,4,2,2,8,Promising
42765,2536,11,24,1,2,2,5,Lost
42796,26,13,24,5,3,2,10,Loyal Users
43172,601,39,68,2,4,4,10,At Risk
43251,71,6,12,4,1,1,6,Promising
43619,545,21,91,2,3,4,9,Casual Users
44046,982,9,13,2,2,1,5,Lost
44140,146,7,8,4,2,1,7,Promising
44286,216,48,138,3,5,4,12,Loyal Users
44698,279,25,29,3,4,2,9,Loyal Users
44907,23,8,86,5,2,4,11,Promising
45246,141,70,273,4,5,5,14,Champions
45884,122,28,107,4,4,4,12,Champions
45898,6,234,357,5,5,5,15,Champions
45938,606,8,24,2,2,2,6,Lost
47034,311,6,12,3,1,1,5,Casual Users
47160,419,8,11,3,2,1,6,Casual Users
47168,22,107,270,5,5,5,15,Champions
47311,7,136,396,5,5,5,15,Champions
47441,154,32,68,4,4,4,12,Champions
47902,1,190,421,5,5,5,15,Champions
48106,222,38,93,3,4,4,11,Loyal Users
48131,419,15,141,3,3,4,10,Loyal Users
48216,663,17,134,2,3,4,9,Casual Users
48358,59,34,104,5,4,4,13,Champions
48469,2878,5,11,1,1,1,3,Lost
48564,1318,38,188,1,4,5,10,At Risk
48731,431,11,18,3,2,2,7,Casual Users
48764,15,28,96,5,4,4,13,Champions
48773,22,48,154,5,5,5,15,Champions
49230,5081,8,8,1,2,1,4,Lost
49451,519,7,41,2,2,3,7,Lost
49479,1628,6,17,1,1,2,4,Lost
49548,125,23,36,4,4,3,11,Loyal Users
49759,82,33,153,4,4,5,13,Champions
49779,294,15,32,3,3,3,9,Loyal Users
49835,633,58,114,2,5,4,11,At Risk
49860,177,13,37,3,3,3,9,Loyal Users
50422,69,102,785,5,5,5,15,Champions
50523,618,8,26,2,2,2,6,Lost
50658,230,39,104,3,4,4,11,Loyal Users
51108,712,13,56,2,3,3,8,Casual Users
51193,1242,9,12,2,2,1,5,Lost
51556,233,31,106,3,4,4,11,Loyal Users
52014,2545,8,13,1,2,1,4,Lost
52293,101,72,261,4,5,5,14,Champions
40353,1939,5,17,1,1,2,4,Lost
40406,4667,6,6,1,1,1,3,Lost
40540,854,6,6,2,1,1,4,Lost
40939,161,71,234,4,5,5,14,Champions
41272,386,13,62,3,3,3,9,Loyal Users
41421,20,41,86,5,4,4,13,Champions
41674,80,74,491,4,5,5,14,Champions
42090,3329,5,11,1,1,1,3,Lost
42192,370,136,265,3,5,5,13,Loyal Users
42544,101,164,269,4,5,5,14,Champions
42599,514,72,323,2,5,5,12,At Risk
42640,547,10,20,2,2,2,6,Lost
43268,591,28,48,2,4,3,9,At Risk
43380,2001,16,110,1,3,4,8,Casual Users
43626,1426,32,54,1,4,3,8,At Risk
43828,45,17,58,5,3,3,11,Loyal Users
44574,105,37,232,4,4,5,13,Champions
44852,7,49,178,5,5,5,15,Champions
44856,2476,8,14,1,2,1,4,Lost
44973,281,56,148,3,5,5,13,Loyal Users
45018,921,6,6,2,1,1,4,Lost
46090,518,21,49,2,3,3,8,Casual Users
46505,224,16,48,3,3,3,9,Loyal Users
46953,217,21,28,3,3,2,8,Loyal Users
47045,33,84,225,5,5,5,15,Champions
47971,212,42,120,3,4,4,11,Loyal Users
48003,136,8,11,4,2,1,7,Promising
48098,5,9,72,5,2,4,11,Promising
48115,106,77,240,4,5,5,14,Champions
48293,149,9,19,4,2,2,8,Promising
48497,20,26,45,5,4,3,12,Loyal Users
48593,215,10,93,3,2,4,9,Casual Users
48675,419,5,7,3,1,1,5,Casual Users
48837,108,6,76,4,1,4,9,Promising
49423,2182,18,34,1,3,3,7,Casual Users
49450,865,5,11,2,1,1,4,Lost
49520,532,7,27,2,2,2,6,Lost
49856,179,65,124,3,5,4,12,Loyal Users
50214,598,18,23,2,3,2,7,Casual Users
50225,2535,5,19,1,1,2,4,Lost
50251,159,13,52,4,3,3,10,Loyal Users
50404,738,17,22,2,3,2,7,Casual Users
50429,2876,5,5,1,1,1,3,Lost
50662,2,80,520,5,5,5,15,Champions
50760,694,22,28,2,4,2,8,At Risk
50877,1596,9,21,1,2,2,5,Lost
51347,2262,12,27,1,3,2,6,Casual Users
51379,8,113,179,5,5,5,15,Champions
51444,834,9,20,2,2,2,6,Lost
51488,122,111,183,4,5,5,14,Champions
51767,632,105,383,2,5,5,12,At Risk
51955,128,10,13,4,2,1,7,Promising
52092,603,6,11,2,1,1,4,Lost
52111,101,128,310,4,5,5,14,Champions
52141,2286,17,40,1,3,3,7,Casual Users
52206,427,5,9,3,1,1,5,Casual Users
39304,108,18,52,4,3,3,10,Loyal Users
39723,82,52,235,4,5,5,14,Champions
39733,16,64,86,5,5,4,14,Champions
39768,303,14,20,3,3,2,8,Loyal Users
39885,1,88,271,5,5,5,15,Champions
40002,95,11,56,4,2,3,9,Promising
40265,548,12,80,2,3,4,9,Casual Users
40774,0,39,75,5,4,4,13,Champions
40879,1363,5,18,1,1,2,4,Lost
41000,2986,6,83,1,1,4,6,Lost
41058,244,56,94,3,5,4,12,Loyal Users
41589,129,31,39,4,4,3,11,Loyal Users
41619,443,56,224,3,5,5,13,Loyal Users
42022,299,23,80,3,4,4,11,Loyal Users
42340,83,35,159,4,4,5,13,Champions
42510,1316,35,146,1,4,4,9,At Risk
42617,847,56,76,2,5,4,11,At Risk
42694,347,12,68,3,3,4,10,Loyal Users
42714,1431,14,30,1,3,2,6,Casual Users
43169,1915,16,30,1,3,2,6,Casual Users
43506,147,11,21,4,2,2,8,Promising
43989,722,14,36,2,3,3,8,Casual Users
44226,172,23,88,3,4,4,11,Loyal Users
44277,1125,7,8,2,2,1,5,Lost
44319,1688,9,16,1,2,2,5,Lost
44712,33,17,60,5,3,3,11,Loyal Users
44757,75,70,213,4,5,5,14,Champions
44829,425,28,96,3,4,4,11,Loyal Users
45141,676,5,5,2,1,1,4,Lost
45261,3318,18,30,1,3,2,6,Casual Users
45298,125,102,346,4,5,5,14,Champions
45892,119,110,605,4,5,5,14,Champions
46033,7,37,64,5,4,4,13,Champions
46162,3643,20,69,1,3,4,8,Casual Users
46215,172,7,7,3,2,1,6,Casual Users
46547,6,19,27,5,3,2,10,Loyal Users
47190,429,33,42,3,4,3,10,Loyal Users
47288,1706,5,19,1,1,2,4,Lost
47387,9,42,111,5,4,4,13,Champions
47516,1693,11,18,1,2,2,5,Lost
47619,256,12,36,3,3,3,9,Loyal Users
47721,1995,7,7,1,2,1,4,Lost
47963,155,42,99,4,4,4,12,Champions
47985,536,7,14,2,2,1,5,Lost
48110,690,5,11,2,1,1,4,Lost
48296,8,6,45,5,1,3,9,Promising
48545,1893,5,5,1,1,1,3,Lost
48579,1189,16,29,2,3,2,7,Casual Users
48981,1534,16,39,1,3,3,7,Casual Users
49770,6,173,486,5,5,5,15,Champions
50299,1044,21,45,2,3,3,8,Casual Users
50377,94,10,46,4,2,3,9,Promising
50564,277,22,58,3,4,3,10,Loyal Users
51093,323,63,85,3,5,4,12,Loyal Users
51417,1039,27,56,2,4,3,9,At Risk
51779,304,14,25,3,3,2,8,Loyal Users
51940,412,27,36,3,4,3,10,Loyal Users
52028,30,18,51,5,3,3,11,Loyal Users
39914,160,15,85,4,3,4,11,Loyal Users
40570,2559,7,17,1,2,2,5,Lost
40813,580,13,93,2,3,4,9,Casual Users
41050,158,7,21,4,2,2,8,Promising
41098,577,22,40,2,4,3,9,At Risk
41380,430,15,52,3,3,3,9,Loyal Users
41407,1539,5,15,1,1,1,3,Lost
41411,0,118,233,5,5,5,15,Champions
41792,58,6,25,5,1,2,8,Promising
42164,823,16,20,2,3,2,7,Casual Users
42494,5424,6,6,1,1,1,3,Lost
42848,828,13,46,2,3,3,8,Casual Users
42851,478,6,11,2,1,1,4,Lost
42892,284,6,19,3,1,2,6,Casual Users
42933,2001,5,8,1,1,1,3,Lost
42945,1981,29,58,1,4,3,8,At Risk
43053,227,6,6,3,1,1,5,Casual Users
43130,154,117,299,4,5,5,14,Champions
43203,285,31,63,3,4,4,11,Loyal Users
43353,113,62,631,4,5,5,14,Champions
43578,101,14,19,4,3,2,9,Loyal Users
43597,115,43,116,4,4,4,12,Champions
43930,1146,25,103,2,4,4,10,At Risk
44372,9,15,115,5,3,4,12,Loyal Users
44479,596,55,167,2,5,5,12,At Risk
44529,644,8,23,2,2,2,6,Lost
45020,22,47,114,5,5,4,14,Champions
45207,69,74,191,5,5,5,15,Champions
45561,114,26,72,4,4,4,12,Champions
45916,699,12,26,2,3,2,7,Casual Users
46535,157,8,10,4,2,1,7,Promising
47135,64,115,342,5,5,5,15,Champions
47284,18,6,8,5,1,1,7,Promising
47354,66,63,156,5,5,5,15,Champions
47839,61,136,486,5,5,5,15,Champions
47862,2842,5,17,1,1,2,4,Lost
48089,131,28,93,4,4,4,12,Champions
48227,136,79,276,4,5,5,14,Champions
48326,138,13,56,4,3,3,10,Loyal Users
48395,4704,9,24,1,2,2,5,Lost
48577,433,13,25,3,3,2,8,Loyal Users
49031,353,89,487,3,5,5,13,Loyal Users
49261,1665,30,213,1,4,5,10,At Risk
49482,32,35,94,5,4,4,13,Champions
49622,1866,5,6,1,1,1,3,Lost
49745,158,63,524,4,5,5,14,Champions
49876,988,8,9,2,2,1,5,Lost
49878,114,23,51,4,4,3,11,Loyal Users
50042,25,63,183,5,5,5,15,Champions
50089,66,62,371,5,5,5,15,Champions
50100,1497,10,48,1,2,3,6,Lost
50209,6,40,119,5,4,4,13,Champions
50375,151,93,149,4,5,5,14,Champions
50900,434,23,99,3,4,4,11,Loyal Users
51007,7,59,120,5,5,4,14,Champions
51049,377,6,19,3,1,2,6,Casual Users
51318,30,73,258,5,5,5,15,Champions
51620,4,57,219,5,5,5,15,Champions
51761,1550,7,38,1,2,3,6,Lost
51993,278,18,61,3,3,3,9,Loyal Users
52117,588,10,15,2,2,1,5,Lost
52173,1286,6,7,1,1,1,3,Lost
52212,814,16,109,2,3,4,9,Casual Users
39349,4148,10,11,1,2,1,4,Lost
39473,1562,7,15,1,2,1,4,Lost
39637,5270,13,42,1,3,3,7,Casual Users
39993,146,11,18,4,2,2,8,Promising
40048,1064,30,84,2,4,4,10,At Risk
40179,822,25,227,2,4,5,11,At Risk
40189,83,5,5,4,1,1,6,Promising
40231,267,25,52,3,4,3,10,Loyal Users
40284,1223,14,35,2,3,3,8,Casual Users
40364,16,167,424,5,5,5,15,Champions
40394,627,15,69,2,3,4,9,Casual Users
40510,146,27,37,4,4,3,11,Loyal Users
40551,2685,5,13,1,1,1,3,Lost
40616,122,26,153,4,4,5,13,Champions
40817,78,17,37,4,3,3,10,Loyal Users
40875,603,25,49,2,4,3,9,At Risk
41133,15,32,70,5,4,4,13,Champions
41379,28,78,149,5,5,5,15,Champions
41550,1542,9,26,1,2,2,5,Lost
41564,875,10,15,2,2,1,5,Lost
42084,278,16,90,3,3,4,10,Loyal Users
42405,1417,11,26,1,2,2,5,Lost
42466,454,41,84,3,4,4,11,Loyal Users
42594,8,35,206,5,4,5,14,Champions
42775,283,41,62,3,4,3,10,Loyal Users
42787,3531,5,44,1,1,3,5,Lost
42838,41,24,36,5,4,3,12,Loyal Users
43328,265,21,30,3,3,2,8,Loyal Users
43382,420,13,36,3,3,3,9,Loyal Users
43490,7,21,50,5,3,3,11,Loyal Users
43552,582,8,36,2,2,3,7,Lost
43583,8,25,65,5,4,4,13,Champions
43788,2194,7,136,1,2,4,7,Lost
43868,591,14,26,2,3,2,7,Casual Users
44009,424,6,12,3,1,1,5,Casual Users
44202,2694,6,14,1,1,1,3,Lost
44433,2919,32,36,1,4,3,8,At Risk
44461,31,21,70,5,3,4,12,Loyal Users
44476,79,229,297,4,5,5,14,Champions
44780,112,24,45,4,4,3,11,Loyal Users
44840,4808,6,8,1,1,1,3,Lost
44910,299,6,6,3,1,1,5,Casual Users
44921,765,6,7,2,1,1,4,Lost
45214,188,54,179,3,5,5,13,Loyal Users
45280,111,26,132,4,4,4,12,Champions
45598,17,96,205,5,5,5,15,Champions
45780,573,110,229,2,5,5,12,At Risk
45848,82,78,263,4,5,5,14,Champions
46656,74,22,34,4,4,3,11,Loyal Users
46662,153,6,6,4,1,1,6,Promising
46834,80,37,78,4,4,4,12,Champions
46889,27,69,279,5,5,5,15,Champions
46975,1154,9,11,2,2,1,5,Lost
47053,1252,11,107,2,2,4,8,Lost
47689,103,10,21,4,2,2,8,Promising
47931,80,45,186,4,4,5,13,Champions
48337,132,14,120,4,3,4,11,Loyal Users
48419,420,9,30,3,2,2,7,Casual Users
48508,3443,37,166,1,4,5,10,At Risk
48604,666,5,5,2,1,1,4,Lost
48926,402,28,53,3,4,3,10,Loyal Users
48956,433,20,27,3,3,2,8,Loyal Users
49780,393,138,382,3,5,5,13,Loyal Users
50059,1626,9,11,1,2,1,4,Lost
50070,1538,8,13,1,2,1,4,Lost
50165,799,5,7,2,1,1,4,Lost
50240,105,11,87,4,2,4,10,Promising
50848,1080,18,40,2,3,3,8,Casual Users
51107,656,9,11,2,2,1,5,Lost
51258,4844,8,30,1,2,2,5,Lost
51425,2425,7,12,1,2,1,4,Lost
51475,4897,5,74,1,1,4,6,Lost
51665,224,103,717,3,5,5,13,Loyal Users
51672,2314,6,12,1,1,1,3,Lost
52093,1274,10,21,1,2,2,5,Lost
52135,797,6,14,2,1,1,4,Lost
52182,8,41,75,5,4,4,13,Champions
52361,322,61,133,3,5,4,12,Loyal Users
39320,17,26,56,5,4,3,12,Loyal Users
39397,206,43,89,3,4,4,11,Loyal Users
39599,113,20,33,4,3,3,10,Loyal Users
39777,538,13,57,2,3,3,8,Casual Users
39913,190,6,28,3,1,2,6,Casual Users
39996,131,53,192,4,5,5,14,Champions
40047,69,19,33,5,3,3,11,Loyal Users
40293,752,13,17,2,3,2,7,Casual Users
40302,1838,13,30,1,3,2,6,Casual Users
40536,294,14,40,3,3,3,9,Loyal Users
40752,12,7,10,5,2,1,8,Promising
40833,3908,5,6,1,1,1,3,Lost
41206,272,16,83,3,3,4,10,Loyal Users
41212,2991,7,17,1,2,2,5,Lost
41413,845,17,24,2,3,2,7,Casual Users
41460,63,11,24,5,2,2,9,Promising
42910,842,7,31,2,2,2,6,Lost
43051,2108,5,10,1,1,1,3,Lost
43174,157,44,75,4,4,4,12,Champions
43354,556,10,25,2,2,2,6,Lost
43700,462,15,26,3,3,2,8,Loyal Users
43730,1594,15,32,1,3,3,7,Casual Users
43873,595,9,31,2,2,2,6,Lost
44125,544,8,9,2,2,1,5,Lost
44332,17,101,917,5,5,5,15,Champions
44449,214,37,140,3,4,4,11,Loyal Users
44489,8,99,284,5,5,5,15,Champions
44895,2143,6,29,1,1,2,4,Lost
45255,63,34,60,5,4,3,12,Loyal Users
45466,1698,6,33,1,1,3,5,Lost
45669,133,22,62,4,4,3,11,Loyal Users
45764,178,91,164,3,5,5,13,Loyal Users
46333,3419,12,16,1,3,2,6,Casual Users
46419,5,28,143,5,4,4,13,Champions
46655,423,6,13,3,1,1,5,Casual Users
46794,661,5,14,2,1,1,4,Lost
46897,1083,17,135,2,3,4,9,Casual Users
46951,1021,15,31,2,3,2,7,Casual Users
47023,811,9,9,2,2,1,5,Lost
47104,138,74,256,4,5,5,14,Champions
47341,930,12,31,2,3,2,7,Casual Users
47589,832,7,11,2,2,1,5,Lost
47601,4,20,69,5,3,4,12,Loyal Users
47788,258,22,73,3,4,4,11,Loyal Users
48085,10,16,28,5,3,2,10,Loyal Users
48930,1176,10,19,2,2,2,6,Lost
49413,840,18,26,2,3,2,7,Casual Users
49438,1540,14,30,1,3,2,6,Casual Users
49562,371,7,12,3,2,1,6,Casual Users
49730,1536,5,5,1,1,1,3,Lost
49832,112,22,88,4,4,4,12,Champions
50123,973,8,10,2,2,1,5,Lost
50317,108,95,608,4,5,5,14,Champions
50534,1473,17,21,1,3,2,6,Casual Users
51974,5280,6,7,1,1,1,3,Lost
51981,4663,8,13,1,2,1,4,Lost
52121,2077,5,6,1,1,1,3,Lost
52167,1216,12,95,2,3,4,9,Casual Users
52353,2011,11,24,1,2,2,5,Lost
39288,2598,10,28,1,2,2,5,Lost
39378,524,5,9,2,1,1,4,Lost
39442,107,117,550,4,5,5,14,Champions
39710,1069,30,76,2,4,4,10,At Risk
39785,60,86,527,5,5,5,15,Champions
39922,14,17,29,5,3,2,10,Loyal Users
39947,222,8,27,3,2,2,7,Casual Users
40112,331,58,75,3,5,4,12,Loyal Users
40595,270,22,27,3,4,2,9,Loyal Users
40604,2734,10,13,1,2,1,4,Lost
41347,970,6,9,2,1,1,4,Lost
41371,579,15,21,2,3,2,7,Casual Users
41631,890,15,45,2,3,3,8,Casual Users
41857,655,6,58,2,1,3,6,Lost
41926,3881,5,7,1,1,1,3,Lost
42058,114,34,133,4,4,4,12,Champions
42173,217,7,9,3,2,1,6,Casual Users
42691,29,33,52,5,4,3,12,Loyal Users
42919,3277,42,118,1,4,4,9,At Risk
43390,124,21,50,4,3,3,10,Loyal Users
43473,280,24,100,3,4,4,11,Loyal Users
43532,36,33,98,5,4,4,13,Champions
43585,281,12,36,3,3,3,9,Loyal Users
43698,3250,8,8,1,2,1,4,Lost
44338,15,11,37,5,2,3,10,Promising
44339,291,7,11,3,2,1,6,Casual Users
44954,5759,12,33,1,3,3,7,Casual Users
45129,722,40,41,2,4,3,9,At Risk
45528,91,39,109,4,4,4,12,Champions
45560,1253,10,65,2,2,4,8,Lost
45790,415,9,31,3,2,2,7,Casual Users
46009,1401,10,35,1,2,3,6,Lost
46027,1125,17,57,2,3,3,8,Casual Users
46679,665,9,9,2,2,1,5,Lost
46745,1414,8,20,1,2,2,5,Lost
46982,142,56,157,4,5,5,14,Champions
47007,673,7,12,2,2,1,5,Lost
47136,468,13,26,3,3,2,8,Loyal Users
47137,733,21,51,2,3,3,8,Casual Users
47258,498,19,99,2,3,4,9,Casual Users
47388,148,17,22,4,3,2,9,Loyal Users
47468,16,63,238,5,5,5,15,Champions
48290,59,26,68,5,4,4,13,Champions
48461,3733,10,13,1,2,1,4,Lost
48725,438,16,24,3,3,2,8,Loyal Users
48784,685,15,68,2,3,4,9,Casual Users
48869,499,10,41,2,2,3,7,Lost
49112,286,46,165,3,5,5,13,Loyal Users
49188,434,5,6,3,1,1,5,Casual Users
49231,245,16,41,3,3,3,9,Loyal Users
49803,3281,8,16,1,2,2,5,Lost
49928,45,62,99,5,5,4,14,Champions
49987,70,76,529,4,5,5,14,Champions
50010,415,12,13,3,3,1,7,Loyal Users
50022,735,58,115,2,5,4,11,At Risk
50055,1731,35,121,1,4,4,9,At Risk
50741,2720,5,31,1,1,2,4,Lost
50943,2666,19,124,1,3,4,8,Casual Users
51206,998,7,8,2,2,1,5,Lost
51338,123,71,283,4,5,5,14,Champions
51967,106,31,222,4,4,5,13,Champions
52061,1990,9,15,1,2,1,4,Lost
52114,1682,7,8,1,2,1,4,Lost
52225,227,80,295,3,5,5,13,Loyal Users
39251,434,10,18,3,2,2,7,Casual Users
39292,816,7,7,2,2,1,5,Lost
39508,2122,8,14,1,2,1,4,Lost
39511,3080,8,10,1,2,1,4,Lost
39602,549,18,26,2,3,2,7,Casual Users
39624,2665,8,10,1,2,1,4,Lost
39753,24,76,315,5,5,5,15,Champions
39968,7,35,101,5,4,4,13,Champions
40057,55,37,230,5,4,5,14,Champions
40081,5256,6,13,1,1,1,3,Lost
40244,280,21,88,3,3,4,10,Loyal Users
40448,251,17,31,3,3,2,8,Loyal Users
40906,767,16,43,2,3,3,8,Casual Users
40933,568,7,15,2,2,1,5,Lost
41069,83,50,127,4,5,4,13,Champions
41093,3127,15,20,1,3,2,6,Casual Users
41603,135,44,133,4,4,4,12,Champions
41919,35,5,6,5,1,1,7,Promising
42139,175,34,46,3,4,3,10,Loyal Users
42528,19,107,230,5,5,5,15,Champions
42607,691,11,22,2,2,2,6,Lost
42855,119,80,405,4,5,5,14,Champions
42895,124,54,106,4,5,4,13,Champions
43143,1997,10,92,1,2,4,7,Lost
43187,152,113,452,4,5,5,14,Champions
43734,63,18,43,5,3,3,11,Loyal Users
44236,2118,46,83,1,5,4,10,At Risk
44345,1021,8,44,2,2,3,7,Lost
44371,2717,7,9,1,2,1,4,Lost
44413,70,128,557,4,5,5,14,Champions
44663,469,5,21,3,1,2,6,Casual Users
44761,3438,7,7,1,2,1,4,Lost
44985,1158,17,70,2,3,4,9,Casual Users
45347,259,12,68,3,3,4,10,Loyal Users
45362,452,5,9,3,1,1,5,Casual Users
45407,1228,9,9,2,2,1,5,Lost
45516,1423,9,13,1,2,1,4,Lost
45723,992,30,167,2,4,5,11,At Risk
45841,287,8,11,3,2,1,6,Casual Users
45909,257,98,245,3,5,5,13,Loyal Users
46418,4257,10,13,1,2,1,4,Lost
46445,29,137,307,5,5,5,15,Champions
46706,269,17,70,3,3,4,10,Loyal Users
46791,94,27,135,4,4,4,12,Champions
47055,63,10,35,5,2,3,10,Promising
47397,863,10,11,2,2,1,5,Lost
47725,300,11,31,3,2,2,7,Casual Users
47761,130,6,6,4,1,1,6,Promising
47852,846,6,13,2,1,1,4,Lost
47910,1844,9,15,1,2,1,4,Lost
47922,90,80,271,4,5,5,14,Champions
48026,169,20,72,3,3,4,10,Loyal Users
48219,151,36,175,4,4,5,13,Champions
48263,38,58,255,5,5,5,15,Champions
48455,151,8,32,4,2,3,9,Promising
48862,390,52,72,3,5,4,12,Loyal Users
48999,876,7,54,2,2,3,7,Lost
49009,505,21,37,2,3,3,8,Casual Users
49281,138,5,11,4,1,1,6,Promising
49519,89,7,18,4,2,2,8,Promising
49618,2777,7,12,1,2,1,4,Lost
49783,27,41,113,5,4,4,13,Champions
50045,287,23,54,3,4,3,10,Loyal Users
50146,559,20,51,2,3,3,8,Casual Users
50312,407,35,57,3,4,3,10,Loyal Users
50361,2,150,307,5,5,5,15,Champions
50720,383,7,9,3,2,1,6,Casual Users
50743,16,166,753,5,5,5,15,Champions
50977,27,21,55,5,3,3,11,Loyal Users
50981,1564,5,10,1,1,1,3,Lost
51064,276,12,30,3,3,2,8,Loyal Users
51073,23,76,258,5,5,5,15,Champions
51153,3749,5,11,1,1,1,3,Lost
51221,50,85,394,5,5,5,15,Champions
52150,290,106,486,3,5,5,13,Loyal Users
39278,244,17,68,3,3,4,10,Loyal Users
39453,563,6,28,2,1,2,5,Lost
39459,441,14,45,3,3,3,9,Loyal Users
39526,867,21,25,2,3,2,7,Casual Users
39869,1415,6,10,1,1,1,3,Lost
40094,139,20,38,4,3,3,10,Loyal Users
40114,4134,12,48,1,3,3,7,Casual Users
40429,278,67,115,3,5,4,12,Loyal Users
40932,484,6,7,2,1,1,4,Lost
40942,3644,22,149,1,4,5,10,At Risk
40969,82,17,45,4,3,3,10,Loyal Users
41142,136,23,60,4,4,3,11,Loyal Users
41466,575,12,18,2,3,2,7,Casual Users
41628,94,13,16,4,3,2,9,Loyal Users
41630,4851,7,9,1,2,1,4,Lost
41646,2,126,310,5,5,5,15,Champions
42165,1092,8,9,2,2,1,5,Lost
42279,447,19,53,3,3,3,9,Loyal Users
42491,821,5,5,2,1,1,4,Lost
42549,174,15,29,3,3,2,8,Loyal Users
42706,973,5,5,2,1,1,4,Lost
42930,304,19,50,3,3,3,9,Loyal Users
42935,229,20,26,3,3,2,8,Loyal Users
43292,13,73,176,5,5,5,15,Champions
43587,18,64,352,5,5,5,15,Champions
43996,12,12,92,5,3,4,12,Loyal Users
44384,861,14,40,2,3,3,8,Casual Users
44462,1845,59,90,1,5,4,10,At Risk
44468,514,13,15,2,3,1,6,Casual Users
44900,288,20,29,3,3,2,8,Loyal Users
44955,164,12,110,4,3,4,11,Loyal Users
45206,1932,8,21,1,2,2,5,Lost
45744,106,44,95,4,4,4,12,Champions
45774,223,30,53,3,4,3,10,Loyal Users
45837,3122,10,17,1,2,2,5,Lost
46211,1780,11,35,1,2,3,6,Lost
46304,884,6,13,2,1,1,4,Lost
46649,158,5,13,4,1,1,6,Promising
47391,14,11,20,5,2,2,9,Promising
47592,407,155,359,3,5,5,13,Loyal Users
47811,829,8,31,2,2,2,6,Lost
47835,296,44,213,3,4,5,12,Loyal Users
48146,2433,9,47,1,2,3,6,Lost
48452,818,5,12,2,1,1,4,Lost
48658,2980,22,141,1,4,4,9,At Risk
48777,33,14,37,5,3,3,11,Loyal Users
48894,293,75,202,3,5,5,13,Loyal Users
49039,1012,14,20,2,3,2,7,Casual Users
49092,1629,5,11,1,1,1,3,Lost
49147,997,31,79,2,4,4,10,At Risk
49474,59,21,49,5,3,3,11,Loyal Users
50329,2059,14,19,1,3,2,6,Casual Users
50438,188,42,194,3,4,5,12,Loyal Users
50592,1435,14,18,1,3,2,6,Casual Users
50678,79,45,157,4,4,5,13,Champions
50733,477,8,25,2,2,2,6,Lost
51092,1557,7,14,1,2,1,4,Lost
51143,429,14,32,3,3,3,9,Loyal Users
51402,118,107,540,4,5,5,14,Champions
51404,622,10,13,2,2,1,5,Lost
51534,7,70,197,5,5,5,15,Champions
51644,1979,7,12,1,2,1,4,Lost
51741,572,41,82,2,4,4,10,At Risk
52162,809,9,15,2,2,1,5,Lost
52198,988,7,34,2,2,3,7,Lost
52201,65,48,216,5,5,5,15,Champions
52273,1313,5,11,1,1,1,3,Lost
39364,123,16,28,4,3,2,9,Loyal Users
39682,390,39,136,3,4,4,11,Loyal Users
39890,344,34,62,3,4,3,10,Loyal Users
40180,1544,8,29,1,2,2,5,Lost
40221,2253,14,18,1,3,2,6,Casual Users
40460,217,59,179,3,5,5,13,Loyal Users
40605,791,33,154,2,4,5,11,At Risk
40678,27,149,420,5,5,5,15,Champions
41146,11,11,60,5,2,3,10,Promising
41177,11,32,118,5,4,4,13,Champions
41465,90,30,102,4,4,4,12,Champions
41469,71,94,346,4,5,5,14,Champions
41580,405,9,52,3,2,3,8,Casual Users
42293,488,33,109,2,4,4,10,At Risk
42353,449,23,46,3,4,3,10,Loyal Users
42409,149,9,12,4,2,1,7,Promising
42690,147,35,229,4,4,5,13,Champions
42704,3901,5,12,1,1,1,3,Lost
43158,849,30,70,2,4,4,10,At Risk
43478,125,36,73,4,4,4,12,Champions
43596,17,211,450,5,5,5,15,Champions
43649,2971,13,55,1,3,3,7,Casual Users
43862,92,133,282,4,5,5,14,Champions
44130,2010,16,38,1,3,3,7,Casual Users
44221,4178,5,19,1,1,2,4,Lost
44523,1987,5,5,1,1,1,3,Lost
44763,479,45,167,2,4,5,11,At Risk
45530,8,145,979,5,5,5,15,Champions
45642,8,17,52,5,3,3,11,Loyal Users
45743,604,19,35,2,3,3,8,Casual Users
45846,0,82,249,5,5,5,15,Champions
46837,340,7,12,3,2,1,6,Casual Users
46845,252,27,42,3,4,3,10,Loyal Users
47309,74,35,61,4,4,3,11,Loyal Users
47403,140,28,47,4,4,3,11,Loyal Users
47784,266,8,18,3,2,2,7,Casual Users
47984,29,82,124,5,5,4,14,Champions
47994,119,73,201,4,5,5,14,Champions
48012,147,10,57,4,2,3,9,Promising
48073,3697,7,26,1,2,2,5,Lost
48188,379,9,19,3,2,2,7,Casual Users
48194,300,44,65,3,4,4,11,Loyal Users
48540,19,56,107,5,5,4,14,Champions
49789,46,9,36,5,2,3,10,Promising
49884,123,94,475,4,5,5,14,Champions
49985,5668,5,7,1,1,1,3,Lost
50444,52,53,161,5,5,5,15,Champions
50558,7,18,46,5,3,3,11,Loyal Users
50728,1190,7,13,2,2,1,5,Lost
50776,223,19,66,3,3,4,10,Loyal Users
50830,3827,7,26,1,2,2,5,Lost
50842,2100,7,12,1,2,1,4,Lost
50867,150,32,82,4,4,4,12,Champions
51038,23,49,316,5,5,5,15,Champions
51259,1399,14,25,1,3,2,6,Casual Users
51394,423,17,43,3,3,3,9,Loyal Users
51621,394,10,74,3,2,4,9,Casual Users
51786,171,35,96,3,4,4,11,Loyal Users
51928,317,7,30,3,2,2,7,Casual Users
51985,121,37,155,4,4,5,13,Champions
52055,162,11,44,4,2,3,9,Promising
52176,14,5,10,5,1,1,7,Promising
39598,4017,5,27,1,1,2,4,Lost
39662,1091,8,11,2,2,1,5,Lost
40140,2061,20,39,1,3,3,7,Casual Users
40426,1745,5,7,1,1,1,3,Lost
40640,370,11,11,3,2,1,6,Casual Users
40877,930,6,12,2,1,1,4,Lost
41084,130,16,21,4,3,2,9,Loyal Users
41101,13,74,189,5,5,5,15,Champions
41118,127,38,68,4,4,4,12,Champions
41200,90,17,24,4,3,2,9,Loyal Users
41357,9,141,335,5,5,5,15,Champions
41436,17,60,174,5,5,5,15,Champions
41866,1078,10,15,2,2,1,5,Lost
41868,1123,23,36,2,4,3,9,At Risk
42014,2672,8,17,1,2,2,5,Lost
42378,961,17,100,2,3,4,9,Casual Users
42522,286,13,37,3,3,3,9,Loyal Users
42650,156,12,17,4,3,2,9,Loyal Users
42711,99,39,62,4,4,3,11,Loyal Users
42729,403,9,13,3,2,1,6,Casual Users
42927,942,56,123,2,5,4,11,At Risk
43036,4,19,27,5,3,2,10,Loyal Users
43376,17,9,27,5,2,2,9,Promising
43572,164,23,39,4,4,3,11,Loyal Users
43758,962,42,71,2,4,4,10,At Risk
43892,277,34,52,3,4,3,10,Loyal Users
43899,103,114,351,4,5,5,14,Champions
43924,627,10,22,2,2,2,6,Lost
43942,863,5,6,2,1,1,4,Lost
44016,1410,5,11,1,1,1,3,Lost
44101,161,37,77,4,4,4,12,Champions
44104,13,6,50,5,1,3,9,Promising
44154,261,5,10,3,1,1,5,Casual Users
44215,229,43,62,3,4,3,10,Loyal Users
44622,822,19,41,2,3,3,8,Casual Users
44683,233,123,777,3,5,5,13,Loyal Users
45395,1678,5,9,1,1,1,3,Lost
45493,2559,5,5,1,1,1,3,Lost
45574,145,14,24,4,3,2,9,Loyal Users
45855,4703,6,8,1,1,1,3,Lost
46089,913,5,11,2,1,1,4,Lost
46297,157,20,20,4,3,2,9,Loyal Users
46584,0,127,320,5,5,5,15,Champions
46654,1089,7,30,2,2,2,6,Lost
46710,135,81,367,4,5,5,14,Champions
46892,6,46,333,5,5,5,15,Champions
47060,669,24,40,2,4,3,9,At Risk
47096,1123,18,36,2,3,3,8,Casual Users
47200,34,46,116,5,5,4,14,Champions
47342,22,77,122,5,5,4,14,Champions
47567,232,7,19,3,2,2,7,Casual Users
47644,4,9,16,5,2,2,9,Promising
48094,281,6,6,3,1,1,5,Casual Users
48189,23,7,39,5,2,3,10,Promising
48563,12,32,55,5,4,3,12,Loyal Users
48603,463,7,11,3,2,1,6,Casual Users
48689,175,50,83,3,5,4,12,Loyal Users
49038,2868,8,9,1,2,1,4,Lost
49212,100,52,105,4,5,4,13,Champions
49342,551,5,15,2,1,1,4,Lost
49639,130,21,60,4,3,3,10,Loyal Users
49865,232,20,37,3,3,3,9,Loyal Users
49897,376,29,118,3,4,4,11,Loyal Users
49938,685,12,59,2,3,3,8,Casual Users
50217,2850,9,17,1,2,2,5,Lost
50250,1469,46,61,1,5,3,9,At Risk
50478,65,9,18,5,2,2,9,Promising
50586,85,30,109,4,4,4,12,Champions
50729,307,26,84,3,4,4,11,Loyal Users
50805,1133,39,332,2,4,5,11,At Risk
50883,134,20,37,4,3,3,10,Loyal Users
51162,126,16,17,4,3,2,9,Loyal Users
51410,3,81,131,5,5,4,14,Champions
51548,117,70,294,4,5,5,14,Champions
52131,408,12,42,3,3,3,9,Loyal Users
39329,861,13,19,2,3,2,7,Casual Users
39429,74,63,115,4,5,4,13,Champions
39524,934,5,11,2,1,1,4,Lost
39722,361,49,226,3,5,5,13,Loyal Users
39764,107,53,144,4,5,4,13,Champions
39871,20,80,268,5,5,5,15,Champions
40565,130,67,162,4,5,5,14,Champions
41100,103,5,15,4,1,1,6,Promising
41173,128,24,31,4,4,2,10,Loyal Users
41509,148,31,65,4,4,4,12,Champions
41627,86,75,151,4,5,5,14,Champions
41874,0,190,210,5,5,5,15,Champions
42542,1981,8,24,1,2,2,5,Lost
42596,187,14,18,3,3,2,8,Loyal Users
42654,1859,6,6,1,1,1,3,Lost
42903,300,24,79,3,4,4,11,Loyal Users
42923,143,12,47,4,3,3,10,Loyal Users
43296,134,11,28,4,2,2,8,Promising
43713,421,26,56,3,4,3,10,Loyal Users
44084,545,48,112,2,5,4,11,At Risk
44361,1974,6,9,1,1,1,3,Lost
44619,857,5,8,2,1,1,4,Lost
45097,2501,30,115,1,4,4,9,At Risk
45105,44,32,260,5,4,5,14,Champions
45257,0,98,204,5,5,5,15,Champions
45672,13,135,522,5,5,5,15,Champions
45725,125,149,542,4,5,5,14,Champions
45840,5573,10,10,1,2,1,4,Lost
45943,270,50,427,3,5,5,13,Loyal Users
45997,856,6,12,2,1,1,4,Lost
46322,192,17,54,3,3,3,9,Loyal Users
46811,4167,6,7,1,1,1,3,Lost
46917,2479,12,84,1,3,4,8,Casual Users
46961,525,5,59,2,1,3,6,Lost
46970,424,6,10,3,1,1,5,Casual Users
47156,5461,6,22,1,1,2,4,Lost
47180,163,67,121,4,5,4,13,Champions
47672,702,9,25,2,2,2,6,Lost
47718,5424,6,26,1,1,2,4,Lost
47929,1708,15,26,1,3,2,6,Casual Users
47932,66,83,228,5,5,5,15,Champions
48002,267,39,66,3,4,4,11,Loyal Users
48156,1607,36,93,1,4,4,9,At Risk
48170,31,9,65,5,2,4,11,Promising
48247,304,15,29,3,3,2,8,Loyal Users
48253,40,96,170,5,5,5,15,Champions
48437,153,25,200,4,4,5,13,Champions
48524,731,17,68,2,3,4,9,Casual Users
48672,1477,5,7,1,1,1,3,Lost
48690,18,34,164,5,4,5,14,Champions
48939,2434,7,15,1,2,1,4,Lost
49125,68,120,358,5,5,5,15,Champions
49389,266,29,117,3,4,4,11,Loyal Users
49721,3425,83,222,1,5,5,11,At Risk
50112,896,35,116,2,4,4,10,At Risk
50263,9,51,230,5,5,5,15,Champions
50397,1603,24,42,1,4,3,8,At Risk
50549,3103,9,28,1,2,2,5,Lost
50653,63,125,620,5,5,5,15,Champions
51207,36,113,360,5,5,5,15,Champions
51291,120,33,82,4,4,4,12,Champions
51432,89,36,83,4,4,4,12,Champions
51766,383,13,27,3,3,2,8,Loyal Users
52163,236,41,98,3,4,4,11,Loyal Users
52236,149,34,233,4,4,5,13,Champions
52360,258,7,24,3,2,2,7,Casual Users
39244,185,6,24,3,1,2,6,Casual Users
39418,1718,7,14,1,2,1,4,Lost
39462,14,40,195,5,4,5,14,Champions
39856,54,179,278,5,5,5,15,Champions
40173,11,92,233,5,5,5,15,Champions
40242,130,19,32,4,3,3,10,Loyal Users
40517,1861,5,16,1,1,2,4,Lost
40525,234,12,27,3,3,2,8,Loyal Users
40814,2853,14,71,1,3,4,8,Casual Users
41159,425,14,26,3,3,2,8,Loyal Users
41352,111,25,62,4,4,3,11,Loyal Users
41439,395,28,54,3,4,3,10,Loyal Users
41494,163,14,24,4,3,2,9,Loyal Users
41546,107,61,161,4,5,5,14,Champions
41949,132,15,137,4,3,4,11,Loyal Users
42050,407,25,28,3,4,2,9,Loyal Users
42248,1385,5,8,1,1,1,3,Lost
42361,961,9,25,2,2,2,6,Lost
42616,837,10,67,2,2,4,8,Lost
42852,285,56,240,3,5,5,13,Loyal Users
42961,550,21,231,2,3,5,10,Casual Users
42987,1943,6,28,1,1,2,4,Lost
43534,1536,5,14,1,1,1,3,Lost
43704,661,5,24,2,1,2,5,Lost
43731,1943,5,7,1,1,1,3,Lost
43802,1149,5,12,2,1,1,4,Lost
43842,833,9,16,2,2,2,6,Lost
43919,64,102,516,5,5,5,15,Champions
44118,0,66,117,5,5,4,14,Champions
44251,169,9,34,3,2,3,8,Casual Users
44352,47,8,11,5,2,1,8,Promising
44493,405,9,18,3,2,2,7,Casual Users
44583,142,19,45,4,3,3,10,Loyal Users
44671,118,39,106,4,4,4,12,Champions
45004,120,23,26,4,4,2,10,Loyal Users
45864,22,8,42,5,2,3,10,Promising
45906,778,5,10,2,1,1,4,Lost
45954,273,7,12,3,2,1,6,Casual Users
45968,264,79,100,3,5,4,12,Loyal Users
46067,284,7,10,3,2,1,6,Casual Users
46381,257,35,98,3,4,4,11,Loyal Users
46507,92,11,26,4,2,2,8,Promising
46598,131,5,13,4,1,1,6,Promising
46731,131,65,177,4,5,5,14,Champions
46746,288,20,156,3,3,5,11,Loyal Users
47134,9,79,244,5,5,5,15,Champions
47266,53,40,311,5,4,5,14,Champions
47472,1538,5,16,1,1,2,4,Lost
47631,105,8,30,4,2,2,8,Promising
47638,80,6,40,4,1,3,8,Promising
47661,71,63,209,4,5,5,14,Champions
47670,44,39,43,5,4,3,12,Loyal Users
47823,267,68,270,3,5,5,13,Loyal Users
47890,399,16,86,3,3,4,10,Loyal Users
48225,8,16,117,5,3,4,12,Loyal Users
48268,73,21,107,4,3,4,11,Loyal Users
48390,419,14,140,3,3,4,10,Loyal Users
48670,429,13,21,3,3,2,8,Loyal Users
48883,393,30,52,3,4,3,10,Loyal Users
49457,270,48,63,3,5,4,12,Loyal Users
49494,220,14,34,3,3,3,9,Loyal Users
49613,413,15,113,3,3,4,10,Loyal Users
50150,1430,9,13,1,2,1,4,Lost
50257,448,44,115,3,4,4,11,Loyal Users
50277,213,23,53,3,4,3,10,Loyal Users
50707,969,14,41,2,3,3,8,Casual Users
50823,369,13,56,3,3,3,9,Loyal Users
50869,423,47,82,3,5,4,12,Loyal Users
51177,84,27,47,4,4,3,11,Loyal Users
51478,2792,5,12,1,1,1,3,Lost
51494,384,6,14,3,1,1,5,Casual Users
51581,236,40,158,3,4,5,12,Loyal Users
51933,1706,5,11,1,1,1,3,Lost
52358,53,18,145,5,3,4,12,Loyal Users
39324,278,78,116,3,5,4,12,Loyal Users
39403,143,13,77,4,3,4,11,Loyal Users
39898,4449,18,35,1,3,3,7,Casual Users
39904,224,28,60,3,4,3,10,Loyal Users
39998,799,6,14,2,1,1,4,Lost
40045,372,31,112,3,4,4,11,Loyal Users
40334,112,13,31,4,3,2,9,Loyal Users
40425,82,14,76,4,3,4,11,Loyal Users
40732,756,11,14,2,2,1,5,Lost
40805,141,8,24,4,2,2,8,Promising
41134,4,24,109,5,4,4,13,Champions
41424,4519,10,24,1,2,2,5,Lost
41542,825,7,32,2,2,3,7,Lost
41611,548,23,33,2,4,3,9,At Risk
42925,522,5,25,2,1,2,5,Lost
43122,523,19,28,2,3,2,7,Casual Users
43447,1032,82,150,2,5,5,12,At Risk
43470,7,54,254,5,5,5,15,Champions
43904,1576,6,25,1,1,2,4,Lost
44288,82,79,409,4,5,5,14,Champions
44293,140,16,66,4,3,4,11,Loyal Users
44304,929,16,35,2,3,3,8,Casual Users
44426,694,7,12,2,2,1,5,Lost
44961,118,135,553,4,5,5,14,Champions
45130,195,5,11,3,1,1,5,Casual Users
45470,541,14,39,2,3,3,8,Casual Users
45747,2,28,95,5,4,4,13,Champions
45937,4564,12,34,1,3,3,7,Casual Users
45940,1020,10,19,2,2,2,6,Lost
45990,988,10,24,2,2,2,6,Lost
46069,96,25,59,4,4,3,11,Loyal Users
46376,160,12,23,4,3,2,9,Loyal Users
46495,32,160,500,5,5,5,15,Champions
46610,458,11,29,3,2,2,7,Casual Users
46885,2,38,44,5,4,3,12,Loyal Users
47121,607,33,44,2,4,3,9,At Risk
47607,5580,6,15,1,1,1,3,Lost
47723,1728,11,28,1,2,2,5,Lost
48067,3248,47,94,1,5,4,10,At Risk
48068,24,98,505,5,5,5,15,Champions
48313,952,10,17,2,2,2,6,Lost
48456,17,45,174,5,4,5,14,Champions
48870,3428,6,16,1,1,2,4,Lost
48928,111,24,40,4,4,3,11,Loyal Users
49601,274,15,37,3,3,3,9,Loyal Users
49690,1022,40,64,2,4,4,10,At Risk
50031,305,13,85,3,3,4,10,Loyal Users
50098,75,19,104,4,3,4,11,Loyal Users
50371,145,13,49,4,3,3,10,Loyal Users
50785,1695,9,22,1,2,2,5,Lost
50975,36,27,65,5,4,4,13,Champions
51335,4,28,64,5,4,4,13,Champions
51873,521,7,7,2,2,1,5,Lost
51990,90,14,20,4,3,2,9,Loyal Users
52205,508,33,125,2,4,4,10,At Risk
39679,26,18,50,5,3,3,11,Loyal Users
39794,18,101,159,5,5,5,15,Champions
39940,3102,7,14,1,2,1,4,Lost
40259,25,5,10,5,1,1,7,Promising
40868,125,34,116,4,4,4,12,Champions
40887,331,6,18,3,1,2,6,Casual Users
40928,408,5,18,3,1,2,6,Casual Users
41009,101,30,204,4,4,5,13,Champions
41209,1089,11,12,2,2,1,5,Lost
41222,246,11,36,3,2,3,8,Casual Users
41232,7,24,26,5,4,2,11,Loyal Users
41334,843,13,29,2,3,2,7,Casual Users
41448,1313,8,12,1,2,1,4,Lost
41532,1484,26,46,1,4,3,8,At Risk
41605,4013,10,18,1,2,2,5,Lost
41658,3697,6,9,1,1,1,3,Lost
41828,245,12,42,3,3,3,9,Loyal Users
42918,993,8,22,2,2,2,6,Lost
43023,27,117,349,5,5,5,15,Champions
43058,840,10,26,2,2,2,6,Lost
43117,19,140,212,5,5,5,15,Champions
43306,1084,7,18,2,2,2,6,Lost
43385,1781,5,20,1,1,2,4,Lost
44648,424,9,11,3,2,1,6,Casual Users
45083,50,18,28,5,3,2,10,Loyal Users
45135,1467,5,29,1,1,2,4,Lost
45264,6,8,41,5,2,3,10,Promising
45330,97,14,94,4,3,4,11,Loyal Users
45425,347,43,189,3,4,5,12,Loyal Users
45576,70,19,66,4,3,4,11,Loyal Users
45610,54,28,55,5,4,3,12,Loyal Users
45612,90,20,33,4,3,3,10,Loyal Users
45759,295,13,29,3,3,2,8,Loyal Users
45945,1690,91,143,1,5,4,10,At Risk
45964,355,91,662,3,5,5,13,Loyal Users
46004,324,35,102,3,4,4,11,Loyal Users
46164,0,124,199,5,5,5,15,Champions
46405,21,30,131,5,4,4,13,Champions
46426,167,22,69,3,4,4,11,Loyal Users
46600,840,15,15,2,3,1,6,Casual Users
46634,156,10,32,4,2,3,9,Promising
47035,411,5,44,3,1,3,7,Casual Users
47074,221,26,99,3,4,4,11,Loyal Users
47080,2430,9,22,1,2,2,5,Lost
47092,3537,5,22,1,1,2,4,Lost
47206,79,21,80,4,3,4,11,Loyal Users
47279,116,65,132,4,5,4,13,Champions
47596,17,17,30,5,3,2,10,Loyal Users
47917,1426,22,29,1,4,2,7,At Risk
47980,879,32,68,2,4,4,10,At Risk
48159,1327,45,90,1,4,4,9,At Risk
48179,90,52,211,4,5,5,14,Champions
48427,702,32,101,2,4,4,10,At Risk
48583,399,24,45,3,4,3,10,Loyal Users
49729,126,51,249,4,5,5,14,Champions
49797,841,5,8,2,1,1,4,Lost
49945,30,139,632,5,5,5,15,Champions
50218,1365,23,57,1,4,3,8,At Risk
50515,1991,7,12,1,2,1,4,Lost
50940,97,11,47,4,2,3,9,Promising
51068,451,23,71,3,4,4,11,Loyal Users
51119,479,70,124,2,5,4,11,At Risk
51810,672,12,14,2,3,1,6,Casual Users
51879,141,33,57,4,4,3,11,Loyal Users
51894,45,6,6,5,1,1,7,Promising
51919,41,27,61,5,4,3,12,Loyal Users
52289,51,56,279,5,5,5,15,Champions
39401,1565,8,19,1,2,2,5,Lost
39618,148,73,292,4,5,5,14,Champions
40064,8,9,28,5,2,2,9,Promising
40156,90,16,19,4,3,2,9,Loyal Users
40247,227,18,38,3,3,3,9,Loyal Users
40652,247,15,63,3,3,4,10,Loyal Users
41372,42,6,22,5,1,2,8,Promising
41473,304,25,120,3,4,4,11,Loyal Users
41488,518,13,71,2,3,4,9,Casual Users
41886,23,15,40,5,3,3,11,Loyal Users
42087,307,8,14,3,2,1,6,Casual Users
42136,1264,5,26,1,1,2,4,Lost
42536,8,55,110,5,5,4,14,Champions
42657,161,18,38,4,3,3,10,Loyal Users
43030,987,5,10,2,1,1,4,Lost
43363,1367,9,20,1,2,2,5,Lost
43962,521,23,45,2,4,3,9,At Risk
43993,31,39,272,5,4,5,14,Champions
44030,82,96,385,4,5,5,14,Champions
44065,80,58,107,4,5,4,13,Champions
44272,324,34,101,3,4,4,11,Loyal Users
44284,513,9,29,2,2,2,6,Lost
44563,24,103,439,5,5,5,15,Champions
44849,117,94,329,4,5,5,14,Champions
44962,66,156,892,5,5,5,15,Champions
44982,3498,7,31,1,2,2,5,Lost
45052,118,14,71,4,3,4,11,Loyal Users
45338,17,95,488,5,5,5,15,Champions
45511,11,10,44,5,2,3,10,Promising
45676,7,27,106,5,4,4,13,Champions
45795,126,10,23,4,2,2,8,Promising
45947,122,53,92,4,5,4,13,Champions
46205,354,51,209,3,5,5,13,Loyal Users
46227,1155,19,48,2,3,3,8,Casual Users
46719,2600,18,30,1,3,2,6,Casual Users
47353,38,48,116,5,5,4,14,Champions
47358,177,42,296,3,4,5,12,Loyal Users
47427,323,9,12,3,2,1,6,Casual Users
47561,132,39,121,4,4,4,12,Champions
48389,114,5,31,4,1,2,7,Promising
48422,268,32,93,3,4,4,11,Loyal Users
48474,690,17,48,2,3,3,8,Casual Users
48541,814,5,10,2,1,1,4,Lost
48676,2,89,238,5,5,5,15,Champions
48766,147,60,133,4,5,4,13,Champions
48810,1417,10,35,1,2,3,6,Lost
48813,135,18,60,4,3,3,10,Loyal Users
48927,411,8,17,3,2,2,7,Casual Users
49017,280,6,6,3,1,1,5,Casual Users
49133,1572,37,177,1,4,5,10,At Risk
49139,574,11,17,2,2,2,6,Lost
49195,832,5,5,2,1,1,4,Lost
49214,0,13,24,5,3,2,10,Loyal Users
49579,1413,6,22,1,1,2,4,Lost
49704,573,9,31,2,2,2,6,Lost
49750,358,14,22,3,3,2,8,Loyal Users
49971,5,90,237,5,5,5,15,Champions
50028,101,6,8,4,1,1,6,Promising
50168,135,37,99,4,4,4,12,Champions
51079,845,15,24,2,3,2,7,Casual Users
51300,215,13,37,3,3,3,9,Loyal Users
51430,5,52,160,5,5,5,15,Champions
51469,1164,68,159,2,5,5,12,At Risk
51862,2449,5,25,1,1,2,4,Lost
51915,234,10,62,3,2,3,8,Casual Users
39505,11,15,15,5,3,1,9,Loyal Users
39846,8,69,255,5,5,5,15,Champions
40436,984,5,6,2,1,1,4,Lost
40634,8,39,68,5,4,4,13,Champions
41124,1247,5,16,2,1,2,5,Lost
41125,433,6,7,3,1,1,5,Casual Users
41497,3,73,177,5,5,5,15,Champions
41835,2256,8,12,1,2,1,4,Lost
41954,4742,8,49,1,2,3,6,Lost
42054,780,19,33,2,3,3,8,Casual Users
42059,1855,13,36,1,3,3,7,Casual Users
42328,106,33,94,4,4,4,12,Champions
42334,17,50,122,5,5,4,14,Champions
42356,80,56,210,4,5,5,14,Champions
42403,405,7,21,3,2,2,7,Casual Users
42832,118,5,14,4,1,1,6,Promising
43342,27,9,29,5,2,2,9,Promising
43410,1261,7,16,1,2,2,5,Lost
43462,28,47,310,5,5,5,15,Champions
43502,142,17,24,4,3,2,9,Loyal Users
43645,245,7,55,3,2,3,8,Casual Users
43762,111,7,10,4,2,1,7,Promising
43789,2815,37,102,1,4,4,9,At Risk
44056,150,34,100,4,4,4,12,Champions
44057,17,48,204,5,5,5,15,Champions
44298,834,8,9,2,2,1,5,Lost
44481,152,23,43,4,4,3,11,Loyal Users
44579,730,7,10,2,2,1,5,Lost
44659,116,11,127,4,2,4,10,Promising
44814,22,5,40,5,1,3,9,Promising
45155,996,6,9,2,1,1,4,Lost
45163,2570,6,14,1,1,1,3,Lost
45317,80,108,519,4,5,5,14,Champions
45334,411,6,64,3,1,4,8,Casual Users
45421,401,26,142,3,4,4,11,Loyal Users
45569,11,168,190,5,5,5,15,Champions
46017,3704,6,11,1,1,1,3,Lost
46169,139,19,27,4,3,2,9,Loyal Users
46250,1517,15,29,1,3,2,6,Casual Users
46737,2078,10,11,1,2,1,4,Lost
47363,714,16,21,2,3,2,7,Casual Users
47531,2012,7,14,1,2,1,4,Lost
47891,1001,8,29,2,2,2,6,Lost
48019,10,53,122,5,5,4,14,Champions
48601,1103,22,72,2,4,4,10,At Risk
48890,88,19,41,4,3,3,10,Loyal Users
48996,3864,24,78,1,4,4,9,At Risk
49012,4,39,53,5,4,3,12,Loyal Users
49075,1,94,447,5,5,5,15,Champions
49393,2972,8,143,1,2,4,7,Lost
49518,297,7,12,3,2,1,6,Casual Users
49636,1222,7,7,2,2,1,5,Lost
50118,18,152,230,5,5,5,15,Champions
50235,150,6,21,4,1,2,7,Promising
51061,298,15,52,3,3,3,9,Loyal Users
52346,35,101,528,5,5,5,15,Champions
39358,1451,27,43,1,4,3,8,At Risk
39684,1,8,32,5,2,3,10,Promising
39812,21,13,78,5,3,4,12,Loyal Users
39849,409,32,94,3,4,4,11,Loyal Users
39924,127,163,584,4,5,5,14,Champions
39939,546,6,18,2,1,2,5,Lost
40106,439,5,16,3,1,2,6,Casual Users
40757,121,27,67,4,4,4,12,Champions
41042,121,6,19,4,1,2,7,Promising
41438,2518,8,35,1,2,3,6,Lost
41761,111,96,229,4,5,5,14,Champions
42056,133,121,346,4,5,5,14,Champions
42311,2003,12,36,1,3,3,7,Casual Users
42431,720,10,10,2,2,1,5,Lost
42519,568,16,64,2,3,4,9,Casual Users
42571,1866,7,37,1,2,3,6,Lost
42630,388,7,7,3,2,1,6,Casual Users
42866,108,32,109,4,4,4,12,Champions
42985,225,24,153,3,4,5,12,Loyal Users
43062,317,44,80,3,4,4,11,Loyal Users
43065,2121,12,23,1,3,2,6,Casual Users
43094,1,197,281,5,5,5,15,Champions
43157,135,12,16,4,3,2,9,Loyal Users
43643,379,24,60,3,4,3,10,Loyal Users
43722,6,30,56,5,4,3,12,Loyal Users
43746,1523,9,14,1,2,1,4,Lost
43968,1,21,60,5,3,3,11,Loyal Users
44110,13,32,47,5,4,3,12,Loyal Users
44120,157,123,368,4,5,5,14,Champions
44334,68,49,264,5,5,5,15,Champions
44817,6,7,50,5,2,3,10,Promising
44848,2,14,54,5,3,3,11,Loyal Users
44975,156,102,262,4,5,5,14,Champions
46174,1015,5,7,2,1,1,4,Lost
46384,311,6,14,3,1,1,5,Casual Users
46625,489,45,120,2,4,4,10,At Risk
46860,127,7,8,4,2,1,7,Promising
46956,9,46,69,5,5,4,14,Champions
47125,567,6,17,2,1,2,5,Lost
47212,2849,36,94,1,4,4,9,At Risk
47244,30,121,483,5,5,5,15,Champions
47359,500,11,61,2,2,3,7,Lost
47750,2659,8,46,1,2,3,6,Lost
48199,136,11,110,4,2,4,10,Promising
48606,36,55,119,5,5,4,14,Champions
48846,70,6,9,4,1,1,6,Promising
48974,1540,22,30,1,4,2,7,At Risk
49161,41,8,46,5,2,3,10,Promising
49179,360,12,21,3,3,2,8,Loyal Users
50038,959,8,20,2,2,2,6,Lost
50073,721,51,459,2,5,5,12,At Risk
50134,123,100,142,4,5,4,13,Champions
50659,695,5,12,2,1,1,4,Lost
50696,568,13,38,2,3,3,8,Casual Users
50702,10,19,80,5,3,4,12,Loyal Users
50984,113,18,53,4,3,3,10,Loyal Users
51615,1242,8,127,2,2,4,8,Lost
51664,433,14,41,3,3,3,9,Loyal Users
51738,321,21,23,3,3,2,8,Loyal Users
51794,32,18,242,5,3,5,13,Loyal Users
52108,4255,6,12,1,1,1,3,Lost
39588,4,234,329,5,5,5,15,Champions
40102,17,30,77,5,4,4,13,Champions
40300,3881,14,20,1,3,2,6,Casual Users
40519,867,45,200,2,4,5,11,At Risk
40656,579,7,7,2,2,1,5,Lost
40684,1739,20,60,1,3,3,7,Casual Users
40911,169,9,10,3,2,1,6,Casual Users
41208,580,9,15,2,2,1,5,Lost
41316,158,35,65,4,4,4,12,Champions
41450,519,8,22,2,2,2,6,Lost
41584,4379,9,12,1,2,1,4,Lost
41731,431,55,129,3,5,4,12,Loyal Users
41781,534,34,74,2,4,4,10,At Risk
42737,93,19,118,4,3,4,11,Loyal Users
42862,2467,11,41,1,2,3,6,Lost
42888,4164,9,16,1,2,2,5,Lost
43121,2841,8,8,1,2,1,4,Lost
43267,2357,5,6,1,1,1,3,Lost
43369,10,34,179,5,4,5,14,Champions
43400,1241,17,30,2,3,2,7,Casual Users
43525,644,9,29,2,2,2,6,Lost
43576,3638,9,35,1,2,3,6,Lost
43663,156,12,21,4,3,2,9,Loyal Users
43920,110,13,19,4,3,2,9,Loyal Users
44182,118,35,103,4,4,4,12,Champions
45166,4,62,175,5,5,5,15,Champions
45365,830,9,27,2,2,2,6,Lost
45867,53,78,295,5,5,5,15,Champions
46689,292,14,24,3,3,2,8,Loyal Users
46733,120,21,38,4,3,3,10,Loyal Users
47276,0,67,148,5,5,5,15,Champions
47347,849,7,13,2,2,1,5,Lost
47357,1319,93,157,1,5,5,11,At Risk
47620,2833,7,31,1,2,2,5,Lost
48103,164,47,128,4,5,4,13,Champions
48224,462,13,20,3,3,2,8,Loyal Users
48271,154,73,231,4,5,5,14,Champions
48454,101,35,85,4,4,4,12,Champions
48457,78,10,15,4,2,1,7,Promising
48514,2728,5,6,1,1,1,3,Lost
48627,107,29,168,4,4,5,13,Champions
49119,1763,19,62,1,3,3,7,Casual Users
49347,1084,11,24,2,2,2,6,Lost
49468,87,28,49,4,4,3,11,Loyal Users
49642,4853,14,91,1,3,4,8,Casual Users
50110,259,111,237,3,5,5,13,Loyal Users
50252,2414,13,14,1,3,1,5,Casual Users
50280,749,9,26,2,2,2,6,Lost
50384,1990,16,39,1,3,3,7,Casual Users
50501,784,5,6,2,1,1,4,Lost
50528,458,34,44,3,4,3,10,Loyal Users
50566,13,31,43,5,4,3,12,Loyal Users
50639,109,30,224,4,4,5,13,Champions
50800,10,171,596,5,5,5,15,Champions
51014,44,124,837,5,5,5,15,Champions
51130,68,33,123,5,4,4,13,Champions
51284,132,67,141,4,5,4,13,Champions
51492,950,5,7,2,1,1,4,Lost
51842,138,6,48,4,1,3,8,Promising
52022,2163,11,26,1,2,2,5,Lost
52051,108,82,262,4,5,5,14,Champions
39529,499,8,41,2,2,3,7,Lost
39622,16,8,23,5,2,2,9,Promising
40229,110,20,100,4,3,4,11,Loyal Users
40597,35,31,75,5,4,4,13,Champions
40738,865,9,15,2,2,1,5,Lost
40746,3712,28,28,1,4,2,7,At Risk
40764,132,35,100,4,4,4,12,Champions
40923,566,12,15,2,3,1,6,Casual Users
41005,9,167,220,5,5,5,15,Champions
41034,885,16,46,2,3,3,8,Casual Users
41045,1273,9,14,1,2,1,4,Lost
41301,0,72,238,5,5,5,15,Champions
41724,430,8,11,3,2,1,6,Casual Users
41806,15,62,126,5,5,4,14,Champions
41881,50,43,182,5,4,5,14,Champions
42283,25,122,504,5,5,5,15,Champions
42316,381,37,179,3,4,5,12,Loyal Users
42417,153,20,33,4,3,3,10,Loyal Users
43077,31,124,246,5,5,5,15,Champions
43191,1350,12,23,1,3,2,6,Casual Users
43207,4,81,239,5,5,5,15,Champions
43269,1154,6,6,2,1,1,4,Lost
43437,101,18,94,4,3,4,11,Loyal Users
43509,251,17,67,3,3,4,10,Loyal Users
43542,64,25,77,5,4,4,13,Champions
43744,22,11,31,5,2,2,9,Promising
43791,226,10,46,3,2,3,8,Casual Users
44127,1134,7,14,2,2,1,5,Lost
44265,697,11,23,2,2,2,6,Lost
44447,570,16,17,2,3,2,7,Casual Users
44554,1678,7,11,1,2,1,4,Lost
44797,290,6,8,3,1,1,5,Casual Users
44919,121,9,15,4,2,1,7,Promising
44966,290,31,46,3,4,3,10,Loyal Users
45049,402,14,34,3,3,3,9,Loyal Users
45406,139,25,39,4,4,3,11,Loyal Users
45500,648,16,32,2,3,3,8,Casual Users
45534,347,24,204,3,4,5,12,Loyal Users
45701,335,8,16,3,2,2,7,Casual Users
45824,168,20,114,3,3,4,10,Loyal Users
46338,30,54,163,5,5,5,15,Champions
46382,1356,8,24,1,2,2,5,Lost
46453,828,16,38,2,3,3,8,Casual Users
46504,397,24,33,3,4,3,10,Loyal Users
46648,40,104,295,5,5,5,15,Champions
46700,3,14,48,5,3,3,11,Loyal Users
46725,2300,12,14,1,3,1,5,Casual Users
47122,1979,5,11,1,1,1,3,Lost
47379,758,20,105,2,3,4,9,Casual Users
47564,774,43,329,2,4,5,11,At Risk
47915,231,36,63,3,4,4,11,Loyal Users
47939,1281,8,10,1,2,1,4,Lost
48043,159,45,171,4,4,5,13,Champions
48186,3,76,611,5,5,5,15,Champions
48489,445,180,593,3,5,5,13,Loyal Users
48651,0,8,8,5,2,1,8,Promising
48667,268,37,201,3,4,5,12,Loyal Users
48688,266,28,84,3,4,4,11,Loyal Users
48696,725,9,12,2,2,1,5,Lost
49030,1369,10,20,1,2,2,5,Lost
49060,134,91,343,4,5,5,14,Champions
49395,9,98,220,5,5,5,15,Champions
49501,231,29,52,3,4,3,10,Loyal Users
50040,265,5,8,3,1,1,5,Casual Users
50139,238,11,93,3,2,4,9,Casual Users
50427,2995,6,12,1,1,1,3,Lost
50855,556,40,248,2,4,5,11,At Risk
51057,905,16,20,2,3,2,7,Casual Users
51087,570,6,10,2,1,1,4,Lost
51114,102,22,52,4,4,3,11,Loyal Users
51151,17,44,213,5,4,5,14,Champions
51313,957,16,67,2,3,4,9,Casual Users
51422,2119,6,24,1,1,2,4,Lost
51586,2946,11,38,1,2,3,6,Lost
51645,1104,27,43,2,4,3,9,At Risk
51838,1534,5,23,1,1,2,4,Lost
52265,30,139,361,5,5,5,15,Champions
52271,140,16,24,4,3,2,9,Loyal Users
39853,995,19,47,2,3,3,8,Casual Users
40641,496,20,94,2,3,4,9,Casual Users
40709,4580,5,17,1,1,2,4,Lost
40885,697,21,105,2,3,4,9,Casual Users
40913,626,6,6,2,1,1,4,Lost
40935,4472,20,46,1,3,3,7,Casual Users
41144,5306,7,27,1,2,2,5,Lost
41287,76,39,184,4,4,5,13,Champions
41711,64,5,18,5,1,2,8,Promising
41766,444,21,37,3,3,3,9,Loyal Users
41784,20,38,228,5,4,5,14,Champions
41861,3350,9,10,1,2,1,4,Lost
42223,1230,15,52,2,3,3,8,Casual Users
42241,8,75,204,5,5,5,15,Champions
42447,10,79,396,5,5,5,15,Champions
42581,213,6,8,3,1,1,5,Casual Users
43356,557,51,96,2,5,4,11,At Risk
44108,18,27,42,5,4,3,12,Loyal Users
44171,204,8,10,3,2,1,6,Casual Users
44188,1045,9,22,2,2,2,6,Lost
44389,297,58,222,3,5,5,13,Loyal Users
45096,7,121,241,5,5,5,15,Champions
45340,20,70,337,5,5,5,15,Champions
45451,3139,5,13,1,1,1,3,Lost
45552,183,13,15,3,3,1,7,Loyal Users
45632,783,13,32,2,3,3,8,Casual Users
45753,269,38,119,3,4,4,11,Loyal Users
46013,37,10,21,5,2,2,9,Promising
46492,2910,8,50,1,2,3,6,Lost
46559,3081,5,5,1,1,1,3,Lost
46624,77,26,34,4,4,3,11,Loyal Users
46678,29,87,203,5,5,5,15,Champions
47093,116,10,45,4,2,3,9,Promising
47962,1418,24,59,1,4,3,8,At Risk
48226,1,21,24,5,3,2,10,Loyal Users
48506,117,35,90,4,4,4,12,Champions
48825,172,34,79,3,4,4,11,Loyal Users
49020,1573,5,25,1,1,2,4,Lost
49081,215,25,95,3,4,4,11,Loyal Users
49099,4839,16,42,1,3,3,7,Casual Users
49108,537,9,51,2,2,3,7,Lost
49243,5575,19,40,1,3,3,7,Casual Users
49320,904,13,14,2,3,1,6,Casual Users
49587,90,23,38,4,4,3,11,Loyal Users
49707,2968,5,9,1,1,1,3,Lost
49871,8,27,51,5,4,3,12,Loyal Users
49981,2422,25,33,1,4,3,8,At Risk
50356,941,13,31,2,3,2,7,Casual Users
50594,5,18,41,5,3,3,11,Loyal Users
50691,68,33,51,5,4,3,12,Loyal Users
50972,434,18,32,3,3,3,9,Loyal Users
51405,8,83,303,5,5,5,15,Champions
51628,27,14,24,5,3,2,10,Loyal Users
51753,954,9,15,2,2,1,5,Lost
51964,218,18,29,3,3,2,8,Loyal Users
39419,424,8,20,3,2,2,7,Casual Users
39737,88,7,11,4,2,1,7,Promising
39781,418,24,28,3,4,2,9,Loyal Users
40174,1097,6,44,2,1,3,6,Lost
40980,17,133,314,5,5,5,15,Champions
40985,3472,7,10,1,2,1,4,Lost
41256,525,8,17,2,2,2,6,Lost
41502,714,9,9,2,2,1,5,Lost
41519,231,9,11,3,2,1,6,Casual Users
41617,413,50,218,3,5,5,13,Loyal Users
42411,57,56,442,5,5,5,15,Champions
42608,132,17,21,4,3,2,9,Loyal Users
42709,126,14,70,4,3,4,11,Loyal Users
42738,238,86,139,3,5,4,12,Loyal Users
43879,303,18,33,3,3,3,9,Loyal Users
44053,471,49,109,2,5,4,11,At Risk
44367,538,17,70,2,3,4,9,Casual Users
44382,116,8,8,4,2,1,7,Promising
44509,305,11,18,3,2,2,7,Casual Users
44647,1169,31,186,2,4,5,11,At Risk
44702,544,18,23,2,3,2,7,Casual Users
44747,1579,21,64,1,3,4,8,Casual Users
44769,2116,11,17,1,2,2,5,Lost
44827,943,16,162,2,3,5,10,Casual Users
45006,2890,6,19,1,1,2,4,Lost
45079,467,13,38,3,3,3,9,Loyal Users
45106,267,31,101,3,4,4,11,Loyal Users
45158,429,5,7,3,1,1,5,Casual Users
45263,1814,5,83,1,1,4,6,Lost
45345,1268,13,49,1,3,3,7,Casual Users
45354,20,25,71,5,4,4,13,Champions
45478,2375,8,34,1,2,3,6,Lost
45495,21,29,43,5,4,3,12,Loyal Users
45888,790,11,28,2,2,2,6,Lost
46002,60,13,20,5,3,2,10,Loyal Users
46241,159,12,26,4,3,2,9,Loyal Users
46551,132,6,11,4,1,1,6,Promising
47105,4630,8,8,1,2,1,4,Lost
47152,56,49,242,5,5,5,15,Champions
47469,1040,8,19,2,2,2,6,Lost
47636,312,11,44,3,2,3,8,Casual Users
47779,661,21,58,2,3,3,8,Casual Users
48029,129,62,270,4,5,5,14,Champions
48107,186,15,23,3,3,2,8,Loyal Users
48459,5,54,165,5,5,5,15,Champions
48516,102,39,82,4,4,4,12,Champions
48533,2993,11,24,1,2,2,5,Lost
48836,233,11,25,3,2,2,7,Casual Users
48889,1850,16,27,1,3,2,6,Casual Users
48911,1010,12,75,2,3,4,9,Casual Users
49028,235,6,8,3,1,1,5,Casual Users
49078,118,107,177,4,5,5,14,Champions
49169,418,8,83,3,2,4,9,Casual Users
49189,2104,15,15,1,3,1,5,Casual Users
49203,117,24,30,4,4,2,10,Loyal Users
49236,158,62,337,4,5,5,14,Champions
49307,531,27,46,2,4,3,9,At Risk
49546,889,14,14,2,3,1,6,Casual Users
49665,274,23,58,3,4,3,10,Loyal Users
49930,77,105,334,4,5,5,14,Champions
49932,449,39,85,3,4,4,11,Loyal Users
50440,683,17,46,2,3,3,8,Casual Users
50642,1410,5,5,1,1,1,3,Lost
51267,845,44,139,2,4,4,10,At Risk
51624,285,18,57,3,3,3,9,Loyal Users
51713,868,16,19,2,3,2,7,Casual Users
51877,9,114,898,5,5,5,15,Champions
52067,223,38,80,3,4,4,11,Loyal Users
52251,46,109,274,5,5,5,15,Champions
52279,3,20,94,5,3,4,12,Loyal Users
52302,39,30,47,5,4,3,12,Loyal Users
39839,49,31,104,5,4,4,13,Champions
40297,12,51,117,5,5,4,14,Champions
40966,2333,7,12,1,2,1,4,Lost
41041,15,113,194,5,5,5,15,Champions
41054,433,11,55,3,2,3,8,Casual Users
41130,283,6,8,3,1,1,5,Casual Users
41139,534,13,16,2,3,2,7,Casual Users
41149,522,7,15,2,2,1,5,Lost
41423,362,25,84,3,4,4,11,Loyal Users
41595,130,17,83,4,3,4,11,Loyal Users
41742,93,92,251,4,5,5,14,Champions
42207,2005,9,19,1,2,2,5,Lost
42307,716,21,34,2,3,3,8,Casual Users
43012,424,8,12,3,2,1,6,Casual Users
43249,26,6,20,5,1,2,8,Promising
43290,5,91,161,5,5,5,15,Champions
43315,196,6,11,3,1,1,5,Casual Users
43621,672,18,45,2,3,3,8,Casual Users
43624,2983,5,7,1,1,1,3,Lost
43657,3138,5,11,1,1,1,3,Lost
44640,523,5,32,2,1,3,6,Lost
44731,1406,9,36,1,2,3,6,Lost
44734,996,5,24,2,1,2,5,Lost
45162,122,35,167,4,4,5,13,Champions
45299,1491,7,12,1,2,1,4,Lost
45600,98,26,78,4,4,4,12,Champions
45835,2483,14,24,1,3,2,6,Casual Users
46018,12,93,375,5,5,5,15,Champions
46202,105,72,127,4,5,4,13,Champions
46568,651,12,53,2,3,3,8,Casual Users
46802,543,64,104,2,5,4,11,At Risk
46858,128,42,97,4,4,4,12,Champions
47043,4458,6,9,1,1,1,3,Lost
47818,347,20,30,3,3,2,8,Loyal Users
47881,104,31,291,4,4,5,13,Champions
48061,64,82,366,5,5,5,15,Champions
48138,23,19,164,5,3,5,13,Loyal Users
48347,675,19,66,2,3,4,9,Casual Users
48415,149,29,221,4,4,5,13,Champions
48691,438,18,46,3,3,3,9,Loyal Users
48762,2292,7,7,1,2,1,4,Lost
49064,1141,5,49,2,1,3,6,Lost
49475,722,10,10,2,2,1,5,Lost
49731,2838,7,7,1,2,1,4,Lost
49778,264,10,29,3,2,2,7,Casual Users
49798,822,5,20,2,1,2,5,Lost
50297,2850,10,33,1,2,3,6,Lost
50620,2264,6,6,1,1,1,3,Lost
50795,1012,7,29,2,2,2,6,Lost
51012,162,11,51,4,2,3,9,Promising
51016,158,30,70,4,4,4,12,Champions
51030,130,16,37,4,3,3,10,Loyal Users
51056,1683,8,97,1,2,4,7,Lost
51235,68,70,218,5,5,5,15,Champions
51378,1689,8,29,1,2,2,5,Lost
51400,589,5,7,2,1,1,4,Lost
51599,2441,10,12,1,2,1,4,Lost
51603,266,16,83,3,3,4,10,Loyal Users
51744,53,7,14,5,2,1,8,Promising
51749,1801,11,24,1,2,2,5,Lost
51806,543,8,29,2,2,2,6,Lost
52174,993,58,195,2,5,5,12,At Risk
52278,2233,16,27,1,3,2,6,Casual Users
39294,364,19,42,3,3,3,9,Loyal Users
39314,1115,7,12,2,2,1,5,Lost
39677,3102,6,13,1,1,1,3,Lost
40028,398,6,11,3,1,1,5,Casual Users
40235,483,15,28,2,3,2,7,Casual Users
40497,791,5,6,2,1,1,4,Lost
40635,4728,10,39,1,2,3,6,Lost
40852,12,96,365,5,5,5,15,Champions
40964,2944,6,10,1,1,1,3,Lost
41027,354,13,184,3,3,5,11,Loyal Users
41355,549,26,40,2,4,3,9,At Risk
41685,1,67,290,5,5,5,15,Champions
41808,818,16,48,2,3,3,8,Casual Users
42247,1274,14,19,1,3,2,6,Casual Users
42299,2376,9,10,1,2,1,4,Lost
42446,217,6,20,3,1,2,6,Casual Users
42463,2429,8,20,1,2,2,5,Lost
42523,468,19,121,3,3,4,10,Loyal Users
42684,635,11,27,2,2,2,6,Lost
43179,15,99,524,5,5,5,15,Champions
43300,687,15,46,2,3,3,8,Casual Users
43420,13,47,109,5,5,4,14,Champions
43494,114,40,164,4,4,5,13,Champions
43827,138,28,77,4,4,4,12,Champions
44617,298,7,16,3,2,2,7,Casual Users
44818,185,20,27,3,3,2,8,Loyal Users
45353,22,56,220,5,5,5,15,Champions
45660,80,96,235,4,5,5,14,Champions
45766,152,59,294,4,5,5,14,Champions
45972,1581,29,72,1,4,4,9,At Risk
46084,1145,18,91,2,3,4,9,Casual Users
46139,971,15,25,2,3,2,7,Casual Users
46183,206,121,286,3,5,5,13,Loyal Users
46920,2270,17,34,1,3,3,7,Casual Users
47147,1078,12,33,2,3,3,8,Casual Users
47267,8,57,122,5,5,4,14,Champions
47429,82,34,51,4,4,3,11,Loyal Users
47681,3,144,363,5,5,5,15,Champions
48090,1194,33,224,2,4,5,11,At Risk
48616,749,11,23,2,2,2,6,Lost
48971,2707,8,8,1,2,1,4,Lost
48989,81,183,340,4,5,5,14,Champions
49072,1566,17,40,1,3,3,7,Casual Users
49136,77,22,105,4,4,4,12,Champions
49313,259,59,204,3,5,5,13,Loyal Users
49499,0,50,196,5,5,5,15,Champions
49616,2812,5,41,1,1,3,5,Lost
49705,2,84,288,5,5,5,15,Champions
49776,1117,12,15,2,3,1,6,Casual Users
49788,357,6,9,3,1,1,5,Casual Users
49844,465,18,25,3,3,2,8,Loyal Users
50087,33,18,60,5,3,3,11,Loyal Users
50331,507,12,16,2,3,2,7,Casual Users
50700,381,6,8,3,1,1,5,Casual Users
50917,1277,7,25,1,2,2,5,Lost
51104,597,10,34,2,2,3,7,Lost
51134,250,30,93,3,4,4,11,Loyal Users
51360,4036,32,46,1,4,3,8,At Risk
51412,144,17,29,4,3,2,9,Loyal Users
51420,123,13,18,4,3,2,9,Loyal Users
51643,1263,6,10,1,1,1,3,Lost
51791,23,151,691,5,5,5,15,Champions
52327,68,11,12,5,2,1,8,Promising
39530,414,6,31,3,1,2,6,Casual Users
39601,3904,9,16,1,2,2,5,Lost
40004,515,40,88,2,4,4,10,At Risk
40419,110,91,248,4,5,5,14,Champions
40440,137,10,49,4,2,3,9,Promising
40487,363,17,91,3,3,4,10,Loyal Users
40579,282,17,43,3,3,3,9,Loyal Users
40633,36,76,163,5,5,5,15,Champions
40662,20,30,150,5,4,5,14,Champions
40674,251,28,125,3,4,4,11,Loyal Users
40783,121,8,53,4,2,3,9,Promising
40972,933,5,7,2,1,1,4,Lost
41390,1571,6,13,1,1,1,3,Lost
41588,1509,6,35,1,1,3,5,Lost
41648,23,18,88,5,3,4,12,Loyal Users
42262,258,26,66,3,4,4,11,Loyal Users
42366,4092,22,44,1,4,3,8,At Risk
42770,128,27,104,4,4,4,12,Champions
43002,129,67,169,4,5,5,14,Champions
43024,5,8,12,5,2,1,8,Promising
43104,583,19,34,2,3,3,8,Casual Users
43352,3683,19,50,1,3,3,7,Casual Users
43371,1368,9,27,1,2,2,5,Lost
43391,4574,6,6,1,1,1,3,Lost
43407,3,51,456,5,5,5,15,Champions
43579,147,6,9,4,1,1,6,Promising
44012,722,9,16,2,2,2,6,Lost
44296,636,27,116,2,4,4,10,At Risk
44457,409,10,27,3,2,2,7,Casual Users
44567,2114,6,8,1,1,1,3,Lost
44643,409,33,93,3,4,4,11,Loyal Users
45104,130,11,76,4,2,4,10,Promising
45252,153,30,343,4,4,5,13,Champions
45282,988,11,16,2,2,2,6,Lost
45286,72,118,357,4,5,5,14,Champions
45860,514,31,149,2,4,5,11,At Risk
46028,1979,6,11,1,1,1,3,Lost
46079,1713,12,28,1,3,2,6,Casual Users
46107,3612,6,38,1,1,3,5,Lost
46865,0,156,697,5,5,5,15,Champions
46872,4225,6,11,1,1,1,3,Lost
46934,90,12,30,4,3,2,9,Loyal Users
47065,130,66,250,4,5,5,14,Champions
47318,4,44,98,5,4,4,13,Champions
47485,698,44,87,2,4,4,10,At Risk
47720,165,12,19,4,3,2,9,Loyal Users
47787,2619,9,12,1,2,1,4,Lost
47879,1415,27,53,1,4,3,8,At Risk
48083,284,12,43,3,3,3,9,Loyal Users
48095,787,12,23,2,3,2,7,Casual Users
48134,132,30,99,4,4,4,12,Champions
48196,107,38,65,4,4,4,12,Champions
48297,298,6,37,3,1,3,7,Casual Users
48534,9,35,135,5,4,4,13,Champions
48634,658,10,30,2,2,2,6,Lost
48642,424,19,29,3,3,2,8,Loyal Users
48760,326,48,144,3,5,4,12,Loyal Users
49273,773,25,49,2,4,3,9,At Risk
49702,697,14,56,2,3,3,8,Casual Users
49911,1574,7,32,1,2,3,6,Lost
49990,37,85,148,5,5,5,15,Champions
50259,121,7,16,4,2,2,8,Promising
50500,1352,18,22,1,3,2,6,Casual Users
50527,102,53,211,4,5,5,14,Champions
50557,781,21,155,2,3,5,10,Casual Users
50705,1118,23,180,2,4,5,11,At Risk
51077,2933,9,11,1,2,1,4,Lost
51362,1604,5,7,1,1,1,3,Lost
51496,844,21,50,2,3,3,8,Casual Users
51508,179,54,167,3,5,5,13,Loyal Users
51553,3,93,147,5,5,5,15,Champions
51601,32,6,10,5,1,1,7,Promising
51693,670,11,34,2,2,3,7,Lost
51696,37,14,72,5,3,4,12,Loyal Users
51896,248,17,77,3,3,4,10,Loyal Users
39270,129,61,83,4,5,4,13,Champions
39375,44,25,28,5,4,2,11,Loyal Users
39458,576,8,18,2,2,2,6,Lost
39616,1090,12,42,2,3,3,8,Casual Users
39647,1537,7,10,1,2,1,4,Lost
39841,4420,5,7,1,1,1,3,Lost
39899,30,20,85,5,3,4,12,Loyal Users
39900,282,20,48,3,3,3,9,Loyal Users
40111,57,39,325,5,4,5,14,Champions
40233,207,16,117,3,3,4,10,Loyal Users
40350,2531,6,42,1,1,3,5,Lost
40637,81,35,140,4,4,4,12,Champions
40798,454,67,98,3,5,4,12,Loyal Users
40894,20,69,358,5,5,5,15,Champions
40993,3580,7,35,1,2,3,6,Lost
41057,679,18,165,2,3,5,10,Casual Users
41295,74,38,95,4,4,4,12,Champions
41775,95,21,23,4,3,2,9,Loyal Users
41863,41,80,188,5,5,5,15,Champions
42251,140,30,191,4,4,5,13,Champions
42407,73,138,322,4,5,5,14,Champions
42986,57,90,148,5,5,5,15,Champions
43216,922,11,53,2,2,3,7,Lost
43471,67,55,208,5,5,5,15,Champions
43489,250,63,160,3,5,5,13,Loyal Users
43607,2751,5,5,1,1,1,3,Lost
43647,49,104,278,5,5,5,15,Champions
43756,1791,11,21,1,2,2,5,Lost
43897,10,72,91,5,5,4,14,Champions
43991,208,6,8,3,1,1,5,Casual Users
44249,2701,11,15,1,2,1,4,Lost
44287,3,7,11,5,2,1,8,Promising
44469,313,14,29,3,3,2,8,Loyal Users
45120,30,8,23,5,2,2,9,Promising
45137,171,25,53,3,4,3,10,Loyal Users
45462,423,5,18,3,1,2,6,Casual Users
46097,497,24,42,2,4,3,9,At Risk
46151,255,12,28,3,3,2,8,Loyal Users
46449,3104,7,18,1,2,2,5,Lost
46921,5,81,119,5,5,4,14,Champions
47155,304,31,46,3,4,3,10,Loyal Users
47878,272,11,44,3,2,3,8,Casual Users
47888,85,6,48,4,1,3,8,Promising
48615,61,5,22,5,1,2,8,Promising
48719,414,20,70,3,3,4,10,Loyal Users
48724,259,13,25,3,3,2,8,Loyal Users
49266,2312,49,82,1,5,4,10,At Risk
49282,131,28,42,4,4,3,11,Loyal Users
49408,14,12,33,5,3,3,11,Loyal Users
49836,1005,47,130,2,5,4,11,At Risk
50017,1157,10,40,2,2,3,7,Lost
50302,101,61,173,4,5,5,14,Champions
50390,127,11,49,4,2,3,9,Promising
50508,2,13,33,5,3,3,11,Loyal Users
50771,41,88,148,5,5,5,15,Champions
51105,859,16,62,2,3,3,8,Casual Users
51113,754,6,19,2,1,2,5,Lost
51231,530,7,20,2,2,2,6,Lost
51395,12,14,28,5,3,2,10,Loyal Users
51610,122,31,183,4,4,5,13,Champions
51678,429,36,73,3,4,4,11,Loyal Users
51686,158,8,12,4,2,1,7,Promising
51817,221,36,137,3,4,4,11,Loyal Users
51987,631,37,70,2,4,4,10,At Risk
39247,100,71,213,4,5,5,14,Champions
39284,149,7,14,4,2,1,7,Promising
39362,1267,5,19,1,1,2,4,Lost
39382,305,5,7,3,1,1,5,Casual Users
39438,90,27,47,4,4,3,11,Loyal Users
39507,1019,9,10,2,2,1,5,Lost
39738,397,9,39,3,2,3,8,Casual Users
40840,84,132,493,4,5,5,14,Champions
40909,4981,14,20,1,3,2,6,Casual Users
41161,36,45,62,5,4,3,12,Loyal Users
41374,567,31,113,2,4,4,10,At Risk
41484,2082,6,35,1,1,3,5,Lost
41527,90,160,432,4,5,5,14,Champions
41608,220,12,32,3,3,3,9,Loyal Users
41907,66,93,208,5,5,5,15,Champions
42200,275,71,247,3,5,5,13,Loyal Users
42745,255,35,136,3,4,4,11,Loyal Users
42944,2110,26,110,1,4,4,9,At Risk
42992,186,28,233,3,4,5,12,Loyal Users
43966,1293,10,32,1,2,3,6,Lost
44317,13,112,323,5,5,5,15,Champions
44363,1850,5,60,1,1,3,5,Lost
44429,238,15,30,3,3,2,8,Loyal Users
44606,1153,10,10,2,2,1,5,Lost
44727,431,39,47,3,4,3,10,Loyal Users
45170,11,88,263,5,5,5,15,Champions
45303,3159,5,30,1,1,2,4,Lost
45514,125,54,188,4,5,5,14,Champions
46040,1013,11,21,2,2,2,6,Lost
46165,926,84,290,2,5,5,12,At Risk
46496,3114,5,7,1,1,1,3,Lost
46650,34,22,55,5,4,3,12,Loyal Users
46727,1832,7,31,1,2,2,5,Lost
46750,278,7,38,3,2,3,8,Casual Users
46754,128,153,756,4,5,5,14,Champions
46939,2110,6,6,1,1,1,3,Lost
47066,60,12,33,5,3,3,11,Loyal Users
47193,7,15,36,5,3,3,11,Loyal Users
47961,2144,63,342,1,5,5,11,At Risk
48655,132,19,71,4,3,4,11,Loyal Users
48794,98,68,212,4,5,5,14,Champions
48829,533,12,89,2,3,4,9,Casual Users
48864,961,44,150,2,4,5,11,At Risk
48957,483,26,48,2,4,3,9,At Risk
49397,213,55,339,3,5,5,13,Loyal Users
49441,111,56,243,4,5,5,14,Champions
49471,77,22,52,4,4,3,11,Loyal Users
49648,69,176,795,5,5,5,15,Champions
49953,384,11,34,3,2,3,8,Casual Users
50126,776,45,103,2,4,4,10,At Risk
50576,699,5,5,2,1,1,4,Lost
50595,1413,23,25,1,4,2,7,At Risk
51383,2143,7,27,1,2,2,5,Lost
51638,218,27,109,3,4,4,11,Loyal Users
51671,126,13,104,4,3,4,11,Loyal Users
51884,113,31,79,4,4,4,12,Champions
51905,209,17,79,3,3,4,10,Loyal Users
52301,1523,93,244,1,5,5,11,At Risk
39343,526,7,14,2,2,1,5,Lost
39577,3915,10,40,1,2,3,6,Lost
39610,101,50,101,4,5,4,13,Champions
39829,288,46,186,3,5,5,13,Loyal Users
40278,550,20,140,2,3,4,9,Casual Users
40812,32,12,35,5,3,3,11,Loyal Users
40948,143,26,102,4,4,4,12,Champions
41234,2702,19,49,1,3,3,7,Casual Users
41309,98,123,202,4,5,5,14,Champions
41329,64,69,213,5,5,5,15,Champions
41600,2561,6,18,1,1,2,4,Lost
41758,5,76,314,5,5,5,15,Champions
41760,111,25,103,4,4,4,12,Champions
42527,127,55,101,4,5,4,13,Champions
42724,417,5,7,3,1,1,5,Casual Users
42752,87,23,37,4,4,3,11,Loyal Users
42806,114,6,8,4,1,1,6,Promising
42898,469,5,9,3,1,1,5,Casual Users
42922,296,90,156,3,5,5,13,Loyal Users
43229,806,5,12,2,1,1,4,Lost
43230,3606,16,16,1,3,2,6,Casual Users
43634,117,6,11,4,1,1,6,Promising
43807,363,20,112,3,3,4,10,Loyal Users
43841,706,5,5,2,1,1,4,Lost
43910,2580,12,12,1,3,1,5,Casual Users
44416,92,16,48,4,3,3,10,Loyal Users
44652,25,89,368,5,5,5,15,Champions
44796,2242,6,23,1,1,2,4,Lost
44987,265,32,45,3,4,3,10,Loyal Users
45048,1,56,232,5,5,5,15,Champions
45584,104,41,112,4,4,4,12,Champions
45592,28,85,354,5,5,5,15,Champions
45776,471,6,12,2,1,1,4,Lost
46288,4775,6,47,1,1,3,5,Lost
46617,325,15,24,3,3,2,8,Loyal Users
46884,90,5,11,4,1,1,6,Promising
46948,361,9,15,3,2,1,6,Casual Users
47009,859,7,8,2,2,1,5,Lost
47824,467,25,63,3,4,4,11,Loyal Users
48032,115,95,368,4,5,5,14,Champions
48274,449,7,12,3,2,1,6,Casual Users
48406,276,21,74,3,3,4,10,Loyal Users
48521,6,52,66,5,5,4,14,Champions
48716,551,14,43,2,3,3,8,Casual Users
48765,24,29,92,5,4,4,13,Champions
48962,1019,10,40,2,2,3,7,Lost
49163,1143,5,11,2,1,1,4,Lost
49739,801,6,14,2,1,1,4,Lost
50161,277,11,26,3,2,2,7,Casual Users
50192,1129,13,13,2,3,1,6,Casual Users
50245,121,10,60,4,2,3,9,Promising
50538,503,15,62,2,3,3,8,Casual Users
50614,2126,30,43,1,4,3,8,At Risk
50718,6,33,139,5,4,4,13,Champions
50802,558,5,6,2,1,1,4,Lost
51279,115,9,18,4,2,2,8,Promising
51292,140,29,102,4,4,4,12,Champions
52142,50,18,31,5,3,2,10,Loyal Users
52280,383,11,22,3,2,2,7,Casual Users
39712,8,100,228,5,5,5,15,Champions
39826,30,118,324,5,5,5,15,Champions
39936,8,125,391,5,5,5,15,Champions
40046,4679,6,19,1,1,2,4,Lost
40205,297,47,100,3,5,4,12,Loyal Users
40520,123,17,67,4,3,4,11,Loyal Users
40592,863,9,49,2,2,3,7,Lost
40690,199,47,251,3,5,5,13,Loyal Users
40789,127,6,10,4,1,1,6,Promising
40953,1098,5,9,2,1,1,4,Lost
40959,17,22,39,5,4,3,12,Loyal Users
41192,2240,36,178,1,4,5,10,At Risk
41260,190,9,25,3,2,2,7,Casual Users
41431,95,66,148,4,5,5,14,Champions
41499,3504,13,21,1,3,2,6,Casual Users
41644,531,6,12,2,1,1,4,Lost
41982,593,17,28,2,3,2,7,Casual Users
41992,50,54,106,5,5,4,14,Champions
42206,1246,18,30,2,3,2,7,Casual Users
42452,250,11,16,3,2,2,7,Casual Users
43114,1548,13,53,1,3,3,7,Casual Users
43166,1637,5,6,1,1,1,3,Lost
43180,1596,8,16,1,2,2,5,Lost
43786,4262,5,8,1,1,1,3,Lost
43790,48,38,64,5,4,4,13,Champions
43851,234,6,12,3,1,1,5,Casual Users
43956,2141,6,11,1,1,1,3,Lost
44381,301,30,42,3,4,3,10,Loyal Users
44618,306,7,22,3,2,2,7,Casual Users
44677,245,16,70,3,3,4,10,Loyal Users
44782,568,28,180,2,4,5,11,At Risk
44788,370,36,58,3,4,3,10,Loyal Users
44865,1431,5,5,1,1,1,3,Lost
44879,97,39,190,4,4,5,13,Champions
45993,88,57,93,4,5,4,13,Champions
46099,45,19,89,5,3,4,12,Loyal Users
46319,364,11,39,3,2,3,8,Casual Users
46350,15,8,99,5,2,4,11,Promising
46842,222,26,180,3,4,5,12,Loyal Users
46989,285,69,108,3,5,4,12,Loyal Users
47031,131,31,169,4,4,5,13,Champions
47072,560,50,87,2,5,4,11,At Risk
47087,285,51,100,3,5,4,12,Loyal Users
47197,12,79,313,5,5,5,15,Champions
47255,3,179,456,5,5,5,15,Champions
47373,674,34,136,2,4,4,10,At Risk
47389,165,17,21,4,3,2,9,Loyal Users
47523,48,34,151,5,4,5,14,Champions
47526,602,6,41,2,1,3,6,Lost
47809,1310,7,12,1,2,1,4,Lost
48147,116,28,209,4,4,5,13,Champions
48305,425,16,23,3,3,2,8,Loyal Users
48357,131,17,67,4,3,4,11,Loyal Users
48536,28,34,181,5,4,5,14,Champions
48590,600,34,69,2,4,4,10,At Risk
49374,261,19,34,3,3,3,9,Loyal Users
49620,1738,9,15,1,2,1,4,Lost
49727,228,14,35,3,3,3,9,Loyal Users
49813,16,163,348,5,5,5,15,Champions
49831,2651,7,13,1,2,1,4,Lost
49918,87,68,167,4,5,5,14,Champions
50194,311,37,84,3,4,4,11,Loyal Users
50580,8,22,120,5,4,4,13,Champions
50744,404,6,33,3,1,3,7,Casual Users
51020,108,46,135,4,5,4,13,Champions
51040,131,45,266,4,4,5,13,Champions
51358,150,66,167,4,5,5,14,Champions
51866,2511,6,27,1,1,2,4,Lost
51890,99,9,41,4,2,3,9,Promising
52021,106,91,197,4,5,5,14,Champions
52216,376,22,116,3,4,4,11,Loyal Users
39279,112,13,64,4,3,4,11,Loyal Users
39701,23,47,112,5,5,4,14,Champions
39762,409,5,12,3,1,1,5,Casual Users
39847,30,17,24,5,3,2,10,Loyal Users
39857,267,18,83,3,3,4,10,Loyal Users
40407,425,5,17,3,1,2,6,Casual Users
41073,140,18,30,4,3,2,9,Loyal Users
41160,593,8,39,2,2,3,7,Lost
41333,515,13,16,2,3,2,7,Casual Users
41375,18,6,91,5,1,4,10,Promising
41563,120,14,51,4,3,3,10,Loyal Users
41566,409,7,12,3,2,1,6,Casual Users
41697,1108,9,45,2,2,3,7,Lost
41734,81,19,73,4,3,4,11,Loyal Users
41793,69,40,86,5,4,4,13,Champions
41801,137,8,18,4,2,2,8,Promising
41934,452,8,14,3,2,1,6,Casual Users
42104,2172,12,54,1,3,3,7,Casual Users
42239,156,26,157,4,4,5,13,Champions
42521,2976,8,33,1,2,3,6,Lost
42667,123,29,77,4,4,4,12,Champions
42685,391,15,19,3,3,2,8,Loyal Users
42748,2044,14,25,1,3,2,6,Casual Users
42828,262,28,103,3,4,4,11,Loyal Users
42921,353,34,67,3,4,4,11,Loyal Users
43021,15,61,142,5,5,4,14,Champions
43182,500,13,25,2,3,2,7,Casual Users
43201,662,5,39,2,1,3,6,Lost
43264,256,15,52,3,3,3,9,Loyal Users
43294,869,39,146,2,4,4,10,At Risk
43528,850,7,41,2,2,3,7,Lost
43635,208,45,137,3,4,4,11,Loyal Users
43847,2988,8,20,1,2,2,5,Lost
43958,464,20,70,3,3,4,10,Loyal Users
44020,0,122,466,5,5,5,15,Champions
44243,542,20,68,2,3,4,9,Casual Users
44310,2436,5,7,1,1,1,3,Lost
44439,1924,8,8,1,2,1,4,Lost
44540,21,11,57,5,2,3,10,Promising
44556,285,19,33,3,3,3,9,Loyal Users
44646,75,110,238,4,5,5,14,Champions
44810,120,11,30,4,2,2,8,Promising
44850,13,58,158,5,5,5,15,Champions
44977,294,19,36,3,3,3,9,Loyal Users
45599,164,6,20,4,1,2,7,Promising
45773,31,114,690,5,5,5,15,Champions
46024,144,8,55,4,2,3,9,Promising
46134,33,55,460,5,5,5,15,Champions
46254,1365,5,18,1,1,2,4,Lost
46566,1210,5,31,2,1,2,5,Lost
46828,208,26,60,3,4,3,10,Loyal Users
47025,237,7,10,3,2,1,6,Casual Users
47392,13,63,158,5,5,5,15,Champions
47647,1827,9,111,1,2,4,7,Lost
47798,594,8,19,2,2,2,6,Lost
47851,1510,8,68,1,2,4,7,Lost
48001,146,15,26,4,3,2,9,Loyal Users
48176,983,13,41,2,3,3,8,Casual Users
48554,363,17,23,3,3,2,8,Loyal Users
48650,65,49,157,5,5,5,15,Champions
49088,168,36,50,3,4,3,10,Loyal Users
49126,255,5,7,3,1,1,5,Casual Users
49194,125,38,87,4,4,4,12,Champions
49225,8,34,48,5,4,3,12,Loyal Users
49908,85,20,54,4,3,3,10,Loyal Users
50148,1258,24,85,1,4,4,9,At Risk
50582,417,9,9,3,2,1,6,Casual Users
50826,173,14,30,3,3,2,8,Loyal Users
50875,5420,24,52,1,4,3,8,At Risk
51164,3,50,89,5,5,4,14,Champions
51212,196,10,17,3,2,2,7,Casual Users
51294,1278,10,11,1,2,1,4,Lost
51421,277,12,48,3,3,3,9,Loyal Users
51541,683,38,151,2,4,5,11,At Risk
51740,996,15,131,2,3,4,9,Casual Users
51868,464,6,9,3,1,1,5,Casual Users
52242,158,44,277,4,4,5,13,Champions
39391,102,45,305,4,4,5,13,Champions
39423,1656,14,61,1,3,3,7,Casual Users
39689,416,14,44,3,3,3,9,Loyal Users
40192,220,33,41,3,4,3,10,Loyal Users
40272,989,9,15,2,2,1,5,Lost
40807,149,21,26,4,3,2,9,Loyal Users
40975,1250,5,27,2,1,2,5,Lost
41258,418,84,194,3,5,5,13,Loyal Users
41299,131,51,64,4,5,4,13,Champions
41925,1253,6,15,2,1,1,4,Lost
42002,4,62,313,5,5,5,15,Champions
42337,185,87,281,3,5,5,13,Loyal Users
42365,133,31,99,4,4,4,12,Champions
42382,252,6,26,3,1,2,6,Casual Users
42415,1834,6,9,1,1,1,3,Lost
42611,12,7,8,5,2,1,8,Promising
43594,83,35,232,4,4,5,13,Champions
43764,736,19,27,2,3,2,7,Casual Users
43929,31,101,654,5,5,5,15,Champions
43972,65,11,11,5,2,1,8,Promising
44289,517,6,23,2,1,2,5,Lost
44701,945,18,85,2,3,4,9,Casual Users
45184,1304,5,7,1,1,1,3,Lost
45194,19,20,46,5,3,3,11,Loyal Users
45532,413,11,23,3,2,2,7,Casual Users
45727,2990,11,34,1,2,3,6,Lost
45914,3427,16,101,1,3,4,8,Casual Users
45923,7,78,431,5,5,5,15,Champions
47069,1276,21,31,1,3,2,6,Casual Users
47099,3005,7,32,1,2,3,6,Lost
47110,691,27,31,2,4,2,8,At Risk
47226,2,44,91,5,4,4,13,Champions
47591,1459,5,5,1,1,1,3,Lost
47768,2830,6,17,1,1,2,4,Lost
47840,16,19,29,5,3,2,10,Loyal Users
48222,208,96,176,3,5,5,13,Loyal Users
48315,1789,5,57,1,1,3,5,Lost
48366,621,8,16,2,2,2,6,Lost
48376,77,13,21,4,3,2,9,Loyal Users
48528,139,15,101,4,3,4,11,Loyal Users
48817,1472,12,119,1,3,4,8,Casual Users
48820,127,14,43,4,3,3,10,Loyal Users
48874,142,28,90,4,4,4,12,Champions
49192,411,5,25,3,1,2,6,Casual Users
49262,270,51,179,3,5,5,13,Loyal Users
49366,105,10,29,4,2,2,8,Promising
49398,531,15,70,2,3,4,9,Casual Users
49658,253,17,48,3,3,3,9,Loyal Users
49912,1749,5,11,1,1,1,3,Lost
50233,17,39,135,5,4,4,13,Champions
50236,1099,5,9,2,1,1,4,Lost
50307,4,9,14,5,2,1,8,Promising
50399,5,127,466,5,5,5,15,Champions
50412,1547,22,63,1,4,4,9,At Risk
50475,2385,7,24,1,2,2,5,Lost
50786,89,100,329,4,5,5,14,Champions
50870,717,12,39,2,3,3,8,Casual Users
51253,30,118,654,5,5,5,15,Champions
51734,0,161,283,5,5,5,15,Champions
51837,417,29,60,3,4,3,10,Loyal Users
51950,10,15,66,5,3,4,12,Loyal Users
52081,57,66,704,5,5,5,15,Champions
52154,155,5,5,4,1,1,6,Promising
52171,313,35,106,3,4,4,11,Loyal Users
52180,30,100,270,5,5,5,15,Champions
39506,665,6,47,2,1,3,6,Lost
39886,645,24,55,2,4,3,9,At Risk
40023,27,87,208,5,5,5,15,Champions
40169,293,22,87,3,4,4,11,Loyal Users
40358,149,46,207,4,5,5,14,Champions
40366,1435,23,130,1,4,4,9,At Risk
40461,232,31,117,3,4,4,11,Loyal Users
40502,5,68,100,5,5,4,14,Champions
40806,450,6,9,3,1,1,5,Casual Users
40929,208,21,29,3,3,2,8,Loyal Users
41047,100,45,100,4,4,4,12,Champions
41215,0,74,393,5,5,5,15,Champions
41307,684,13,122,2,3,4,9,Casual Users
41732,42,79,321,5,5,5,15,Champions
41762,3800,6,20,1,1,2,4,Lost
41794,22,17,37,5,3,3,11,Loyal Users
41813,258,22,46,3,4,3,10,Loyal Users
41815,187,68,102,3,5,4,12,Loyal Users
41848,63,98,169,5,5,5,15,Champions
41875,28,14,35,5,3,3,11,Loyal Users
41950,171,18,42,3,3,3,9,Loyal Users
41961,1152,10,13,2,2,1,5,Lost
42003,1156,50,71,2,5,4,11,At Risk
42078,11,7,8,5,2,1,8,Promising
42216,751,5,9,2,1,1,4,Lost
42636,93,7,9,4,2,1,7,Promising
42662,131,12,45,4,3,3,10,Loyal Users
42719,695,28,29,2,4,2,8,At Risk
42853,103,36,134,4,4,4,12,Champions
42990,1,71,140,5,5,4,14,Champions
43006,994,12,51,2,3,3,8,Casual Users
43185,111,8,26,4,2,2,8,Promising
43404,4116,11,25,1,2,2,5,Lost
43729,2082,5,15,1,1,1,3,Lost
44264,63,34,56,5,4,3,12,Loyal Users
44434,5606,6,12,1,1,1,3,Lost
44443,291,32,78,3,4,4,11,Loyal Users
44772,1450,20,33,1,3,3,7,Casual Users
45034,24,76,203,5,5,5,15,Champions
45488,1655,12,19,1,3,2,6,Casual Users
45550,231,67,269,3,5,5,13,Loyal Users
45565,241,23,162,3,4,5,12,Loyal Users
45611,435,20,109,3,3,4,10,Loyal Users
45619,716,36,240,2,4,5,11,At Risk
46253,345,63,160,3,5,5,13,Loyal Users
46785,3534,7,10,1,2,1,4,Lost
47221,290,97,434,3,5,5,13,Loyal Users
47223,12,130,202,5,5,5,15,Champions
47265,3695,5,8,1,1,1,3,Lost
47416,417,11,23,3,2,2,7,Casual Users
47594,267,45,166,3,4,5,12,Loyal Users
47789,66,121,493,5,5,5,15,Champions
48314,621,7,11,2,2,1,5,Lost
48431,668,7,9,2,2,1,5,Lost
48595,2281,5,7,1,1,1,3,Lost
48910,108,48,79,4,5,4,13,Champions
49330,2826,5,10,1,1,1,3,Lost
49491,220,39,244,3,4,5,12,Loyal Users
49638,1996,12,19,1,3,2,6,Casual Users
49734,124,9,62,4,2,3,9,Promising
49822,4,5,10,5,1,1,7,Promising
49907,2,187,425,5,5,5,15,Champions
49998,427,15,17,3,3,2,8,Loyal Users
50026,0,80,527,5,5,5,15,Champions
50215,393,20,37,3,3,3,9,Loyal Users
50220,2476,7,12,1,2,1,4,Lost
50442,98,66,256,4,5,5,14,Champions
51222,1135,8,26,2,2,2,6,Lost
51351,179,23,68,3,4,4,11,Loyal Users
51683,117,11,61,4,2,3,9,Promising
51945,5046,22,30,1,4,2,7,At Risk
51976,4,132,348,5,5,5,15,Champions
52217,967,8,16,2,2,2,6,Lost
39691,2634,7,30,1,2,2,5,Lost
39824,1125,7,9,2,2,1,5,Lost
40063,2,7,7,5,2,1,8,Promising
40099,1381,14,14,1,3,1,5,Casual Users
40116,1673,5,5,1,1,1,3,Lost
40251,940,15,36,2,3,3,8,Casual Users
40401,589,24,65,2,4,4,10,At Risk
40627,506,14,22,2,3,2,7,Casual Users
40771,3,28,63,5,4,4,13,Champions
40781,1186,15,39,2,3,3,8,Casual Users
41113,122,11,14,4,2,1,7,Promising
41262,4,10,32,5,2,3,10,Promising
41719,343,56,139,3,5,4,12,Loyal Users
41880,2697,8,16,1,2,2,5,Lost
41955,136,77,468,4,5,5,14,Champions
42212,15,62,139,5,5,4,14,Champions
42261,112,173,284,4,5,5,14,Champions
42477,234,5,5,3,1,1,5,Casual Users
42763,86,15,43,4,3,3,10,Loyal Users
42814,127,27,55,4,4,3,11,Loyal Users
43099,1142,11,15,2,2,1,5,Lost
43160,103,23,69,4,4,4,12,Champions
43507,110,99,359,4,5,5,14,Champions
43826,21,89,189,5,5,5,15,Champions
44027,4120,17,23,1,3,2,6,Casual Users
44037,3061,7,27,1,2,2,5,Lost
44151,397,28,56,3,4,3,10,Loyal Users
44520,164,12,22,4,3,2,9,Loyal Users
44550,30,116,295,5,5,5,15,Champions
44593,634,9,31,2,2,2,6,Lost
44664,1147,10,22,2,2,2,6,Lost
44729,586,19,37,2,3,3,8,Casual Users
44809,182,33,80,3,4,4,11,Loyal Users
45178,489,11,64,2,2,4,8,Lost
45952,110,58,86,4,5,4,13,Champions
45959,285,24,44,3,4,3,10,Loyal Users
46195,689,19,25,2,3,2,7,Casual Users
46273,2864,7,19,1,2,2,5,Lost
46330,1578,24,85,1,4,4,9,At Risk
46564,32,8,37,5,2,3,10,Promising
46873,384,18,27,3,3,2,8,Loyal Users
46955,731,7,13,2,2,1,5,Lost
46965,193,64,76,3,5,4,12,Loyal Users
47001,66,27,55,5,4,3,12,Loyal Users
47166,1097,10,15,2,2,1,5,Lost
47172,146,39,108,4,4,4,12,Champions
47257,3567,9,19,1,2,2,5,Lost
47407,750,7,16,2,2,2,6,Lost
47565,1382,39,69,1,4,4,9,At Risk
47702,5017,6,12,1,1,1,3,Lost
47815,928,19,57,2,3,3,8,Casual Users
47920,417,7,35,3,2,3,8,Casual Users
48036,586,16,41,2,3,3,8,Casual Users
48062,20,42,358,5,4,5,14,Champions
48079,440,6,7,3,1,1,5,Casual Users
48081,349,70,261,3,5,5,13,Loyal Users
48306,133,16,39,4,3,3,10,Loyal Users
48665,427,6,10,3,1,1,5,Casual Users
48790,137,47,276,4,5,5,14,Champions
48973,2478,8,18,1,2,2,5,Lost
49041,4387,18,76,1,3,4,8,Casual Users
49248,18,20,23,5,3,2,10,Loyal Users
49324,15,21,104,5,3,4,12,Loyal Users
49337,1535,17,34,1,3,3,7,Casual Users
49463,16,48,82,5,5,4,14,Champions
49481,413,20,35,3,3,3,9,Loyal Users
49625,2,41,101,5,4,4,13,Champions
50072,171,52,239,3,5,5,13,Loyal Users
50256,349,35,137,3,4,4,11,Loyal Users
50531,105,19,65,4,3,4,11,Loyal Users
50708,18,43,95,5,4,4,13,Champions
50810,55,56,130,5,5,4,14,Champions
51005,25,36,65,5,4,4,13,Champions
51101,42,40,52,5,4,3,12,Loyal Users
51310,5396,11,15,1,2,1,4,Lost
51682,208,47,284,3,5,5,13,Loyal Users
51880,85,116,315,4,5,5,14,Champions
52200,600,19,119,2,3,4,9,Casual Users
39359,6009,11,15,1,2,1,4,Lost
39619,278,34,77,3,4,4,11,Loyal Users
39675,45,118,199,5,5,5,15,Champions
39695,12,32,73,5,4,4,13,Champions
39727,263,52,180,3,5,5,13,Loyal Users
39976,21,22,107,5,4,4,13,Champions
40071,5005,13,23,1,3,2,6,Casual Users
40241,1293,5,6,1,1,1,3,Lost
40381,136,26,84,4,4,4,12,Champions
40645,110,21,51,4,3,3,10,Loyal Users
40688,2149,12,23,1,3,2,6,Casual Users
40903,726,5,24,2,1,2,5,Lost
40982,101,87,574,4,5,5,14,Champions
41002,121,30,199,4,4,5,13,Champions
41032,62,17,46,5,3,3,11,Loyal Users
41384,580,12,22,2,3,2,7,Casual Users
41558,1423,28,163,1,4,5,10,At Risk
41633,946,18,53,2,3,3,8,Casual Users
41666,3799,5,13,1,1,1,3,Lost
41671,127,54,91,4,5,4,13,Champions
41928,6,77,303,5,5,5,15,Champions
42111,1794,6,6,1,1,1,3,Lost
42123,827,28,66,2,4,4,10,At Risk
42377,160,18,225,4,3,5,12,Loyal Users
42395,863,6,6,2,1,1,4,Lost
42508,1835,5,27,1,1,2,4,Lost
42577,70,25,51,4,4,3,11,Loyal Users
42717,37,55,280,5,5,5,15,Champions
42889,36,126,442,5,5,5,15,Champions
42939,106,21,100,4,3,4,11,Loyal Users
43063,601,49,269,2,5,5,12,At Risk
43096,130,9,91,4,2,4,10,Promising
43181,1152,14,21,2,3,2,7,Casual Users
43257,345,27,46,3,4,3,10,Loyal Users
43355,11,44,52,5,4,3,12,Loyal Users
43760,1433,7,9,1,2,1,4,Lost
44136,1005,9,15,2,2,1,5,Lost
44586,2616,6,6,1,1,1,3,Lost
44886,679,5,5,2,1,1,4,Lost
44978,2697,11,24,1,2,2,5,Lost
45174,15,5,12,5,1,1,7,Promising
45295,292,37,64,3,4,4,11,Loyal Users
45904,2828,6,22,1,1,2,4,Lost
46468,2019,9,25,1,2,2,5,Lost
46563,1479,24,50,1,4,3,8,At Risk
46964,463,7,7,3,2,1,6,Casual Users
47187,444,38,53,3,4,3,10,Loyal Users
47210,80,8,18,4,2,2,8,Promising
47537,163,103,625,4,5,5,14,Champions
47874,716,6,12,2,1,1,4,Lost
48139,72,32,37,4,4,3,11,Loyal Users
48162,94,69,171,4,5,5,14,Champions
48479,2129,8,12,1,2,1,4,Lost
48605,569,17,37,2,3,3,8,Casual Users
48619,274,38,135,3,4,4,11,Loyal Users
49184,5,5,10,5,1,1,7,Promising
49538,239,33,107,3,4,4,11,Loyal Users
49549,28,15,21,5,3,2,10,Loyal Users
49757,467,25,93,3,4,4,11,Loyal Users
49880,3778,13,30,1,3,2,6,Casual Users
49972,125,14,17,4,3,2,9,Loyal Users
50127,10,26,87,5,4,4,13,Champions
50487,471,26,108,2,4,4,10,At Risk
50513,4,8,38,5,2,3,10,Promising
50548,118,17,27,4,3,2,9,Loyal Users
51438,120,25,227,4,4,5,13,Champions
51479,56,11,15,5,2,1,8,Promising
51481,1830,35,63,1,4,4,9,At Risk
51619,316,28,301,3,4,5,12,Loyal Users
51661,65,34,74,5,4,4,13,Champions
51962,103,125,519,4,5,5,14,Champions
52147,73,95,225,4,5,5,14,Champions
39535,714,12,14,2,3,1,6,Casual Users
39838,55,132,381,5,5,5,15,Champions
40044,1780,37,78,1,4,4,9,At Risk
40074,129,23,60,4,4,3,11,Loyal Users
40142,2977,5,8,1,1,1,3,Lost
40225,1293,18,28,1,3,2,6,Casual Users
40951,4,45,230,5,4,5,14,Champions
41031,1116,11,32,2,2,3,7,Lost
41108,1716,11,36,1,2,3,6,Lost
41553,309,31,80,3,4,4,11,Loyal Users
41675,245,12,18,3,3,2,8,Loyal Users
41717,3517,5,77,1,1,4,6,Lost
41812,959,31,81,2,4,4,10,At Risk
42315,3145,5,5,1,1,1,3,Lost
42560,117,57,146,4,5,4,13,Champions
42836,128,39,117,4,4,4,12,Champions
43141,279,11,20,3,2,2,7,Casual Users
43491,515,15,80,2,3,4,9,Casual Users
43503,78,10,13,4,2,1,7,Promising
43872,16,15,92,5,3,4,12,Loyal Users
44128,3201,32,89,1,4,4,9,At Risk
44395,82,28,48,4,4,3,11,Loyal Users
44484,1888,16,17,1,3,2,6,Casual Users
44490,1441,5,6,1,1,1,3,Lost
44516,30,11,38,5,2,3,10,Promising
44993,699,66,138,2,5,4,11,At Risk
45045,2383,6,16,1,1,2,4,Lost
45288,130,31,95,4,4,4,12,Champions
45490,137,10,14,4,2,1,7,Promising
45594,5,18,21,5,3,2,10,Loyal Users
45673,375,5,11,3,1,1,5,Casual Users
45726,656,8,16,2,2,2,6,Lost
46112,943,43,66,2,4,4,10,At Risk
46232,688,39,134,2,4,4,10,At Risk
46415,420,13,66,3,3,4,10,Loyal Users
46644,418,16,20,3,3,2,8,Loyal Users
46698,14,18,48,5,3,3,11,Loyal Users
46995,34,110,364,5,5,5,15,Champions
46996,406,51,85,3,5,4,12,Loyal Users
47569,976,10,24,2,2,2,6,Lost
47587,103,26,173,4,4,5,13,Champions
47717,874,8,18,2,2,2,6,Lost
47802,61,96,247,5,5,5,15,Champions
48099,23,42,98,5,4,4,13,Champions
48163,133,31,82,4,4,4,12,Champions
48202,0,107,393,5,5,5,15,Champions
48702,24,6,7,5,1,1,7,Promising
49050,2,57,88,5,5,4,14,Champions
49172,32,88,327,5,5,5,15,Champions
49341,34,65,361,5,5,5,15,Champions
49508,845,8,13,2,2,1,5,Lost
49983,987,21,58,2,3,3,8,Casual Users
50083,221,42,238,3,4,5,12,Loyal Users
50120,4579,14,36,1,3,3,7,Casual Users
50182,697,6,13,2,1,1,4,Lost
50287,214,11,12,3,2,1,6,Casual Users
50330,8,45,173,5,4,5,14,Champions
50672,411,16,68,3,3,4,10,Loyal Users
50687,97,32,124,4,4,4,12,Champions
50772,126,48,338,4,5,5,14,Champions
51434,1116,13,75,2,3,4,9,Casual Users
51770,465,10,16,3,2,2,7,Casual Users
52152,6,104,396,5,5,5,15,Champions
52261,0,101,598,5,5,5,15,Champions
39282,566,15,29,2,3,2,7,Casual Users
39428,2259,9,48,1,2,3,6,Lost
39707,1440,5,5,1,1,1,3,Lost
40000,872,17,26,2,3,2,7,Casual Users
40041,1817,15,79,1,3,4,8,Casual Users
40126,162,30,60,4,4,3,11,Loyal Users
40236,110,28,38,4,4,3,11,Loyal Users
40543,2409,7,13,1,2,1,4,Lost
40763,1407,14,35,1,3,3,7,Casual Users
40861,1186,10,15,2,2,1,5,Lost
40864,114,8,18,4,2,2,8,Promising
41181,63,36,110,5,4,4,13,Champions
41259,71,19,180,4,3,5,12,Loyal Users
41763,3590,10,21,1,2,2,5,Lost
41799,118,82,348,4,5,5,14,Champions
41908,15,20,156,5,3,5,13,Loyal Users
42126,471,27,110,2,4,4,10,At Risk
42154,431,16,35,3,3,3,9,Loyal Users
42264,252,18,33,3,3,3,9,Loyal Users
42376,9,56,127,5,5,4,14,Champions
42660,2,79,312,5,5,5,15,Champions
43236,1359,6,9,1,1,1,3,Lost
43262,2951,10,29,1,2,2,5,Lost
43265,1948,17,49,1,3,3,7,Casual Users
43414,115,76,248,4,5,5,14,Champions
43712,448,14,37,3,3,3,9,Loyal Users
44167,2134,5,6,1,1,1,3,Lost
44237,4499,5,6,1,1,1,3,Lost
44239,2828,18,35,1,3,3,7,Casual Users
44368,29,30,70,5,4,4,13,Champions
44502,2360,5,7,1,1,1,3,Lost
44706,2457,10,16,1,2,2,5,Lost
44833,36,21,46,5,3,3,11,Loyal Users
44963,34,53,215,5,5,5,15,Champions
45452,24,103,147,5,5,5,15,Champions
45595,562,16,88,2,3,4,9,Casual Users
45617,301,76,299,3,5,5,13,Loyal Users
46021,1126,42,98,2,4,4,10,At Risk
46110,510,6,11,2,1,1,4,Lost
46111,550,22,28,2,4,2,8,At Risk
46638,943,14,79,2,3,4,9,Casual Users
47968,1027,8,35,2,2,3,7,Lost
48723,25,99,314,5,5,5,15,Champions
49116,284,10,24,3,2,2,7,Casual Users
49250,124,5,32,4,1,3,8,Promising
49259,232,31,218,3,4,5,12,Loyal Users
49300,2005,8,11,1,2,1,4,Lost
49586,15,6,13,5,1,1,7,Promising
49859,22,86,293,5,5,5,15,Champions
50035,396,12,16,3,3,2,8,Loyal Users
50058,174,24,47,3,4,3,10,Loyal Users
50085,140,40,92,4,4,4,12,Champions
50368,1,211,669,5,5,5,15,Champions
50630,157,6,8,4,1,1,6,Promising
50688,730,15,29,2,3,2,7,Casual Users
51039,2,58,115,5,5,4,14,Champions
51183,1238,7,32,2,2,3,7,Lost
51401,110,6,16,4,1,2,7,Promising
51680,3430,6,9,1,1,1,3,Lost
51694,812,194,592,2,5,5,12,At Risk
51715,2411,10,11,1,2,1,4,Lost
51814,438,10,49,3,2,3,8,Casual Users
51972,384,27,46,3,4,3,10,Loyal Users
52132,1849,13,30,1,3,2,6,Casual Users
39274,258,26,147,3,4,5,12,Loyal Users
39440,18,23,33,5,4,3,12,Loyal Users
39547,84,64,237,4,5,5,14,Champions
39746,3818,5,9,1,1,1,3,Lost
39828,309,9,11,3,2,1,6,Casual Users
40273,867,5,9,2,1,1,4,Lost
40376,2,14,23,5,3,2,10,Loyal Users
40444,16,100,150,5,5,5,15,Champions
41292,2204,30,47,1,4,3,8,At Risk
41578,570,12,33,2,3,3,8,Casual Users
41629,1126,9,17,2,2,2,6,Lost
41962,284,13,33,3,3,3,9,Loyal Users
42035,654,7,18,2,2,2,6,Lost
42338,15,20,39,5,3,3,11,Loyal Users
42474,1688,12,62,1,3,3,7,Casual Users
42672,506,30,48,2,4,3,9,At Risk
42692,5488,6,9,1,1,1,3,Lost
43263,430,25,33,3,4,3,10,Loyal Users
43266,1710,7,12,1,2,1,4,Lost
43283,164,50,377,4,5,5,14,Champions
43459,281,12,28,3,3,2,8,Loyal Users
43501,2248,5,141,1,1,4,6,Lost
43963,160,19,34,4,3,3,10,Loyal Users
44180,3608,5,11,1,1,1,3,Lost
44341,6,64,357,5,5,5,15,Champions
44396,1358,5,6,1,1,1,3,Lost
44422,171,21,94,3,3,4,10,Loyal Users
44607,20,17,28,5,3,2,10,Loyal Users
44632,276,43,83,3,4,4,11,Loyal Users
44803,132,116,184,4,5,5,14,Champions
44986,766,69,420,2,5,5,12,At Risk
44990,270,17,246,3,3,5,11,Loyal Users
45575,1854,6,14,1,1,1,3,Lost
45659,417,15,15,3,3,1,7,Loyal Users
45752,3462,8,19,1,2,2,5,Lost
45831,529,5,15,2,1,1,4,Lost
46136,29,19,71,5,3,4,12,Loyal Users
46240,1836,24,33,1,4,3,8,At Risk
46348,169,16,61,3,3,3,9,Loyal Users
46414,898,26,121,2,4,4,10,At Risk
46528,1,141,346,5,5,5,15,Champions
46592,285,36,154,3,4,5,12,Loyal Users
46741,477,10,21,2,2,2,6,Lost
46942,2695,5,14,1,1,1,3,Lost
47247,1747,11,23,1,2,2,5,Lost
47375,20,57,110,5,5,4,14,Champions
47420,1,124,481,5,5,5,15,Champions
47861,3556,5,8,1,1,1,3,Lost
48034,5,78,661,5,5,5,15,Champions
48211,5415,5,9,1,1,1,3,Lost
48312,68,46,140,5,5,4,14,Champions
48470,478,30,41,2,4,3,9,At Risk
48490,670,59,285,2,5,5,12,At Risk
48700,451,9,24,3,2,2,7,Casual Users
48739,131,8,11,4,2,1,7,Promising
48767,150,27,58,4,4,3,11,Loyal Users
49004,17,16,62,5,3,3,11,Loyal Users
49211,1588,19,42,1,3,3,7,Casual Users
49256,123,118,192,4,5,5,14,Champions
49526,20,19,42,5,3,3,11,Loyal Users
49528,53,69,180,5,5,5,15,Champions
49615,5932,12,35,1,3,3,7,Casual Users
49641,128,53,85,4,5,4,13,Champions
49720,268,13,29,3,3,2,8,Loyal Users
50204,12,51,148,5,5,5,15,Champions
50539,32,32,69,5,4,4,13,Champions
50682,1605,6,11,1,1,1,3,Lost
51097,68,24,34,5,4,3,12,Loyal Users
51577,670,7,8,2,2,1,5,Lost
51605,2522,5,5,1,1,1,3,Lost
51625,3827,5,9,1,1,1,3,Lost
51781,1659,5,6,1,1,1,3,Lost
51802,47,29,97,5,4,4,13,Champions
51954,110,55,171,4,5,5,14,Champions
52123,2972,5,10,1,1,1,3,Lost
52268,863,6,94,2,1,4,7,Lost
39332,1212,13,102,2,3,4,9,Casual Users
39988,726,11,51,2,2,3,7,Lost
40269,583,6,12,2,1,1,4,Lost
41331,84,83,227,4,5,5,14,Champions
41879,2042,7,9,1,2,1,4,Lost
41935,1776,5,6,1,1,1,3,Lost
42013,581,6,9,2,1,1,4,Lost
42158,4689,9,95,1,2,4,7,Lost
42242,1515,5,9,1,1,1,3,Lost
42482,101,20,56,4,3,3,10,Loyal Users
42624,90,44,89,4,4,4,12,Champions
42680,740,5,16,2,1,2,5,Lost
42740,1651,10,11,1,2,1,4,Lost
42960,2332,8,45,1,2,3,6,Lost
43044,3418,6,7,1,1,1,3,Lost
43299,330,20,107,3,3,4,10,Loyal Users
43334,1238,6,31,2,1,2,5,Lost
43378,460,5,11,3,1,1,5,Casual Users
43513,2891,12,20,1,3,2,6,Casual Users
43556,5034,23,78,1,4,4,9,At Risk
43560,78,92,188,4,5,5,14,Champions
43691,2156,7,13,1,2,1,4,Lost
43728,398,9,10,3,2,1,6,Casual Users
44005,8,32,88,5,4,4,13,Champions
44014,965,5,14,2,1,1,4,Lost
44199,98,14,24,4,3,2,9,Loyal Users
44212,16,88,470,5,5,5,15,Champions
44421,424,6,6,3,1,1,5,Casual Users
44498,1156,6,7,2,1,1,4,Lost
44670,388,27,61,3,4,3,10,Loyal Users
44688,1304,5,6,1,1,1,3,Lost
45021,163,7,20,4,2,2,8,Promising
45118,205,56,130,3,5,4,12,Loyal Users
45319,2693,10,24,1,2,2,5,Lost
45388,256,11,20,3,2,2,7,Casual Users
45670,1667,6,66,1,1,4,6,Lost
45853,689,14,31,2,3,2,7,Casual Users
45919,65,6,9,5,1,1,7,Promising
45939,749,7,10,2,2,1,5,Lost
45989,18,54,364,5,5,5,15,Champions
46256,1756,6,8,1,1,1,3,Lost
46383,9,51,332,5,5,5,15,Champions
46421,157,52,134,4,5,4,13,Champions
46452,1548,6,8,1,1,1,3,Lost
46499,264,35,78,3,4,4,11,Loyal Users
47314,334,13,16,3,3,2,8,Loyal Users
47361,1976,10,13,1,2,1,4,Lost
47382,1281,70,119,1,5,4,10,At Risk
47482,139,33,70,4,4,4,12,Champions
47701,3276,9,9,1,2,1,4,Lost
47727,0,29,47,5,4,3,12,Loyal Users
47743,229,26,244,3,4,5,12,Loyal Users
47755,711,5,11,2,1,1,4,Lost
47918,2,38,114,5,4,4,13,Champions
48129,269,26,82,3,4,4,11,Loyal Users
48382,16,43,235,5,4,5,14,Champions
48630,111,53,108,4,5,4,13,Champions
48884,236,36,70,3,4,4,11,Loyal Users
48912,3081,5,9,1,1,1,3,Lost
49375,1133,12,50,2,3,3,8,Casual Users
49560,663,14,34,2,3,3,8,Casual Users
49576,1742,14,25,1,3,2,6,Casual Users
49853,133,29,47,4,4,3,11,Loyal Users
49886,114,17,26,4,3,2,9,Loyal Users
49967,753,7,18,2,2,2,6,Lost
50131,2,200,775,5,5,5,15,Champions
50454,139,29,43,4,4,3,11,Loyal Users
50544,1248,5,15,2,1,1,4,Lost
50953,124,27,110,4,4,4,12,Champions
51034,444,14,24,3,3,2,8,Loyal Users
51081,220,12,38,3,3,3,9,Loyal Users
51396,23,12,28,5,3,2,10,Loyal Users
51637,47,178,909,5,5,5,15,Champions
52004,641,18,28,2,3,2,7,Casual Users
52084,715,6,12,2,1,1,4,Lost
39340,223,11,31,3,2,2,7,Casual Users
39415,1,8,9,5,2,1,8,Promising
39520,503,39,137,2,4,4,10,At Risk
39901,718,27,55,2,4,3,9,At Risk
39920,2532,5,23,1,1,2,4,Lost
40201,1723,99,186,1,5,5,11,At Risk
40380,17,68,231,5,5,5,15,Champions
41004,119,51,103,4,5,4,13,Champions
41036,315,103,186,3,5,5,13,Loyal Users
41170,3168,15,32,1,3,3,7,Casual Users
41663,139,11,14,4,2,1,7,Promising
41728,545,29,43,2,4,3,9,At Risk
41912,165,17,32,4,3,3,10,Loyal Users
41991,149,9,18,4,2,2,8,Promising
42149,4,20,51,5,3,3,11,Loyal Users
42383,59,66,116,5,5,4,14,Champions
42505,28,37,69,5,4,4,13,Champions
42914,1710,12,51,1,3,3,7,Casual Users
42951,1412,6,11,1,1,1,3,Lost
43017,848,31,75,2,4,4,10,At Risk
43161,1261,9,15,1,2,1,4,Lost
43665,9,9,28,5,2,2,9,Promising
43709,492,6,9,2,1,1,4,Lost
43865,2479,8,8,1,2,1,4,Lost
43889,44,44,215,5,4,5,14,Champions
43934,1015,6,7,2,1,1,4,Lost
44242,239,40,159,3,4,5,12,Loyal Users
44331,38,6,9,5,1,1,7,Promising
44482,290,17,50,3,3,3,9,Loyal Users
44745,415,34,121,3,4,4,11,Loyal Users
44775,133,63,444,4,5,5,14,Champions
44820,10,155,454,5,5,5,15,Champions
44980,7,6,10,5,1,1,7,Promising
44996,11,189,496,5,5,5,15,Champions
45012,14,77,129,5,5,4,14,Champions
45138,1457,5,9,1,1,1,3,Lost
45222,224,10,93,3,2,4,9,Casual Users
45370,428,73,97,3,5,4,12,Loyal Users
45473,566,52,419,2,5,5,12,At Risk
45474,3,120,690,5,5,5,15,Champions
45522,20,61,414,5,5,5,15,Champions
45603,37,53,95,5,5,4,14,Champions
45710,11,85,286,5,5,5,15,Champions
45778,871,8,10,2,2,1,5,Lost
45922,262,52,91,3,5,4,12,Loyal Users
46047,3268,10,10,1,2,1,4,Lost
46056,38,10,22,5,2,2,9,Promising
46104,4,5,12,5,1,1,7,Promising
46411,408,15,24,3,3,2,8,Loyal Users
46478,4089,9,37,1,2,3,6,Lost
46520,85,15,74,4,3,4,11,Loyal Users
46824,133,8,15,4,2,1,7,Promising
46825,265,10,10,3,2,1,6,Casual Users
46894,2032,10,17,1,2,2,5,Lost
47369,586,8,32,2,2,3,7,Lost
47409,52,105,186,5,5,5,15,Champions
47704,73,45,293,4,4,5,13,Champions
47810,51,99,422,5,5,5,15,Champions
47876,423,70,165,3,5,5,13,Loyal Users
48105,91,58,125,4,5,4,13,Champions
48526,536,25,188,2,4,5,11,At Risk
48995,668,6,17,2,1,2,5,Lost
49305,1035,7,47,2,2,3,7,Lost
49315,9,51,96,5,5,4,14,Champions
49402,91,46,85,4,5,4,13,Champions
49524,300,16,59,3,3,3,9,Loyal Users
49685,127,16,126,4,3,4,11,Loyal Users
49786,131,30,157,4,4,5,13,Champions
50177,70,37,231,4,4,5,13,Champions
50270,70,48,264,4,5,5,14,Champions
50590,1137,12,30,2,3,2,7,Casual Users
50699,130,57,103,4,5,4,13,Champions
50725,3280,9,25,1,2,2,5,Lost
50764,488,44,117,2,4,4,10,At Risk
50806,896,11,26,2,2,2,6,Lost
50904,44,55,552,5,5,5,15,Champions
51709,44,9,30,5,2,2,9,Promising
51782,282,42,78,3,4,4,11,Loyal Users
51831,786,8,8,2,2,1,5,Lost
39617,1,42,99,5,4,4,13,Champions
39633,5,54,132,5,5,4,14,Champions
39665,127,78,341,4,5,5,14,Champions
39964,1226,10,48,2,2,3,7,Lost
40170,4469,25,50,1,4,3,8,At Risk
40346,843,13,20,2,3,2,7,Casual Users
40594,1500,10,49,1,2,3,6,Lost
40761,294,9,23,3,2,2,7,Casual Users
40854,982,16,28,2,3,2,7,Casual Users
40902,227,48,103,3,5,4,12,Loyal Users
40954,111,65,157,4,5,5,14,Champions
40957,12,38,74,5,4,4,13,Champions
41266,3,49,76,5,5,4,14,Champions
41397,135,31,142,4,4,4,12,Champions
41516,68,80,152,5,5,5,15,Champions
41759,266,11,12,3,2,1,6,Casual Users
41899,77,6,26,4,1,2,7,Promising
42025,111,19,48,4,3,3,10,Loyal Users
42047,422,16,27,3,3,2,8,Loyal Users
42159,696,32,105,2,4,4,10,At Risk
42244,2180,16,32,1,3,3,7,Casual Users
42313,2496,7,12,1,2,1,4,Lost
42323,327,23,178,3,4,5,12,Loyal Users
42333,17,35,61,5,4,3,12,Loyal Users
42559,895,7,10,2,2,1,5,Lost
42586,97,142,229,4,5,5,14,Champions
43403,2140,6,6,1,1,1,3,Lost
43543,10,49,328,5,5,5,15,Champions
43778,997,14,33,2,3,3,8,Casual Users
43822,547,5,7,2,1,1,4,Lost
43983,132,11,34,4,2,3,9,Promising
44122,3877,8,8,1,2,1,4,Lost
44204,1,19,38,5,3,3,11,Loyal Users
44254,115,42,104,4,4,4,12,Champions
44455,4,68,206,5,5,5,15,Champions
44599,26,13,13,5,3,1,9,Loyal Users
44708,374,17,28,3,3,2,8,Loyal Users
45223,845,6,21,2,1,2,5,Lost
45471,102,5,7,4,1,1,6,Promising
45763,1564,6,8,1,1,1,3,Lost
46058,22,32,83,5,4,4,13,Champions
46364,1483,8,22,1,2,2,5,Lost
46456,112,73,113,4,5,4,13,Champions
46538,1001,5,6,2,1,1,4,Lost
46742,81,85,395,4,5,5,14,Champions
46768,161,60,291,4,5,5,14,Champions
47051,698,12,30,2,3,2,7,Casual Users
47162,50,25,81,5,4,4,13,Champions
47499,131,19,98,4,3,4,11,Loyal Users
47760,2975,8,8,1,2,1,4,Lost
48016,2151,5,5,1,1,1,3,Lost
48056,25,100,487,5,5,5,15,Champions
48203,22,72,127,5,5,4,14,Champions
48220,515,33,42,2,4,3,9,At Risk
48258,541,12,32,2,3,3,8,Casual Users
48279,536,56,107,2,5,4,11,At Risk
48562,1869,10,34,1,2,3,6,Lost
48580,17,19,60,5,3,3,11,Loyal Users
48860,861,9,54,2,2,3,7,Lost
48978,12,202,259,5,5,5,15,Champions
49010,28,9,10,5,2,1,8,Promising
49249,1087,9,33,2,2,3,7,Lost
49367,52,103,189,5,5,5,15,Champions
49368,97,9,39,4,2,3,9,Promising
49512,0,54,140,5,5,4,14,Champions
49556,890,31,49,2,4,3,9,At Risk
49675,1255,8,15,2,2,1,5,Lost
50027,2566,6,12,1,1,1,3,Lost
50157,1431,15,26,1,3,2,6,Casual Users
50189,4426,11,12,1,2,1,4,Lost
50295,48,39,48,5,4,3,12,Loyal Users
50316,412,10,14,3,2,1,6,Casual Users
50365,3999,6,7,1,1,1,3,Lost
50383,323,16,35,3,3,3,9,Loyal Users
50572,3517,5,8,1,1,1,3,Lost
50643,4652,6,11,1,1,1,3,Lost
50711,2562,13,16,1,3,2,6,Casual Users
50739,7,22,46,5,4,3,12,Loyal Users
50914,1608,11,28,1,2,2,5,Lost
50936,1433,7,55,1,2,3,6,Lost
51302,104,11,18,4,2,2,8,Promising
51537,68,88,527,5,5,5,15,Champions
51937,88,17,77,4,3,4,11,Loyal Users
52345,413,8,11,3,2,1,6,Casual Users
39380,1410,8,46,1,2,3,6,Lost
39443,5,6,23,5,1,2,8,Promising
39499,3290,5,5,1,1,1,3,Lost
39706,613,26,48,2,4,3,9,At Risk
40075,3,24,74,5,4,4,13,Champions
40198,199,7,17,3,2,2,7,Casual Users
40298,68,41,78,5,4,4,13,Champions
40319,1234,36,49,2,4,3,9,At Risk
40548,2258,5,5,1,1,1,3,Lost
40561,142,22,40,4,4,3,11,Loyal Users
41049,569,32,54,2,4,3,9,At Risk
41082,28,76,251,5,5,5,15,Champions
41490,142,67,242,4,5,5,14,Champions
41668,351,32,51,3,4,3,10,Loyal Users
42021,782,5,9,2,1,1,4,Lost
42290,258,10,11,3,2,1,6,Casual Users
42591,94,8,12,4,2,1,7,Promising
42618,95,93,703,4,5,5,14,Champions
42645,30,131,329,5,5,5,15,Champions
42756,413,17,26,3,3,2,8,Loyal Users
43295,147,5,7,4,1,1,6,Promising
43706,435,13,111,3,3,4,10,Loyal Users
44562,70,10,13,4,2,1,7,Promising
44603,23,44,76,5,4,4,13,Champions
44785,146,6,11,4,1,1,6,Promising
44920,4,15,19,5,3,2,10,Loyal Users
45361,1444,5,11,1,1,1,3,Lost
45980,127,18,83,4,3,4,11,Loyal Users
46031,2255,12,18,1,3,2,6,Casual Users
46226,571,12,126,2,3,4,9,Casual Users
46639,14,104,417,5,5,5,15,Champions
46692,484,6,6,2,1,1,4,Lost
46743,94,18,29,4,3,2,9,Loyal Users
46779,11,102,330,5,5,5,15,Champions
46931,621,6,21,2,1,2,5,Lost
46986,137,14,47,4,3,3,10,Loyal Users
47236,13,199,312,5,5,5,15,Champions
47285,809,15,47,2,3,3,8,Casual Users
47511,86,9,19,4,2,2,8,Promising
47817,114,87,264,4,5,5,14,Champions
48013,1269,11,157,1,2,5,8,Lost
48153,1506,8,11,1,2,1,4,Lost
48183,175,22,64,3,4,4,11,Loyal Users
48277,4041,27,159,1,4,5,10,At Risk
48643,549,64,186,2,5,5,12,At Risk
48859,273,53,175,3,5,5,13,Loyal Users
49011,5,171,319,5,5,5,15,Champions
49053,324,15,83,3,3,4,10,Loyal Users
49084,51,51,365,5,5,5,15,Champions
49132,859,36,41,2,4,3,9,At Risk
49428,2987,10,18,1,2,2,5,Lost
49565,2430,11,16,1,2,2,5,Lost
49732,1258,42,70,1,4,4,9,At Risk
49799,397,24,34,3,4,3,10,Loyal Users
49842,5022,31,103,1,4,4,9,At Risk
49965,466,20,20,3,3,2,8,Loyal Users
50164,2449,5,7,1,1,1,3,Lost
50249,179,61,138,3,5,4,12,Loyal Users
50374,1536,10,55,1,2,3,6,Lost
50511,139,6,13,4,1,1,6,Promising
50773,2298,14,44,1,3,3,7,Casual Users
50961,85,10,36,4,2,3,9,Promising
51303,698,6,8,2,1,1,4,Lost
51359,1565,13,33,1,3,3,7,Casual Users
51798,424,8,48,3,2,3,8,Casual Users
51818,147,276,331,4,5,5,14,Champions
51936,88,25,66,4,4,4,12,Champions
52069,3544,8,11,1,2,1,4,Lost
39366,949,15,29,2,3,2,7,Casual Users
39377,2955,10,18,1,2,2,5,Lost
39384,30,11,28,5,2,2,9,Promising
39437,1135,8,21,2,2,2,6,Lost
39615,27,70,297,5,5,5,15,Champions
39876,2173,5,8,1,1,1,3,Lost
39944,529,23,164,2,4,5,11,At Risk
40035,3535,5,12,1,1,1,3,Lost
40524,1097,5,6,2,1,1,4,Lost
40827,928,7,10,2,2,1,5,Lost
41056,2143,8,9,1,2,1,4,Lost
41066,3320,10,12,1,2,1,4,Lost
41274,677,13,16,2,3,2,7,Casual Users
41522,405,83,171,3,5,5,13,Loyal Users
41598,136,72,241,4,5,5,14,Champions
42355,1232,5,25,2,1,2,5,Lost
43198,141,5,9,4,1,1,6,Promising
43395,5179,7,11,1,2,1,4,Lost
43397,272,22,33,3,4,3,10,Loyal Users
43514,247,52,168,3,5,5,13,Loyal Users
43780,16,175,783,5,5,5,15,Champions
43940,443,49,87,3,5,4,12,Loyal Users
44041,161,5,33,4,1,3,8,Promising
44144,4853,6,9,1,1,1,3,Lost
44262,1102,7,52,2,2,3,7,Lost
44294,83,80,136,4,5,4,13,Champions
44360,109,36,174,4,4,5,13,Champions
44486,116,36,46,4,4,3,11,Loyal Users
44531,2619,6,10,1,1,1,3,Lost
44641,2806,9,61,1,2,3,6,Lost
44927,333,27,259,3,4,5,12,Loyal Users
45115,243,26,50,3,4,3,10,Loyal Users
45871,75,143,992,4,5,5,14,Champions
46262,237,41,140,3,4,4,11,Loyal Users
46441,116,14,23,4,3,2,9,Loyal Users
46589,494,51,70,2,5,4,11,At Risk
47203,935,15,42,2,3,3,8,Casual Users
48014,160,15,20,4,3,2,9,Loyal Users
48353,5493,8,10,1,2,1,4,Lost
48393,2424,7,11,1,2,1,4,Lost
48448,448,12,37,3,3,3,9,Loyal Users
48885,116,23,48,4,4,3,11,Loyal Users
49682,2189,10,90,1,2,4,7,Lost
49913,1661,16,28,1,3,2,6,Casual Users
50056,705,5,9,2,1,1,4,Lost
50064,21,12,32,5,3,3,11,Loyal Users
50336,93,50,107,4,5,4,13,Champions
50486,31,10,99,5,2,4,11,Promising
50990,262,5,5,3,1,1,5,Casual Users
51261,297,17,59,3,3,3,9,Loyal Users
51269,194,34,66,3,4,4,11,Loyal Users
51286,1830,12,24,1,3,2,6,Casual Users
52166,1670,9,18,1,2,2,5,Lost
39563,3284,32,59,1,4,3,8,At Risk
39581,2196,6,6,1,1,1,3,Lost
39694,74,72,302,4,5,5,14,Champions
39728,292,9,29,3,2,2,7,Casual Users
39979,2022,11,19,1,2,2,5,Lost
40182,1131,7,27,2,2,2,6,Lost
40342,292,26,37,3,4,3,10,Loyal Users
40552,1436,5,17,1,1,2,4,Lost
40790,250,32,77,3,4,4,11,Loyal Users
40791,1289,5,5,1,1,1,3,Lost
40830,1275,8,8,1,2,1,4,Lost
40842,97,7,11,4,2,1,7,Promising
40947,117,79,379,4,5,5,14,Champions
41188,106,8,13,4,2,1,7,Promising
41358,133,15,73,4,3,4,11,Loyal Users
41504,2,103,425,5,5,5,15,Champions
41791,138,21,61,4,3,3,10,Loyal Users
41929,1,209,334,5,5,5,15,Champions
42424,43,33,92,5,4,4,13,Champions
42525,1115,6,23,2,1,2,5,Lost
42861,253,5,5,3,1,1,5,Casual Users
43105,40,10,20,5,2,2,9,Promising
43316,277,51,76,3,5,4,12,Loyal Users
43321,1118,6,28,2,1,2,5,Lost
43413,3010,16,38,1,3,3,7,Casual Users
43415,99,73,112,4,5,4,13,Champions
43569,109,14,25,4,3,2,9,Loyal Users
43586,74,28,72,4,4,4,12,Champions
43632,366,5,17,3,1,2,6,Casual Users
44068,5509,6,10,1,1,1,3,Lost
44201,67,37,102,5,4,4,13,Champions
44348,1,103,253,5,5,5,15,Champions
44473,273,8,24,3,2,2,7,Casual Users
44530,1829,5,7,1,1,1,3,Lost
44634,421,5,15,3,1,1,5,Casual Users
44736,93,19,25,4,3,2,9,Loyal Users
44903,169,29,84,3,4,4,11,Loyal Users
45389,31,14,35,5,3,3,11,Loyal Users
45543,696,12,24,2,3,2,7,Casual Users
45666,1003,5,6,2,1,1,4,Lost
45698,101,47,285,4,5,5,14,Champions
45720,109,114,404,4,5,5,14,Champions
45721,4269,18,20,1,3,2,6,Casual Users
45724,130,34,321,4,4,5,13,Champions
45826,1613,34,62,1,4,3,8,At Risk
45930,208,14,74,3,3,4,10,Loyal Users
46150,271,11,17,3,2,2,7,Casual Users
46463,28,53,112,5,5,4,14,Champions
46472,7,103,702,5,5,5,15,Champions
46511,438,10,31,3,2,2,7,Casual Users
46554,19,20,69,5,3,4,12,Loyal Users
46588,2567,7,11,1,2,1,4,Lost
47167,21,66,459,5,5,5,15,Champions
47777,146,6,9,4,1,1,6,Promising
48255,394,15,56,3,3,3,9,Loyal Users
48387,17,41,68,5,4,4,13,Champions
49058,1848,15,45,1,3,3,7,Casual Users
49244,450,19,139,3,3,4,10,Loyal Users
49319,16,88,101,5,5,4,14,Champions
49559,425,64,148,3,5,5,13,Loyal Users
49584,1141,57,200,2,5,5,12,At Risk
49904,637,27,55,2,4,3,9,At Risk
49916,1730,13,16,1,3,2,6,Casual Users
50388,760,10,98,2,2,4,8,Lost
50889,14,41,120,5,4,4,13,Champions
50895,20,7,36,5,2,3,10,Promising
51924,262,20,55,3,3,3,9,Loyal Users
52287,82,17,93,4,3,4,11,Loyal Users
39342,242,83,223,3,5,5,13,Loyal Users
39634,96,97,348,4,5,5,14,Champions
39686,570,5,8,2,1,1,4,Lost
40246,233,27,168,3,4,5,12,Loyal Users
40322,3148,9,13,1,2,1,4,Lost
40611,80,27,35,4,4,3,11,Loyal Users
41350,98,35,76,4,4,4,12,Champions
41361,120,32,116,4,4,4,12,Champions
41420,1354,13,16,1,3,2,6,Casual Users
41679,3269,8,24,1,2,2,5,Lost
41747,80,13,17,4,3,2,9,Loyal Users
41867,531,23,71,2,4,4,10,At Risk
42143,3,57,193,5,5,5,15,Champions
42254,5,8,12,5,2,1,8,Promising
42255,47,55,162,5,5,5,15,Champions
42321,38,10,14,5,2,1,8,Promising
42445,112,61,247,4,5,5,14,Champions
42568,382,20,35,3,3,3,9,Loyal Users
42573,1420,5,20,1,1,2,4,Lost
42629,120,39,285,4,4,5,13,Champions
42665,484,20,38,2,3,3,8,Casual Users
42822,524,26,141,2,4,4,10,At Risk
43011,409,18,40,3,3,3,9,Loyal Users
43026,1,128,224,5,5,5,15,Champions
43073,581,23,67,2,4,4,10,At Risk
43135,1024,8,22,2,2,2,6,Lost
43254,208,7,12,3,2,1,6,Casual Users
43324,83,41,96,4,4,4,12,Champions
43571,2085,6,11,1,1,1,3,Lost
43617,462,19,33,3,3,3,9,Loyal Users
43749,115,12,64,4,3,4,11,Loyal Users
43759,160,51,115,4,5,4,13,Champions
44137,126,34,203,4,4,5,13,Champions
44303,105,19,67,4,3,4,11,Loyal Users
44572,249,19,121,3,3,4,10,Loyal Users
44577,435,9,60,3,2,3,8,Casual Users
44754,61,46,238,5,5,5,15,Champions
44806,411,15,89,3,3,4,10,Loyal Users
45404,368,18,105,3,3,4,10,Loyal Users
45445,2404,6,7,1,1,1,3,Lost
45580,450,13,14,3,3,1,7,Loyal Users
45706,379,51,125,3,5,4,12,Loyal Users
45732,859,11,21,2,2,2,6,Lost
46000,576,10,27,2,2,2,6,Lost
46100,5,9,9,5,2,1,8,Promising
46377,29,66,122,5,5,4,14,Champions
46443,1122,9,14,2,2,1,5,Lost
46782,69,31,82,5,4,4,13,Champions
47216,271,14,62,3,3,3,9,Loyal Users
47396,12,24,103,5,4,4,13,Champions
47558,10,53,360,5,5,5,15,Champions
47562,82,23,46,4,4,3,11,Loyal Users
47577,93,7,8,4,2,1,7,Promising
47758,254,89,200,3,5,5,13,Loyal Users
47850,1022,29,44,2,4,3,9,At Risk
48578,285,56,75,3,5,4,12,Loyal Users
48628,2482,5,16,1,1,2,4,Lost
48681,3580,5,5,1,1,1,3,Lost
48783,412,21,32,3,3,3,9,Loyal Users
49048,1403,14,75,1,3,4,8,Casual Users
49370,102,22,129,4,4,4,12,Champions
49446,83,47,197,4,5,5,14,Champions
49544,119,33,41,4,4,3,11,Loyal Users
49574,2516,5,20,1,1,2,4,Lost
49595,112,21,53,4,3,3,10,Loyal Users
49608,263,16,61,3,3,3,9,Loyal Users
49795,625,7,34,2,2,3,7,Lost
50047,366,29,65,3,4,4,11,Loyal Users
50195,1724,13,52,1,3,3,7,Casual Users
50784,334,47,121,3,5,4,12,Loyal Users
50801,9,54,263,5,5,5,15,Champions
50989,44,203,297,5,5,5,15,Champions
51516,4819,22,37,1,4,3,8,At Risk
51697,196,11,27,3,2,2,7,Casual Users
51989,2,5,20,5,1,2,8,Promising
52307,105,6,12,4,1,1,6,Promising
39326,2578,15,28,1,3,2,6,Casual Users
39363,297,11,21,3,2,2,7,Casual Users
39422,578,37,80,2,4,4,10,At Risk
39540,1196,5,12,2,1,1,4,Lost
39652,4605,14,22,1,3,2,6,Casual Users
39805,1488,44,273,1,4,5,10,At Risk
40015,1371,14,26,1,3,2,6,Casual Users
40141,1125,10,19,2,2,2,6,Lost
40306,3,17,80,5,3,4,12,Loyal Users
40379,2789,114,190,1,5,5,11,At Risk
40453,242,18,28,3,3,2,8,Loyal Users
40727,48,54,374,5,5,5,15,Champions
41308,713,6,15,2,1,1,4,Lost
41325,13,94,576,5,5,5,15,Champions
41590,116,81,217,4,5,5,14,Champions
41635,695,10,32,2,2,3,7,Lost
41681,1416,14,33,1,3,3,7,Casual Users
42163,116,52,129,4,5,4,13,Champions
42475,104,14,24,4,3,2,9,Loyal Users
42728,824,22,34,2,4,3,9,At Risk
42766,88,27,100,4,4,4,12,Champions
42842,54,22,38,5,4,3,12,Loyal Users
42957,11,20,29,5,3,2,10,Loyal Users
42962,405,5,10,3,1,1,5,Casual Users
42994,269,10,15,3,2,1,6,Casual Users
43235,266,17,44,3,3,3,9,Loyal Users
44257,1499,44,99,1,4,4,9,At Risk
44506,1164,17,52,2,3,3,8,Casual Users
44527,1056,6,8,2,1,1,4,Lost
44914,1858,13,30,1,3,2,6,Casual Users
44916,103,66,79,4,5,4,13,Champions
44960,1442,43,59,1,4,3,8,At Risk
45301,676,8,76,2,2,4,8,Lost
45305,432,12,32,3,3,3,9,Loyal Users
45391,833,5,18,2,1,2,5,Lost
45911,391,10,31,3,2,2,7,Casual Users
46015,1149,18,53,2,3,3,8,Casual Users
46222,658,22,52,2,4,3,9,At Risk
46891,885,9,23,2,2,2,6,Lost
46930,2569,11,20,1,2,2,5,Lost
47119,133,11,19,4,2,2,8,Promising
47128,1794,5,5,1,1,1,3,Lost
47390,101,44,65,4,4,4,12,Champions
47595,422,19,59,3,3,3,9,Loyal Users
48020,55,39,112,5,4,4,13,Champions
48750,295,5,7,3,1,1,5,Casual Users
48970,8,112,288,5,5,5,15,Champions
49299,1310,9,11,1,2,1,4,Lost
49697,1261,10,44,1,2,3,6,Lost
49931,139,34,61,4,4,3,11,Loyal Users
49946,261,144,245,3,5,5,13,Loyal Users
50622,396,22,44,3,4,3,10,Loyal Users
50856,64,11,13,5,2,1,8,Promising
51305,402,39,102,3,4,4,11,Loyal Users
51308,1545,9,42,1,2,3,6,Lost
51337,2431,5,12,1,1,1,3,Lost
51843,352,10,20,3,2,2,7,Casual Users
52250,209,10,38,3,2,3,8,Casual Users
39560,1014,22,105,2,4,4,10,At Risk
39741,705,13,16,2,3,2,7,Casual Users
39874,588,41,65,2,4,4,10,At Risk
39896,281,6,14,3,1,1,5,Casual Users
40227,4147,6,6,1,1,1,3,Lost
40260,1935,9,21,1,2,2,5,Lost
40963,967,19,25,2,3,2,7,Casual Users
41458,111,38,335,4,4,5,13,Champions
41475,4241,7,15,1,2,1,4,Lost
41804,697,5,5,2,1,1,4,Lost
42019,1155,23,35,2,4,3,9,At Risk
42066,113,35,106,4,4,4,12,Champions
42085,20,111,425,5,5,5,15,Champions
43209,16,66,539,5,5,5,15,Champions
43650,568,17,34,2,3,3,8,Casual Users
43840,14,95,251,5,5,5,15,Champions
43882,137,25,76,4,4,4,12,Champions
44219,118,50,180,4,5,5,14,Champions
44273,702,19,82,2,3,4,9,Casual Users
45169,0,75,450,5,5,5,15,Champions
45276,694,6,39,2,1,3,6,Lost
45531,30,33,116,5,4,4,13,Champions
45664,18,13,40,5,3,3,11,Loyal Users
45715,31,24,85,5,4,4,13,Champions
45812,12,33,333,5,4,5,14,Champions
46029,139,34,142,4,4,4,12,Champions
46085,9,6,7,5,1,1,7,Promising
46244,78,15,100,4,3,4,11,Loyal Users
46489,2,89,322,5,5,5,15,Champions
46514,1039,13,56,2,3,3,8,Casual Users
46958,2689,21,60,1,3,3,7,Casual Users
47150,416,6,9,3,1,1,5,Casual Users
47544,164,5,7,4,1,1,6,Promising
47635,1608,8,19,1,2,2,5,Lost
47645,3964,5,9,1,1,1,3,Lost
48041,306,20,58,3,3,3,9,Loyal Users
48158,722,12,49,2,3,3,8,Casual Users
48160,1093,5,7,2,1,1,4,Lost
48570,2,73,242,5,5,5,15,Champions
49193,96,15,47,4,3,3,10,Loyal Users
49614,36,46,67,5,5,4,14,Champions
49833,539,14,55,2,3,3,8,Casual Users
49874,404,7,14,3,2,1,6,Casual Users
49991,59,122,346,5,5,5,15,Champions
50426,1412,12,86,1,3,4,8,Casual Users
50439,327,7,8,3,2,1,6,Casual Users
50496,103,40,135,4,4,4,12,Champions
50657,286,24,51,3,4,3,10,Loyal Users
51828,213,6,17,3,1,2,6,Casual Users
52158,1170,8,8,2,2,1,5,Lost
52283,2566,7,12,1,2,1,4,Lost
39257,4963,5,8,1,1,1,3,Lost
39261,434,18,54,3,3,3,9,Loyal Users
39298,515,33,56,2,4,3,9,At Risk
39406,1399,5,6,1,1,1,3,Lost
39990,651,14,35,2,3,3,8,Casual Users
40066,1542,11,15,1,2,1,4,Lost
40533,410,7,15,3,2,1,6,Casual Users
40703,526,18,138,2,3,4,9,Casual Users
41046,894,5,17,2,1,2,5,Lost
41094,2813,6,10,1,1,1,3,Lost
41574,313,14,30,3,3,2,8,Loyal Users
41669,126,5,19,4,1,2,7,Promising
42195,20,67,178,5,5,5,15,Champions
42341,226,38,53,3,4,3,10,Loyal Users
42387,16,18,40,5,3,3,11,Loyal Users
42429,34,11,20,5,2,2,9,Promising
42441,148,13,45,4,3,3,10,Loyal Users
42857,78,117,164,4,5,5,14,Champions
43037,80,14,27,4,3,2,9,Loyal Users
43098,120,67,189,4,5,5,14,Champions
43616,306,8,17,3,2,2,7,Casual Users
44261,65,37,100,5,4,4,13,Champions
44397,1560,7,12,1,2,1,4,Lost
44500,163,16,76,4,3,4,11,Loyal Users
44525,113,25,36,4,4,3,11,Loyal Users
44749,561,7,9,2,2,1,5,Lost
45190,12,30,55,5,4,3,12,Loyal Users
45231,4144,6,6,1,1,1,3,Lost
45760,296,31,220,3,4,5,12,Loyal Users
46168,63,65,199,5,5,5,15,Champions
46282,253,9,109,3,2,4,9,Casual Users
46454,120,7,42,4,2,3,9,Promising
46484,15,37,96,5,4,4,13,Champions
46604,3549,14,15,1,3,1,5,Casual Users
46760,115,31,71,4,4,4,12,Champions
46765,1813,8,11,1,2,1,4,Lost
46810,219,15,34,3,3,3,9,Loyal Users
46935,4072,11,23,1,2,2,5,Lost
46998,4185,11,26,1,2,2,5,Lost
47077,1397,5,13,1,1,1,3,Lost
47525,1053,22,101,2,4,4,10,At Risk
47808,53,57,83,5,5,4,14,Champions
47855,8,17,57,5,3,3,11,Loyal Users
48283,93,11,22,4,2,2,8,Promising
48758,407,33,95,3,4,4,11,Loyal Users
48920,106,35,221,4,4,5,13,Champions
48946,1741,17,40,1,3,3,7,Casual Users
49007,675,5,7,2,1,1,4,Lost
49071,300,21,188,3,3,5,11,Loyal Users
49186,182,58,388,3,5,5,13,Loyal Users
49271,143,203,499,4,5,5,14,Champions
49550,102,87,893,4,5,5,14,Champions
49956,808,6,35,2,1,3,6,Lost
50482,34,17,27,5,3,2,10,Loyal Users
50912,106,12,220,4,3,5,12,Loyal Users
51189,135,6,7,4,1,1,6,Promising
51252,725,10,19,2,2,2,6,Lost
51689,1032,19,42,2,3,3,8,Casual Users
51808,157,10,14,4,2,1,7,Promising
51912,1224,20,161,2,3,5,10,Casual Users
52009,114,8,14,4,2,1,7,Promising
52312,80,119,277,4,5,5,14,Champions
39854,1543,7,7,1,2,1,4,Lost
39962,1564,12,41,1,3,3,7,Casual Users
40415,1993,8,15,1,2,1,4,Lost
40593,75,154,454,4,5,5,14,Champions
40622,137,6,8,4,1,1,6,Promising
41158,112,49,154,4,5,5,14,Champions
41163,217,14,117,3,3,4,10,Loyal Users
41288,94,16,21,4,3,2,9,Loyal Users
41381,2262,7,17,1,2,2,5,Lost
41893,2541,10,14,1,2,1,4,Lost
41943,64,108,312,5,5,5,15,Champions
43067,162,47,173,4,5,5,14,Champions
43388,114,70,267,4,5,5,14,Champions
43488,163,18,84,4,3,4,11,Loyal Users
43573,551,131,252,2,5,5,12,At Risk
43661,381,17,24,3,3,2,8,Loyal Users
43723,1857,5,5,1,1,1,3,Lost
43933,106,119,395,4,5,5,14,Champions
44109,374,25,28,3,4,2,9,Loyal Users
44147,245,6,16,3,1,2,6,Casual Users
44403,6,16,44,5,3,3,11,Loyal Users
44478,402,6,9,3,1,1,5,Casual Users
44800,97,8,45,4,2,3,9,Promising
44843,283,13,29,3,3,2,8,Loyal Users
44939,183,5,11,3,1,1,5,Casual Users
45040,107,43,131,4,4,4,12,Champions
45136,123,37,59,4,4,3,11,Loyal Users
45589,191,21,36,3,3,3,9,Loyal Users
45700,0,48,139,5,5,4,14,Champions
45987,108,9,19,4,2,2,8,Promising
46299,134,118,346,4,5,5,14,Champions
46398,722,11,31,2,2,2,6,Lost
46498,50,17,28,5,3,2,10,Loyal Users
46509,1698,10,20,1,2,2,5,Lost
46711,201,24,83,3,4,4,11,Loyal Users
46799,216,23,44,3,4,3,10,Loyal Users
46924,27,10,43,5,2,3,10,Promising
46945,161,6,10,4,1,1,6,Promising
46950,65,83,149,5,5,5,15,Champions
46983,196,55,202,3,5,5,13,Loyal Users
47024,2675,5,9,1,1,1,3,Lost
47296,647,44,105,2,4,4,10,At Risk
47335,113,105,170,4,5,5,14,Champions
47509,455,15,25,3,3,2,8,Loyal Users
47803,25,73,174,5,5,5,15,Champions
47859,98,50,153,4,5,5,14,Champions
47996,527,64,200,2,5,5,12,At Risk
48420,434,95,148,3,5,5,13,Loyal Users
49422,1909,5,7,1,1,1,3,Lost
49927,2941,8,8,1,2,1,4,Lost
50107,1103,18,30,2,3,2,7,Casual Users
50171,410,20,33,3,3,3,9,Loyal Users
50261,79,30,102,4,4,4,12,Champions
50489,470,10,119,3,2,4,9,Casual Users
50588,80,43,277,4,4,5,13,Champions
50864,135,24,33,4,4,3,11,Loyal Users
51174,480,9,10,2,2,1,5,Lost
51374,138,34,75,4,4,4,12,Champions
51533,5,24,81,5,4,4,13,Champions
51560,643,10,58,2,2,3,7,Lost
51617,3090,7,54,1,2,3,6,Lost
51815,5338,5,5,1,1,1,3,Lost
52139,3129,5,16,1,1,2,4,Lost
52300,93,29,117,4,4,4,12,Champions
52342,13,42,184,5,4,5,14,Champions
39250,2047,7,10,1,2,1,4,Lost
39281,583,32,92,2,4,4,10,At Risk
39603,122,76,356,4,5,5,14,Champions
40089,392,14,50,3,3,3,9,Loyal Users
40109,1582,9,77,1,2,4,7,Lost
40152,88,10,34,4,2,3,9,Promising
40181,1975,8,10,1,2,1,4,Lost
40308,412,5,9,3,1,1,5,Casual Users
40468,655,13,48,2,3,3,8,Casual Users
40523,28,99,160,5,5,5,15,Champions
40726,731,13,37,2,3,3,8,Casual Users
41193,1564,13,17,1,3,2,6,Casual Users
41444,992,27,50,2,4,3,9,At Risk
41493,1070,5,5,2,1,1,4,Lost
41512,1434,6,14,1,1,1,3,Lost
41649,25,23,133,5,4,4,13,Champions
41829,254,6,14,3,1,1,5,Casual Users
42144,692,20,23,2,3,2,7,Casual Users
43242,3424,8,15,1,2,1,4,Lost
43348,488,13,14,2,3,1,6,Casual Users
43441,88,26,153,4,4,5,13,Champions
44054,27,37,212,5,4,5,14,Champions
44157,647,15,20,2,3,2,7,Casual Users
44266,426,117,163,3,5,5,13,Loyal Users
44549,3114,8,40,1,2,3,6,Lost
44874,2546,16,89,1,3,4,8,Casual Users
45007,4,5,11,5,1,1,7,Promising
45035,4705,7,34,1,2,3,6,Lost
45186,117,6,13,4,1,1,6,Promising
46001,95,23,97,4,4,4,12,Champions
46016,2436,14,35,1,3,3,7,Casual Users
46148,133,6,36,4,1,3,8,Promising
46283,109,22,37,4,4,3,11,Loyal Users
46428,141,35,125,4,4,4,12,Champions
46763,245,10,23,3,2,2,7,Casual Users
46783,45,62,92,5,5,4,14,Champions
46993,3611,8,13,1,2,1,4,Lost
47085,250,7,65,3,2,4,9,Casual Users
47144,999,15,63,2,3,4,9,Casual Users
47237,9,217,543,5,5,5,15,Champions
47305,295,9,11,3,2,1,6,Casual Users
47722,230,7,11,3,2,1,6,Casual Users
47938,303,16,45,3,3,3,9,Loyal Users
47981,147,17,52,4,3,3,10,Loyal Users
48135,2711,5,6,1,1,1,3,Lost
48149,169,31,84,3,4,4,11,Loyal Users
48340,2,192,502,5,5,5,15,Champions
48464,1838,5,11,1,1,1,3,Lost
48718,187,44,370,3,4,5,12,Loyal Users
48950,4429,6,18,1,1,2,4,Lost
49018,134,17,23,4,3,2,9,Loyal Users
49346,280,6,7,3,1,1,5,Casual Users
49578,833,16,89,2,3,4,9,Casual Users
49735,1975,6,17,1,1,2,4,Lost
49986,1702,8,8,1,2,1,4,Lost
50037,141,17,25,4,3,2,9,Loyal Users
50060,3427,16,36,1,3,3,7,Casual Users
50226,347,47,159,3,5,5,13,Loyal Users
50231,147,10,40,4,2,3,9,Promising
50308,6,21,103,5,3,4,12,Loyal Users
50693,16,16,115,5,3,4,12,Loyal Users
50757,138,24,94,4,4,4,12,Champions
50766,88,11,103,4,2,4,10,Promising
51354,873,14,30,2,3,2,7,Casual Users
51365,533,7,22,2,2,2,6,Lost
51623,2,152,576,5,5,5,15,Champions
51825,201,11,42,3,2,3,8,Casual Users
51887,2,114,623,5,5,5,15,Champions
51916,353,29,320,3,4,5,12,Loyal Users
52336,843,8,39,2,2,3,7,Lost
39792,738,16,32,2,3,3,8,Casual Users
39850,123,73,155,4,5,5,14,Champions
40137,3838,9,9,1,2,1,4,Lost
40168,724,24,83,2,4,4,10,At Risk
40526,1204,46,83,2,5,4,11,At Risk
40580,107,25,88,4,4,4,12,Champions
40610,115,66,173,4,5,5,14,Champions
40823,111,38,156,4,4,5,13,Champions
40974,80,35,106,4,4,4,12,Champions
41187,2690,8,29,1,2,2,5,Lost
41427,81,12,36,4,3,3,10,Loyal Users
42155,26,16,32,5,3,3,11,Loyal Users
42275,1321,9,13,1,2,1,4,Lost
42390,238,18,37,3,3,3,9,Loyal Users
42619,13,134,560,5,5,5,15,Champions
42812,1672,16,17,1,3,2,6,Casual Users
42934,1643,5,19,1,1,2,4,Lost
42940,1508,5,18,1,1,2,4,Lost
42973,1189,5,36,2,1,3,6,Lost
45203,627,8,20,2,2,2,6,Lost
45448,680,77,124,2,5,4,11,At Risk
45604,23,72,488,5,5,5,15,Champions
45704,89,8,20,4,2,2,8,Promising
45722,698,53,74,2,5,4,11,At Risk
46643,80,66,176,4,5,5,14,Champions
46914,510,5,9,2,1,1,4,Lost
47003,254,53,145,3,5,4,12,Loyal Users
47042,338,6,15,3,1,1,5,Casual Users
47687,13,105,197,5,5,5,15,Champions
47978,490,24,95,2,4,4,10,At Risk
48187,9,83,123,5,5,4,14,Champions
48582,569,43,137,2,4,4,10,At Risk
48637,133,9,10,4,2,1,7,Promising
49097,1886,7,15,1,2,1,4,Lost
49252,286,29,52,3,4,3,10,Loyal Users
49274,95,8,13,4,2,1,7,Promising
49400,14,29,94,5,4,4,13,Champions
49510,13,36,81,5,4,4,13,Champions
49609,4369,5,7,1,1,1,3,Lost
49657,110,42,145,4,4,4,12,Champions
49695,8,23,89,5,4,4,13,Champions
49709,67,12,65,5,3,4,12,Loyal Users
49954,129,82,141,4,5,4,13,Champions
49978,247,14,123,3,3,4,10,Loyal Users
50254,405,9,47,3,2,3,8,Casual Users
50342,408,17,43,3,3,3,9,Loyal Users
50863,31,93,297,5,5,5,15,Champions
51106,150,7,19,4,2,2,8,Promising
51450,284,7,16,3,2,2,7,Casual Users
51509,123,9,65,4,2,4,10,Promising
51527,793,6,19,2,1,2,5,Lost
51552,1238,13,24,2,3,2,7,Casual Users
51872,1,7,18,5,2,2,9,Promising
52065,218,25,160,3,4,5,12,Loyal Users
39909,12,133,554,5,5,5,15,Champions
39911,252,10,12,3,2,1,6,Casual Users
40053,562,49,59,2,5,3,10,At Risk
40145,1692,6,19,1,1,2,4,Lost
40267,288,6,9,3,1,1,5,Casual Users
40375,8,40,64,5,4,4,13,Champions
40400,468,8,9,3,2,1,6,Casual Users
40518,3748,18,28,1,3,2,6,Casual Users
40782,3442,5,6,1,1,1,3,Lost
40853,283,30,149,3,4,5,12,Loyal Users
41010,63,6,28,5,1,2,8,Promising
41052,1234,6,14,2,1,1,4,Lost
41167,419,23,68,3,4,4,11,Loyal Users
41180,1974,8,12,1,2,1,4,Lost
41315,279,15,31,3,3,2,8,Loyal Users
41831,1577,11,28,1,2,2,5,Lost
42157,1622,6,19,1,1,2,4,Lost
42193,13,90,390,5,5,5,15,Champions
42266,2571,5,28,1,1,2,4,Lost
42339,143,158,694,4,5,5,14,Champions
42419,1051,5,5,2,1,1,4,Lost
42612,9,16,21,5,3,2,10,Loyal Users
42698,38,13,63,5,3,4,12,Loyal Users
43163,0,76,226,5,5,5,15,Champions
43322,65,134,529,5,5,5,15,Champions
43463,277,181,511,3,5,5,13,Loyal Users
43710,5231,25,203,1,4,5,10,At Risk
44073,99,13,79,4,3,4,11,Loyal Users
44099,141,27,78,4,4,4,12,Champions
44163,274,17,24,3,3,2,8,Loyal Users
44452,563,8,35,2,2,3,7,Lost
44901,4857,23,51,1,4,3,8,At Risk
45072,0,15,51,5,3,3,11,Loyal Users
45132,911,11,21,2,2,2,6,Lost
45351,160,20,253,4,3,5,12,Loyal Users
45484,139,18,21,4,3,2,9,Loyal Users
45567,1479,11,22,1,2,2,5,Lost
45692,125,20,44,4,3,3,10,Loyal Users
45875,593,51,268,2,5,5,12,At Risk
46804,48,10,24,5,2,2,9,Promising
46901,845,12,15,2,3,1,6,Casual Users
47222,646,9,140,2,2,4,8,Lost
47428,525,7,19,2,2,2,6,Lost
47462,1086,5,25,2,1,2,5,Lost
47752,950,5,14,2,1,1,4,Lost
47820,600,5,13,2,1,1,4,Lost
47860,278,7,9,3,2,1,6,Casual Users
47904,4,117,426,5,5,5,15,Champions
48104,470,8,15,3,2,1,6,Casual Users
48125,318,19,28,3,3,2,8,Loyal Users
48632,28,38,109,5,4,4,13,Champions
49138,33,101,387,5,5,5,15,Champions
49412,112,72,136,4,5,4,13,Champions
49758,557,8,18,2,2,2,6,Lost
49764,405,51,168,3,5,5,13,Loyal Users
50398,251,63,251,3,5,5,13,Loyal Users
50542,139,13,56,4,3,3,10,Loyal Users
50807,136,43,75,4,4,4,12,Champions
51060,566,6,20,2,1,2,5,Lost
51072,407,47,63,3,5,4,12,Loyal Users
51160,3428,16,26,1,3,2,6,Casual Users
51238,2220,6,31,1,1,2,4,Lost
51309,119,17,22,4,3,2,9,Loyal Users
51521,209,19,61,3,3,3,9,Loyal Users
51538,9,87,308,5,5,5,15,Champions
51618,77,44,136,4,4,4,12,Champions
51626,122,58,70,4,5,4,13,Champions
51853,2888,21,98,1,3,4,8,Casual Users
51882,421,41,62,3,4,3,10,Loyal Users
52066,42,122,263,5,5,5,15,Champions
39260,85,7,11,4,2,1,7,Promising
39328,241,12,98,3,3,4,10,Loyal Users
39369,66,38,240,5,4,5,14,Champions
40122,1484,5,6,1,1,1,3,Lost
40249,140,6,19,4,1,2,7,Promising
40313,2266,28,80,1,4,4,9,At Risk
40685,2759,5,5,1,1,1,3,Lost
40958,698,9,19,2,2,2,6,Lost
41014,261,41,269,3,4,5,12,Loyal Users
41683,96,153,211,4,5,5,14,Champions
41836,117,8,20,4,2,2,8,Promising
42509,418,13,16,3,3,2,8,Loyal Users
42696,20,47,115,5,5,4,14,Champions
42825,347,19,98,3,3,4,10,Loyal Users
42906,6,41,61,5,4,3,12,Loyal Users
43637,31,5,11,5,1,1,7,Promising
43674,77,46,169,4,5,5,14,Champions
43692,42,51,145,5,5,4,14,Champions
44035,791,17,59,2,3,3,8,Casual Users
44088,601,16,81,2,3,4,9,Casual Users
44301,2260,7,18,1,2,2,5,Lost
44889,81,36,172,4,4,5,13,Champions
45044,2307,6,14,1,1,1,3,Lost
45172,579,21,130,2,3,4,9,Casual Users
45454,388,18,39,3,3,3,9,Loyal Users
45637,245,38,112,3,4,4,11,Loyal Users
45816,215,33,119,3,4,4,11,Loyal Users
45878,1161,6,22,2,1,2,5,Lost
46140,384,15,35,3,3,3,9,Loyal Users
46386,6,42,110,5,4,4,13,Champions
46497,571,6,6,2,1,1,4,Lost
46912,359,14,93,3,3,4,10,Loyal Users
47107,413,16,27,3,3,2,8,Loyal Users
47114,27,30,281,5,4,5,14,Champions
47605,2799,17,45,1,3,3,7,Casual Users
47621,147,25,191,4,4,5,13,Champions
47697,1265,10,17,1,2,2,5,Lost
47831,5415,8,16,1,2,2,5,Lost
48112,430,23,57,3,4,3,10,Loyal Users
48434,279,20,48,3,3,3,9,Loyal Users
48539,4278,9,15,1,2,1,4,Lost
48629,324,5,25,3,1,2,6,Casual Users
48738,13,111,236,5,5,5,15,Champions
48781,1380,10,79,1,2,4,7,Lost
48807,32,15,83,5,3,4,12,Loyal Users
49123,683,11,20,2,2,2,6,Lost
49427,1312,5,7,1,1,1,3,Lost
49539,696,10,19,2,2,2,6,Lost
49572,33,15,23,5,3,2,10,Loyal Users
50004,424,6,9,3,1,1,5,Casual Users
50238,531,6,45,2,1,3,6,Lost
50578,363,13,31,3,3,2,8,Loyal Users
50797,105,6,10,4,1,1,6,Promising
50809,140,31,53,4,4,3,11,Loyal Users
51551,99,53,199,4,5,5,14,Champions
51699,1114,11,25,2,2,2,6,Lost
51720,462,27,29,3,4,2,9,Loyal Users
52170,157,24,51,4,4,3,11,Loyal Users
39411,510,13,30,2,3,2,7,Casual Users
39585,67,30,181,5,4,5,14,Champions
39614,336,5,6,3,1,1,5,Casual Users
40098,1817,90,311,1,5,5,11,At Risk
40268,842,19,37,2,3,3,8,Casual Users
40636,25,24,36,5,4,3,12,Loyal Users
40698,21,10,22,5,2,2,9,Promising
40979,12,85,306,5,5,5,15,Champions
41467,11,8,20,5,2,2,9,Promising
41665,307,13,17,3,3,2,8,Loyal Users
41819,537,7,18,2,2,2,6,Lost
41837,134,33,136,4,4,4,12,Champions
41840,2794,5,6,1,1,1,3,Lost
41975,71,8,21,4,2,2,8,Promising
42410,1,114,221,5,5,5,15,Champions
42891,4276,5,10,1,1,1,3,Lost
43082,431,11,11,3,2,1,6,Casual Users
43148,272,19,45,3,3,3,9,Loyal Users
43151,101,9,50,4,2,3,9,Promising
43217,4517,16,45,1,3,3,7,Casual Users
43438,120,17,21,4,3,2,9,Loyal Users
43838,700,10,21,2,2,2,6,Lost
43853,305,160,348,3,5,5,13,Loyal Users
44333,417,22,24,3,4,2,9,Loyal Users
44343,244,50,85,3,5,4,12,Loyal Users
44578,120,41,85,4,4,4,12,Champions
44753,2369,7,19,1,2,2,5,Lost
44841,352,7,7,3,2,1,6,Casual Users
45119,19,6,13,5,1,1,7,Promising
45597,581,42,119,2,4,4,10,At Risk
45682,2990,5,7,1,1,1,3,Lost
45703,1824,7,8,1,2,1,4,Lost
46048,159,50,342,4,5,5,14,Champions
46220,1360,8,12,1,2,1,4,Lost
47058,110,20,59,4,3,3,10,Loyal Users
47164,138,34,62,4,4,3,11,Loyal Users
47297,609,18,66,2,3,4,9,Casual Users
47495,1275,7,9,1,2,1,4,Lost
47658,647,15,30,2,3,2,7,Casual Users
47770,531,61,127,2,5,4,11,At Risk
48059,111,68,516,4,5,5,14,Champions
48198,232,52,105,3,5,4,12,Loyal Users
48787,771,10,10,2,2,1,5,Lost
49215,253,14,22,3,3,2,8,Loyal Users
49605,72,75,415,4,5,5,14,Champions
49891,238,14,24,3,3,2,8,Loyal Users
50095,2,50,239,5,5,5,15,Champions
50103,22,48,116,5,5,4,14,Champions
50278,151,11,52,4,2,3,9,Promising
50537,53,24,83,5,4,4,13,Champions
50637,23,58,71,5,5,4,14,Champions
50648,63,9,12,5,2,1,8,Promising
50660,286,14,39,3,3,3,9,Loyal Users
50853,646,12,85,2,3,4,9,Casual Users
51102,1709,5,9,1,1,1,3,Lost
51155,87,13,165,4,3,5,12,Loyal Users
51179,2590,12,33,1,3,3,7,Casual Users
51646,123,44,62,4,4,3,11,Loyal Users
51658,2423,14,20,1,3,2,6,Casual Users
51674,2,12,31,5,3,2,10,Loyal Users
51695,259,23,48,3,4,3,10,Loyal Users
51729,25,12,16,5,3,2,10,Loyal Users
51732,271,41,173,3,4,5,12,Loyal Users
51874,15,21,35,5,3,3,11,Loyal Users
52305,47,52,176,5,5,5,15,Champions
39287,283,13,37,3,3,3,9,Loyal Users
39361,311,15,49,3,3,3,9,Loyal Users
39860,30,38,117,5,4,4,13,Champions
40119,434,9,12,3,2,1,6,Casual Users
40410,992,11,15,2,2,1,5,Lost
40414,1772,12,46,1,3,3,7,Casual Users
40511,169,25,55,3,4,3,10,Loyal Users
40563,822,7,26,2,2,2,6,Lost
40584,397,8,12,3,2,1,6,Casual Users
40657,2766,6,10,1,1,1,3,Lost
41243,731,8,28,2,2,2,6,Lost
41280,425,35,47,3,4,3,10,Loyal Users
41330,547,11,22,2,2,2,6,Lost
41368,1263,9,21,1,2,2,5,Lost
41809,313,9,17,3,2,2,7,Casual Users
41905,4044,8,8,1,2,1,4,Lost
42042,2700,5,27,1,1,2,4,Lost
42433,1406,5,9,1,1,1,3,Lost
42625,142,56,179,4,5,5,14,Champions
42705,39,127,210,5,5,5,15,Champions
42794,544,18,49,2,3,3,8,Casual Users
42810,229,20,70,3,3,4,10,Loyal Users
43500,539,22,65,2,4,4,10,At Risk
43681,145,5,6,4,1,1,6,Promising
44079,526,8,32,2,2,3,7,Lost
44156,412,7,33,3,2,3,8,Casual Users
44375,1411,18,44,1,3,3,7,Casual Users
44466,125,38,94,4,4,4,12,Champions
44584,5245,7,7,1,2,1,4,Lost
44764,128,26,53,4,4,3,11,Loyal Users
45770,1414,7,17,1,2,2,5,Lost
46389,76,91,401,4,5,5,14,Champions
46537,262,17,25,3,3,2,8,Loyal Users
47006,4840,5,9,1,1,1,3,Lost
47027,1823,5,15,1,1,1,3,Lost
47028,544,30,47,2,4,3,9,At Risk
47280,534,125,540,2,5,5,12,At Risk
47294,100,51,94,4,5,4,13,Champions
47371,694,18,103,2,3,4,9,Casual Users
47553,402,21,64,3,3,4,10,Loyal Users
47612,164,19,19,4,3,2,9,Loyal Users
47691,303,60,129,3,5,4,12,Loyal Users
47757,31,42,69,5,4,4,13,Champions
47877,4239,8,22,1,2,2,5,Lost
48133,45,37,292,5,4,5,14,Champions
48137,175,11,40,3,2,3,8,Casual Users
48383,11,5,8,5,1,1,7,Promising
48512,2419,67,190,1,5,5,11,At Risk
48624,596,17,71,2,3,4,9,Casual Users
48898,5,18,99,5,3,4,12,Loyal Users
48977,501,10,31,2,2,2,6,Lost
49504,121,77,156,4,5,5,14,Champions
49525,100,30,42,4,4,3,11,Loyal Users
49557,1271,5,5,1,1,1,3,Lost
49677,129,104,368,4,5,5,14,Champions
49819,290,6,8,3,1,1,5,Casual Users
49976,141,17,155,4,3,5,12,Loyal Users
50039,283,28,121,3,4,4,11,Loyal Users
50069,0,60,337,5,5,5,15,Champions
50092,984,24,90,2,4,4,10,At Risk
50111,266,18,22,3,3,2,8,Loyal Users
50170,2578,5,7,1,1,1,3,Lost
50298,1185,25,48,2,4,3,9,At Risk
50338,1606,10,37,1,2,3,6,Lost
50644,690,39,69,2,4,4,10,At Risk
50774,249,17,72,3,3,4,10,Loyal Users
51152,1434,20,33,1,3,3,7,Casual Users
51523,1017,27,68,2,4,4,10,At Risk
51612,54,86,372,5,5,5,15,Champions
51616,23,14,49,5,3,3,11,Loyal Users
51742,2033,6,20,1,1,2,4,Lost
52281,352,28,51,3,4,3,10,Loyal Users
52339,32,41,62,5,4,3,12,Loyal Users
39331,455,70,248,3,5,5,13,Loyal Users
39417,126,6,8,4,1,1,6,Promising
39687,813,8,46,2,2,3,7,Lost
39714,16,127,558,5,5,5,15,Champions
39875,574,7,11,2,2,1,5,Lost
39921,286,6,34,3,1,3,7,Casual Users
40052,413,8,14,3,2,1,6,Casual Users
40090,5023,9,11,1,2,1,4,Lost
40262,122,12,31,4,3,2,9,Loyal Users
40282,2238,6,8,1,1,1,3,Lost
41028,370,10,13,3,2,1,6,Casual Users
41147,414,33,162,3,4,5,12,Loyal Users
41323,282,19,77,3,3,4,10,Loyal Users
41348,83,91,734,4,5,5,14,Champions
41856,4413,6,15,1,1,1,3,Lost
42225,30,90,335,5,5,5,15,Champions
42344,373,28,78,3,4,4,11,Loyal Users
42785,580,34,104,2,4,4,10,At Risk
42982,1,20,34,5,3,3,11,Loyal Users
43188,140,5,10,4,1,1,6,Promising
43253,273,33,117,3,4,4,11,Loyal Users
44072,357,15,17,3,3,2,8,Loyal Users
44485,496,37,159,2,4,5,11,At Risk
44587,2,30,51,5,4,3,12,Loyal Users
45101,981,11,26,2,2,2,6,Lost
45181,271,5,37,3,1,3,7,Casual Users
45327,1500,10,15,1,2,1,4,Lost
45384,1410,32,57,1,4,3,8,At Risk
45447,25,19,243,5,3,5,13,Loyal Users
45533,650,101,714,2,5,5,12,At Risk
45751,112,79,366,4,5,5,14,Champions
45932,96,34,63,4,4,4,12,Champions
46045,1057,9,19,2,2,2,6,Lost
46455,972,14,33,2,3,3,8,Casual Users
46557,16,94,368,5,5,5,15,Champions
46647,18,82,275,5,5,5,15,Champions
46767,92,54,255,4,5,5,14,Champions
46808,87,73,393,4,5,5,14,Champions
47171,3438,5,12,1,1,1,3,Lost
47175,19,9,29,5,2,2,9,Promising
47287,303,74,106,3,5,4,12,Loyal Users
47383,293,7,28,3,2,2,7,Casual Users
47476,2,49,89,5,5,4,14,Champions
47521,148,79,348,4,5,5,14,Champions
47549,1702,11,26,1,2,2,5,Lost
47745,34,53,312,5,5,5,15,Champions
47863,973,6,16,2,1,2,5,Lost
48022,303,36,300,3,4,5,12,Loyal Users
48030,15,53,108,5,5,4,14,Champions
48589,929,8,22,2,2,2,6,Lost
48722,379,22,33,3,4,3,10,Loyal Users
49151,318,21,35,3,3,3,9,Loyal Users
49239,33,68,151,5,5,5,15,Champions
49621,50,42,117,5,4,4,13,Champions
49691,39,66,85,5,5,4,14,Champions
49820,144,19,51,4,3,3,10,Loyal Users
49863,1581,6,10,1,1,1,3,Lost
50115,13,70,169,5,5,5,15,Champions
50253,302,6,6,3,1,1,5,Casual Users
50334,0,45,368,5,4,5,14,Champions
50387,136,32,137,4,4,4,12,Champions
50669,0,60,81,5,5,4,14,Champions
50812,292,35,100,3,4,4,11,Loyal Users
50913,1862,6,9,1,1,1,3,Lost
51139,129,14,41,4,3,3,10,Loyal Users
51188,854,10,23,2,2,2,6,Lost
51200,1286,58,91,1,5,4,10,At Risk
51236,302,5,23,3,1,2,6,Casual Users
51948,77,45,132,4,4,4,12,Champions
52190,42,29,105,5,4,4,13,Champions
39424,3924,5,12,1,1,1,3,Lost
39455,48,87,152,5,5,5,15,Champions
39510,8,48,70,5,5,4,14,Champions
39561,1183,6,11,2,1,1,4,Lost
39718,884,10,18,2,2,2,6,Lost
39906,142,6,13,4,1,1,6,Promising
39983,23,48,318,5,5,5,15,Champions
40069,9,11,52,5,2,3,10,Promising
40144,257,5,35,3,1,3,7,Casual Users
40271,251,6,12,3,1,1,5,Casual Users
40374,300,54,94,3,5,4,12,Loyal Users
40725,1554,20,69,1,3,4,8,Casual Users
41618,46,48,86,5,5,4,14,Champions
42189,1094,22,30,2,4,2,8,At Risk
42281,49,29,94,5,4,4,13,Champions
42631,573,35,59,2,4,3,9,At Risk
42703,82,57,87,4,5,4,13,Champions
43450,4036,9,16,1,2,2,5,Lost
43466,4526,10,12,1,2,1,4,Lost
43593,20,57,270,5,5,5,15,Champions
43666,715,7,17,2,2,2,6,Lost
43964,116,82,207,4,5,5,14,Champions
44492,2,8,33,5,2,3,10,Promising
44860,112,8,39,4,2,3,9,Promising
45322,136,53,161,4,5,5,14,Champions
45326,846,10,16,2,2,2,6,Lost
45435,315,8,11,3,2,1,6,Casual Users
45649,67,69,335,5,5,5,15,Champions
45674,77,52,152,4,5,5,14,Champions
45836,116,157,623,4,5,5,14,Champions
45933,1267,41,166,1,4,5,10,At Risk
45951,735,32,155,2,4,5,11,At Risk
46064,45,36,40,5,4,3,12,Loyal Users
46285,1353,11,14,1,2,1,4,Lost
46525,1101,12,14,2,3,1,6,Casual Users
47083,564,16,29,2,3,2,7,Casual Users
47146,117,35,102,4,4,4,12,Champions
47422,350,5,6,3,1,1,5,Casual Users
47698,94,139,438,4,5,5,14,Champions
47790,181,32,198,3,4,5,12,Loyal Users
47793,170,10,75,3,2,4,9,Casual Users
47883,123,75,248,4,5,5,14,Champions
48054,1006,5,6,2,1,1,4,Lost
48180,16,10,16,5,2,2,9,Promising
48250,137,83,161,4,5,5,14,Champions
48355,5217,7,9,1,2,1,4,Lost
48443,68,75,110,5,5,4,14,Champions
48477,680,12,30,2,3,2,7,Casual Users
48788,621,18,22,2,3,2,7,Casual Users
48899,1693,9,18,1,2,2,5,Lost
49221,1980,6,28,1,1,2,4,Lost
49301,223,22,86,3,4,4,11,Loyal Users
49382,3965,7,19,1,2,2,5,Lost
49419,309,8,51,3,2,3,8,Casual Users
49597,827,9,15,2,2,1,5,Lost
49849,946,8,32,2,2,3,7,Lost
49850,19,169,366,5,5,5,15,Champions
50378,388,11,56,3,2,3,8,Casual Users
50396,88,65,195,4,5,5,14,Champions
50495,275,28,31,3,4,2,9,Loyal Users
50506,142,19,31,4,3,2,9,Loyal Users
50532,146,15,40,4,3,3,10,Loyal Users
50535,119,8,25,4,2,2,8,Promising
50597,0,22,102,5,4,4,13,Champions
50599,41,73,105,5,5,4,14,Champions
50791,652,48,75,2,5,4,11,At Risk
51352,439,16,20,3,3,2,8,Loyal Users
51632,35,163,467,5,5,5,15,Champions
51849,1387,18,26,1,3,2,6,Casual Users
52072,12,10,23,5,2,2,9,Promising
52155,4925,6,13,1,1,1,3,Lost
39554,3,16,20,5,3,2,10,Loyal Users
39649,1683,5,17,1,1,2,4,Lost
39650,65,55,417,5,5,5,15,Champions
39808,251,12,66,3,3,4,10,Loyal Users
40024,1751,6,28,1,1,2,4,Lost
40481,129,16,190,4,3,5,12,Loyal Users
40544,384,14,52,3,3,3,9,Loyal Users
40697,487,32,78,2,4,4,10,At Risk
40873,532,7,11,2,2,1,5,Lost
41008,110,157,884,4,5,5,14,Champions
41059,44,164,522,5,5,5,15,Champions
41186,132,10,15,4,2,1,7,Promising
41254,7,26,115,5,4,4,13,Champions
41337,450,22,43,3,4,3,10,Loyal Users
41757,5134,11,15,1,2,1,4,Lost
42303,583,39,152,2,4,5,11,At Risk
42768,816,14,41,2,3,3,8,Casual Users
42859,691,13,27,2,3,2,7,Casual Users
43128,541,19,40,2,3,3,8,Casual Users
43498,523,19,78,2,3,4,9,Casual Users
43615,359,19,45,3,3,3,9,Loyal Users
43804,282,22,213,3,4,5,12,Loyal Users
43981,1287,20,33,1,3,3,7,Casual Users
43992,1282,18,185,1,3,5,9,Casual Users
44194,87,12,25,4,3,2,9,Loyal Users
44450,52,19,207,5,3,5,13,Loyal Users
44626,114,68,340,4,5,5,14,Champions
44981,362,5,11,3,1,1,5,Casual Users
45126,811,19,30,2,3,2,7,Casual Users
45239,267,5,5,3,1,1,5,Casual Users
45492,211,8,17,3,2,2,7,Casual Users
45542,144,7,11,4,2,1,7,Promising
45735,3014,12,20,1,3,2,6,Casual Users
45793,1,50,93,5,5,4,14,Champions
45796,3,298,525,5,5,5,15,Champions
45832,1101,9,28,2,2,2,6,Lost
45861,1839,11,20,1,2,2,5,Lost
46053,966,7,26,2,2,2,6,Lost
46258,59,25,57,5,4,3,12,Loyal Users
46388,2667,9,25,1,2,2,5,Lost
46401,2528,31,44,1,4,3,8,At Risk
46512,2415,6,8,1,1,1,3,Lost
46513,13,23,71,5,4,4,13,Champions
47329,73,46,93,4,5,4,13,Champions
47334,1416,7,10,1,2,1,4,Lost
47470,1833,23,77,1,4,4,9,At Risk
47483,274,71,90,3,5,4,12,Loyal Users
47517,103,69,130,4,5,4,13,Champions
47700,9,101,247,5,5,5,15,Champions
47730,139,11,30,4,2,2,8,Promising
47791,493,9,11,2,2,1,5,Lost
48047,2383,49,68,1,5,4,10,At Risk
48060,179,5,15,3,1,1,5,Casual Users
48151,992,11,17,2,2,2,6,Lost
48172,1559,5,22,1,1,2,4,Lost
48491,1708,8,20,1,2,2,5,Lost
48557,1137,15,100,2,3,4,9,Casual Users
48684,36,44,155,5,4,5,14,Champions
48712,127,28,48,4,4,3,11,Loyal Users
48915,559,5,18,2,1,2,5,Lost
48980,68,6,19,5,1,2,8,Promising
49062,2849,10,18,1,2,2,5,Lost
49077,29,37,81,5,4,4,13,Champions
49354,3710,7,41,1,2,3,6,Lost
49462,568,23,71,2,4,4,10,At Risk
49514,13,15,21,5,3,2,10,Loyal Users
49551,490,21,37,2,3,3,8,Casual Users
49619,422,10,28,3,2,2,7,Casual Users
49645,13,126,258,5,5,5,15,Champions
49760,141,6,18,4,1,2,7,Promising
50102,13,22,144,5,4,4,13,Champions
50364,122,12,27,4,3,2,9,Loyal Users
50391,1028,7,7,2,2,1,5,Lost
50851,356,26,161,3,4,5,12,Loyal Users
51176,289,10,29,3,2,2,7,Casual Users
51312,1271,5,12,1,1,1,3,Lost
51960,2001,6,18,1,1,2,4,Lost
52161,4667,22,93,1,4,4,9,At Risk
52330,671,6,12,2,1,1,4,Lost
39276,128,12,17,4,3,2,9,Loyal Users
39992,268,11,83,3,2,4,9,Casual Users
40171,679,5,7,2,1,1,4,Lost
40214,361,45,124,3,4,4,11,Loyal Users
40328,26,47,202,5,5,5,15,Champions
40612,117,11,14,4,2,1,7,Promising
40702,190,48,121,3,5,4,12,Loyal Users
41026,3136,7,38,1,2,3,6,Lost
41178,3,17,91,5,3,4,12,Loyal Users
41229,17,142,221,5,5,5,15,Champions
41847,14,50,283,5,5,5,15,Champions
41883,1155,21,29,2,3,2,7,Casual Users
42175,1256,10,16,2,2,2,6,Lost
42308,23,73,139,5,5,4,14,Champions
42451,157,7,11,4,2,1,7,Promising
42801,335,42,78,3,4,4,11,Loyal Users
42913,980,11,24,2,2,2,6,Lost
42963,547,6,18,2,1,2,5,Lost
43144,6,165,615,5,5,5,15,Champions
43696,366,14,28,3,3,2,8,Loyal Users
43960,738,13,34,2,3,3,8,Casual Users
44112,340,22,26,3,4,2,9,Loyal Users
44191,110,40,54,4,4,3,11,Loyal Users
44256,290,13,89,3,3,4,10,Loyal Users
44598,4026,9,10,1,2,1,4,Lost
44724,459,19,49,3,3,3,9,Loyal Users
44918,112,33,99,4,4,4,12,Champions
45065,4722,8,20,1,2,2,5,Lost
45325,501,5,5,2,1,1,4,Lost
45696,5551,11,11,1,2,1,4,Lost
45931,15,43,118,5,4,4,13,Champions
46019,997,10,10,2,2,1,5,Lost
46051,45,27,158,5,4,5,14,Champions
46072,6057,8,8,1,2,1,4,Lost
46831,307,5,7,3,1,1,5,Casual Users
46878,79,44,307,4,4,5,13,Champions
47046,738,7,34,2,2,3,7,Lost
47377,27,76,287,5,5,5,15,Champions
47386,113,39,269,4,4,5,13,Champions
47731,76,9,38,4,2,3,9,Promising
47998,161,21,154,4,3,5,12,Loyal Users
48402,413,54,129,3,5,4,12,Loyal Users
48607,784,27,90,2,4,4,10,At Risk
48663,1510,11,75,1,2,4,7,Lost
49220,6,73,158,5,5,5,15,Champions
49288,347,9,15,3,2,1,6,Casual Users
49498,125,43,77,4,4,4,12,Champions
49643,5,30,127,5,4,4,13,Champions
49651,86,69,260,4,5,5,14,Champions
49793,1296,19,52,1,3,3,7,Casual Users
49846,1549,5,10,1,1,1,3,Lost
50024,1,94,744,5,5,5,15,Champions
50314,130,36,41,4,4,3,11,Loyal Users
50366,24,65,92,5,5,4,14,Champions
50633,16,55,117,5,5,4,14,Champions
50768,142,35,80,4,4,4,12,Champions
50789,1846,7,44,1,2,3,6,Lost
50861,489,27,70,2,4,4,10,At Risk
50934,30,61,130,5,5,4,14,Champions
50946,4213,20,31,1,3,2,6,Casual Users
50966,17,24,38,5,4,3,12,Loyal Users
51579,128,26,132,4,4,4,12,Champions
51591,154,8,9,4,2,1,7,Promising
51728,8,69,135,5,5,4,14,Champions
51885,130,46,261,4,5,5,14,Champions
51968,1555,6,6,1,1,1,3,Lost
52013,136,7,8,4,2,1,7,Promising
52097,7,26,59,5,4,3,12,Loyal Users
52102,124,29,40,4,4,3,11,Loyal Users
52126,776,11,109,2,2,4,8,Lost
39272,530,25,85,2,4,4,10,At Risk
39305,2550,42,62,1,4,3,8,At Risk
39484,6,45,146,5,4,4,13,Champions
39591,447,13,44,3,3,3,9,Loyal Users
39666,7,17,36,5,3,3,11,Loyal Users
39676,150,51,129,4,5,4,13,Champions
39836,358,19,29,3,3,2,8,Loyal Users
40093,670,15,28,2,3,2,7,Casual Users
40153,2453,8,47,1,2,3,6,Lost
40705,738,6,27,2,1,2,5,Lost
40788,57,181,505,5,5,5,15,Champions
40865,6,154,232,5,5,5,15,Champions
41261,5078,6,61,1,1,3,5,Lost
41543,523,5,5,2,1,1,4,Lost
41602,849,5,5,2,1,1,4,Lost
41638,211,18,48,3,3,3,9,Loyal Users
41690,116,30,84,4,4,4,12,Champions
41769,1102,6,42,2,1,3,6,Lost
41916,57,20,135,5,3,4,12,Loyal Users
42224,1557,6,11,1,1,1,3,Lost
42278,1364,40,96,1,4,4,9,At Risk
42402,5845,9,9,1,2,1,4,Lost
42416,677,18,55,2,3,3,8,Casual Users
43219,1076,7,38,2,2,3,7,Lost
43291,293,6,23,3,1,2,6,Casual Users
43467,442,5,5,3,1,1,5,Casual Users
43803,101,178,427,4,5,5,14,Champions
44324,126,89,118,4,5,4,13,Champions
44604,409,7,8,3,2,1,6,Casual Users
44710,106,25,190,4,4,5,13,Champions
44744,113,31,266,4,4,5,13,Champions
44762,119,43,194,4,4,5,13,Champions
44779,124,108,272,4,5,5,14,Champions
44845,546,12,28,2,3,2,7,Casual Users
45228,295,5,10,3,1,1,5,Casual Users
45380,520,25,168,2,4,5,11,At Risk
45517,80,13,39,4,3,3,10,Loyal Users
45893,142,8,25,4,2,2,8,Promising
45976,4,10,20,5,2,2,9,Promising
46293,13,25,38,5,4,3,12,Loyal Users
46303,69,64,172,5,5,5,15,Champions
47207,132,16,28,4,3,2,9,Loyal Users
47312,129,17,73,4,3,4,11,Loyal Users
47473,1582,49,213,1,5,5,11,At Risk
47623,1145,34,77,2,4,4,10,At Risk
47693,101,61,142,4,5,4,13,Champions
48027,26,31,238,5,4,5,14,Champions
48118,302,38,43,3,4,3,10,Loyal Users
48185,1991,52,133,1,5,4,10,At Risk
48379,713,6,11,2,1,1,4,Lost
48678,483,14,20,2,3,2,7,Casual Users
48808,234,47,304,3,5,5,13,Loyal Users
48828,257,14,88,3,3,4,10,Loyal Users
48844,16,88,138,5,5,4,14,Champions
48896,568,10,20,2,2,2,6,Lost
49063,118,18,37,4,3,3,10,Loyal Users
49280,267,6,9,3,1,1,5,Casual Users
49306,125,83,198,4,5,5,14,Champions
49763,2232,26,35,1,4,3,8,At Risk
49925,2022,16,37,1,3,3,7,Casual Users
50147,2538,6,19,1,1,2,4,Lost
50193,1474,5,19,1,1,2,4,Lost
50207,1156,9,13,2,2,1,5,Lost
50575,2236,8,36,1,2,3,6,Lost
51080,130,63,164,4,5,5,14,Champions
51136,2671,8,23,1,2,2,5,Lost
51213,1421,29,31,1,4,2,7,At Risk
51796,356,72,163,3,5,5,13,Loyal Users
51908,864,54,101,2,5,4,11,At Risk
51930,17,62,144,5,5,4,14,Champions
52031,1118,10,56,2,2,3,7,Lost
52034,1103,11,36,2,2,3,7,Lost
52223,696,21,88,2,3,4,9,Casual Users
39299,219,10,15,3,2,1,6,Casual Users
39308,617,9,11,2,2,1,5,Lost
40040,151,94,187,4,5,5,14,Champions
40775,122,24,88,4,4,4,12,Champions
40786,137,34,280,4,4,5,13,Champions
41435,122,45,125,4,4,4,12,Champions
41457,543,7,7,2,2,1,5,Lost
41870,228,25,40,3,4,3,10,Loyal Users
41921,61,21,51,5,3,3,11,Loyal Users
41986,149,10,41,4,2,3,9,Promising
42131,1434,6,8,1,1,1,3,Lost
42199,11,28,52,5,4,3,12,Loyal Users
42487,549,10,13,2,2,1,5,Lost
42741,690,11,19,2,2,2,6,Lost
42815,123,126,511,4,5,5,14,Champions
43126,908,23,49,2,4,3,9,At Risk
43426,308,5,92,3,1,4,8,Casual Users
43477,108,29,120,4,4,4,12,Champions
43562,98,58,355,4,5,5,14,Champions
43652,475,23,104,2,4,4,10,At Risk
43708,211,192,369,3,5,5,13,Loyal Users
44503,416,21,59,3,3,3,9,Loyal Users
44528,645,6,18,2,1,2,5,Lost
44703,33,84,145,5,5,4,14,Champions
45306,433,8,12,3,2,1,6,Casual Users
45463,1452,6,6,1,1,1,3,Lost
45479,2069,8,30,1,2,2,5,Lost
45512,3346,13,20,1,3,2,6,Casual Users
45801,2570,15,61,1,3,3,7,Casual Users
45971,109,32,126,4,4,4,12,Champions
46050,151,5,11,4,1,1,6,Promising
46081,1,6,19,5,1,2,8,Promising
46466,101,15,23,4,3,2,9,Loyal Users
47304,302,8,24,3,2,2,7,Casual Users
47571,272,133,220,3,5,5,13,Loyal Users
47771,0,55,178,5,5,5,15,Champions
48114,5,63,252,5,5,5,15,Champions
48414,124,73,306,4,5,5,14,Champions
48551,468,8,14,3,2,1,6,Casual Users
48553,868,20,43,2,3,3,8,Casual Users
48955,424,32,87,3,4,4,11,Loyal Users
48968,1585,6,15,1,1,1,3,Lost
49373,554,53,143,2,5,4,11,At Risk
49406,121,5,10,4,1,1,6,Promising
49949,2591,7,12,1,2,1,4,Lost
50142,1125,45,64,2,4,4,10,At Risk
50465,1351,6,28,1,1,2,4,Lost
50484,6,39,63,5,4,4,13,Champions
50520,270,24,50,3,4,3,10,Loyal Users
50596,568,11,27,2,2,2,6,Lost
50689,383,25,71,3,4,4,11,Loyal Users
50793,1982,9,25,1,2,2,5,Lost
50958,946,19,28,2,3,2,7,Casual Users
50973,566,6,42,2,1,3,6,Lost
51230,4927,6,27,1,1,2,4,Lost
51517,4024,8,10,1,2,1,4,Lost
51670,678,15,38,2,3,3,8,Casual Users
51851,259,34,79,3,4,4,11,Loyal Users
51897,709,9,30,2,2,2,6,Lost
52096,346,22,133,3,4,4,11,Loyal Users
52248,585,12,19,2,3,2,7,Casual Users
52254,565,52,78,2,5,4,11,At Risk
39376,504,24,108,2,4,4,10,At Risk
39498,10,52,173,5,5,5,15,Champions
39589,184,37,117,3,4,4,11,Loyal Users
39880,1395,12,18,1,3,2,6,Casual Users
40060,150,67,124,4,5,4,13,Champions
40370,677,5,9,2,1,1,4,Lost
40450,1104,5,15,2,1,1,4,Lost
40811,60,31,149,5,4,5,14,Champions
40836,343,22,44,3,4,3,10,Loyal Users
40874,136,9,19,4,2,2,8,Promising
41672,30,130,586,5,5,5,15,Champions
41730,268,26,96,3,4,4,11,Loyal Users
42114,1021,19,28,2,3,2,7,Casual Users
42479,30,123,208,5,5,5,15,Champions
42628,137,34,126,4,4,4,12,Champions
42850,280,160,1001,3,5,5,13,Loyal Users
42865,5319,7,21,1,2,2,5,Lost
42907,325,9,15,3,2,1,6,Casual Users
43014,2930,7,10,1,2,1,4,Lost
43054,27,16,55,5,3,3,11,Loyal Users
43271,363,11,40,3,2,3,8,Casual Users
43423,219,35,73,3,4,4,11,Loyal Users
44255,298,20,25,3,3,2,8,Loyal Users
44269,1426,7,10,1,2,1,4,Lost
44459,808,7,22,2,2,2,6,Lost
44561,18,82,117,5,5,4,14,Champions
44576,310,6,8,3,1,1,5,Casual Users
44675,286,26,53,3,4,3,10,Loyal Users
45055,418,15,127,3,3,4,10,Loyal Users
45094,264,55,154,3,5,5,13,Loyal Users
45342,15,245,594,5,5,5,15,Champions
45426,186,28,55,3,4,3,10,Loyal Users
45437,80,11,34,4,2,3,9,Promising
45646,277,14,14,3,3,1,7,Loyal Users
45762,4545,27,114,1,4,4,9,At Risk
45935,2720,18,58,1,3,3,7,Casual Users
46182,4982,5,19,1,1,2,4,Lost
46803,106,30,165,4,4,5,13,Champions
47088,89,11,21,4,2,2,8,Promising
47381,576,34,68,2,4,4,10,At Risk
47437,4397,7,9,1,2,1,4,Lost
47456,4866,5,19,1,1,2,4,Lost
47705,18,69,417,5,5,5,15,Champions
47912,101,32,90,4,4,4,12,Champions
48388,1163,15,30,2,3,2,7,Casual Users
48439,1848,5,11,1,1,1,3,Lost
48527,29,13,16,5,3,2,10,Loyal Users
48610,142,20,84,4,3,4,11,Loyal Users
48906,280,11,50,3,2,3,8,Casual Users
48934,669,15,15,2,3,1,6,Casual Users
49492,20,86,251,5,5,5,15,Champions
49738,22,234,457,5,5,5,15,Champions
49800,256,12,19,3,3,2,8,Loyal Users
49838,557,6,19,2,1,2,5,Lost
50560,1398,19,31,1,3,2,6,Casual Users
50632,128,43,154,4,4,5,13,Champions
50683,423,14,22,3,3,2,8,Loyal Users
51035,126,21,59,4,3,3,10,Loyal Users
51245,992,5,9,2,1,1,4,Lost
51491,398,10,19,3,2,2,7,Casual Users
51572,296,54,222,3,5,5,13,Loyal Users
51733,1027,18,47,2,3,3,8,Casual Users
51785,56,21,103,5,3,4,12,Loyal Users
52039,690,43,117,2,4,4,10,At Risk
52241,1064,24,54,2,4,3,9,At Risk
39295,100,5,9,4,1,1,6,Promising
39390,271,21,89,3,3,4,10,Loyal Users
39468,2642,8,34,1,2,3,6,Lost
40369,63,59,266,5,5,5,15,Champions
40480,402,12,51,3,3,3,9,Loyal Users
40646,157,27,95,4,4,4,12,Champions
40778,82,9,24,4,2,2,8,Promising
41406,424,27,71,3,4,4,11,Loyal Users
41520,1691,22,83,1,4,4,9,At Risk
41944,106,8,9,4,2,1,7,Promising
41998,317,48,110,3,5,4,12,Loyal Users
42115,155,14,97,4,3,4,11,Loyal Users
42439,0,76,412,5,5,5,15,Champions
42518,6,5,9,5,1,1,7,Promising
43338,1664,10,28,1,2,2,5,Lost
43367,2411,6,24,1,1,2,4,Lost
43677,577,11,20,2,2,2,6,Lost
43766,132,7,18,4,2,2,8,Promising
43988,274,38,140,3,4,4,11,Loyal Users
44045,112,69,170,4,5,5,14,Champions
44047,1590,5,31,1,1,2,4,Lost
44408,601,24,41,2,4,3,9,At Risk
44491,1605,9,12,1,2,1,4,Lost
44876,107,131,372,4,5,5,14,Champions
45230,130,27,44,4,4,3,11,Loyal Users
45278,3011,7,13,1,2,1,4,Lost
45503,337,15,219,3,3,5,11,Loyal Users
45690,141,21,77,4,3,4,11,Loyal Users
45804,1733,5,5,1,1,1,3,Lost
46065,1230,12,18,2,3,2,7,Casual Users
46200,1219,8,26,2,2,2,6,Lost
46524,233,14,75,3,3,4,10,Loyal Users
46788,298,56,92,3,5,4,12,Loyal Users
46888,20,46,211,5,5,5,15,Champions
46900,101,9,10,4,2,1,7,Promising
47108,328,6,9,3,1,1,5,Casual Users
47170,190,7,31,3,2,2,7,Casual Users
47552,2933,20,55,1,3,3,7,Casual Users
47844,3976,6,16,1,1,2,4,Lost
48021,1701,6,18,1,1,2,4,Lost
48084,2586,5,8,1,1,1,3,Lost
48243,512,8,21,2,2,2,6,Lost
48391,2135,6,14,1,1,1,3,Lost
48424,1271,5,8,1,1,1,3,Lost
48573,22,71,221,5,5,5,15,Champions
48736,502,56,138,2,5,4,11,At Risk
48769,115,55,185,4,5,5,14,Champions
48965,1994,18,28,1,3,2,6,Casual Users
49160,1035,17,58,2,3,3,8,Casual Users
49497,320,24,118,3,4,4,11,Loyal Users
49502,275,10,23,3,2,2,7,Casual Users
49781,146,91,315,4,5,5,14,Champions
50448,87,28,57,4,4,3,11,Loyal Users
51085,1312,22,139,1,4,4,9,At Risk
51094,288,16,82,3,3,4,10,Loyal Users
51169,550,6,11,2,1,1,4,Lost
51424,19,88,863,5,5,5,15,Champions
51706,31,31,44,5,4,3,12,Loyal Users
39648,186,20,118,3,3,4,10,Loyal Users
39731,1491,11,26,1,2,2,5,Lost
39758,131,80,178,4,5,5,14,Champions
39770,278,9,13,3,2,1,6,Casual Users
39804,3307,64,95,1,5,4,10,At Risk
40082,985,5,23,2,1,2,5,Lost
40148,613,5,11,2,1,1,4,Lost
41021,1436,7,13,1,2,1,4,Lost
41218,2695,5,7,1,1,1,3,Lost
41367,524,12,25,2,3,2,7,Casual Users
41517,409,11,77,3,2,4,9,Casual Users
41534,102,31,124,4,4,4,12,Champions
41540,1817,7,33,1,2,3,6,Lost
41557,416,10,22,3,2,2,7,Casual Users
41968,103,16,43,4,3,3,10,Loyal Users
42227,3117,13,15,1,3,1,5,Casual Users
42426,3531,8,12,1,2,1,4,Lost
42481,1,14,26,5,3,2,10,Loyal Users
42716,1122,10,54,2,2,3,7,Lost
42996,16,8,32,5,2,3,10,Promising
43168,3839,6,26,1,1,2,4,Lost
43399,592,5,5,2,1,1,4,Lost
43640,92,16,46,4,3,3,10,Loyal Users
43724,1293,22,31,1,4,2,7,At Risk
43883,1,55,165,5,5,5,15,Champions
44024,574,17,29,2,3,2,7,Casual Users
44051,109,10,18,4,2,2,8,Promising
44107,19,5,9,5,1,1,7,Promising
44248,26,11,23,5,2,2,9,Promising
44768,1,77,295,5,5,5,15,Champions
45064,142,20,26,4,3,2,9,Loyal Users
45212,843,16,51,2,3,3,8,Casual Users
45277,187,58,121,3,5,4,12,Loyal Users
45441,92,29,57,4,4,3,11,Loyal Users
45459,715,43,90,2,4,4,10,At Risk
46052,869,23,187,2,4,5,11,At Risk
46137,764,25,116,2,4,4,10,At Risk
46176,855,8,15,2,2,1,5,Lost
46354,1076,104,408,2,5,5,12,At Risk
46446,28,140,270,5,5,5,15,Champions
46826,1422,13,17,1,3,2,6,Casual Users
47418,1041,17,68,2,3,4,9,Casual Users
47503,123,33,68,4,4,4,12,Champions
47540,44,34,272,5,4,5,14,Champions
47629,276,5,6,3,1,1,5,Casual Users
47695,1718,9,15,1,2,1,4,Lost
47919,4,84,202,5,5,5,15,Champions
47973,886,8,23,2,2,2,6,Lost
48038,566,20,41,2,3,3,8,Casual Users
48318,4939,8,26,1,2,2,5,Lost
48433,129,71,265,4,5,5,14,Champions
48520,2116,5,6,1,1,1,3,Lost
48747,17,23,57,5,4,3,12,Loyal Users
49059,1033,11,27,2,2,2,6,Lost
49073,1281,19,117,1,3,4,8,Casual Users
49426,28,34,105,5,4,4,13,Champions
49588,520,6,12,2,1,1,4,Lost
49671,2571,27,82,1,4,4,9,At Risk
49728,286,48,213,3,5,5,13,Loyal Users
49920,1,25,82,5,4,4,13,Champions
50012,1047,7,17,2,2,2,6,Lost
50052,1117,18,44,2,3,3,8,Casual Users
50081,244,7,7,3,2,1,6,Casual Users
50605,393,56,105,3,5,4,12,Loyal Users
50897,716,5,8,2,1,1,4,Lost
50924,4094,16,75,1,3,4,8,Casual Users
51223,984,8,17,2,2,2,6,Lost
51226,676,15,22,2,3,2,7,Casual Users
51254,158,11,17,4,2,2,8,Promising
51257,1729,12,16,1,3,2,6,Casual Users
51462,124,94,398,4,5,5,14,Champions
51739,40,62,147,5,5,5,15,Champions
51833,93,11,15,4,2,1,7,Promising
52078,65,19,55,5,3,3,11,Loyal Users
52193,128,29,177,4,4,5,13,Champions
52290,1060,8,21,2,2,2,6,Lost
52333,68,30,121,5,4,4,13,Champions
52343,279,83,534,3,5,5,13,Loyal Users
39481,297,7,29,3,2,2,7,Casual Users
39639,391,24,67,3,4,4,11,Loyal Users
39902,254,7,22,3,2,2,7,Casual Users
40007,103,8,38,4,2,3,9,Promising
40136,2748,32,273,1,4,5,10,At Risk
40150,691,8,9,2,2,1,5,Lost
40296,0,17,73,5,3,4,12,Loyal Users
40354,2699,5,29,1,1,2,4,Lost
40659,2442,5,16,1,1,2,4,Lost
40927,31,5,8,5,1,1,7,Promising
41244,28,50,167,5,5,5,15,Champions
41430,177,6,28,3,1,2,6,Casual Users
41854,1674,12,81,1,3,4,8,Casual Users
42271,56,105,599,5,5,5,15,Champions
42502,421,6,9,3,1,1,5,Casual Users
42656,28,106,234,5,5,5,15,Champions
42687,1539,83,255,1,5,5,11,At Risk
42747,393,7,13,3,2,1,6,Casual Users
42887,26,22,81,5,4,4,13,Champions
42901,158,12,78,4,3,4,11,Loyal Users
43078,629,10,22,2,2,2,6,Lost
43241,259,25,152,3,4,5,12,Loyal Users
43345,432,8,18,3,2,2,7,Casual Users
43656,121,18,47,4,3,3,10,Loyal Users
43782,1253,5,10,2,1,1,4,Lost
43909,398,14,29,3,3,2,8,Loyal Users
43957,52,10,16,5,2,2,9,Promising
44411,156,6,9,4,1,1,6,Promising
44612,2,109,201,5,5,5,15,Champions
44771,77,73,294,4,5,5,14,Champions
45122,131,5,5,4,1,1,6,Promising
45216,717,12,19,2,3,2,7,Casual Users
45749,81,148,397,4,5,5,14,Champions
45886,294,55,193,3,5,5,13,Loyal Users
46113,1544,36,126,1,4,4,9,At Risk
46178,299,10,147,3,2,5,10,Casual Users
46688,602,83,152,2,5,5,12,At Risk
46839,394,9,23,3,2,2,7,Casual Users
46867,3955,9,22,1,2,2,5,Lost
46905,5544,5,21,1,1,2,4,Lost
46947,1878,26,113,1,4,4,9,At Risk
47443,38,7,10,5,2,1,8,Promising
47600,143,60,267,4,5,5,14,Champions
47726,73,10,81,4,2,4,10,Promising
48236,31,137,303,5,5,5,15,Champions
48513,4259,5,17,1,1,2,4,Lost
48633,1983,8,12,1,2,1,4,Lost
49098,23,27,82,5,4,4,13,Champions
49791,85,12,39,4,3,3,10,Loyal Users
49885,141,6,14,4,1,1,6,Promising
49982,283,6,6,3,1,1,5,Casual Users
50023,1426,11,20,1,2,2,5,Lost
50160,48,5,7,5,1,1,7,Promising
50271,544,56,97,2,5,4,11,At Risk
50649,77,6,15,4,1,1,6,Promising
50949,273,6,6,3,1,1,5,Casual Users
51187,616,13,26,2,3,2,7,Casual Users
51805,327,38,121,3,4,4,11,Loyal Users
51975,268,6,11,3,1,1,5,Casual Users
39321,542,18,145,2,3,4,9,Casual Users
39503,231,16,31,3,3,2,8,Loyal Users
39669,3260,24,61,1,4,3,8,At Risk
39807,703,17,42,2,3,3,8,Casual Users
40038,1352,8,13,1,2,1,4,Lost
40070,569,16,34,2,3,3,8,Casual Users
40184,10,225,931,5,5,5,15,Champions
40326,280,11,84,3,2,4,9,Casual Users
40512,1261,5,9,1,1,1,3,Lost
40668,2564,11,24,1,2,2,5,Lost
41071,460,9,42,3,2,3,8,Casual Users
41343,1974,11,17,1,2,2,5,Lost
41624,628,17,19,2,3,2,7,Casual Users
41640,143,5,7,4,1,1,6,Promising
41860,27,84,122,5,5,4,14,Champions
42043,101,38,109,4,4,4,12,Champions
42112,9,62,167,5,5,5,15,Champions
42396,20,6,36,5,1,3,9,Promising
42515,265,24,40,3,4,3,10,Loyal Users
43015,3248,5,38,1,1,3,5,Lost
43610,836,26,116,2,4,4,10,At Risk
44145,403,5,10,3,1,1,5,Casual Users
44230,94,9,18,4,2,2,8,Promising
44480,119,61,121,4,5,4,13,Champions
44666,674,5,32,2,1,3,6,Lost
44923,105,46,64,4,5,4,13,Champions
45154,4307,59,104,1,5,4,10,At Risk
45160,15,67,421,5,5,5,15,Champions
45302,2477,5,12,1,1,1,3,Lost
45498,1,156,538,5,5,5,15,Champions
45620,7,12,31,5,3,2,10,Loyal Users
45810,0,39,236,5,4,5,14,Champions
45813,143,21,30,4,3,2,9,Loyal Users
46036,3385,6,18,1,1,2,4,Lost
46214,3397,8,9,1,2,1,4,Lost
46272,95,33,197,4,4,5,13,Champions
46344,266,11,28,3,2,2,7,Casual Users
46480,1719,5,11,1,1,1,3,Lost
46675,2035,6,18,1,1,2,4,Lost
46896,203,110,284,3,5,5,13,Loyal Users
46972,445,8,37,3,2,3,8,Casual Users
47050,1006,23,70,2,4,4,10,At Risk
47889,2652,17,72,1,3,4,8,Casual Users
48404,272,9,54,3,2,3,8,Casual Users
48631,1561,12,51,1,3,3,7,Casual Users
48709,1718,5,14,1,1,1,3,Lost
48823,877,10,69,2,2,4,8,Lost
48849,878,13,52,2,3,3,8,Casual Users
49021,208,17,36,3,3,3,9,Loyal Users
49350,982,11,26,2,2,2,6,Lost
49567,141,82,332,4,5,5,14,Champions
49921,408,19,42,3,3,3,9,Loyal Users
49950,1232,6,21,2,1,2,5,Lost
50310,405,18,28,3,3,2,8,Loyal Users
51120,421,10,19,3,2,2,7,Casual Users
51195,249,24,141,3,4,4,11,Loyal Users
51249,990,5,33,2,1,3,6,Lost
51282,365,37,118,3,4,4,11,Loyal Users
51460,5,8,24,5,2,2,9,Promising
51476,141,64,102,4,5,4,13,Champions
51725,420,30,42,3,4,3,10,Loyal Users
51752,274,39,103,3,4,4,11,Loyal Users
51939,468,21,64,3,3,4,10,Loyal Users
51983,1512,9,11,1,2,1,4,Lost
52183,114,77,194,4,5,5,14,Champions
39271,73,32,140,4,4,4,12,Champions
39371,143,7,34,4,2,3,9,Promising
39491,182,5,11,3,1,1,5,Casual Users
39736,385,7,13,3,2,1,6,Casual Users
39845,4158,8,8,1,2,1,4,Lost
40085,1313,21,43,1,3,3,7,Casual Users
40223,955,9,16,2,2,2,6,Lost
40285,379,12,17,3,3,2,8,Loyal Users
40588,402,8,15,3,2,1,6,Casual Users
40843,294,34,163,3,4,5,12,Loyal Users
41013,659,16,37,2,3,3,8,Casual Users
41174,121,8,12,4,2,1,7,Promising
41220,1018,5,11,2,1,1,4,Lost
41356,524,32,94,2,4,4,10,At Risk
41562,93,155,667,4,5,5,14,Champions
41909,1990,8,36,1,2,3,6,Lost
42276,170,26,43,3,4,3,10,Loyal Users
42513,655,8,14,2,2,1,5,Lost
42789,195,39,131,3,4,4,11,Loyal Users
43672,197,6,12,3,1,1,5,Casual Users
44166,1075,16,52,2,3,3,8,Casual Users
44394,422,11,15,3,2,1,6,Casual Users
44853,16,43,329,5,4,5,14,Champions
45082,466,34,93,3,4,4,11,Loyal Users
45157,113,46,471,4,5,5,14,Champions
45187,108,10,41,4,2,3,9,Promising
45428,12,100,550,5,5,5,15,Champions
45449,4231,5,85,1,1,4,6,Lost
45652,7,155,241,5,5,5,15,Champions
45786,1278,8,8,1,2,1,4,Lost
46485,24,5,5,5,1,1,7,Promising
46556,1476,7,8,1,2,1,4,Lost
46585,3366,53,195,1,5,5,11,At Risk
46614,2940,9,19,1,2,2,5,Lost
47030,411,13,20,3,3,2,8,Loyal Users
47273,1130,5,5,2,1,1,4,Lost
47322,529,10,55,2,2,3,7,Lost
47551,1410,10,29,1,2,2,5,Lost
47669,5,129,689,5,5,5,15,Champions
47778,2954,9,32,1,2,3,6,Lost
47954,743,32,43,2,4,3,9,At Risk
47966,694,13,18,2,3,2,7,Casual Users
48348,277,38,52,3,4,3,10,Loyal Users
48486,0,58,97,5,5,4,14,Champions
48504,369,6,17,3,1,2,6,Casual Users
48515,2960,7,40,1,2,3,6,Lost
48525,996,8,9,2,2,1,5,Lost
49026,83,81,231,4,5,5,14,Champions
49198,19,10,19,5,2,2,9,Promising
49312,133,15,71,4,3,4,11,Loyal Users
49417,164,8,13,4,2,1,7,Promising
49454,427,7,49,3,2,3,8,Casual Users
49829,8,20,104,5,3,4,12,Loyal Users
49854,490,5,8,2,1,1,4,Lost
50005,1258,12,30,1,3,2,6,Casual Users
50124,2003,12,32,1,3,3,7,Casual Users
50173,33,94,181,5,5,5,15,Champions
50471,846,24,71,2,4,4,10,At Risk
50928,2687,6,13,1,1,1,3,Lost
50988,809,6,10,2,1,1,4,Lost
51427,5090,6,6,1,1,1,3,Lost
51429,810,10,16,2,2,2,6,Lost
51489,156,15,76,4,3,4,11,Loyal Users
51878,25,30,59,5,4,3,12,Loyal Users
51982,2477,7,29,1,2,2,5,Lost
52029,396,88,132,3,5,4,12,Loyal Users
39307,49,116,234,5,5,5,15,Champions
39518,834,8,20,2,2,2,6,Lost
39730,2357,7,8,1,2,1,4,Lost
39946,101,23,68,4,4,4,12,Champions
40014,523,22,43,2,4,3,9,At Risk
40043,419,14,28,3,3,2,8,Loyal Users
40175,142,12,42,4,3,3,10,Loyal Users
40427,742,10,17,2,2,2,6,Lost
40556,33,8,26,5,2,2,9,Promising
40664,559,6,20,2,1,2,5,Lost
40729,2823,36,388,1,4,5,10,At Risk
40888,247,26,108,3,4,4,11,Loyal Users
41166,558,5,29,2,1,2,5,Lost
41211,91,13,37,4,3,3,10,Loyal Users
41472,15,49,154,5,5,5,15,Champions
41767,758,22,108,2,4,4,10,At Risk
41980,2688,5,12,1,1,1,3,Lost
42294,520,8,11,2,2,1,5,Lost
42695,120,91,305,4,5,5,14,Champions
42697,195,8,35,3,2,3,8,Casual Users
42948,542,10,31,2,2,2,6,Lost
43446,420,32,61,3,4,3,10,Loyal Users
43460,1410,10,54,1,2,3,6,Lost
43701,100,119,333,4,5,5,14,Champions
44085,94,20,71,4,3,4,11,Loyal Users
44092,255,6,6,3,1,1,5,Casual Users
44096,29,47,94,5,5,4,14,Champions
44152,6,19,40,5,3,3,11,Loyal Users
44223,1389,43,270,1,4,5,10,At Risk
44415,1255,8,34,2,2,3,7,Lost
44690,643,14,120,2,3,4,9,Casual Users
44774,59,15,126,5,3,4,12,Loyal Users
44838,406,10,34,3,2,3,8,Casual Users
44844,262,6,6,3,1,1,5,Casual Users
45179,3418,5,9,1,1,1,3,Lost
45349,643,5,43,2,1,3,6,Lost
45374,4105,6,11,1,1,1,3,Lost
45393,829,8,12,2,2,1,5,Lost
45506,115,15,141,4,3,4,11,Loyal Users
45585,49,64,313,5,5,5,15,Champions
45614,883,5,37,2,1,3,6,Lost
45665,637,11,23,2,2,2,6,Lost
45675,421,5,5,3,1,1,5,Casual Users
45729,5,7,46,5,2,3,10,Promising
45834,2999,8,10,1,2,1,4,Lost
45842,241,45,102,3,4,4,11,Loyal Users
46022,41,68,107,5,5,4,14,Champions
46400,153,12,33,4,3,3,10,Loyal Users
47408,5271,12,12,1,3,1,5,Casual Users
47586,2080,10,96,1,2,4,7,Lost
47611,50,118,410,5,5,5,15,Champions
47734,44,51,202,5,5,5,15,Champions
47741,621,6,19,2,1,2,5,Lost
48050,31,52,76,5,5,4,14,Champions
48178,300,11,49,3,2,3,8,Casual Users
48200,21,25,78,5,4,4,13,Champions
48556,439,8,29,3,2,2,7,Casual Users
48879,17,43,84,5,4,4,13,Champions
49080,660,14,43,2,3,3,8,Casual Users
49796,1,8,27,5,2,2,9,Promising
49879,36,94,356,5,5,5,15,Champions
49989,926,13,28,2,3,2,7,Casual Users
50323,3403,5,7,1,1,1,3,Lost
50450,1425,6,20,1,1,2,4,Lost
50493,868,53,190,2,5,5,12,At Risk
50827,109,27,96,4,4,4,12,Champions
51203,1675,7,9,1,2,1,4,Lost
51215,1026,6,9,2,1,1,4,Lost
51232,276,9,24,3,2,2,7,Casual Users
51274,167,15,34,3,3,3,9,Loyal Users
51298,95,47,160,4,5,5,14,Champions
51304,1895,19,33,1,3,3,7,Casual Users
51368,2453,13,61,1,3,3,7,Casual Users
51532,834,29,62,2,4,3,9,At Risk
52156,1213,11,23,2,2,2,6,Lost
40505,669,5,13,2,1,1,4,Lost
40603,4,82,314,5,5,5,15,Champions
40718,460,24,45,3,4,3,10,Loyal Users
40845,17,7,16,5,2,2,9,Promising
40899,3301,8,13,1,2,1,4,Lost
41276,163,42,96,4,4,4,12,Champions
41319,868,9,23,2,2,2,6,Lost
41376,266,15,22,3,3,2,8,Loyal Users
41446,1107,15,45,2,3,3,8,Casual Users
41462,1,182,778,5,5,5,15,Champions
41891,420,23,30,3,4,2,9,Loyal Users
41952,4,30,51,5,4,3,12,Loyal Users
41958,507,5,15,2,1,1,4,Lost
42605,2129,18,31,1,3,2,6,Casual Users
43110,437,14,27,3,3,2,8,Loyal Users
43288,2,17,82,5,3,4,12,Loyal Users
44402,319,6,9,3,1,1,5,Casual Users
44649,2176,10,38,1,2,3,6,Lost
44869,1617,5,17,1,1,2,4,Lost
45173,35,31,175,5,4,5,14,Champions
45236,178,61,131,3,5,4,12,Loyal Users
45510,2,113,284,5,5,5,15,Champions
45557,87,27,61,4,4,3,11,Loyal Users
45883,16,5,21,5,1,2,8,Promising
46138,445,22,36,3,4,3,10,Loyal Users
46276,1968,14,22,1,3,2,6,Casual Users
46862,126,28,34,4,4,3,11,Loyal Users
47308,3169,36,65,1,4,4,9,At Risk
47393,1752,14,77,1,3,4,8,Casual Users
47627,16,35,160,5,4,5,14,Champions
47650,4813,31,109,1,4,4,9,At Risk
47663,229,12,34,3,3,3,9,Loyal Users
47746,973,27,122,2,4,4,10,At Risk
47775,32,17,42,5,3,3,11,Loyal Users
48126,265,65,322,3,5,5,13,Loyal Users
48360,1761,8,22,1,2,2,5,Lost
48444,432,5,23,3,1,2,6,Casual Users
48574,2536,8,14,1,2,1,4,Lost
48752,103,17,35,4,3,3,10,Loyal Users
48897,55,28,143,5,4,4,13,Champions
49003,1766,7,10,1,2,1,4,Lost
49107,1615,7,9,1,2,1,4,Lost
49870,2133,8,13,1,2,1,4,Lost
49947,423,18,62,3,3,3,9,Loyal Users
49957,113,14,45,4,3,3,10,Loyal Users
50721,111,30,96,4,4,4,12,Champions
50745,263,37,60,3,4,3,10,Loyal Users
50964,122,19,159,4,3,5,12,Loyal Users
51348,4571,5,6,1,1,1,3,Lost
51498,166,12,27,3,3,2,8,Loyal Users
51963,1312,6,50,1,1,3,5,Lost
52062,180,18,31,3,3,2,8,Loyal Users
52120,4585,6,21,1,1,2,4,Lost
40299,27,11,26,5,2,2,9,Promising
40349,1899,7,8,1,2,1,4,Lost
40392,2013,11,59,1,2,3,6,Lost
40617,272,8,24,3,2,2,7,Casual Users
40618,1513,6,6,1,1,1,3,Lost
40742,256,7,16,3,2,2,7,Casual Users
41043,59,47,96,5,5,4,14,Champions
41437,2804,6,11,1,1,1,3,Lost
41455,1080,12,86,2,3,4,9,Casual Users
41708,387,21,39,3,3,3,9,Loyal Users
42040,5,74,183,5,5,5,15,Champions
42168,292,7,9,3,2,1,6,Casual Users
42180,11,26,203,5,4,5,14,Champions
42240,416,6,17,3,1,2,6,Casual Users
42867,115,35,77,4,4,4,12,Champions
43519,92,62,124,4,5,4,13,Champions
43721,1150,15,71,2,3,4,9,Casual Users
43785,117,19,47,4,3,3,10,Loyal Users
44121,4103,8,28,1,2,2,5,Lost
44168,663,12,61,2,3,3,8,Casual Users
44200,248,6,19,3,1,2,6,Casual Users
44306,835,7,15,2,2,1,5,Lost
44804,428,17,29,3,3,2,8,Loyal Users
44855,4,51,109,5,5,4,14,Champions
44873,126,16,38,4,3,3,10,Loyal Users
45159,37,12,20,5,3,2,10,Loyal Users
45240,124,55,153,4,5,5,14,Champions
45364,1786,5,58,1,1,3,5,Lost
45387,229,5,7,3,1,1,5,Casual Users
45547,436,8,8,3,2,1,6,Casual Users
45559,204,10,22,3,2,2,7,Casual Users
45686,9,120,497,5,5,5,15,Champions
45730,5,26,143,5,4,4,13,Champions
46055,509,45,98,2,4,4,10,At Risk
46613,12,5,15,5,1,1,7,Promising
46641,628,21,36,2,3,3,8,Casual Users
46977,111,54,123,4,5,4,13,Champions
47215,2134,7,23,1,2,2,5,Lost
47430,15,91,339,5,5,5,15,Champions
47541,1504,9,17,1,2,2,5,Lost
47678,173,10,31,3,2,2,7,Casual Users
48372,676,20,30,2,3,2,7,Casual Users
48413,411,17,73,3,3,4,10,Loyal Users
49013,41,9,13,5,2,1,8,Promising
49121,80,50,231,4,5,5,14,Champions
49218,883,8,17,2,2,2,6,Lost
49824,44,75,277,5,5,5,15,Champions
49933,3347,15,33,1,3,3,7,Casual Users
49935,647,62,208,2,5,5,12,At Risk
50050,15,11,51,5,2,3,10,Promising
50311,1141,24,107,2,4,4,10,At Risk
50651,275,5,33,3,1,3,7,Casual Users
50799,60,12,18,5,3,2,10,Loyal Users
50840,153,53,98,4,5,4,13,Champions
51025,2,7,17,5,2,2,9,Promising
51158,445,7,15,3,2,1,6,Casual Users
51175,193,9,14,3,2,1,6,Casual Users
51211,46,42,255,5,4,5,14,Champions
51315,4257,9,17,1,2,2,5,Lost
52199,60,127,847,5,5,5,15,Champions
39771,4423,5,10,1,1,1,3,Lost
39926,262,5,8,3,1,1,5,Casual Users
40084,547,12,15,2,3,1,6,Casual Users
40710,846,7,50,2,2,3,7,Lost
41250,514,10,31,2,2,2,6,Lost
41447,1427,11,70,1,2,4,7,Lost
41593,395,66,140,3,5,4,12,Loyal Users
42121,16,125,768,5,5,5,15,Champions
42201,1151,21,46,2,3,3,8,Casual Users
42443,124,53,181,4,5,5,14,Champions
42461,20,23,59,5,4,3,12,Loyal Users
42496,824,13,25,2,3,2,7,Casual Users
42558,319,62,182,3,5,5,13,Loyal Users
42614,440,11,14,3,2,1,6,Casual Users
42941,76,17,39,4,3,3,10,Loyal Users
43055,102,14,117,4,3,4,11,Loyal Users
43240,1253,6,8,2,1,1,4,Lost
43329,564,84,349,2,5,5,12,At Risk
43745,2671,12,40,1,3,3,7,Casual Users
43800,647,6,13,2,1,1,4,Lost
43809,1284,7,49,1,2,3,6,Lost
43839,11,67,170,5,5,5,15,Champions
44222,119,36,252,4,4,5,13,Champions
44307,758,8,11,2,2,1,5,Lost
44645,934,89,232,2,5,5,12,At Risk
44881,110,48,390,4,5,5,14,Champions
44956,280,9,31,3,2,2,7,Casual Users
45001,416,5,8,3,1,1,5,Casual Users
45133,1592,5,5,1,1,1,3,Lost
45399,639,16,34,2,3,3,8,Casual Users
45728,19,34,129,5,4,4,13,Champions
45852,7,98,348,5,5,5,15,Champions
46312,482,55,160,2,5,5,12,At Risk
46572,642,8,14,2,2,1,5,Lost
46574,15,20,51,5,3,3,11,Loyal Users
47004,256,55,122,3,5,4,12,Loyal Users
47245,531,16,23,2,3,2,7,Casual Users
47248,37,11,91,5,2,4,11,Promising
47289,32,8,13,5,2,1,8,Promising
47323,581,12,48,2,3,3,8,Casual Users
47410,68,73,199,5,5,5,15,Champions
47461,520,18,35,2,3,3,8,Casual Users
47500,118,46,200,4,5,5,14,Champions
47584,6,18,82,5,3,4,12,Loyal Users
47590,2457,14,20,1,3,2,6,Casual Users
47624,221,34,259,3,4,5,12,Loyal Users
47630,436,38,64,3,4,4,11,Loyal Users
47719,292,7,129,3,2,4,9,Casual Users
47853,5105,6,47,1,1,3,5,Lost
47999,12,33,101,5,4,4,13,Champions
48130,1456,16,38,1,3,3,7,Casual Users
48367,117,82,159,4,5,5,14,Champions
48782,14,16,64,5,3,4,12,Loyal Users
48792,743,21,88,2,3,4,9,Casual Users
48865,135,89,288,4,5,5,14,Champions
49467,133,55,161,4,5,5,14,Champions
49469,25,38,94,5,4,4,13,Champions
49703,599,29,125,2,4,4,10,At Risk
49837,1566,9,19,1,2,2,5,Lost
50216,155,31,95,4,4,4,12,Champions
50491,991,9,27,2,2,2,6,Lost
50529,176,13,80,3,3,4,10,Loyal Users
50755,718,8,11,2,2,1,5,Lost
50837,33,90,430,5,5,5,15,Champions
50898,18,14,31,5,3,2,10,Loyal Users
50930,8,11,32,5,2,3,10,Promising
51201,42,10,32,5,2,3,10,Promising
51244,120,5,47,4,1,3,8,Promising
51446,1469,30,98,1,4,4,9,At Risk
52053,431,7,12,3,2,1,6,Casual Users
52105,210,14,25,3,3,2,8,Loyal Users
39277,415,8,12,3,2,1,6,Casual Users
39984,423,12,13,3,3,1,7,Loyal Users
40216,2,55,126,5,5,4,14,Champions
40307,1,5,8,5,1,1,7,Promising
41127,296,21,25,3,3,2,8,Loyal Users
41364,5114,8,34,1,2,3,6,Lost
41555,248,19,80,3,3,4,10,Loyal Users
41871,434,45,203,3,4,5,12,Loyal Users
42232,270,6,18,3,1,2,6,Casual Users
42652,1073,18,26,2,3,2,7,Casual Users
42725,103,85,148,4,5,5,14,Champions
42726,91,5,8,4,1,1,6,Promising
42964,391,17,41,3,3,3,9,Loyal Users
43284,82,8,17,4,2,2,8,Promising
43440,830,15,23,2,3,2,7,Casual Users
43452,990,17,33,2,3,3,8,Casual Users
43535,24,100,471,5,5,5,15,Champions
43890,255,9,26,3,2,2,7,Casual Users
44036,736,5,9,2,1,1,4,Lost
44681,2024,9,52,1,2,3,6,Lost
44684,29,41,140,5,4,4,13,Champions
44693,289,15,66,3,3,4,10,Loyal Users
45418,416,56,120,3,5,4,12,Loyal Users
45483,246,19,216,3,3,5,11,Loyal Users
45869,1529,83,514,1,5,5,11,At Risk
45913,6,14,36,5,3,3,11,Loyal Users
45967,31,37,212,5,4,5,14,Champions
46221,713,6,13,2,1,1,4,Lost
46394,725,37,39,2,4,3,9,At Risk
46429,1091,6,12,2,1,1,4,Lost
46502,12,5,6,5,1,1,7,Promising
46565,129,16,22,4,3,2,9,Loyal Users
46665,15,46,64,5,5,4,14,Champions
47317,39,79,307,5,5,5,15,Champions
47326,406,15,139,3,3,4,10,Loyal Users
47454,4490,5,10,1,1,1,3,Lost
47598,2323,8,17,1,2,2,5,Lost
47845,8,13,17,5,3,2,10,Loyal Users
47952,42,103,178,5,5,5,15,Champions
48272,212,138,861,3,5,5,13,Loyal Users
48411,614,47,146,2,5,4,11,At Risk
48535,2852,6,7,1,1,1,3,Lost
48559,50,84,335,5,5,5,15,Champions
49120,1520,9,18,1,2,2,5,Lost
49505,11,88,183,5,5,5,15,Champions
49821,7,76,200,5,5,5,15,Champions
50213,1009,17,97,2,3,4,9,Casual Users
50519,30,33,48,5,4,3,12,Loyal Users
50735,836,24,54,2,4,3,9,At Risk
50834,319,8,48,3,2,3,8,Casual Users
51058,154,79,525,4,5,5,14,Champions
51210,295,18,38,3,3,3,9,Loyal Users
51382,940,5,44,2,1,3,6,Lost
51477,38,8,24,5,2,2,9,Promising
51493,462,15,22,3,3,2,8,Loyal Users
52030,289,5,31,3,1,2,6,Casual Users
52129,9,17,46,5,3,3,11,Loyal Users
52160,104,20,42,4,3,3,10,Loyal Users
52334,513,6,8,2,1,1,4,Lost
39367,260,14,19,3,3,2,8,Loyal Users
39512,4715,16,33,1,3,3,7,Casual Users
39878,346,11,22,3,2,2,7,Casual Users
39960,15,14,34,5,3,3,11,Loyal Users
40003,111,32,71,4,4,4,12,Champions
40020,1287,5,12,1,1,1,3,Lost
40162,136,65,193,4,5,5,14,Champions
40172,435,5,10,3,1,1,5,Casual Users
40255,103,70,366,4,5,5,14,Champions
40294,4601,6,14,1,1,1,3,Lost
40311,7,32,80,5,4,4,13,Champions
40485,413,30,71,3,4,4,11,Loyal Users
40651,213,13,19,3,3,2,8,Loyal Users
40754,576,12,23,2,3,2,7,Casual Users
40910,5037,23,28,1,4,2,7,At Risk
40940,845,11,19,2,2,2,6,Lost
40997,2856,5,12,1,1,1,3,Lost
41024,364,20,69,3,3,4,10,Loyal Users
41064,1036,17,33,2,3,3,8,Casual Users
41537,1949,7,21,1,2,2,5,Lost
41676,577,85,217,2,5,5,12,At Risk
41691,559,5,11,2,1,1,4,Lost
41709,1050,71,105,2,5,4,11,At Risk
41750,1007,7,15,2,2,1,5,Lost
41798,24,72,156,5,5,5,15,Champions
41984,134,6,6,4,1,1,6,Promising
42122,242,25,51,3,4,3,10,Loyal Users
42134,1117,6,7,2,1,1,4,Lost
42384,1119,22,28,2,4,2,8,At Risk
42547,51,13,23,5,3,2,10,Loyal Users
42647,4487,5,5,1,1,1,3,Lost
42915,139,10,14,4,2,1,7,Promising
43042,720,22,70,2,4,4,10,At Risk
43154,15,57,247,5,5,5,15,Champions
43246,125,7,21,4,2,2,8,Promising
43314,289,6,33,3,1,3,7,Casual Users
43546,467,26,55,3,4,3,10,Loyal Users
43888,5286,64,76,1,5,4,10,At Risk
43900,2407,23,34,1,4,3,8,At Risk
44115,160,39,97,4,4,4,12,Champions
44183,292,29,46,3,4,3,10,Loyal Users
44404,48,6,25,5,1,2,8,Promising
44661,3743,13,36,1,3,3,7,Casual Users
44816,163,101,210,4,5,5,14,Champions
45015,225,24,102,3,4,4,11,Loyal Users
45038,532,38,50,2,4,3,9,At Risk
45352,450,6,26,3,1,2,6,Casual Users
45502,100,155,419,4,5,5,14,Champions
45691,456,21,45,3,3,3,9,Loyal Users
45874,80,140,488,4,5,5,14,Champions
45926,545,18,19,2,3,2,7,Casual Users
45988,729,33,154,2,4,5,11,At Risk
46144,25,104,542,5,5,5,15,Champions
46177,56,152,245,5,5,5,15,Champions
46192,1582,10,16,1,2,2,5,Lost
46284,158,35,96,4,4,4,12,Champions
46503,392,36,75,3,4,4,11,Loyal Users
46631,3689,7,11,1,2,1,4,Lost
47194,422,6,8,3,1,1,5,Casual Users
47374,427,42,140,3,4,4,11,Loyal Users
47423,59,12,33,5,3,3,11,Loyal Users
47585,40,124,310,5,5,5,15,Champions
47686,17,62,232,5,5,5,15,Champions
47749,221,15,79,3,3,4,10,Loyal Users
48117,2590,6,16,1,1,2,4,Lost
48205,77,19,146,4,3,4,11,Loyal Users
48246,1086,10,61,2,2,3,7,Lost
48377,114,18,32,4,3,3,10,Loyal Users
48806,399,15,26,3,3,2,8,Loyal Users
48839,5461,28,115,1,4,4,9,At Risk
49165,5991,5,10,1,1,1,3,Lost
49178,1576,52,147,1,5,5,11,At Risk
49263,226,29,74,3,4,4,11,Loyal Users
49385,3,92,212,5,5,5,15,Champions
49617,260,60,139,3,5,4,12,Loyal Users
49775,125,15,79,4,3,4,11,Loyal Users
49794,23,87,181,5,5,5,15,Champions
49960,23,38,125,5,4,4,13,Champions
50053,808,24,88,2,4,4,10,At Risk
50344,1676,6,8,1,1,1,3,Lost
50524,415,31,66,3,4,4,11,Loyal Users
50995,80,78,94,4,5,4,13,Champions
51204,765,12,34,2,3,3,8,Casual Users
51539,137,8,30,4,2,2,8,Promising
51587,553,12,16,2,3,2,7,Casual Users
39514,14,7,8,5,2,1,8,Promising
39948,1870,7,9,1,2,1,4,Lost
40159,179,19,32,3,3,3,9,Loyal Users
40228,24,57,184,5,5,5,15,Champions
40312,181,11,102,3,2,4,9,Casual Users
40324,1,147,351,5,5,5,15,Champions
40474,4,88,437,5,5,5,15,Champions
40733,56,13,20,5,3,2,10,Loyal Users
40768,199,50,94,3,5,4,12,Loyal Users
41075,741,13,19,2,3,2,7,Casual Users
41087,102,11,18,4,2,2,8,Promising
41152,18,81,223,5,5,5,15,Champions
41395,96,7,18,4,2,2,8,Promising
42372,1052,7,25,2,2,2,6,Lost
42398,2948,6,9,1,1,1,3,Lost
42427,234,22,38,3,4,3,10,Loyal Users
42904,19,77,174,5,5,5,15,Champions
43595,1871,6,6,1,1,1,3,Lost
43753,159,23,96,4,4,4,12,Champions
43846,1016,5,34,2,1,3,6,Lost
44245,1901,12,61,1,3,3,7,Casual Users
44692,744,10,33,2,2,3,7,Lost
45005,912,14,23,2,3,2,7,Casual Users
45485,26,86,127,5,5,4,14,Champions
45524,454,7,12,3,2,1,6,Casual Users
46023,295,21,58,3,3,3,9,Loyal Users
46261,2783,5,7,1,1,1,3,Lost
46717,292,45,67,3,4,4,11,Loyal Users
46726,388,17,20,3,3,2,8,Loyal Users
46841,124,72,88,4,5,4,13,Champions
47124,256,30,62,3,4,3,10,Loyal Users
47220,1727,6,19,1,1,2,4,Lost
47344,88,123,267,4,5,5,14,Champions
47464,133,117,181,4,5,5,14,Champions
47781,245,8,41,3,2,3,8,Casual Users
48066,835,6,14,2,1,1,4,Lost
48120,744,6,10,2,1,1,4,Lost
48161,203,22,89,3,4,4,11,Loyal Users
48177,546,13,21,2,3,2,7,Casual Users
48213,11,99,324,5,5,5,15,Champions
48418,2441,9,11,1,2,1,4,Lost
48639,2,70,162,5,5,5,15,Champions
48715,409,17,112,3,3,4,10,Loyal Users
48877,130,42,79,4,4,4,12,Champions
49049,695,22,51,2,4,3,9,At Risk
49109,2713,8,25,1,2,2,5,Lost
49234,878,12,15,2,3,1,6,Casual Users
49445,104,5,10,4,1,1,6,Promising
49517,328,9,25,3,2,2,7,Casual Users
49768,2114,6,6,1,1,1,3,Lost
50132,4791,7,62,1,2,3,6,Lost
50144,398,46,102,3,5,4,12,Loyal Users
50650,1,33,72,5,4,4,13,Champions
50684,110,142,337,4,5,5,14,Champions
50892,650,7,31,2,2,2,6,Lost
51117,415,8,31,3,2,2,7,Casual Users
51205,0,49,83,5,5,4,14,Champions
51634,1017,6,6,2,1,1,4,Lost
51653,1300,14,47,1,3,3,7,Casual Users
51827,71,6,33,4,1,3,8,Promising
51957,598,10,57,2,2,3,7,Lost
52329,421,105,165,3,5,5,13,Loyal Users
39374,1329,22,32,1,4,3,8,At Risk
39425,617,30,49,2,4,3,9,At Risk
39516,103,33,125,4,4,4,12,Champions
39551,2836,5,11,1,1,1,3,Lost
39763,27,6,6,5,1,1,7,Promising
40049,86,23,78,4,4,4,12,Champions
40188,548,5,8,2,1,1,4,Lost
40194,228,17,34,3,3,3,9,Loyal Users
40257,110,97,148,4,5,5,14,Champions
40280,413,5,19,3,1,2,6,Casual Users
40289,608,14,18,2,3,2,7,Casual Users
40449,2,42,71,5,4,4,13,Champions
40516,3808,5,5,1,1,1,3,Lost
40553,150,28,62,4,4,3,11,Loyal Users
41072,3205,7,24,1,2,2,5,Lost
41312,5483,5,9,1,1,1,3,Lost
41927,217,15,33,3,3,3,9,Loyal Users
42055,232,6,7,3,1,1,5,Casual Users
42203,39,13,19,5,3,2,10,Loyal Users
42245,143,66,191,4,5,5,14,Champions
42514,946,5,8,2,1,1,4,Lost
42551,145,72,304,4,5,5,14,Champions
42579,348,28,51,3,4,3,10,Loyal Users
42683,607,23,58,2,4,3,9,At Risk
42856,125,8,25,4,2,2,8,Promising
42968,422,6,17,3,1,2,6,Casual Users
43200,48,50,80,5,5,4,14,Champions
43206,222,53,200,3,5,5,13,Loyal Users
43368,0,13,35,5,3,3,11,Loyal Users
43444,232,32,168,3,4,5,12,Loyal Users
43530,10,11,14,5,2,1,8,Promising
43773,546,14,21,2,3,2,7,Casual Users
43980,993,11,30,2,2,2,6,Lost
44377,582,11,24,2,2,2,6,Lost
44746,2,26,36,5,4,3,12,Loyal Users
45073,1,80,221,5,5,5,15,Champions
45210,1262,8,140,1,2,4,7,Lost
45249,41,57,430,5,5,5,15,Champions
45359,0,80,418,5,5,5,15,Champions
45527,166,19,36,3,3,3,9,Loyal Users
45582,256,14,19,3,3,2,8,Loyal Users
45716,108,7,26,4,2,2,8,Promising
45807,460,65,228,3,5,5,13,Loyal Users
45830,9,10,11,5,2,1,8,Promising
46005,335,60,66,3,5,4,12,Loyal Users
46014,5,224,681,5,5,5,15,Champions
46301,141,44,217,4,4,5,13,Champions
46437,436,10,40,3,2,3,8,Casual Users
46904,3471,14,16,1,3,2,6,Casual Users
47036,272,49,100,3,5,4,12,Loyal Users
47444,120,60,203,4,5,5,14,Champions
47536,161,10,37,4,2,3,9,Promising
47610,259,122,437,3,5,5,13,Loyal Users
47796,1873,8,11,1,2,1,4,Lost
47819,48,37,88,5,4,4,13,Champions
48193,17,22,35,5,4,3,12,Loyal Users
48239,91,67,542,4,5,5,14,Champions
48833,28,23,31,5,4,2,11,Loyal Users
48985,5486,8,15,1,2,1,4,Lost
49035,127,8,10,4,2,1,7,Promising
49115,201,10,22,3,2,2,7,Casual Users
49295,126,12,48,4,3,3,10,Loyal Users
49980,1650,11,17,1,2,2,5,Lost
50184,1564,7,11,1,2,1,4,Lost
50319,716,17,29,2,3,2,7,Casual Users
51126,298,7,12,3,2,1,6,Casual Users
51268,49,15,206,5,3,5,13,Loyal Users
51343,3,5,45,5,1,3,9,Promising
51648,270,49,136,3,5,4,12,Loyal Users
51722,1673,12,35,1,3,3,7,Casual Users
51800,1333,5,6,1,1,1,3,Lost
52006,2,55,109,5,5,4,14,Champions
52256,124,49,80,4,5,4,13,Champions
52284,645,11,52,2,2,3,7,Lost
39471,182,22,83,3,4,4,11,Loyal Users
39831,20,102,197,5,5,5,15,Champions
39837,2274,8,14,1,2,1,4,Lost
40022,284,11,62,3,2,3,8,Casual Users
40336,141,15,26,4,3,2,9,Loyal Users
40390,4397,11,63,1,2,4,7,Lost
40855,430,29,116,3,4,4,11,Loyal Users
41129,719,5,5,2,1,1,4,Lost
41901,74,74,295,4,5,5,14,Champions
41922,96,61,392,4,5,5,14,Champions
42420,288,29,63,3,4,4,11,Loyal Users
42999,309,10,28,3,2,2,7,Casual Users
43258,140,11,19,4,2,2,8,Promising
43813,45,52,221,5,5,5,15,Champions
43952,2406,5,8,1,1,1,3,Lost
44143,25,64,178,5,5,5,15,Champions
44308,79,8,13,4,2,1,7,Promising
44535,127,129,200,4,5,5,14,Champions
44937,422,5,7,3,1,1,5,Casual Users
45000,837,5,9,2,1,1,4,Lost
45254,179,7,11,3,2,1,6,Casual Users
45847,4777,5,14,1,1,1,3,Lost
46229,10,72,264,5,5,5,15,Champions
46822,661,8,10,2,2,1,5,Lost
46869,150,78,137,4,5,4,13,Champions
46875,101,60,118,4,5,4,13,Champions
47112,128,10,38,4,2,3,9,Promising
47127,428,8,26,3,2,2,7,Casual Users
47240,1373,16,22,1,3,2,6,Casual Users
47256,123,8,14,4,2,1,7,Promising
47484,37,6,12,5,1,1,7,Promising
47892,146,48,80,4,5,4,13,Champions
47893,844,24,126,2,4,4,10,At Risk
47982,506,29,122,2,4,4,10,At Risk
48208,3697,17,24,1,3,2,6,Casual Users
48546,112,7,35,4,2,3,9,Promising
48548,218,36,59,3,4,3,10,Loyal Users
48567,5891,10,10,1,2,1,4,Lost
48763,1944,5,12,1,1,1,3,Lost
49892,57,171,789,5,5,5,15,Champions
50360,75,49,177,4,5,5,14,Champions
50379,99,23,74,4,4,4,12,Champions
50843,88,7,17,4,2,2,8,Promising
51046,1678,109,600,1,5,5,11,At Risk
51066,823,8,96,2,2,4,8,Lost
51246,28,15,110,5,3,4,12,Loyal Users
51265,356,6,8,3,1,1,5,Casual Users
51323,2106,6,15,1,1,1,3,Lost
51889,414,6,31,3,1,2,6,Casual Users
51953,7,26,39,5,4,3,12,Loyal Users
39269,275,22,75,3,4,4,11,Loyal Users
39490,508,9,38,2,2,3,7,Lost
39572,86,93,136,4,5,4,13,Champions
39592,2076,5,5,1,1,1,3,Lost
39606,823,96,134,2,5,4,11,At Risk
40010,36,68,87,5,5,4,14,Champions
40499,905,22,134,2,4,4,10,At Risk
40554,127,11,31,4,2,2,8,Promising
41169,2678,5,12,1,1,1,3,Lost
41202,113,32,86,4,4,4,12,Champions
41236,4448,5,12,1,1,1,3,Lost
41451,3237,20,28,1,3,2,6,Casual Users
41506,278,13,65,3,3,4,10,Loyal Users
41521,65,125,502,5,5,5,15,Champions
41569,1023,9,46,2,2,3,7,Lost
41705,368,6,6,3,1,1,5,Casual Users
41839,16,18,48,5,3,3,11,Loyal Users
42124,14,104,568,5,5,5,15,Champions
42336,1416,6,15,1,1,1,3,Lost
42575,1137,31,75,2,4,4,10,At Risk
43524,419,5,7,3,1,1,5,Casual Users
43529,195,19,37,3,3,3,9,Loyal Users
43538,442,14,37,3,3,3,9,Loyal Users
43687,3087,5,7,1,1,1,3,Lost
44327,101,40,172,4,4,5,13,Champions
44374,657,34,111,2,4,4,10,At Risk
44417,3298,31,117,1,4,4,9,At Risk
44440,153,91,258,4,5,5,14,Champions
44784,5,40,105,5,4,4,13,Champions
44890,1579,7,19,1,2,2,5,Lost
45229,6,79,144,5,5,4,14,Champions
45355,413,26,110,3,4,4,11,Loyal Users
45368,38,54,148,5,5,5,15,Champions
45372,1530,31,50,1,4,3,8,At Risk
45392,562,16,42,2,3,3,8,Casual Users
45476,201,11,34,3,2,3,8,Casual Users
45519,375,10,18,3,2,2,7,Casual Users
45544,104,8,20,4,2,2,8,Promising
45963,4534,14,28,1,3,2,6,Casual Users
46020,42,56,180,5,5,5,15,Champions
46116,173,5,13,3,1,1,5,Casual Users
46409,223,23,47,3,4,3,10,Loyal Users
46432,2467,6,7,1,1,1,3,Lost
46560,518,7,14,2,2,1,5,Lost
46690,65,10,23,5,2,2,9,Promising
46871,3,8,10,5,2,1,8,Promising
46893,137,7,11,4,2,1,7,Promising
47291,493,47,152,2,5,5,12,At Risk
47449,698,23,160,2,4,5,11,At Risk
47474,147,34,84,4,4,4,12,Champions
47914,4,20,27,5,3,2,10,Loyal Users
48116,266,12,23,3,3,2,8,Loyal Users
48343,555,13,33,2,3,3,8,Casual Users
48531,19,125,720,5,5,5,15,Champions
48568,282,19,38,3,3,3,9,Loyal Users
48600,1171,14,123,2,3,4,9,Casual Users
48646,2972,8,28,1,2,2,5,Lost
48743,24,32,69,5,4,4,13,Champions
49290,56,43,75,5,4,4,13,Champions
49594,562,12,59,2,3,3,8,Casual Users
49858,170,88,269,3,5,5,13,Loyal Users
49975,430,12,14,3,3,1,7,Loyal Users
49988,138,32,210,4,4,5,13,Champions
50137,3117,13,14,1,3,1,5,Casual Users
50246,1530,10,43,1,2,3,6,Lost
50407,1840,9,11,1,2,1,4,Lost
50437,411,9,31,3,2,2,7,Casual Users
50551,113,22,44,4,4,3,11,Loyal Users
50838,65,7,16,5,2,2,9,Promising
50849,79,22,139,4,4,4,12,Champions
51260,1789,10,16,1,2,2,5,Lost
51353,116,16,54,4,3,3,10,Loyal Users
51525,1461,6,21,1,1,2,4,Lost
51562,391,38,139,3,4,4,11,Loyal Users
51596,687,11,26,2,2,2,6,Lost
51759,424,6,18,3,1,2,6,Casual Users
52175,3,200,631,5,5,5,15,Champions
39567,136,118,396,4,5,5,14,Champions
39767,4152,9,12,1,2,1,4,Lost
39813,28,64,239,5,5,5,15,Champions
40105,6,83,178,5,5,5,15,Champions
40367,652,9,28,2,2,2,6,Lost
40465,155,35,62,4,4,3,11,Loyal Users
40721,4126,9,20,1,2,2,5,Lost
40734,158,19,34,4,3,3,10,Loyal Users
40809,1957,5,33,1,1,3,5,Lost
40926,11,97,198,5,5,5,15,Champions
41107,83,37,94,4,4,4,12,Champions
41572,19,5,50,5,1,3,9,Promising
41776,123,158,349,4,5,5,14,Champions
42486,809,9,17,2,2,2,6,Lost
42649,14,27,55,5,4,3,12,Loyal Users
42744,271,54,159,3,5,5,13,Loyal Users
42905,140,15,17,4,3,2,9,Loyal Users
42911,714,19,85,2,3,4,9,Casual Users
43297,35,44,93,5,4,4,13,Champions
43614,1419,10,17,1,2,2,5,Lost
43916,245,24,34,3,4,3,10,Loyal Users
44066,1513,5,10,1,1,1,3,Lost
44436,34,103,606,5,5,5,15,Champions
44444,132,27,63,4,4,4,12,Champions
44778,1449,12,40,1,3,3,7,Casual Users
45039,2404,9,16,1,2,2,5,Lost
45056,383,28,96,3,4,4,11,Loyal Users
45446,33,11,18,5,2,2,9,Promising
45523,239,14,68,3,3,4,10,Loyal Users
45823,3158,5,7,1,1,1,3,Lost
45903,3229,5,7,1,1,1,3,Lost
45912,2415,19,46,1,3,3,7,Casual Users
46289,4923,39,210,1,4,5,10,At Risk
46341,89,26,63,4,4,4,12,Champions
46413,4260,5,6,1,1,1,3,Lost
46609,432,11,58,3,2,3,8,Casual Users
46843,91,90,322,4,5,5,14,Champions
47376,7,42,115,5,4,4,13,Champions
47417,322,49,86,3,5,4,12,Loyal Users
47709,13,69,134,5,5,4,14,Champions
47801,1771,6,31,1,1,2,4,Lost
48143,175,23,76,3,4,4,11,Loyal Users
48294,2485,5,5,1,1,1,3,Lost
48338,715,7,15,2,2,1,5,Lost
48814,137,46,129,4,5,4,13,Champions
48924,84,48,85,4,5,4,13,Champions
49144,327,10,40,3,2,3,8,Casual Users
49219,2171,13,35,1,3,3,7,Casual Users
49817,810,6,6,2,1,1,4,Lost
50341,1566,9,33,1,2,3,6,Lost
50418,135,10,26,4,2,2,8,Promising
50436,233,30,239,3,4,5,12,Loyal Users
50512,131,19,66,4,3,4,11,Loyal Users
50600,402,14,87,3,3,4,10,Loyal Users
50781,2555,7,23,1,2,2,5,Lost
50813,276,26,97,3,4,4,11,Loyal Users
51053,251,9,65,3,2,4,9,Casual Users
51133,1963,12,18,1,3,2,6,Casual Users
51540,790,19,49,2,3,3,8,Casual Users
51832,6,12,29,5,3,2,10,Loyal Users
52036,213,53,76,3,5,4,12,Loyal Users
52094,12,114,238,5,5,5,15,Champions
52211,84,28,212,4,4,5,13,Champions
39303,1951,8,10,1,2,1,4,Lost
39994,1123,52,68,2,5,4,11,At Risk
40019,954,5,11,2,1,1,4,Lost
40211,229,17,93,3,3,4,10,Loyal Users
40274,1912,5,7,1,1,1,3,Lost
40382,104,16,41,4,3,3,10,Loyal Users
40395,288,23,62,3,4,3,10,Loyal Users
40403,1743,7,11,1,2,1,4,Lost
40804,151,24,393,4,4,5,13,Champions
40984,1138,8,29,2,2,2,6,Lost
41143,30,61,95,5,5,4,14,Champions
41226,111,87,162,4,5,5,14,Champions
41257,140,5,11,4,1,1,6,Promising
41318,201,32,146,3,4,4,11,Loyal Users
41378,106,48,210,4,5,5,14,Champions
41528,2695,6,6,1,1,1,3,Lost
42027,1869,6,9,1,1,1,3,Lost
42237,869,16,59,2,3,3,8,Casual Users
42277,712,9,35,2,2,3,7,Lost
42651,33,15,27,5,3,2,10,Loyal Users
42870,73,9,55,4,2,3,9,Promising
42924,407,8,14,3,2,1,6,Casual Users
42938,5134,8,8,1,2,1,4,Lost
43481,223,52,141,3,5,4,12,Loyal Users
43850,1409,8,19,1,2,2,5,Lost
44175,99,31,264,4,4,5,13,Champions
44442,382,103,462,3,5,5,13,Loyal Users
44805,120,28,87,4,4,4,12,Champions
45152,768,8,15,2,2,1,5,Lost
45199,34,23,46,5,4,3,12,Loyal Users
45707,173,41,90,3,4,4,11,Loyal Users
45787,33,16,37,5,3,3,11,Loyal Users
45866,79,153,539,4,5,5,14,Champions
46189,3987,9,39,1,2,3,6,Lost
46230,301,21,54,3,3,3,9,Loyal Users
46275,18,28,74,5,4,4,13,Champions
46321,162,11,14,4,2,1,7,Promising
46397,371,8,17,3,2,2,7,Casual Users
46827,272,39,128,3,4,4,11,Loyal Users
46856,1576,5,8,1,1,1,3,Lost
47094,1275,10,13,1,2,1,4,Lost
47227,1779,8,12,1,2,1,4,Lost
47529,2428,7,33,1,2,3,6,Lost
47692,330,31,47,3,4,3,10,Loyal Users
47748,410,6,13,3,1,1,5,Casual Users
47756,1701,6,15,1,1,1,3,Lost
47948,1965,6,12,1,1,1,3,Lost
47958,496,34,116,2,4,4,10,At Risk
48006,103,42,137,4,4,4,12,Champions
48270,38,25,26,5,4,2,11,Loyal Users
48537,1576,6,33,1,1,3,5,Lost
48649,11,22,44,5,4,3,12,Loyal Users
49255,8,102,236,5,5,5,15,Champions
49592,4,64,309,5,5,5,15,Champions
49676,2156,12,34,1,3,3,7,Casual Users
49977,105,8,26,4,2,2,8,Promising
50046,9,8,10,5,2,1,8,Promising
50116,1691,9,12,1,2,1,4,Lost
50135,0,64,149,5,5,5,15,Champions
50140,2813,8,9,1,2,1,4,Lost
50428,264,14,25,3,3,2,8,Loyal Users
50457,1964,26,62,1,4,3,8,At Risk
50490,3196,18,57,1,3,3,7,Casual Users
50818,22,29,38,5,4,3,12,Loyal Users
50860,159,5,7,4,1,1,6,Promising
51043,1065,6,24,2,1,2,5,Lost
51173,1296,31,64,1,4,4,9,At Risk
51712,153,63,333,4,5,5,14,Champions
51717,109,40,147,4,4,5,13,Champions
51836,59,15,45,5,3,3,11,Loyal Users
52252,297,9,40,3,2,3,8,Casual Users
52303,408,16,33,3,3,3,9,Loyal Users
39816,2,41,50,5,4,3,12,Loyal Users
39919,411,47,178,3,5,5,13,Loyal Users
40147,137,11,15,4,2,1,7,Promising
40252,2666,8,50,1,2,3,6,Lost
40287,294,68,179,3,5,5,13,Loyal Users
40683,3716,6,18,1,1,2,4,Lost
40822,96,12,20,4,3,2,9,Loyal Users
40878,4406,13,19,1,3,2,6,Casual Users
41238,20,11,24,5,2,2,9,Promising
41737,90,71,141,4,5,4,13,Champions
42147,41,43,131,5,4,4,13,Champions
42236,2633,7,11,1,2,1,4,Lost
42354,141,65,101,4,5,4,13,Champions
42455,436,30,70,3,4,4,11,Loyal Users
42529,384,16,34,3,3,3,9,Loyal Users
42718,222,8,16,3,2,2,7,Casual Users
42750,20,42,174,5,4,5,14,Champions
42798,222,18,67,3,3,4,10,Loyal Users
43038,136,7,35,4,2,3,9,Promising
43074,647,23,52,2,4,3,9,At Risk
43083,0,162,873,5,5,5,15,Champions
43332,415,7,13,3,2,1,6,Casual Users
43485,1833,23,80,1,4,4,9,At Risk
43545,106,15,39,4,3,3,10,Loyal Users
43796,87,8,11,4,2,1,7,Promising
44187,83,173,343,4,5,5,14,Champions
44280,440,55,102,3,5,4,12,Loyal Users
44342,31,83,457,5,5,5,15,Champions
44673,5,48,311,5,5,5,15,Champions
44759,69,5,8,5,1,1,7,Promising
44938,4702,11,29,1,2,2,5,Lost
45010,150,23,79,4,4,4,12,Champions
45100,3688,5,5,1,1,1,3,Lost
45243,129,12,23,4,3,2,9,Loyal Users
45383,146,11,15,4,2,1,7,Promising
45539,1030,6,21,2,1,2,5,Lost
45549,2019,9,32,1,2,3,6,Lost
45663,397,12,116,3,3,4,10,Loyal Users
45817,26,61,356,5,5,5,15,Champions
46185,514,34,51,2,4,3,9,At Risk
46198,7,47,108,5,5,4,14,Champions
46265,212,20,30,3,3,2,8,Loyal Users
46336,141,43,192,4,4,5,13,Champions
46379,699,8,20,2,2,2,6,Lost
46476,7,52,118,5,5,4,14,Champions
46618,1861,6,17,1,1,2,4,Lost
47038,31,15,32,5,3,3,11,Loyal Users
47188,2874,5,13,1,1,1,3,Lost
47487,980,5,5,2,1,1,4,Lost
48242,1,50,314,5,5,5,15,Champions
48324,394,7,13,3,2,1,6,Casual Users
48458,1416,9,15,1,2,1,4,Lost
49568,311,12,23,3,3,2,8,Loyal Users
49742,4320,17,39,1,3,3,7,Casual Users
49816,301,20,32,3,3,3,9,Loyal Users
50063,1273,14,20,1,3,2,6,Casual Users
50185,20,12,48,5,3,3,11,Loyal Users
50318,1030,8,20,2,2,2,6,Lost
50926,1233,10,10,2,2,1,5,Lost
51111,30,108,498,5,5,5,15,Champions
51505,4,24,58,5,4,3,12,Loyal Users
51524,841,187,579,2,5,5,12,At Risk
51565,1045,8,10,2,2,1,5,Lost
51588,8,91,365,5,5,5,15,Champions
51737,1588,7,13,1,2,1,4,Lost
52043,1066,7,40,2,2,3,7,Lost
39393,0,74,377,5,5,5,15,Champions
39558,117,22,28,4,4,2,10,Loyal Users
39566,3224,9,25,1,2,2,5,Lost
39740,417,41,272,3,4,5,12,Loyal Users
39864,477,24,47,2,4,3,9,At Risk
40104,145,45,79,4,4,4,12,Champions
40723,1134,13,55,2,3,3,8,Casual Users
40917,1743,20,72,1,3,4,8,Casual Users
41744,4407,5,16,1,1,2,4,Lost
41892,1522,6,23,1,1,2,4,Lost
41920,449,59,311,3,5,5,13,Loyal Users
42555,172,27,75,3,4,4,11,Loyal Users
42648,390,11,18,3,2,2,7,Casual Users
42761,3097,10,18,1,2,2,5,Lost
42953,291,50,57,3,5,3,11,Loyal Users
43664,2076,7,10,1,2,1,4,Lost
43676,502,18,24,2,3,2,7,Casual Users
43743,3807,8,8,1,2,1,4,Lost
43906,244,17,32,3,3,3,9,Loyal Users
43982,56,91,220,5,5,5,15,Champions
44011,378,10,38,3,2,3,8,Casual Users
44058,2,28,71,5,4,4,13,Champions
44174,84,11,29,4,2,2,8,Promising
44366,21,8,13,5,2,1,8,Promising
44517,13,108,204,5,5,5,15,Champions
44718,117,10,69,4,2,4,10,Promising
45059,1778,27,43,1,4,3,8,At Risk
45313,575,13,47,2,3,3,8,Casual Users
45467,329,16,68,3,3,4,10,Loyal Users
45571,1322,36,155,1,4,5,10,At Risk
45579,448,10,39,3,2,3,8,Casual Users
45687,104,23,127,4,4,4,12,Champions
46581,1037,7,21,2,2,2,6,Lost
47037,525,5,10,2,1,1,4,Lost
47583,52,63,196,5,5,5,15,Champions
48070,136,19,60,4,3,3,10,Loyal Users
48080,117,26,36,4,4,3,11,Loyal Users
48087,6,169,254,5,5,5,15,Champions
48166,641,7,60,2,2,3,7,Lost
48204,181,12,32,3,3,3,9,Loyal Users
48483,1007,7,56,2,2,3,7,Lost
48492,278,14,35,3,3,3,9,Loyal Users
48922,539,8,8,2,2,1,5,Lost
49033,420,47,72,3,5,4,12,Loyal Users
49083,28,11,25,5,2,2,9,Promising
49142,12,77,228,5,5,5,15,Champions
49279,442,6,41,3,1,3,7,Casual Users
49304,1632,7,13,1,2,1,4,Lost
49407,20,170,675,5,5,5,15,Champions
49470,934,7,22,2,2,2,6,Lost
49811,219,13,72,3,3,4,10,Loyal Users
50881,685,24,78,2,4,4,10,At Risk
50920,1440,5,5,1,1,1,3,Lost
51202,548,13,23,2,3,2,7,Casual Users
51330,577,8,10,2,2,1,5,Lost
51385,6107,9,13,1,2,1,4,Lost
51597,40,52,233,5,5,5,15,Champions
51681,1263,9,21,1,2,2,5,Lost
51934,62,90,275,5,5,5,15,Champions
52010,72,27,70,4,4,4,12,Champions
52023,96,106,634,4,5,5,14,Champions
52255,37,69,323,5,5,5,15,Champions
39311,3118,5,8,1,1,1,3,Lost
39448,2509,10,37,1,2,3,6,Lost
39586,547,12,31,2,3,2,7,Casual Users
39759,514,21,31,2,3,2,7,Casual Users
40012,17,68,165,5,5,5,15,Champions
40013,42,6,7,5,1,1,7,Promising
40239,33,107,280,5,5,5,15,Champions
40479,1125,21,122,2,3,4,9,Casual Users
41341,74,7,8,4,2,1,7,Promising
41464,2547,19,91,1,3,4,8,Casual Users
42153,534,7,16,2,2,2,6,Lost
43039,38,55,101,5,5,4,14,Champions
43468,40,113,376,5,5,5,15,Champions
43476,542,17,37,2,3,3,8,Casual Users
43553,1407,21,59,1,3,3,7,Casual Users
43717,1096,5,9,2,1,1,4,Lost
43732,13,12,35,5,3,3,11,Loyal Users
44283,771,11,11,2,2,1,5,Lost
44465,101,19,97,4,3,4,11,Loyal Users
44922,875,10,25,2,2,2,6,Lost
45116,8,39,81,5,4,4,13,Champions
45269,444,77,186,3,5,5,13,Loyal Users
45548,1164,47,83,2,5,4,11,At Risk
45885,421,5,14,3,1,1,5,Casual Users
45918,662,6,34,2,1,3,6,Lost
46357,4297,8,12,1,2,1,4,Lost
46436,7,130,694,5,5,5,15,Champions
46705,979,13,30,2,3,2,7,Casual Users
46978,288,23,42,3,4,3,10,Loyal Users
47142,135,36,99,4,4,4,12,Champions
47275,5,142,278,5,5,5,15,Champions
47960,613,20,154,2,3,5,10,Casual Users
48445,1128,35,118,2,4,4,10,At Risk
49229,801,9,52,2,2,3,7,Lost
49237,577,7,11,2,2,1,5,Lost
49458,240,36,94,3,4,4,11,Loyal Users
49771,46,89,230,5,5,5,15,Champions
49936,21,146,685,5,5,5,15,Champions
50048,1323,33,96,1,4,4,9,At Risk
50306,384,27,56,3,4,3,10,Loyal Users
50380,7,35,61,5,4,3,12,Loyal Users
50499,131,22,74,4,4,4,12,Champions
50985,298,88,171,3,5,5,13,Loyal Users
51042,847,17,23,2,3,2,7,Casual Users
51530,24,57,150,5,5,5,15,Champions
51544,544,5,6,2,1,1,4,Lost
52011,16,6,8,5,1,1,7,Promising
52194,50,11,98,5,2,4,11,Promising
39280,323,17,25,3,3,2,8,Loyal Users
39395,40,114,504,5,5,5,15,Champions
39995,3,74,115,5,5,4,14,Champions
40121,1484,19,34,1,3,3,7,Casual Users
40506,522,32,144,2,4,4,10,At Risk
40572,508,6,25,2,1,2,5,Lost
40839,124,14,16,4,3,2,9,Loyal Users
40971,941,6,8,2,1,1,4,Lost
41483,642,19,55,2,3,3,8,Casual Users
41727,20,135,315,5,5,5,15,Champions
41953,112,65,149,4,5,5,14,Champions
42182,51,33,115,5,4,4,13,Champions
42257,4840,10,13,1,2,1,4,Lost
42347,84,21,105,4,3,4,11,Loyal Users
42483,656,14,23,2,3,2,7,Casual Users
43170,129,60,68,4,5,4,13,Champions
43301,40,161,752,5,5,5,15,Champions
43497,802,19,83,2,3,4,9,Casual Users
43592,413,7,43,3,2,3,8,Casual Users
43631,1422,7,11,1,2,1,4,Lost
44062,647,8,20,2,2,2,6,Lost
44276,105,78,413,4,5,5,14,Champions
44318,4310,6,6,1,1,1,3,Lost
44373,673,5,15,2,1,1,4,Lost
44483,47,106,245,5,5,5,15,Champions
44514,582,11,110,2,2,4,8,Lost
44628,1862,9,17,1,2,2,5,Lost
44751,6,6,6,5,1,1,7,Promising
45080,3011,6,13,1,1,1,3,Lost
45144,265,15,32,3,3,3,9,Loyal Users
45185,292,8,17,3,2,2,7,Casual Users
45208,174,17,118,3,3,4,10,Loyal Users
45356,1002,7,9,2,2,1,5,Lost
45465,272,7,16,3,2,2,7,Casual Users
45636,678,9,25,2,2,2,6,Lost
46046,2268,13,31,1,3,2,6,Casual Users
46088,4660,7,44,1,2,3,6,Lost
46180,154,64,137,4,5,4,13,Champions
46290,75,66,160,4,5,5,14,Champions
46311,828,14,33,2,3,3,8,Casual Users
46640,120,10,21,4,2,2,8,Promising
46985,866,8,13,2,2,1,5,Lost
46990,463,15,30,3,3,2,8,Loyal Users
47542,406,13,91,3,3,4,10,Loyal Users
47765,2888,6,34,1,1,3,5,Lost
48057,281,10,35,3,2,3,8,Casual Users
48339,604,12,58,2,3,3,8,Casual Users
48914,148,34,66,4,4,4,12,Champions
48963,322,72,141,3,5,4,12,Loyal Users
49129,326,30,150,3,4,5,12,Loyal Users
49464,116,53,132,4,5,4,13,Champions
49915,3067,26,35,1,4,3,8,At Risk
50201,1166,10,19,2,2,2,6,Lost
50282,36,40,67,5,4,4,13,Champions
50415,216,101,163,3,5,5,13,Loyal Users
50472,128,6,15,4,1,1,6,Promising
50656,1280,13,63,1,3,4,8,Casual Users
50970,678,36,93,2,4,4,10,At Risk
51184,1691,10,19,1,2,2,5,Lost
51426,543,9,12,2,2,1,5,Lost
51502,31,85,338,5,5,5,15,Champions
51840,2906,7,49,1,2,3,6,Lost
51893,4836,6,11,1,1,1,3,Lost
52125,71,34,56,4,4,3,11,Loyal Users
52197,229,61,302,3,5,5,13,Loyal Users
52306,50,7,25,5,2,2,9,Promising
39408,487,38,82,2,4,4,10,At Risk
39692,5370,5,16,1,1,2,4,Lost
39779,1213,8,12,2,2,1,5,Lost
39858,119,7,9,4,2,1,7,Promising
39941,2438,5,6,1,1,1,3,Lost
39943,96,83,166,4,5,5,14,Champions
40862,77,95,281,4,5,5,14,Champions
41097,285,20,44,3,3,3,9,Loyal Users
41205,459,12,12,3,3,1,7,Loyal Users
41264,261,56,109,3,5,4,12,Loyal Users
41514,159,55,138,4,5,4,13,Champions
41707,1674,8,12,1,2,1,4,Lost
41882,4292,11,22,1,2,2,5,Lost
42049,44,99,550,5,5,5,15,Champions
42103,133,72,265,4,5,5,14,Champions
42371,163,7,10,4,2,1,7,Promising
42590,1429,7,21,1,2,2,5,Lost
42593,1258,12,24,1,3,2,6,Casual Users
42989,63,160,245,5,5,5,15,Champions
43165,5127,6,20,1,1,2,4,Lost
43377,679,21,32,2,3,3,8,Casual Users
43453,708,19,38,2,3,3,8,Casual Users
43877,2,144,398,5,5,5,15,Champions
44059,262,10,17,3,2,2,7,Casual Users
44060,4754,5,5,1,1,1,3,Lost
44344,493,14,44,2,3,3,8,Casual Users
44510,250,14,35,3,3,3,9,Loyal Users
44654,17,32,72,5,4,4,13,Champions
44892,837,8,10,2,2,1,5,Lost
44898,1028,5,11,2,1,1,4,Lost
45092,850,19,26,2,3,2,7,Casual Users
45131,282,8,16,3,2,2,7,Casual Users
45161,2164,5,6,1,1,1,3,Lost
45198,446,8,17,3,2,2,7,Casual Users
45289,117,8,17,4,2,2,8,Promising
45344,882,26,59,2,4,3,9,At Risk
45414,24,55,206,5,5,5,15,Champions
45556,84,48,228,4,5,5,14,Champions
45733,725,5,25,2,1,2,5,Lost
45858,1657,11,27,1,2,2,5,Lost
46096,148,11,25,4,2,2,8,Promising
46331,90,45,54,4,4,3,11,Loyal Users
46407,177,48,83,3,5,4,12,Loyal Users
46470,125,218,362,4,5,5,14,Champions
46682,24,5,9,5,1,1,7,Promising
46771,113,82,503,4,5,5,14,Champions
46815,4098,6,12,1,1,1,3,Lost
47047,831,16,49,2,3,3,8,Casual Users
47182,11,19,98,5,3,4,12,Loyal Users
47545,123,29,99,4,4,4,12,Champions
47651,924,5,10,2,1,1,4,Lost
47934,110,36,107,4,4,4,12,Champions
47964,32,38,43,5,4,3,12,Loyal Users
48037,2716,5,16,1,1,2,4,Lost
48123,1158,5,21,2,1,2,5,Lost
48232,245,71,299,3,5,5,13,Loyal Users
48636,2831,28,61,1,4,3,8,At Risk
48842,285,8,25,3,2,2,7,Casual Users
48876,69,77,170,5,5,5,15,Champions
48933,429,50,208,3,5,5,13,Loyal Users
48945,881,22,87,2,4,4,10,At Risk
49317,105,8,16,4,2,2,8,Promising
49575,2982,23,166,1,4,5,10,At Risk
49823,2388,9,16,1,2,2,5,Lost
50210,24,97,460,5,5,5,15,Champions
50234,832,10,26,2,2,2,6,Lost
50543,441,18,24,3,3,2,8,Loyal Users
50769,682,15,66,2,3,4,9,Casual Users
50820,3316,18,42,1,3,3,7,Casual Users
50866,66,68,128,5,5,4,14,Champions
50971,11,107,295,5,5,5,15,Champions
51387,21,110,593,5,5,5,15,Champions
51495,2,72,337,5,5,5,15,Champions
51614,2787,5,7,1,1,1,3,Lost
51956,1561,5,6,1,1,1,3,Lost
52079,1383,5,8,1,1,1,3,Lost
52309,158,45,241,4,4,5,13,Champions
39656,511,8,30,2,2,2,6,Lost
39959,258,24,65,3,4,4,11,Loyal Users
40029,719,45,55,2,4,3,9,At Risk
40325,396,15,26,3,3,2,8,Loyal Users
40576,7,55,109,5,5,4,14,Champions
40628,41,64,292,5,5,5,15,Champions
40770,250,41,179,3,4,5,12,Loyal Users
40792,1120,7,24,2,2,2,6,Lost
40858,839,7,12,2,2,1,5,Lost
40924,163,65,103,4,5,4,13,Champions
41029,4236,25,48,1,4,3,8,At Risk
41614,420,8,36,3,2,3,8,Casual Users
41993,12,41,83,5,4,4,13,Champions
42501,92,7,25,4,2,2,8,Promising
42839,1168,5,11,2,1,1,4,Lost
42840,3250,6,22,1,1,2,4,Lost
42882,233,13,31,3,3,2,8,Loyal Users
43118,10,7,8,5,2,1,8,Promising
43234,793,5,5,2,1,1,4,Lost
43248,132,10,18,4,2,2,8,Promising
43392,212,14,130,3,3,4,10,Loyal Users
43825,19,35,270,5,4,5,14,Champions
43951,183,30,80,3,4,4,11,Loyal Users
43974,630,15,25,2,3,2,7,Casual Users
43987,137,125,409,4,5,5,14,Champions
44474,314,17,91,3,3,4,10,Loyal Users
44815,669,11,19,2,2,2,6,Lost
44929,1108,5,61,2,1,3,6,Lost
44984,568,9,11,2,2,1,5,Lost
45171,131,49,91,4,5,4,13,Champions
45272,266,35,51,3,4,3,10,Loyal Users
45403,257,50,79,3,5,4,12,Loyal Users
45450,148,9,16,4,2,2,8,Promising
45638,107,24,59,4,4,3,11,Loyal Users
45693,71,73,312,4,5,5,14,Champions
45870,226,5,24,3,1,2,6,Casual Users
45910,1477,13,47,1,3,3,7,Casual Users
46103,2939,8,14,1,2,1,4,Lost
46117,3494,8,22,1,2,2,5,Lost
46296,256,6,7,3,1,1,5,Casual Users
46305,817,37,140,2,4,4,10,At Risk
46351,21,15,104,5,3,4,12,Loyal Users
46494,142,24,46,4,4,3,11,Loyal Users
46635,104,5,13,4,1,1,6,Promising
46728,52,24,37,5,4,3,12,Loyal Users
46881,1402,10,38,1,2,3,6,Lost
47015,837,5,6,2,1,1,4,Lost
47021,965,6,19,2,1,2,5,Lost
47365,16,70,110,5,5,4,14,Champions
47959,436,30,50,3,4,3,10,Loyal Users
48381,2938,5,22,1,1,2,4,Lost
48496,31,9,21,5,2,2,9,Promising
48640,33,20,50,5,3,3,11,Loyal Users
48992,4410,6,64,1,1,4,6,Lost
49085,2,33,50,5,4,3,12,Loyal Users
49141,78,26,50,4,4,3,11,Loyal Users
49348,15,30,343,5,4,5,14,Champions
49369,11,19,59,5,3,3,11,Loyal Users
49602,149,7,10,4,2,1,7,Promising
50075,1127,12,58,2,3,3,8,Casual Users
50262,1441,8,8,1,2,1,4,Lost
50533,771,9,27,2,2,2,6,Lost
50559,230,14,18,3,3,2,8,Loyal Users
50567,8,8,10,5,2,1,8,Promising
50756,237,11,75,3,2,4,9,Casual Users
50968,398,7,12,3,2,1,6,Casual Users
51052,55,51,151,5,5,5,15,Champions
51297,135,6,6,4,1,1,6,Promising
51554,698,15,36,2,3,3,8,Casual Users
51813,267,14,38,3,3,3,9,Loyal Users
51861,3388,22,52,1,4,3,8,At Risk
51931,445,7,23,3,2,2,7,Casual Users
52027,1090,5,6,2,1,1,4,Lost
52292,111,35,85,4,4,4,12,Champions
39246,801,5,15,2,1,1,4,Lost
39719,144,31,42,4,4,3,11,Loyal Users
39745,94,8,12,4,2,1,7,Promising
39991,3433,7,49,1,2,3,6,Lost
40158,323,102,450,3,5,5,13,Loyal Users
40795,77,9,68,4,2,4,10,Promising
41223,229,36,182,3,4,5,12,Loyal Users
41268,5492,8,8,1,2,1,4,Lost
41405,575,29,139,2,4,4,10,At Risk
41824,262,38,168,3,4,5,12,Loyal Users
42026,0,142,547,5,5,5,15,Champions
42036,1501,11,53,1,2,3,6,Lost
42160,104,38,94,4,4,4,12,Champions
42161,14,327,600,5,5,5,15,Champions
42214,33,95,518,5,5,5,15,Champions
42226,1415,5,12,1,1,1,3,Lost
42351,646,35,60,2,4,3,9,At Risk
42485,4974,6,6,1,1,1,3,Lost
42524,1738,5,6,1,1,1,3,Lost
42621,138,54,248,4,5,5,14,Champions
42638,1649,5,14,1,1,1,3,Lost
42831,4755,5,45,1,1,3,5,Lost
42998,412,46,102,3,5,4,12,Loyal Users
43016,5169,8,19,1,2,2,5,Lost
43132,118,71,209,4,5,5,14,Champions
43402,845,16,21,2,3,2,7,Casual Users
43536,494,18,25,2,3,2,7,Casual Users
43612,86,19,30,4,3,2,9,Loyal Users
44544,29,10,34,5,2,3,10,Promising
44715,433,14,26,3,3,2,8,Loyal Users
44767,1041,18,19,2,3,2,7,Casual Users
44894,320,47,468,3,5,5,13,Loyal Users
45320,14,6,11,5,1,1,7,Promising
46126,5124,11,29,1,2,2,5,Lost
46199,1008,34,102,2,4,4,10,At Risk
46328,632,10,22,2,2,2,6,Lost
46659,136,8,15,4,2,1,7,Promising
46709,566,11,28,2,2,2,6,Lost
46805,417,25,34,3,4,3,10,Loyal Users
46902,1202,12,26,2,3,2,7,Casual Users
46915,37,72,135,5,5,4,14,Champions
47158,1744,7,7,1,2,1,4,Lost
47628,1,25,119,5,4,4,13,Champions
47826,7,30,90,5,4,4,13,Champions
48040,835,5,10,2,1,1,4,Lost
49095,26,108,411,5,5,5,15,Champions
49322,77,9,26,4,2,2,8,Promising
49424,6,58,106,5,5,4,14,Champions
50001,1419,17,42,1,3,3,7,Casual Users
50136,814,115,204,2,5,5,12,At Risk
50239,30,37,87,5,4,4,13,Champions
50424,409,6,22,3,1,2,6,Casual Users
50504,463,17,49,3,3,3,9,Loyal Users
50606,24,26,42,5,4,3,12,Loyal Users
50655,3684,6,12,1,1,1,3,Lost
50845,140,22,43,4,4,3,11,Loyal Users
50938,543,11,19,2,2,2,6,Lost
50983,130,102,416,4,5,5,14,Champions
51755,115,35,64,4,4,4,12,Champions
51819,383,13,62,3,3,3,9,Loyal Users
52165,3902,5,6,1,1,1,3,Lost
52230,119,43,187,4,4,5,13,Champions
39354,1954,6,8,1,1,1,3,Lost
39430,40,22,33,5,4,3,12,Loyal Users
39451,696,12,67,2,3,4,9,Casual Users
39927,220,42,181,3,4,5,12,Loyal Users
39937,180,69,281,3,5,5,13,Loyal Users
40160,382,5,38,3,1,3,7,Casual Users
40345,251,16,86,3,3,4,10,Loyal Users
40397,2278,13,62,1,3,3,7,Casual Users
40555,144,6,9,4,1,1,6,Promising
40582,159,25,67,4,4,4,12,Champions
40586,100,11,14,4,2,1,7,Promising
40714,93,60,81,4,5,4,13,Champions
40815,867,30,43,2,4,3,9,At Risk
41063,445,23,33,3,4,3,10,Loyal Users
41273,718,14,108,2,3,4,9,Casual Users
42006,251,23,42,3,4,3,10,Loyal Users
42297,380,7,73,3,2,4,9,Casual Users
42413,907,6,26,2,1,2,5,Lost
42626,886,37,85,2,4,4,10,At Risk
42811,76,70,116,4,5,4,13,Champions
42997,3696,9,45,1,2,3,6,Lost
43220,949,6,10,2,1,1,4,Lost
43318,9,61,149,5,5,5,15,Champions
43379,3565,11,20,1,2,2,5,Lost
43651,75,26,150,4,4,5,13,Champions
43781,72,60,112,4,5,4,13,Champions
44184,995,7,21,2,2,2,6,Lost
44412,478,5,5,2,1,1,4,Lost
44435,131,44,93,4,4,4,12,Champions
44521,280,6,6,3,1,1,5,Casual Users
44835,13,117,679,5,5,5,15,Champions
45225,113,22,86,4,4,4,12,Champions
45572,127,13,28,4,3,2,9,Loyal Users
45605,2,7,16,5,2,2,9,Promising
45618,189,49,213,3,5,5,13,Loyal Users
45648,286,10,28,3,2,2,7,Casual Users
45714,1108,7,82,2,2,4,8,Lost
45785,94,7,17,4,2,2,8,Promising
46025,5137,23,75,1,4,4,9,At Risk
46037,153,9,39,4,2,3,9,Promising
46098,98,7,10,4,2,1,7,Promising
46337,4,98,235,5,5,5,15,Champions
46370,456,23,42,3,4,3,10,Loyal Users
46424,2636,8,32,1,2,3,6,Lost
46541,412,12,20,3,3,2,8,Loyal Users
46857,1270,6,8,1,1,1,3,Lost
47078,68,61,226,5,5,5,15,Champions
47384,102,17,132,4,3,4,11,Loyal Users
47395,598,6,8,2,1,1,4,Lost
47894,1154,8,27,2,2,2,6,Lost
47946,162,145,571,4,5,5,14,Champions
47991,409,15,25,3,3,2,8,Loyal Users
48370,2370,10,45,1,2,3,6,Lost
48660,878,26,65,2,4,4,10,At Risk
48799,2416,8,12,1,2,1,4,Lost
48887,1718,12,28,1,3,2,6,Casual Users
49593,3017,7,51,1,2,3,6,Lost
49746,759,8,10,2,2,1,5,Lost
49766,655,52,248,2,5,5,12,At Risk
50086,93,33,119,4,4,4,12,Champions
50522,22,104,258,5,5,5,15,Champions
50646,3277,10,56,1,2,3,6,Lost
50752,814,6,14,2,1,1,4,Lost
50916,1772,5,22,1,1,2,4,Lost
50935,4,153,277,5,5,5,15,Champions
51000,5661,12,33,1,3,3,7,Casual Users
51004,133,6,10,4,1,1,6,Promising
51027,752,6,13,2,1,1,4,Lost
51146,3,124,393,5,5,5,15,Champions
51512,1652,29,53,1,4,3,8,At Risk
51700,161,9,16,4,2,2,8,Promising
51705,1733,9,15,1,2,1,4,Lost
51731,3836,5,9,1,1,1,3,Lost
51865,429,5,7,3,1,1,5,Casual Users
52227,677,7,11,2,2,1,5,Lost
52266,405,32,86,3,4,4,11,Loyal Users
39388,131,32,120,4,4,4,12,Champions
39580,3,17,96,5,3,4,12,Loyal Users
39729,515,12,20,2,3,2,7,Casual Users
39748,123,40,70,4,4,4,12,Champions
39893,507,11,45,2,2,3,7,Lost
40143,249,120,478,3,5,5,13,Loyal Users
40230,257,8,10,3,2,1,6,Casual Users
40869,261,5,12,3,1,1,5,Casual Users
40996,91,13,36,4,3,3,10,Loyal Users
41111,36,61,98,5,5,4,14,Champions
41252,5461,7,26,1,2,2,5,Lost
41479,382,17,29,3,3,2,8,Loyal Users
41657,600,7,18,2,2,2,6,Lost
41900,540,29,119,2,4,4,10,At Risk
42015,294,9,37,3,2,3,8,Casual Users
42209,1123,44,118,2,4,4,10,At Risk
42456,2824,12,82,1,3,4,8,Casual Users
42677,113,34,61,4,4,3,11,Loyal Users
42902,457,6,23,3,1,2,6,Casual Users
43381,1214,11,47,2,2,3,7,Lost
43387,4,32,78,5,4,4,13,Champions
43448,282,32,36,3,4,3,10,Loyal Users
43771,253,44,124,3,4,4,11,Loyal Users
43783,2713,24,34,1,4,3,8,At Risk
43816,2824,7,12,1,2,1,4,Lost
44081,86,128,485,4,5,5,14,Champions
44164,423,50,143,3,5,4,12,Loyal Users
44209,21,30,284,5,4,5,14,Champions
44313,1004,17,152,2,3,5,10,Casual Users
44349,90,56,332,4,5,5,14,Champions
44546,267,14,131,3,3,4,10,Loyal Users
45290,2429,15,36,1,3,3,7,Casual Users
45518,92,38,59,4,4,3,11,Loyal Users
45578,580,9,25,2,2,2,6,Lost
46510,3643,8,12,1,2,1,4,Lost
46531,729,48,283,2,5,5,12,At Risk
46657,1564,12,20,1,3,2,6,Casual Users
46716,885,17,36,2,3,3,8,Casual Users
46740,1649,7,17,1,2,2,5,Lost
47098,148,14,45,4,3,3,10,Loyal Users
47151,10,217,340,5,5,5,15,Champions
47199,1818,11,45,1,2,3,6,Lost
47333,1872,7,11,1,2,1,4,Lost
47568,690,7,10,2,2,1,5,Lost
47603,11,90,317,5,5,5,15,Champions
47703,406,5,11,3,1,1,5,Casual Users
48317,1380,8,10,1,2,1,4,Lost
48356,2272,5,10,1,1,1,3,Lost
48412,5,20,37,5,3,3,11,Loyal Users
48596,2499,6,15,1,1,1,3,Lost
48796,1250,7,7,2,2,1,5,Lost
49156,99,70,109,4,5,4,13,Champions
49554,408,53,151,3,5,5,13,Loyal Users
49848,307,8,91,3,2,4,9,Casual Users
50105,134,8,17,4,2,2,8,Promising
50268,407,21,38,3,3,3,9,Loyal Users
50449,8,130,691,5,5,5,15,Champions
50704,74,61,205,4,5,5,14,Champions
50758,966,24,90,2,4,4,10,At Risk
50907,1552,5,5,1,1,1,3,Lost
50931,41,10,55,5,2,3,10,Promising
51716,2303,6,9,1,1,1,3,Lost
51730,626,12,20,2,3,2,7,Casual Users
52005,937,29,41,2,4,3,9,At Risk
39327,1118,11,21,2,2,2,6,Lost
39629,115,59,195,4,5,5,14,Champions
39887,94,10,12,4,2,1,7,Promising
39889,391,13,19,3,3,2,8,Loyal Users
40076,1845,6,16,1,1,2,4,Lost
40129,1805,11,13,1,2,1,4,Lost
40317,108,21,85,4,3,4,11,Loyal Users
40644,877,25,56,2,4,3,9,At Risk
40737,1428,11,20,1,2,2,5,Lost
40779,138,64,139,4,5,4,13,Champions
41386,10,71,233,5,5,5,15,Champions
41677,1235,11,15,2,2,1,5,Lost
42188,1210,7,8,2,2,1,5,Lost
42399,238,49,112,3,5,4,12,Loyal Users
42401,1241,7,7,2,2,1,5,Lost
42578,62,15,90,5,3,4,12,Loyal Users
42600,401,23,31,3,4,2,9,Loyal Users
42632,549,5,6,2,1,1,4,Lost
42739,2562,14,124,1,3,4,8,Casual Users
42743,4091,17,28,1,3,2,6,Casual Users
42809,421,6,15,3,1,1,5,Casual Users
43097,457,10,53,3,2,3,8,Casual Users
43204,2979,6,6,1,1,1,3,Lost
43808,252,17,34,3,3,3,9,Loyal Users
43971,3238,35,78,1,4,4,9,At Risk
44019,144,23,141,4,4,4,12,Champions
44241,121,59,121,4,5,4,13,Champions
44438,464,28,53,3,4,3,10,Loyal Users
44532,1313,5,60,1,1,3,5,Lost
44538,1462,8,31,1,2,2,5,Lost
44685,4,65,466,5,5,5,15,Champions
44752,2623,7,7,1,2,1,4,Lost
44793,3167,6,13,1,1,1,3,Lost
44831,973,11,19,2,2,2,6,Lost
45041,544,35,95,2,4,4,10,At Risk
45074,1879,5,31,1,1,2,4,Lost
45250,382,16,47,3,3,3,9,Loyal Users
45358,77,8,39,4,2,3,9,Promising
45521,137,25,46,4,4,3,11,Loyal Users
45811,11,30,54,5,4,3,12,Loyal Users
46268,135,19,29,4,3,2,9,Loyal Users
46313,0,121,184,5,5,5,15,Champions
46603,70,15,64,4,3,4,11,Loyal Users
46786,27,6,18,5,1,2,8,Promising
47131,113,37,91,4,4,4,12,Champions
47214,248,5,24,3,1,2,6,Casual Users
47241,442,14,31,3,3,2,8,Loyal Users
47319,653,16,33,2,3,3,8,Casual Users
47380,709,5,7,2,1,1,4,Lost
47425,401,34,154,3,4,5,12,Loyal Users
47933,17,139,538,5,5,5,15,Champions
48004,109,21,31,4,3,2,9,Loyal Users
48010,593,5,9,2,1,1,4,Lost
48329,2438,5,6,1,1,1,3,Lost
48687,1317,20,36,1,3,3,7,Casual Users
48993,1432,6,14,1,1,1,3,Lost
49067,2770,29,80,1,4,4,9,At Risk
49103,2434,5,5,1,1,1,3,Lost
49173,103,102,314,4,5,5,14,Champions
49434,2291,16,47,1,3,3,7,Casual Users
49507,24,59,88,5,5,4,14,Champions
49589,1000,17,51,2,3,3,8,Casual Users
49631,310,30,70,3,4,4,11,Loyal Users
49726,40,15,65,5,3,4,12,Loyal Users
49747,172,24,69,3,4,4,11,Loyal Users
49802,35,7,18,5,2,2,9,Promising
50080,355,12,34,3,3,3,9,Loyal Users
50096,568,6,17,2,1,2,5,Lost
50119,685,5,8,2,1,1,4,Lost
50269,85,82,249,4,5,5,14,Champions
50494,8,31,53,5,4,3,12,Loyal Users
50618,140,9,20,4,2,2,8,Promising
50731,30,116,425,5,5,5,15,Champions
51001,2163,9,20,1,2,2,5,Lost
51170,291,36,82,3,4,4,11,Loyal Users
51499,4419,6,11,1,1,1,3,Lost
51593,260,7,40,3,2,3,8,Casual Users
51679,1569,11,15,1,2,1,4,Lost
51775,105,38,98,4,4,4,12,Champions
51776,4972,5,11,1,1,1,3,Lost
52044,1555,20,43,1,3,3,7,Casual Users
52045,2008,34,43,1,4,3,8,At Risk
52276,121,27,75,4,4,4,12,Champions
39416,4,40,135,5,4,4,13,Champions
39502,697,5,36,2,1,3,6,Lost
39670,133,25,127,4,4,4,12,Champions
40745,658,12,19,2,3,2,7,Casual Users
40876,26,118,354,5,5,5,15,Champions
40905,157,19,38,4,3,3,10,Loyal Users
41099,230,86,158,3,5,5,13,Loyal Users
41235,453,51,148,3,5,5,13,Loyal Users
41253,1386,11,18,1,2,2,5,Lost
41400,84,31,78,4,4,4,12,Champions
41655,3253,15,38,1,3,3,7,Casual Users
41797,1547,5,15,1,1,1,3,Lost
41818,39,5,39,5,1,3,9,Promising
42070,156,38,75,4,4,4,12,Champions
42606,20,6,7,5,1,1,7,Promising
42920,250,19,24,3,3,2,8,Loyal Users
43089,0,15,59,5,3,3,11,Loyal Users
43146,114,11,19,4,2,2,8,Promising
43255,261,10,14,3,2,1,6,Casual Users
43405,680,17,31,2,3,2,7,Casual Users
43685,798,20,56,2,3,3,8,Casual Users
43776,250,7,11,3,2,1,6,Casual Users
44542,16,29,49,5,4,3,12,Loyal Users
44743,701,9,17,2,2,2,6,Lost
45071,1739,5,5,1,1,1,3,Lost
45148,1140,14,18,2,3,2,7,Casual Users
45150,108,43,96,4,4,4,12,Champions
45270,140,8,32,4,2,3,9,Promising
45314,132,60,387,4,5,5,14,Champions
45526,1046,14,24,2,3,2,7,Casual Users
45583,3261,19,81,1,3,4,8,Casual Users
46213,1345,6,34,1,1,3,5,Lost
46329,165,25,155,4,4,5,13,Champions
46876,138,84,135,4,5,4,13,Champions
47400,119,26,45,4,4,3,11,Loyal Users
47633,141,7,10,4,2,1,7,Promising
47637,104,27,62,4,4,3,11,Loyal Users
47776,1121,33,39,2,4,3,9,At Risk
48320,346,67,353,3,5,5,13,Loyal Users
48341,24,94,620,5,5,5,15,Champions
48368,432,7,20,3,2,2,7,Casual Users
48759,104,23,69,4,4,4,12,Champions
49149,1712,8,29,1,2,2,5,Lost
50176,154,58,138,4,5,4,13,Champions
50178,393,17,28,3,3,2,8,Loyal Users
50563,1561,11,24,1,2,2,5,Lost
51654,1832,6,17,1,1,2,4,Lost
52073,1132,7,51,2,2,3,7,Lost
52213,29,169,578,5,5,5,15,Champions
39301,101,28,181,4,4,5,13,Champions
39322,87,17,29,4,3,2,9,Loyal Users
39465,37,103,192,5,5,5,15,Champions
39708,77,96,221,4,5,5,14,Champions
39833,5346,7,12,1,2,1,4,Lost
39851,1422,16,80,1,3,4,8,Casual Users
40219,1709,6,47,1,1,3,5,Lost
40452,2229,6,6,1,1,1,3,Lost
40562,707,8,16,2,2,2,6,Lost
40735,4786,14,32,1,3,3,7,Casual Users
40860,555,9,55,2,2,3,7,Lost
40961,130,26,80,4,4,4,12,Champions
40977,450,16,49,3,3,3,9,Loyal Users
41271,2165,9,16,1,2,2,5,Lost
41290,787,5,9,2,1,1,4,Lost
41404,585,5,11,2,1,1,4,Lost
42198,10,37,93,5,4,4,13,Champions
42459,113,12,19,4,3,2,9,Loyal Users
42800,111,34,60,4,4,3,11,Loyal Users
42847,963,6,7,2,1,1,4,Lost
43335,71,18,29,4,3,2,9,Loyal Users
43521,1694,6,36,1,1,3,5,Lost
43660,611,6,98,2,1,4,7,Lost
43754,431,12,19,3,3,2,8,Loyal Users
43819,2,194,894,5,5,5,15,Champions
43973,348,85,371,3,5,5,13,Loyal Users
44350,3668,7,44,1,2,3,6,Lost
44537,853,11,21,2,2,2,6,Lost
44568,1694,7,14,1,2,1,4,Lost
45077,141,45,133,4,4,4,12,Champions
45258,55,69,169,5,5,5,15,Champions
45608,3127,18,32,1,3,3,7,Casual Users
46373,84,59,90,4,5,4,13,Champions
46444,142,10,13,4,2,1,7,Promising
46467,227,83,684,3,5,5,13,Loyal Users
46599,1722,9,23,1,2,2,5,Lost
46769,114,62,154,4,5,5,14,Champions
46823,112,17,32,4,3,3,10,Loyal Users
47269,35,95,465,5,5,5,15,Champions
47281,435,38,94,3,4,4,11,Loyal Users
47362,5314,5,5,1,1,1,3,Lost
47451,63,51,306,5,5,5,15,Champions
47514,3705,5,8,1,1,1,3,Lost
47640,1065,10,35,2,2,3,7,Lost
47675,4,59,173,5,5,5,15,Champions
47837,262,53,208,3,5,5,13,Loyal Users
48197,112,21,66,4,3,4,11,Loyal Users
48228,163,10,81,4,2,4,10,Promising
48947,1,27,67,5,4,4,13,Champions
49168,237,7,25,3,2,2,7,Casual Users
49199,2558,8,27,1,2,2,5,Lost
50180,696,71,119,2,5,4,11,At Risk
50479,419,32,93,3,4,4,11,Loyal Users
51148,716,23,50,2,4,3,9,At Risk
51234,129,28,44,4,4,3,11,Loyal Users
51841,98,49,104,4,5,4,13,Champions
51900,126,8,14,4,2,1,7,Promising
52070,103,23,189,4,4,5,13,Champions
52098,1061,19,33,2,3,3,8,Casual Users
52325,1077,5,8,2,1,1,4,Lost
39347,2129,19,42,1,3,3,7,Casual Users
39600,2142,7,13,1,2,1,4,Lost
39840,128,121,699,4,5,5,14,Champions
40339,149,38,234,4,4,5,13,Champions
40398,97,108,388,4,5,5,14,Champions
41077,4888,18,53,1,3,3,7,Casual Users
41112,515,10,18,2,2,2,6,Lost
41204,3414,7,20,1,2,2,5,Lost
41224,1273,7,56,1,2,3,6,Lost
41255,1265,8,32,1,2,3,6,Lost
41401,672,5,11,2,1,1,4,Lost
41456,289,49,127,3,5,4,12,Loyal Users
41485,53,84,112,5,5,4,14,Champions
41513,4180,10,25,1,2,2,5,Lost
41576,3,48,223,5,5,5,15,Champions
41620,627,7,10,2,2,1,5,Lost
41720,1369,9,41,1,2,3,6,Lost
41802,3566,12,13,1,3,1,5,Casual Users
42116,161,57,157,4,5,5,14,Champions
42284,2579,71,194,1,5,5,11,At Risk
42301,2969,7,41,1,2,3,6,Lost
42425,809,8,10,2,2,1,5,Lost
42601,120,7,20,4,2,2,8,Promising
42633,2,51,131,5,5,4,14,Champions
43205,610,5,5,2,1,1,4,Lost
43227,91,24,56,4,4,3,11,Loyal Users
43429,7,11,26,5,2,2,9,Promising
43512,817,22,66,2,4,4,10,At Risk
43539,61,16,63,5,3,4,12,Loyal Users
44192,106,16,109,4,3,4,11,Loyal Users
44311,21,58,82,5,5,4,14,Champions
44322,137,11,62,4,2,3,9,Promising
44387,2998,7,16,1,2,2,5,Lost
44613,530,22,85,2,4,4,10,At Risk
44657,97,35,120,4,4,4,12,Champions
44672,1832,11,23,1,2,2,5,Lost
44871,388,5,8,3,1,1,5,Casual Users
45180,9,89,480,5,5,5,15,Champions
45328,176,8,27,3,2,2,7,Casual Users
45408,424,19,43,3,3,3,9,Loyal Users
45412,1004,5,13,2,1,1,4,Lost
45464,204,94,618,3,5,5,13,Loyal Users
45515,73,56,257,4,5,5,14,Champions
45535,92,32,192,4,4,5,13,Champions
45851,828,74,589,2,5,5,12,At Risk
45856,3633,6,47,1,1,3,5,Lost
46114,439,11,21,3,2,2,7,Casual Users
46315,6027,5,34,1,1,3,5,Lost
46462,30,57,163,5,5,5,15,Champions
46530,1403,11,29,1,2,2,5,Lost
46602,3,94,291,5,5,5,15,Champions
46694,1,84,423,5,5,5,15,Champions
46772,2686,50,180,1,5,5,11,At Risk
46813,3373,5,27,1,1,2,4,Lost
46918,2477,10,13,1,2,1,4,Lost
46933,571,18,29,2,3,2,7,Casual Users
47518,453,6,42,3,1,3,7,Casual Users
47563,226,73,121,3,5,4,12,Loyal Users
47696,1076,10,16,2,2,2,6,Lost
47901,3705,7,16,1,2,2,5,Lost
48267,2982,9,16,1,2,2,5,Lost
48304,145,82,240,4,5,5,14,Champions
48385,1281,9,25,1,2,2,5,Lost
48550,623,6,6,2,1,1,4,Lost
48983,286,35,58,3,4,3,10,Loyal Users
49898,837,5,6,2,1,1,4,Lost
49962,3,52,186,5,5,5,15,Champions
50571,1673,6,6,1,1,1,3,Lost
50619,1021,8,12,2,2,1,5,Lost
50778,368,11,61,3,2,3,8,Casual Users
50871,961,15,24,2,3,2,7,Casual Users
51220,65,19,38,5,3,3,11,Loyal Users
51411,12,14,62,5,3,3,11,Loyal Users
51772,56,70,234,5,5,5,15,Champions
51821,362,15,83,3,3,4,10,Loyal Users
51998,3335,5,5,1,1,1,3,Lost
52619,4973,9,21,1,2,2,5,Lost
52703,735,16,49,2,3,3,8,Casual Users
52828,24,67,323,5,5,5,15,Champions
53026,1471,10,12,1,2,1,4,Lost
53055,3720,7,18,1,2,2,5,Lost
53329,100,28,46,4,4,3,11,Loyal Users
53542,1099,7,26,2,2,2,6,Lost
53822,3677,40,55,1,4,3,8,At Risk
54127,686,18,26,2,3,2,7,Casual Users
54398,582,11,16,2,2,2,6,Lost
54738,1036,182,300,2,5,5,12,At Risk
55383,2329,19,36,1,3,3,7,Casual Users
55441,254,16,43,3,3,3,9,Loyal Users
55466,277,13,15,3,3,1,7,Loyal Users
55799,1396,6,7,1,1,1,3,Lost
55902,4349,11,21,1,2,2,5,Lost
56173,55,74,97,5,5,4,14,Champions
56344,287,6,25,3,1,2,6,Casual Users
56612,118,32,120,4,4,4,12,Champions
56889,56,5,20,5,1,2,8,Promising
57008,102,18,98,4,3,4,11,Loyal Users
57639,559,6,19,2,1,2,5,Lost
57650,847,5,12,2,1,1,4,Lost
57734,6,49,224,5,5,5,15,Champions
57987,1687,8,25,1,2,2,5,Lost
58272,92,41,92,4,4,4,12,Champions
58332,1452,10,31,1,2,2,5,Lost
58425,425,21,24,3,3,2,8,Loyal Users
58558,278,80,373,3,5,5,13,Loyal Users
58589,469,5,22,3,1,2,6,Casual Users
58618,2136,9,30,1,2,2,5,Lost
58622,1960,5,16,1,1,2,4,Lost
58635,2706,10,23,1,2,2,5,Lost
58773,5,52,177,5,5,5,15,Champions
58918,335,11,33,3,2,3,8,Casual Users
59053,3586,10,10,1,2,1,4,Lost
59054,137,15,58,4,3,3,10,Loyal Users
59251,961,22,69,2,4,4,10,At Risk
59252,2810,62,203,1,5,5,11,At Risk
59616,438,32,47,3,4,3,10,Loyal Users
59639,2131,15,50,1,3,3,7,Casual Users
60034,115,22,78,4,4,4,12,Champions
60184,2867,5,5,1,1,1,3,Lost
60287,115,6,9,4,1,1,6,Promising
60346,29,64,146,5,5,4,14,Champions
60442,1486,19,23,1,3,2,6,Casual Users
60606,3557,5,11,1,1,1,3,Lost
60636,2088,12,26,1,3,2,6,Casual Users
60812,93,52,203,4,5,5,14,Champions
60814,9,57,269,5,5,5,15,Champions
60941,994,39,111,2,4,4,10,At Risk
61048,24,55,121,5,5,4,14,Champions
61377,119,60,164,4,5,5,14,Champions
61470,1973,7,19,1,2,2,5,Lost
61645,793,17,55,2,3,3,8,Casual Users
61723,393,79,182,3,5,5,13,Loyal Users
61980,404,21,53,3,3,3,9,Loyal Users
62417,425,16,122,3,3,4,10,Loyal Users
62422,1544,7,7,1,2,1,4,Lost
62634,2,39,154,5,4,5,14,Champions
62714,11,57,159,5,5,5,15,Champions
62918,351,28,55,3,4,3,10,Loyal Users
62920,686,10,18,2,2,2,6,Lost
63238,80,18,46,4,3,3,10,Loyal Users
63369,143,70,265,4,5,5,14,Champions
63499,112,56,117,4,5,4,13,Champions
63504,41,22,74,5,4,4,13,Champions
63786,145,133,275,4,5,5,14,Champions
63831,417,25,225,3,4,5,12,Loyal Users
64126,98,131,281,4,5,5,14,Champions
64265,12,111,471,5,5,5,15,Champions
64318,131,27,81,4,4,4,12,Champions
64384,72,56,314,4,5,5,14,Champions
64490,132,8,13,4,2,1,7,Promising
64602,306,46,99,3,5,4,12,Loyal Users
64732,13,61,169,5,5,5,15,Champions
64863,951,10,12,2,2,1,5,Lost
64906,3465,21,29,1,3,2,6,Casual Users
65083,2140,18,20,1,3,2,6,Casual Users
52492,77,71,172,4,5,5,14,Champions
52710,2464,11,11,1,2,1,4,Lost
52731,2500,7,9,1,2,1,4,Lost
52835,813,6,11,2,1,1,4,Lost
53085,1,101,453,5,5,5,15,Champions
53505,22,49,384,5,5,5,15,Champions
53614,296,18,35,3,3,3,9,Loyal Users
53651,2718,5,19,1,1,2,4,Lost
53932,16,61,421,5,5,5,15,Champions
54195,641,6,8,2,1,1,4,Lost
54413,1710,24,96,1,4,4,9,At Risk
54616,299,13,22,3,3,2,8,Loyal Users
55309,295,16,22,3,3,2,8,Loyal Users
55331,6,143,647,5,5,5,15,Champions
55387,7,23,68,5,4,4,13,Champions
55431,160,42,488,4,4,5,13,Champions
55489,421,9,42,3,2,3,8,Casual Users
55548,142,55,184,4,5,5,14,Champions
55839,85,64,164,4,5,5,14,Champions
55921,4143,5,10,1,1,1,3,Lost
56154,1850,15,16,1,3,2,6,Casual Users
56368,229,14,22,3,3,2,8,Loyal Users
56554,160,90,209,4,5,5,14,Champions
56845,1392,6,6,1,1,1,3,Lost
57199,16,10,27,5,2,2,9,Promising
57533,3563,6,6,1,1,1,3,Lost
57689,548,17,71,2,3,4,9,Casual Users
57700,207,22,38,3,4,3,10,Loyal Users
57822,59,8,38,5,2,3,10,Promising
57920,192,62,244,3,5,5,13,Loyal Users
57946,3,29,78,5,4,4,13,Champions
58288,96,11,15,4,2,1,7,Promising
58322,894,12,16,2,3,2,7,Casual Users
58722,192,51,83,3,5,4,12,Loyal Users
58862,267,12,16,3,3,2,8,Loyal Users
59048,96,9,17,4,2,2,8,Promising
59221,594,19,51,2,3,3,8,Casual Users
59222,316,6,7,3,1,1,5,Casual Users
59270,4,119,434,5,5,5,15,Champions
59538,26,23,51,5,4,3,12,Loyal Users
59812,121,21,192,4,3,5,12,Loyal Users
59903,407,11,12,3,2,1,6,Casual Users
59984,124,26,118,4,4,4,12,Champions
60047,50,18,220,5,3,5,13,Loyal Users
60440,1424,30,74,1,4,4,9,At Risk
60583,525,9,19,2,2,2,6,Lost
60689,3464,14,34,1,3,3,7,Casual Users
60715,1292,7,24,1,2,2,5,Lost
60785,123,15,39,4,3,3,10,Loyal Users
60866,1994,14,24,1,3,2,6,Casual Users
61065,1428,5,5,1,1,1,3,Lost
61273,372,13,36,3,3,3,9,Loyal Users
61329,5592,6,6,1,1,1,3,Lost
61545,279,28,42,3,4,3,10,Loyal Users
61802,253,46,82,3,5,4,12,Loyal Users
61954,1271,9,23,1,2,2,5,Lost
62230,1784,10,63,1,2,4,7,Lost
62283,2691,7,17,1,2,2,5,Lost
62427,0,51,175,5,5,5,15,Champions
62510,5,16,87,5,3,4,12,Loyal Users
62598,523,28,117,2,4,4,10,At Risk
62827,896,8,31,2,2,2,6,Lost
63006,454,17,83,3,3,4,10,Loyal Users
63123,145,5,13,4,1,1,6,Promising
63242,3,28,79,5,4,4,13,Champions
63460,237,23,80,3,4,4,11,Loyal Users
63728,2191,10,36,1,2,3,6,Lost
63845,27,24,51,5,4,3,12,Loyal Users
64247,1,18,39,5,3,3,11,Loyal Users
64404,2545,16,55,1,3,3,7,Casual Users
64616,113,8,88,4,2,4,10,Promising
65019,118,27,66,4,4,4,12,Champions
65148,178,9,12,3,2,1,6,Casual Users
65162,839,33,115,2,4,4,10,At Risk
65285,1952,21,111,1,3,4,8,Casual Users
65319,1416,6,9,1,1,1,3,Lost
52387,40,5,9,5,1,1,7,Promising
52510,20,91,498,5,5,5,15,Champions
52704,135,16,89,4,3,4,11,Loyal Users
52756,1,70,320,5,5,5,15,Champions
53220,121,53,77,4,5,4,13,Champions
53474,30,6,37,5,1,3,9,Promising
53682,2,80,370,5,5,5,15,Champions
53755,1028,35,71,2,4,4,10,At Risk
53888,897,8,30,2,2,2,6,Lost
53902,3,6,13,5,1,1,7,Promising
54015,145,14,18,4,3,2,9,Loyal Users
54715,71,74,162,4,5,5,14,Champions
54855,405,9,28,3,2,2,7,Casual Users
54977,104,25,52,4,4,3,11,Loyal Users
55125,8,73,398,5,5,5,15,Champions
55138,951,8,19,2,2,2,6,Lost
55801,1846,84,174,1,5,5,11,At Risk
56119,130,56,128,4,5,4,13,Champions
56720,0,50,158,5,5,5,15,Champions
56998,230,13,64,3,3,4,10,Loyal Users
57250,0,60,283,5,5,5,15,Champions
57335,694,18,71,2,3,4,9,Casual Users
58164,304,106,174,3,5,5,13,Loyal Users
58429,727,13,25,2,3,2,7,Casual Users
58507,300,26,94,3,4,4,11,Loyal Users
58644,234,10,16,3,2,2,7,Casual Users
58935,33,148,595,5,5,5,15,Champions
59315,2808,7,18,1,2,2,5,Lost
59326,44,6,16,5,1,2,8,Promising
59336,121,20,36,4,3,3,10,Loyal Users
59424,79,45,240,4,4,5,13,Champions
59475,343,11,31,3,2,2,7,Casual Users
59581,140,62,205,4,5,5,14,Champions
59626,837,31,177,2,4,5,11,At Risk
59690,42,10,37,5,2,3,10,Promising
59822,412,9,64,3,2,4,9,Casual Users
59936,69,64,460,5,5,5,15,Champions
60061,27,43,111,5,4,4,13,Champions
60575,38,79,111,5,5,4,14,Champions
60668,2133,52,154,1,5,5,11,At Risk
61018,28,11,52,5,2,3,10,Promising
61026,2578,5,9,1,1,1,3,Lost
61034,179,77,221,3,5,5,13,Loyal Users
61091,112,52,87,4,5,4,13,Champions
61240,1139,8,24,2,2,2,6,Lost
61321,268,34,180,3,4,5,12,Loyal Users
61336,649,13,16,2,3,2,7,Casual Users
61690,113,70,499,4,5,5,14,Champions
61821,612,27,53,2,4,3,9,At Risk
62016,1273,9,12,1,2,1,4,Lost
62100,142,16,62,4,3,3,10,Loyal Users
62180,73,43,230,4,4,5,13,Champions
62308,87,71,282,4,5,5,14,Champions
62362,88,15,17,4,3,2,9,Loyal Users
62778,856,12,45,2,3,3,8,Casual Users
62835,132,7,10,4,2,1,7,Promising
62842,1331,97,225,1,5,5,11,At Risk
62882,263,30,74,3,4,4,11,Loyal Users
62943,3,41,95,5,4,4,13,Champions
63283,107,18,64,4,3,4,11,Loyal Users
63373,541,14,24,2,3,2,7,Casual Users
63431,1319,5,13,1,1,1,3,Lost
63811,17,46,181,5,5,5,15,Champions
63946,290,52,182,3,5,5,13,Loyal Users
63988,707,5,8,2,1,1,4,Lost
64075,354,20,54,3,3,3,9,Loyal Users
64643,81,72,158,4,5,5,14,Champions
64657,342,8,10,3,2,1,6,Casual Users
65158,1728,9,9,1,2,1,4,Lost
65361,2,32,46,5,4,3,12,Loyal Users
52560,2124,6,8,1,1,1,3,Lost
52639,17,26,237,5,4,5,14,Champions
52853,284,20,77,3,3,4,10,Loyal Users
52999,99,21,114,4,3,4,11,Loyal Users
53424,169,44,89,3,4,4,11,Loyal Users
53911,21,98,656,5,5,5,15,Champions
54044,83,54,184,4,5,5,14,Champions
54390,124,17,28,4,3,2,9,Loyal Users
54542,167,75,343,3,5,5,13,Loyal Users
55146,453,10,15,3,2,1,6,Casual Users
55336,15,92,156,5,5,5,15,Champions
55440,1836,9,13,1,2,1,4,Lost
55502,934,11,73,2,2,4,8,Lost
55700,81,21,79,4,3,4,11,Loyal Users
55812,129,6,10,4,1,1,6,Promising
56052,79,92,226,4,5,5,14,Champions
56086,2982,11,20,1,2,2,5,Lost
57031,320,29,174,3,4,5,12,Loyal Users
57043,889,5,6,2,1,1,4,Lost
57553,2755,21,112,1,3,4,8,Casual Users
57580,65,156,533,5,5,5,15,Champions
58157,22,115,221,5,5,5,15,Champions
58208,144,66,175,4,5,5,14,Champions
58468,0,17,33,5,3,3,11,Loyal Users
58922,1583,6,10,1,1,1,3,Lost
58984,508,8,30,2,2,2,6,Lost
59017,1418,6,7,1,1,1,3,Lost
59024,760,12,32,2,3,3,8,Casual Users
59480,3,5,6,5,1,1,7,Promising
59497,2521,5,18,1,1,2,4,Lost
59531,139,18,67,4,3,4,11,Loyal Users
59619,60,8,44,5,2,3,10,Promising
59622,17,66,88,5,5,4,14,Champions
59635,1709,35,71,1,4,4,9,At Risk
59649,120,42,133,4,4,4,12,Champions
59688,251,17,45,3,3,3,9,Loyal Users
59781,866,14,124,2,3,4,9,Casual Users
60818,473,11,19,2,2,2,6,Lost
60881,2538,6,18,1,1,2,4,Lost
60963,112,5,15,4,1,1,6,Promising
61120,1,24,110,5,4,4,13,Champions
61164,310,19,107,3,3,4,10,Loyal Users
61229,1667,37,105,1,4,4,9,At Risk
61253,52,56,544,5,5,5,15,Champions
61469,285,31,112,3,4,4,11,Loyal Users
62162,260,24,43,3,4,3,10,Loyal Users
62164,962,5,10,2,1,1,4,Lost
62183,41,65,187,5,5,5,15,Champions
62206,423,5,9,3,1,1,5,Casual Users
62279,10,9,14,5,2,1,8,Promising
62281,3713,5,16,1,1,2,4,Lost
62359,549,26,107,2,4,4,10,At Risk
62377,1544,6,9,1,1,1,3,Lost
62439,3874,8,11,1,2,1,4,Lost
62941,2279,18,23,1,3,2,6,Casual Users
62996,702,26,207,2,4,5,11,At Risk
63218,73,10,11,4,2,1,7,Promising
63498,103,27,41,4,4,3,11,Loyal Users
63512,741,14,20,2,3,2,7,Casual Users
63772,113,39,88,4,4,4,12,Champions
63902,85,10,14,4,2,1,7,Promising
63989,4012,6,15,1,1,1,3,Lost
64200,435,8,18,3,2,2,7,Casual Users
64685,121,7,10,4,2,1,7,Promising
64902,278,5,10,3,1,1,5,Casual Users
65182,99,40,82,4,4,4,12,Champions
52535,30,46,147,5,5,5,15,Champions
52938,10,32,74,5,4,4,13,Champions
53059,413,21,29,3,3,2,8,Loyal Users
53114,142,19,39,4,3,3,10,Loyal Users
53470,1183,5,8,2,1,1,4,Lost
53636,489,24,37,2,4,3,9,At Risk
53736,263,6,14,3,1,1,5,Casual Users
53849,2821,7,39,1,2,3,6,Lost
54131,294,14,22,3,3,2,8,Loyal Users
54150,26,5,33,5,1,3,9,Promising
54200,113,18,53,4,3,3,10,Loyal Users
54251,458,5,8,3,1,1,5,Casual Users
54510,2170,21,33,1,3,3,7,Casual Users
54529,1331,16,21,1,3,2,6,Casual Users
54881,413,15,38,3,3,3,9,Loyal Users
54885,14,33,53,5,4,3,12,Loyal Users
54928,9,18,24,5,3,2,10,Loyal Users
55379,1293,15,39,1,3,3,7,Casual Users
55384,38,9,9,5,2,1,8,Promising
55536,405,20,70,3,3,4,10,Loyal Users
55538,118,27,34,4,4,3,11,Loyal Users
55678,142,17,37,4,3,3,10,Loyal Users
55725,80,110,485,4,5,5,14,Champions
55946,382,26,75,3,4,4,11,Loyal Users
56144,308,12,19,3,3,2,8,Loyal Users
56209,2825,10,13,1,2,1,4,Lost
56392,682,11,13,2,2,1,5,Lost
56546,658,9,30,2,2,2,6,Lost
56855,606,15,62,2,3,3,8,Casual Users
56902,68,82,562,5,5,5,15,Champions
57087,1116,7,7,2,2,1,5,Lost
57246,562,9,42,2,2,3,7,Lost
57583,2,114,214,5,5,5,15,Champions
57699,3261,9,28,1,2,2,5,Lost
57869,694,5,42,2,1,3,6,Lost
57938,1891,16,35,1,3,3,7,Casual Users
57962,7,96,299,5,5,5,15,Champions
58081,140,29,168,4,4,5,13,Champions
58106,514,9,10,2,2,1,5,Lost
59035,1,15,82,5,3,4,12,Loyal Users
59372,869,7,7,2,2,1,5,Lost
59715,530,9,110,2,2,4,8,Lost
59742,3252,16,26,1,3,2,6,Casual Users
59798,522,12,29,2,3,2,7,Casual Users
59957,19,31,114,5,4,4,13,Champions
60118,91,14,42,4,3,3,10,Loyal Users
60331,455,95,529,3,5,5,13,Loyal Users
60709,1155,7,7,2,2,1,5,Lost
60763,540,46,136,2,5,4,11,At Risk
61089,4686,9,24,1,2,2,5,Lost
61794,69,6,16,5,1,2,8,Promising
62174,125,48,115,4,5,4,13,Champions
62176,1738,16,39,1,3,3,7,Casual Users
62411,449,5,21,3,1,2,6,Casual Users
62627,1044,10,34,2,2,3,7,Lost
62719,391,29,131,3,4,4,11,Loyal Users
63679,2020,8,10,1,2,1,4,Lost
63714,57,47,57,5,5,3,13,Loyal Users
63721,131,42,146,4,4,4,12,Champions
63987,3860,13,19,1,3,2,6,Casual Users
64194,10,19,37,5,3,3,11,Loyal Users
64844,3232,12,22,1,3,2,6,Casual Users
64963,256,11,21,3,2,2,7,Casual Users
65138,77,89,257,4,5,5,14,Champions
65267,206,9,36,3,2,3,8,Casual Users
65370,1731,28,30,1,4,2,7,At Risk
52936,1993,6,8,1,1,1,3,Lost
53023,2960,7,10,1,2,1,4,Lost
53045,310,17,72,3,3,4,10,Loyal Users
53304,409,23,216,3,4,5,12,Loyal Users
53582,455,83,217,3,5,5,13,Loyal Users
53702,139,25,80,4,4,4,12,Champions
53766,4979,5,13,1,1,1,3,Lost
54067,69,118,185,5,5,5,15,Champions
54706,1625,5,6,1,1,1,3,Lost
54842,993,9,36,2,2,3,7,Lost
54867,804,6,26,2,1,2,5,Lost
54889,1248,8,24,2,2,2,6,Lost
54897,3230,13,52,1,3,3,7,Casual Users
55149,537,5,6,2,1,1,4,Lost
55179,2509,16,50,1,3,3,7,Casual Users
55240,2989,9,18,1,2,2,5,Lost
55325,2377,7,19,1,2,2,5,Lost
55377,99,15,31,4,3,2,9,Loyal Users
55638,40,26,169,5,4,5,14,Champions
55722,420,8,64,3,2,4,9,Casual Users
56220,1403,9,72,1,2,4,7,Lost
56448,6,10,107,5,2,4,11,Promising
56857,704,9,11,2,2,1,5,Lost
56988,3345,7,11,1,2,1,4,Lost
57369,261,32,159,3,4,5,12,Loyal Users
57378,117,103,274,4,5,5,14,Champions
57595,1267,5,10,1,1,1,3,Lost
57835,72,6,8,4,1,1,6,Promising
58102,131,43,109,4,4,4,12,Champions
58847,872,12,21,2,3,2,7,Casual Users
59122,146,11,42,4,2,3,9,Promising
59824,928,17,97,2,3,4,9,Casual Users
59865,225,17,34,3,3,3,9,Loyal Users
59985,2568,9,13,1,2,1,4,Lost
60036,145,11,17,4,2,2,8,Promising
60607,244,26,225,3,4,5,12,Loyal Users
60626,1692,7,55,1,2,3,6,Lost
60653,993,14,19,2,3,2,7,Casual Users
60666,51,99,324,5,5,5,15,Champions
60693,248,8,47,3,2,3,8,Casual Users
60878,2681,7,9,1,2,1,4,Lost
60943,67,7,9,5,2,1,8,Promising
61076,3889,61,97,1,5,4,10,At Risk
61141,608,7,12,2,2,1,5,Lost
61159,128,104,157,4,5,5,14,Champions
61512,162,10,72,4,2,4,10,Promising
61903,878,9,19,2,2,2,6,Lost
61973,413,15,19,3,3,2,8,Loyal Users
62045,230,5,12,3,1,1,5,Casual Users
62213,118,32,67,4,4,4,12,Champions
62511,23,8,15,5,2,1,8,Promising
62722,49,119,524,5,5,5,15,Champions
62970,133,8,20,4,2,2,8,Promising
63163,301,27,73,3,4,4,11,Loyal Users
63424,579,6,16,2,1,2,5,Lost
63462,172,7,11,3,2,1,6,Casual Users
63649,433,12,32,3,3,3,9,Loyal Users
64090,3107,6,6,1,1,1,3,Lost
64310,117,13,18,4,3,2,9,Loyal Users
64460,101,108,346,4,5,5,14,Champions
64758,238,30,64,3,4,4,11,Loyal Users
64823,363,5,24,3,1,2,6,Casual Users
64879,151,41,124,4,4,4,12,Champions
65206,733,6,8,2,1,1,4,Lost
65252,1283,6,15,1,1,1,3,Lost
65265,860,9,18,2,2,2,6,Lost
65385,993,22,64,2,4,4,10,At Risk
53004,161,20,43,4,3,3,10,Loyal Users
53112,80,42,70,4,4,4,12,Champions
53554,411,62,229,3,5,5,13,Loyal Users
53675,1102,5,10,2,1,1,4,Lost
54057,3,31,50,5,4,3,12,Loyal Users
54197,109,89,162,4,5,5,14,Champions
54532,3848,13,32,1,3,3,7,Casual Users
54834,775,5,9,2,1,1,4,Lost
54837,325,13,26,3,3,2,8,Loyal Users
54866,17,64,203,5,5,5,15,Champions
55180,118,71,124,4,5,4,13,Champions
55975,4,73,282,5,5,5,15,Champions
56092,2980,6,31,1,1,2,4,Lost
56385,683,5,9,2,1,1,4,Lost
56431,609,7,9,2,2,1,5,Lost
56904,1825,8,55,1,2,3,6,Lost
57140,1354,6,11,1,1,1,3,Lost
57531,2997,5,9,1,1,1,3,Lost
57625,1766,10,28,1,2,2,5,Lost
57765,141,107,551,4,5,5,14,Champions
57870,59,12,170,5,3,5,13,Loyal Users
58121,464,14,25,3,3,2,8,Loyal Users
58222,111,72,611,4,5,5,14,Champions
58256,1224,11,48,2,2,3,7,Lost
58540,487,11,48,2,2,3,7,Lost
58759,38,59,258,5,5,5,15,Champions
58857,123,44,196,4,4,5,13,Champions
59249,432,31,43,3,4,3,10,Loyal Users
59501,14,54,65,5,5,4,14,Champions
59788,1292,9,31,1,2,2,5,Lost
59907,262,9,23,3,2,2,7,Casual Users
59997,112,14,73,4,3,4,11,Loyal Users
60404,22,73,189,5,5,5,15,Champions
60633,3378,6,7,1,1,1,3,Lost
61232,202,22,68,3,4,4,11,Loyal Users
61252,622,14,18,2,3,2,7,Casual Users
61342,1380,21,63,1,3,4,8,Casual Users
61371,301,10,41,3,2,3,8,Casual Users
61635,1249,10,27,2,2,2,6,Lost
62116,531,15,92,2,3,4,9,Casual Users
62465,3731,10,10,1,2,1,4,Lost
62469,118,28,74,4,4,4,12,Champions
63181,18,32,43,5,4,3,12,Loyal Users
63641,1669,10,45,1,2,3,6,Lost
64215,507,7,29,2,2,2,6,Lost
64237,33,11,25,5,2,2,9,Promising
64409,15,96,151,5,5,5,15,Champions
64427,244,42,64,3,4,4,11,Loyal Users
64502,1400,33,61,1,4,3,8,At Risk
64697,46,182,331,5,5,5,15,Champions
64832,702,7,22,2,2,2,6,Lost
65197,550,14,44,2,3,3,8,Casual Users
52412,2849,6,6,1,1,1,3,Lost
52556,1757,10,33,1,2,3,6,Lost
52826,137,77,314,4,5,5,14,Champions
52950,1803,11,16,1,2,2,5,Lost
53001,120,29,59,4,4,3,11,Loyal Users
53042,605,29,61,2,4,3,9,At Risk
53065,17,9,12,5,2,1,8,Promising
53255,3361,6,6,1,1,1,3,Lost
53490,7,76,188,5,5,5,15,Champions
53506,377,14,26,3,3,2,8,Loyal Users
53914,0,159,459,5,5,5,15,Champions
54206,23,68,422,5,5,5,15,Champions
54481,138,17,35,4,3,3,10,Loyal Users
54677,159,5,123,4,1,4,9,Promising
54826,92,57,162,4,5,5,14,Champions
54930,2590,6,41,1,1,3,5,Lost
54997,1146,12,53,2,3,3,8,Casual Users
55015,144,19,50,4,3,3,10,Loyal Users
55104,8,10,20,5,2,2,9,Promising
55470,2828,16,29,1,3,2,6,Casual Users
55530,620,38,107,2,4,4,10,At Risk
55660,115,41,262,4,4,5,13,Champions
55662,619,28,140,2,4,4,10,At Risk
55841,438,7,18,3,2,2,7,Casual Users
56257,2816,8,20,1,2,2,5,Lost
56366,123,40,211,4,4,5,13,Champions
56646,509,20,33,2,3,3,8,Casual Users
57141,547,52,109,2,5,4,11,At Risk
57355,23,58,129,5,5,4,14,Champions
57394,35,123,366,5,5,5,15,Champions
57611,4,27,64,5,4,4,13,Champions
58275,569,5,7,2,1,1,4,Lost
58690,113,8,29,4,2,2,8,Promising
58764,123,8,10,4,2,1,7,Promising
58930,971,18,28,2,3,2,7,Casual Users
59001,241,24,89,3,4,4,11,Loyal Users
59088,1520,5,6,1,1,1,3,Lost
59676,4,90,165,5,5,5,15,Champions
59777,1221,5,13,2,1,1,4,Lost
59916,1,120,452,5,5,5,15,Champions
60324,2,11,34,5,2,3,10,Promising
60669,1167,48,56,2,5,3,10,At Risk
61088,94,96,613,4,5,5,14,Champions
61127,144,72,155,4,5,5,14,Champions
61201,85,11,52,4,2,3,9,Promising
61591,17,9,19,5,2,2,9,Promising
61725,674,6,9,2,1,1,4,Lost
62151,1299,7,7,1,2,1,4,Lost
62167,28,68,214,5,5,5,15,Champions
62336,132,6,9,4,1,1,6,Promising
62370,1837,11,37,1,2,3,6,Lost
62395,314,88,137,3,5,4,12,Loyal Users
62457,78,76,214,4,5,5,14,Champions
62584,16,48,101,5,5,4,14,Champions
62887,395,50,58,3,5,3,11,Loyal Users
62959,372,8,10,3,2,1,6,Casual Users
63003,0,54,210,5,5,5,15,Champions
63013,69,6,7,5,1,1,7,Promising
63100,410,28,47,3,4,3,10,Loyal Users
63134,141,88,155,4,5,5,14,Champions
63328,422,7,43,3,2,3,8,Casual Users
63454,0,82,292,5,5,5,15,Champions
63487,833,6,12,2,1,1,4,Lost
63538,1606,13,37,1,3,3,7,Casual Users
63642,12,12,28,5,3,2,10,Loyal Users
64659,9,196,786,5,5,5,15,Champions
64884,2084,8,26,1,2,2,5,Lost
64961,693,13,15,2,3,1,6,Casual Users
65062,426,14,34,3,3,3,9,Loyal Users
65160,0,63,369,5,5,5,15,Champions
65207,27,38,109,5,4,4,13,Champions
65224,57,152,406,5,5,5,15,Champions
65226,426,21,39,3,3,3,9,Loyal Users
65366,819,17,18,2,3,2,7,Casual Users
65375,10,5,18,5,1,2,8,Promising
52457,134,14,28,4,3,2,9,Loyal Users
52563,9,85,137,5,5,4,14,Champions
52805,373,12,153,3,3,5,11,Loyal Users
52842,2550,7,15,1,2,1,4,Lost
53130,130,9,86,4,2,4,10,Promising
53297,277,30,58,3,4,3,10,Loyal Users
53389,88,11,28,4,2,2,8,Promising
53444,3912,6,6,1,1,1,3,Lost
53664,3710,14,21,1,3,2,6,Casual Users
53711,3799,5,8,1,1,1,3,Lost
53751,2630,11,20,1,2,2,5,Lost
53868,172,5,9,3,1,1,5,Casual Users
54266,1726,77,292,1,5,5,11,At Risk
54693,176,17,117,3,3,4,10,Loyal Users
54863,106,13,75,4,3,4,11,Loyal Users
55203,3417,16,58,1,3,3,7,Casual Users
55408,331,20,23,3,3,2,8,Loyal Users
55611,270,39,215,3,4,5,12,Loyal Users
55690,2442,11,31,1,2,2,5,Lost
55780,22,6,6,5,1,1,7,Promising
56103,1270,5,10,1,1,1,3,Lost
56210,93,18,31,4,3,2,9,Loyal Users
56227,1445,8,13,1,2,1,4,Lost
56295,545,10,19,2,2,2,6,Lost
56547,510,9,86,2,2,4,8,Lost
56817,4,66,315,5,5,5,15,Champions
56832,70,8,30,4,2,2,8,Promising
56906,27,141,275,5,5,5,15,Champions
56962,175,19,26,3,3,2,8,Loyal Users
56969,446,10,78,3,2,4,9,Casual Users
57041,5,40,200,5,4,5,14,Champions
57333,12,13,25,5,3,2,10,Loyal Users
57354,333,11,55,3,2,3,8,Casual Users
57671,1715,6,27,1,1,2,4,Lost
57857,815,14,27,2,3,2,7,Casual Users
57929,1542,6,14,1,1,1,3,Lost
58093,8,108,363,5,5,5,15,Champions
58187,13,92,310,5,5,5,15,Champions
58291,1990,12,40,1,3,3,7,Casual Users
58701,567,8,15,2,2,1,5,Lost
58708,994,54,166,2,5,5,12,At Risk
58754,1291,19,21,1,3,2,6,Casual Users
58796,427,6,10,3,1,1,5,Casual Users
59043,297,12,18,3,3,2,8,Loyal Users
59063,0,48,293,5,5,5,15,Champions
59093,134,17,23,4,3,2,9,Loyal Users
59195,247,42,146,3,4,4,11,Loyal Users
59295,9,36,141,5,4,4,13,Champions
59302,464,25,55,3,4,3,10,Loyal Users
59747,81,35,386,4,4,5,13,Champions
59763,4782,6,7,1,1,1,3,Lost
59871,860,17,30,2,3,2,7,Casual Users
59927,718,34,101,2,4,4,10,At Risk
60380,14,40,60,5,4,3,12,Loyal Users
60553,6,5,12,5,1,1,7,Promising
60732,234,26,69,3,4,4,11,Loyal Users
61101,74,24,65,4,4,4,12,Champions
61148,24,89,360,5,5,5,15,Champions
61154,1424,5,30,1,1,2,4,Lost
61263,675,9,43,2,2,3,7,Lost
61353,125,29,86,4,4,4,12,Champions
61577,270,11,21,3,2,2,7,Casual Users
61806,374,11,31,3,2,2,7,Casual Users
62083,434,7,15,3,2,1,6,Casual Users
62581,110,56,330,4,5,5,14,Champions
62628,92,46,186,4,5,5,14,Champions
62850,6,23,100,5,4,4,13,Champions
63207,3611,7,11,1,2,1,4,Lost
63214,5,37,57,5,4,3,12,Loyal Users
63241,932,21,107,2,3,4,9,Casual Users
63656,857,7,13,2,2,1,5,Lost
63799,23,94,297,5,5,5,15,Champions
64481,2632,7,9,1,2,1,4,Lost
64504,44,121,406,5,5,5,15,Champions
65089,122,26,91,4,4,4,12,Champions
65103,846,5,9,2,1,1,4,Lost
65276,0,63,305,5,5,5,15,Champions
52521,275,15,30,3,3,2,8,Loyal Users
52581,0,11,26,5,2,2,9,Promising
52838,125,60,90,4,5,4,13,Champions
52863,114,9,34,4,2,3,9,Promising
52886,893,5,7,2,1,1,4,Lost
52962,119,7,25,4,2,2,8,Promising
53440,14,65,103,5,5,4,14,Champions
53727,21,8,12,5,2,1,8,Promising
53891,1500,20,39,1,3,3,7,Casual Users
54029,2192,8,8,1,2,1,4,Lost
54149,416,5,7,3,1,1,5,Casual Users
54199,8,103,192,5,5,5,15,Champions
54234,119,9,47,4,2,3,9,Promising
54248,135,9,22,4,2,2,8,Promising
54334,698,49,65,2,5,4,11,At Risk
54682,101,30,143,4,4,4,12,Champions
54988,1117,18,22,2,3,2,7,Casual Users
55188,134,31,80,4,4,4,12,Champions
55391,30,97,505,5,5,5,15,Champions
55397,1366,6,11,1,1,1,3,Lost
55427,129,10,29,4,2,2,8,Promising
55626,3949,31,65,1,4,4,9,At Risk
55687,111,25,44,4,4,3,11,Loyal Users
55936,270,9,68,3,2,4,9,Casual Users
55971,41,15,21,5,3,2,10,Loyal Users
56189,16,80,95,5,5,4,14,Champions
56601,7,124,590,5,5,5,15,Champions
56792,1261,49,107,1,5,4,10,At Risk
56831,13,84,362,5,5,5,15,Champions
56865,0,85,242,5,5,5,15,Champions
56973,85,63,356,4,5,5,14,Champions
57119,48,27,50,5,4,3,12,Loyal Users
57173,4486,6,31,1,1,2,4,Lost
57191,1672,6,9,1,1,1,3,Lost
57397,90,14,21,4,3,2,9,Loyal Users
57418,5248,6,13,1,1,1,3,Lost
57547,2407,5,9,1,1,1,3,Lost
57556,394,16,36,3,3,3,9,Loyal Users
57633,1270,11,52,1,2,3,6,Lost
57712,340,8,12,3,2,1,6,Casual Users
58111,35,147,921,5,5,5,15,Champions
58290,2492,5,5,1,1,1,3,Lost
58296,580,7,15,2,2,1,5,Lost
58484,379,73,227,3,5,5,13,Loyal Users
58655,836,13,17,2,3,2,7,Casual Users
58712,2730,6,10,1,1,1,3,Lost
58872,4602,48,63,1,5,4,10,At Risk
59179,274,14,36,3,3,3,9,Loyal Users
59378,462,5,7,3,1,1,5,Casual Users
59465,66,48,128,5,5,4,14,Champions
60095,287,47,152,3,5,5,13,Loyal Users
60165,125,22,27,4,4,2,10,Loyal Users
60272,309,15,57,3,3,3,9,Loyal Users
60469,783,19,29,2,3,2,7,Casual Users
60506,109,37,50,4,4,3,11,Loyal Users
60762,103,58,245,4,5,5,14,Champions
60922,109,81,295,4,5,5,14,Champions
61057,2014,7,45,1,2,3,6,Lost
61087,275,60,249,3,5,5,13,Loyal Users
61425,3722,10,19,1,2,2,5,Lost
61717,249,103,372,3,5,5,13,Loyal Users
61805,1469,9,13,1,2,1,4,Lost
61945,53,69,102,5,5,4,14,Champions
62270,2131,8,8,1,2,1,4,Lost
63031,34,29,131,5,4,4,13,Champions
63265,1585,8,15,1,2,1,4,Lost
63419,521,21,43,2,3,3,8,Casual Users
63448,138,88,197,4,5,5,14,Champions
63699,3444,14,19,1,3,2,6,Casual Users
63744,537,32,58,2,4,3,9,At Risk
64196,2031,13,25,1,3,2,6,Casual Users
64584,89,153,570,4,5,5,14,Champions
64696,177,14,50,3,3,3,9,Loyal Users
64895,724,15,112,2,3,4,9,Casual Users
64904,822,9,18,2,2,2,6,Lost
52442,98,42,161,4,4,5,13,Champions
52947,411,16,21,3,3,2,8,Loyal Users
53214,150,5,31,4,1,2,7,Promising
53497,2424,6,14,1,1,1,3,Lost
53733,346,21,41,3,3,3,9,Loyal Users
54578,93,76,289,4,5,5,14,Champions
54639,391,15,29,3,3,2,8,Loyal Users
54803,3,42,165,5,4,5,14,Champions
54868,101,9,19,4,2,2,8,Promising
54978,272,11,33,3,2,3,8,Casual Users
55059,429,6,18,3,1,2,6,Casual Users
55111,417,13,53,3,3,3,9,Loyal Users
55163,848,8,14,2,2,1,5,Lost
55199,447,9,22,3,2,2,7,Casual Users
55285,531,21,54,2,3,3,8,Casual Users
55351,287,40,59,3,4,3,10,Loyal Users
55491,140,7,25,4,2,2,8,Promising
56268,216,39,148,3,4,5,12,Loyal Users
56303,258,47,101,3,5,4,12,Loyal Users
56709,1850,6,11,1,1,1,3,Lost
56757,1,154,958,5,5,5,15,Champions
57204,33,6,9,5,1,1,7,Promising
57310,546,146,288,2,5,5,12,At Risk
57630,91,63,114,4,5,4,13,Champions
57663,430,9,20,3,2,2,7,Casual Users
57777,1863,19,30,1,3,2,6,Casual Users
57888,1424,11,17,1,2,2,5,Lost
57922,882,22,124,2,4,4,10,At Risk
58022,2431,5,15,1,1,1,3,Lost
58174,454,9,13,3,2,1,6,Casual Users
58212,28,113,708,5,5,5,15,Champions
58367,46,45,76,5,4,4,13,Champions
58479,542,20,41,2,3,3,8,Casual Users
58536,1148,12,34,2,3,3,8,Casual Users
58726,2474,5,9,1,1,1,3,Lost
58840,798,5,36,2,1,3,6,Lost
58998,4467,18,37,1,3,3,7,Casual Users
59129,716,7,21,2,2,2,6,Lost
59183,667,7,23,2,2,2,6,Lost
59358,822,9,18,2,2,2,6,Lost
59514,161,39,105,4,4,4,12,Champions
59861,171,10,84,3,2,4,9,Casual Users
60102,21,57,176,5,5,5,15,Champions
60204,1708,6,17,1,1,2,4,Lost
60312,0,90,339,5,5,5,15,Champions
60526,694,10,48,2,2,3,7,Lost
61160,2698,5,7,1,1,1,3,Lost
61698,425,35,42,3,4,3,10,Loyal Users
63040,112,22,42,4,4,3,11,Loyal Users
63189,658,38,194,2,4,5,11,At Risk
63231,3448,16,27,1,3,2,6,Casual Users
63875,61,76,276,5,5,5,15,Champions
64052,405,5,14,3,1,1,5,Casual Users
64626,212,61,196,3,5,5,13,Loyal Users
64721,4950,5,5,1,1,1,3,Lost
64996,285,25,160,3,4,5,12,Loyal Users
65105,21,39,119,5,4,4,13,Champions
65324,132,21,40,4,3,3,10,Loyal Users
52655,7,49,175,5,5,5,15,Champions
52770,750,30,63,2,4,4,10,At Risk
52872,74,116,527,4,5,5,14,Champions
52916,1076,16,45,2,3,3,8,Casual Users
52951,1976,10,34,1,2,3,6,Lost
53011,1968,11,17,1,2,2,5,Lost
53372,935,11,19,2,2,2,6,Lost
53453,365,60,596,3,5,5,13,Loyal Users
53536,562,5,6,2,1,1,4,Lost
53836,1027,15,35,2,3,3,8,Casual Users
53842,1100,11,11,2,2,1,5,Lost
53940,6,55,197,5,5,5,15,Champions
54281,2509,6,8,1,1,1,3,Lost
54380,688,5,11,2,1,1,4,Lost
54441,1423,9,10,1,2,1,4,Lost
54645,433,18,30,3,3,2,8,Loyal Users
54683,148,41,122,4,4,4,12,Champions
54804,1276,6,10,1,1,1,3,Lost
54910,131,32,96,4,4,4,12,Champions
55144,131,6,23,4,1,2,7,Promising
55147,128,11,14,4,2,1,7,Promising
55215,1280,6,42,1,1,3,5,Lost
55753,140,52,162,4,5,5,14,Champions
56553,574,9,14,2,2,1,5,Lost
56580,1189,15,23,2,3,2,7,Casual Users
56582,3,28,122,5,4,4,13,Champions
56765,100,88,167,4,5,5,14,Champions
56811,130,28,89,4,4,4,12,Champions
56844,415,6,14,3,1,1,5,Casual Users
56956,131,8,11,4,2,1,7,Promising
57592,929,25,73,2,4,4,10,At Risk
57641,37,11,21,5,2,2,9,Promising
57760,424,14,35,3,3,3,9,Loyal Users
57762,175,36,160,3,4,5,12,Loyal Users
58046,849,10,22,2,2,2,6,Lost
58105,135,6,14,4,1,1,6,Promising
58153,93,12,33,4,3,3,10,Loyal Users
58703,313,23,32,3,4,3,10,Loyal Users
58951,509,22,68,2,4,4,10,At Risk
58956,2227,5,11,1,1,1,3,Lost
59524,10,122,227,5,5,5,15,Champions
60073,278,36,176,3,4,5,12,Loyal Users
60083,62,64,443,5,5,5,15,Champions
60142,125,13,72,4,3,4,11,Loyal Users
60179,166,9,43,3,2,3,8,Casual Users
60229,412,22,91,3,4,4,11,Loyal Users
60256,0,70,143,5,5,4,14,Champions
60412,8,8,31,5,2,2,9,Promising
60438,439,19,46,3,3,3,9,Loyal Users
60471,414,15,21,3,3,2,8,Loyal Users
60685,23,8,18,5,2,2,9,Promising
60869,2419,22,98,1,4,4,9,At Risk
60911,277,14,27,3,3,2,8,Loyal Users
61021,3469,10,11,1,2,1,4,Lost
61104,1912,6,12,1,1,1,3,Lost
61190,115,10,25,4,2,2,8,Promising
61647,7,81,141,5,5,4,14,Champions
61757,2611,7,12,1,2,1,4,Lost
62064,236,79,241,3,5,5,13,Loyal Users
62934,2971,10,24,1,2,2,5,Lost
63302,271,124,420,3,5,5,13,Loyal Users
63543,3522,11,46,1,2,3,6,Lost
63544,735,41,121,2,4,4,10,At Risk
63692,93,9,45,4,2,3,9,Promising
63804,44,25,87,5,4,4,13,Champions
64128,5,62,179,5,5,5,15,Champions
64141,96,5,23,4,1,2,7,Promising
64160,572,15,89,2,3,4,9,Casual Users
64241,659,15,35,2,3,3,8,Casual Users
64327,702,7,20,2,2,2,6,Lost
64383,609,6,7,2,1,1,4,Lost
64601,1,10,18,5,2,2,9,Promising
64662,2862,11,23,1,2,2,5,Lost
64935,590,40,60,2,4,3,9,At Risk
65015,837,36,89,2,4,4,10,At Risk
65059,441,18,33,3,3,3,9,Loyal Users
65193,29,26,126,5,4,4,13,Champions
65349,62,136,455,5,5,5,15,Champions
52449,494,13,16,2,3,2,7,Casual Users
52591,142,15,51,4,3,3,10,Loyal Users
53192,0,35,144,5,4,4,13,Champions
53215,835,6,11,2,1,1,4,Lost
53229,403,6,19,3,1,2,6,Casual Users
53494,936,5,12,2,1,1,4,Lost
53507,146,29,80,4,4,4,12,Champions
53739,1435,21,242,1,3,5,9,Casual Users
53857,711,9,92,2,2,4,8,Lost
53883,1904,8,9,1,2,1,4,Lost
53933,119,37,176,4,4,5,13,Champions
54034,119,53,116,4,5,4,13,Champions
54554,125,115,692,4,5,5,14,Champions
54573,220,56,176,3,5,5,13,Loyal Users
54835,132,56,241,4,5,5,14,Champions
54901,198,5,10,3,1,1,5,Casual Users
54973,4878,14,37,1,3,3,7,Casual Users
55092,421,22,43,3,4,3,10,Loyal Users
55122,1422,5,7,1,1,1,3,Lost
55322,20,101,284,5,5,5,15,Champions
55369,51,68,211,5,5,5,15,Champions
55430,37,6,13,5,1,1,7,Promising
55545,694,5,17,2,1,2,5,Lost
55667,147,66,251,4,5,5,14,Champions
55734,39,13,47,5,3,3,11,Loyal Users
55881,1968,6,16,1,1,2,4,Lost
55916,407,13,47,3,3,3,9,Loyal Users
56042,1135,10,21,2,2,2,6,Lost
56355,134,7,8,4,2,1,7,Promising
56357,1557,6,8,1,1,1,3,Lost
56634,706,30,171,2,4,5,11,At Risk
56760,133,129,183,4,5,5,14,Champions
56784,100,57,366,4,5,5,14,Champions
56839,1544,14,36,1,3,3,7,Casual Users
56879,1242,8,29,2,2,2,6,Lost
57275,5,111,189,5,5,5,15,Champions
57643,1271,50,111,1,5,4,10,At Risk
58019,834,10,15,2,2,1,5,Lost
58270,191,26,86,3,4,4,11,Loyal Users
58378,253,9,23,3,2,2,7,Casual Users
58516,150,20,23,4,3,2,9,Loyal Users
58793,1832,8,9,1,2,1,4,Lost
58799,743,6,6,2,1,1,4,Lost
58803,142,15,29,4,3,2,9,Loyal Users
58866,247,6,6,3,1,1,5,Casual Users
59219,106,192,615,4,5,5,14,Champions
59300,1097,12,113,2,3,4,9,Casual Users
59338,568,9,30,2,2,2,6,Lost
59373,1002,7,37,2,2,3,7,Lost
59726,241,41,176,3,4,5,12,Loyal Users
59737,123,24,93,4,4,4,12,Champions
60479,537,31,85,2,4,4,10,At Risk
60797,149,32,48,4,4,3,11,Loyal Users
60875,1898,12,56,1,3,3,7,Casual Users
60896,3873,5,21,1,1,2,4,Lost
61481,10,43,115,5,4,4,13,Champions
61684,969,17,56,2,3,3,8,Casual Users
61881,132,34,106,4,4,4,12,Champions
62095,136,10,39,4,2,3,9,Promising
62104,12,26,51,5,4,3,12,Loyal Users
62640,14,10,16,5,2,2,9,Promising
62684,543,10,15,2,2,1,5,Lost
62787,23,69,110,5,5,4,14,Champions
62872,443,23,70,3,4,4,11,Loyal Users
63395,13,179,357,5,5,5,15,Champions
63648,2,99,235,5,5,5,15,Champions
64071,968,30,72,2,4,4,10,At Risk
64079,9,112,295,5,5,5,15,Champions
64197,7,16,88,5,3,4,12,Loyal Users
64350,113,14,54,4,3,3,10,Loyal Users
64461,89,105,599,4,5,5,14,Champions
64734,137,5,8,4,1,1,6,Promising
65154,65,35,163,5,4,5,14,Champions
65345,678,10,15,2,2,1,5,Lost
52503,972,12,19,2,3,2,7,Casual Users
52785,17,38,96,5,4,4,13,Champions
52878,1367,13,15,1,3,1,5,Casual Users
53428,283,6,18,3,1,2,6,Casual Users
53794,877,5,5,2,1,1,4,Lost
54022,12,62,298,5,5,5,15,Champions
54298,125,32,170,4,4,5,13,Champions
54486,153,50,200,4,5,5,14,Champions
54498,190,12,16,3,3,2,8,Loyal Users
54588,29,81,225,5,5,5,15,Champions
54629,68,98,299,5,5,5,15,Champions
55493,711,15,34,2,3,3,8,Casual Users
56051,1294,5,12,1,1,1,3,Lost
56427,533,29,80,2,4,4,10,At Risk
56683,312,35,148,3,4,5,12,Loyal Users
57066,76,34,47,4,4,3,11,Loyal Users
57523,18,94,170,5,5,5,15,Champions
57584,610,26,62,2,4,3,9,At Risk
57874,1541,8,30,1,2,2,5,Lost
57979,4954,9,68,1,2,4,7,Lost
58120,272,23,58,3,4,3,10,Loyal Users
58614,322,51,262,3,5,5,13,Loyal Users
58647,1104,68,135,2,5,4,11,At Risk
58874,50,56,241,5,5,5,15,Champions
58996,336,6,27,3,1,2,6,Casual Users
59205,1118,15,27,2,3,2,7,Casual Users
59227,1853,6,6,1,1,1,3,Lost
59256,128,16,66,4,3,4,11,Loyal Users
59479,17,6,9,5,1,1,7,Promising
59695,146,14,80,4,3,4,11,Loyal Users
59806,807,7,38,2,2,3,7,Lost
60234,1803,14,49,1,3,3,7,Casual Users
60483,40,64,297,5,5,5,15,Champions
60841,13,34,197,5,4,5,14,Champions
60989,2919,6,7,1,1,1,3,Lost
61366,2661,18,19,1,3,2,6,Casual Users
61471,24,92,465,5,5,5,15,Champions
62135,2061,42,65,1,4,4,9,At Risk
62296,80,6,35,4,1,3,8,Promising
62500,712,12,26,2,3,2,7,Casual Users
62530,994,14,25,2,3,2,7,Casual Users
62782,420,27,244,3,4,5,12,Loyal Users
62875,237,105,153,3,5,5,13,Loyal Users
63113,145,27,51,4,4,3,11,Loyal Users
64268,81,142,278,4,5,5,14,Champions
64361,2593,22,27,1,4,2,7,At Risk
64401,1704,17,31,1,3,2,6,Casual Users
64433,30,8,20,5,2,2,9,Promising
64466,0,148,482,5,5,5,15,Champions
64547,906,6,7,2,1,1,4,Lost
64581,237,8,9,3,2,1,6,Casual Users
64814,131,21,48,4,3,3,10,Loyal Users
64835,37,46,231,5,5,5,15,Champions
64878,118,102,343,4,5,5,14,Champions
64923,449,13,32,3,3,3,9,Loyal Users
65136,3,43,273,5,4,5,14,Champions
53032,1540,5,8,1,1,1,3,Lost
53147,4408,7,54,1,2,3,6,Lost
53399,457,35,333,3,4,5,12,Loyal Users
53647,61,14,17,5,3,2,10,Loyal Users
53648,241,20,33,3,3,3,9,Loyal Users
54100,3545,57,135,1,5,4,10,At Risk
54260,97,31,146,4,4,4,12,Champions
54458,159,11,47,4,2,3,9,Promising
54555,118,58,233,4,5,5,14,Champions
54994,683,7,7,2,2,1,5,Lost
55037,589,20,54,2,3,3,8,Casual Users
55134,2998,10,14,1,2,1,4,Lost
55151,129,139,824,4,5,5,14,Champions
55174,69,50,77,5,5,4,14,Champions
55274,3001,5,7,1,1,1,3,Lost
55341,19,23,97,5,4,4,13,Champions
55723,3151,8,9,1,2,1,4,Lost
55803,131,16,122,4,3,4,11,Loyal Users
55847,210,25,109,3,4,4,11,Loyal Users
55898,799,7,13,2,2,1,5,Lost
55983,423,122,348,3,5,5,13,Loyal Users
56088,268,49,82,3,5,4,12,Loyal Users
56497,1842,10,75,1,2,4,7,Lost
56972,240,6,11,3,1,1,5,Casual Users
57032,1978,7,53,1,2,3,6,Lost
57044,72,17,41,4,3,3,10,Loyal Users
57110,1517,5,26,1,1,2,4,Lost
57437,79,85,233,4,5,5,14,Champions
57496,103,22,103,4,4,4,12,Champions
57520,1008,36,45,2,4,3,9,At Risk
57619,4947,27,102,1,4,4,9,At Risk
58069,4698,5,10,1,1,1,3,Lost
58175,760,6,43,2,1,3,6,Lost
58493,694,14,59,2,3,3,8,Casual Users
58698,353,6,11,3,1,1,5,Casual Users
59039,613,27,75,2,4,4,10,At Risk
59484,172,43,98,3,4,4,11,Loyal Users
59502,66,41,185,5,4,5,14,Champions
59766,432,20,48,3,3,3,9,Loyal Users
59917,1166,14,78,2,3,4,9,Casual Users
60078,252,6,11,3,1,1,5,Casual Users
60130,137,18,112,4,3,4,11,Loyal Users
60140,207,9,37,3,2,3,8,Casual Users
60371,115,9,108,4,2,4,10,Promising
60673,144,16,73,4,3,4,11,Loyal Users
61199,859,5,17,2,1,2,5,Lost
61268,135,109,433,4,5,5,14,Champions
61359,3456,9,11,1,2,1,4,Lost
61439,53,19,210,5,3,5,13,Loyal Users
61610,65,63,190,5,5,5,15,Champions
61876,64,9,82,5,2,4,11,Promising
61898,1231,31,132,2,4,4,10,At Risk
61941,1243,5,11,2,1,1,4,Lost
62076,579,28,72,2,4,4,10,At Risk
62165,186,39,57,3,4,3,10,Loyal Users
62179,76,11,42,4,2,3,9,Promising
62601,414,19,92,3,3,4,10,Loyal Users
62759,590,10,23,2,2,2,6,Lost
62768,1003,19,106,2,3,4,9,Casual Users
62779,12,24,41,5,4,3,12,Loyal Users
63461,32,79,135,5,5,4,14,Champions
63542,543,12,25,2,3,2,7,Casual Users
63693,354,23,44,3,4,3,10,Loyal Users
63822,134,59,95,4,5,4,13,Champions
64276,700,34,59,2,4,3,9,At Risk
64501,1561,13,26,1,3,2,6,Casual Users
64750,117,50,278,4,5,5,14,Champions
64997,223,21,75,3,3,4,10,Loyal Users
65092,548,9,31,2,2,2,6,Lost
65195,698,10,11,2,2,1,5,Lost
52375,454,34,92,3,4,4,11,Loyal Users
52491,684,5,7,2,1,1,4,Lost
52734,587,9,27,2,2,2,6,Lost
53274,569,9,9,2,2,1,5,Lost
53667,116,14,16,4,3,2,9,Loyal Users
53722,12,39,85,5,4,4,13,Champions
53946,1139,16,23,2,3,2,7,Casual Users
54395,106,64,116,4,5,4,13,Champions
54420,500,5,18,2,1,2,5,Lost
54663,1079,11,25,2,2,2,6,Lost
54668,136,10,24,4,2,2,8,Promising
54960,3565,5,9,1,1,1,3,Lost
55268,151,47,245,4,5,5,14,Champions
55404,994,19,63,2,3,4,9,Casual Users
55434,126,195,483,4,5,5,14,Champions
55666,4595,11,13,1,2,1,4,Lost
55738,1093,13,46,2,3,3,8,Casual Users
56081,121,50,65,4,5,4,13,Champions
56098,1122,8,8,2,2,1,5,Lost
56123,981,9,10,2,2,1,5,Lost
56191,74,43,180,4,4,5,13,Champions
56374,5,92,523,5,5,5,15,Champions
56836,317,55,111,3,5,4,12,Loyal Users
57101,576,13,28,2,3,2,7,Casual Users
57400,145,17,26,4,3,2,9,Loyal Users
57417,38,139,469,5,5,5,15,Champions
57504,90,23,93,4,4,4,12,Champions
57721,549,5,9,2,1,1,4,Lost
58047,4283,8,8,1,2,1,4,Lost
58142,40,36,109,5,4,4,13,Champions
58503,289,66,480,3,5,5,13,Loyal Users
58678,478,12,50,2,3,3,8,Casual Users
58875,3,45,137,5,4,4,13,Champions
58887,76,6,23,4,1,2,7,Promising
59018,547,27,46,2,4,3,9,At Risk
59278,1239,5,13,2,1,1,4,Lost
60209,580,18,53,2,3,3,8,Casual Users
60273,2517,6,39,1,1,3,5,Lost
60309,235,69,327,3,5,5,13,Loyal Users
60536,204,61,187,3,5,5,13,Loyal Users
60584,832,7,18,2,2,2,6,Lost
60748,274,10,33,3,2,3,8,Casual Users
60873,881,18,26,2,3,2,7,Casual Users
61037,319,26,55,3,4,3,10,Loyal Users
61393,23,13,39,5,3,3,11,Loyal Users
61667,129,19,33,4,3,3,10,Loyal Users
61696,1825,13,18,1,3,2,6,Casual Users
61998,300,22,42,3,4,3,10,Loyal Users
62009,23,62,156,5,5,5,15,Champions
62255,426,7,9,3,2,1,6,Casual Users
62409,49,242,362,5,5,5,15,Champions
62454,65,94,336,5,5,5,15,Champions
62749,463,27,45,3,4,3,10,Loyal Users
63018,499,39,50,2,4,3,9,At Risk
63129,8,97,116,5,5,4,14,Champions
63747,3248,17,47,1,3,3,7,Casual Users
63960,114,38,164,4,4,5,13,Champions
64201,23,73,532,5,5,5,15,Champions
65060,64,6,25,5,1,2,8,Promising
65071,526,24,30,2,4,2,8,At Risk
65376,444,8,10,3,2,1,6,Casual Users
52454,605,8,10,2,2,1,5,Lost
53084,747,10,84,2,2,4,8,Lost
53537,136,17,43,4,3,3,10,Loyal Users
53679,1130,9,54,2,2,3,7,Lost
53731,243,28,58,3,4,3,10,Loyal Users
53753,143,49,231,4,5,5,14,Champions
53830,89,41,184,4,4,5,13,Champions
53983,365,34,167,3,4,5,12,Loyal Users
54143,1600,5,20,1,1,2,4,Lost
54203,569,15,42,2,3,3,8,Casual Users
54235,2175,13,25,1,3,2,6,Casual Users
54257,3830,19,104,1,3,4,8,Casual Users
54696,879,12,18,2,3,2,7,Casual Users
54733,445,25,70,3,4,4,11,Loyal Users
54876,1414,16,34,1,3,3,7,Casual Users
55157,318,6,15,3,1,1,5,Casual Users
55469,327,18,59,3,3,3,9,Loyal Users
55605,217,45,145,3,4,4,11,Loyal Users
55907,250,6,11,3,1,1,5,Casual Users
56114,151,7,12,4,2,1,7,Promising
56241,381,9,26,3,2,2,7,Casual Users
56276,115,49,154,4,5,5,14,Champions
56328,357,23,41,3,4,3,10,Loyal Users
56424,179,81,119,3,5,4,12,Loyal Users
56782,147,92,262,4,5,5,14,Champions
56888,107,28,70,4,4,4,12,Champions
57024,427,48,91,3,5,4,12,Loyal Users
57730,286,39,50,3,4,3,10,Loyal Users
57892,120,31,234,4,4,5,13,Champions
58020,712,7,11,2,2,1,5,Lost
58337,22,268,582,5,5,5,15,Champions
58443,60,9,11,5,2,1,8,Promising
58459,2743,7,15,1,2,1,4,Lost
58505,858,9,26,2,2,2,6,Lost
59029,324,63,152,3,5,5,13,Loyal Users
59307,782,8,10,2,2,1,5,Lost
59312,444,18,42,3,3,3,9,Loyal Users
59405,101,6,26,4,1,2,7,Promising
59421,1003,13,104,2,3,4,9,Casual Users
59696,165,15,36,4,3,3,10,Loyal Users
60178,534,5,11,2,1,1,4,Lost
60786,71,38,113,4,4,4,12,Champions
60798,698,6,14,2,1,1,4,Lost
61071,1042,12,101,2,3,4,9,Casual Users
61086,4393,6,7,1,1,1,3,Lost
61200,115,72,523,4,5,5,14,Champions
61408,2557,6,6,1,1,1,3,Lost
61416,129,41,228,4,4,5,13,Champions
61446,4,50,112,5,5,4,14,Champions
61568,81,43,122,4,4,4,12,Champions
61908,4336,9,11,1,2,1,4,Lost
62081,126,40,55,4,4,3,11,Loyal Users
62358,35,26,45,5,4,3,12,Loyal Users
62558,413,30,86,3,4,4,11,Loyal Users
62855,135,14,23,4,3,2,9,Loyal Users
62914,1217,37,150,2,4,5,11,At Risk
63008,3,77,577,5,5,5,15,Champions
63135,7,15,26,5,3,2,10,Loyal Users
63149,2327,9,34,1,2,3,6,Lost
63225,884,7,19,2,2,2,6,Lost
63347,2829,6,25,1,1,2,4,Lost
63611,278,8,21,3,2,2,7,Casual Users
63617,285,50,64,3,5,4,12,Loyal Users
63640,567,7,13,2,2,1,5,Lost
63653,374,18,29,3,3,2,8,Loyal Users
63846,323,22,62,3,4,3,10,Loyal Users
63860,130,30,84,4,4,4,12,Champions
63911,1281,57,197,1,5,5,11,At Risk
64017,299,7,10,3,2,1,6,Casual Users
64673,54,35,56,5,4,3,12,Loyal Users
64748,955,10,28,2,2,2,6,Lost
65187,1169,8,24,2,2,2,6,Lost
65225,116,30,121,4,4,4,12,Champions
65228,98,58,77,4,5,4,13,Champions
65263,3664,9,19,1,2,2,5,Lost
65351,1297,25,85,1,4,4,9,At Risk
52373,87,12,53,4,3,3,10,Loyal Users
52544,3234,5,16,1,1,2,4,Lost
52558,16,24,65,5,4,4,13,Champions
52607,4,102,391,5,5,5,15,Champions
53002,18,239,441,5,5,5,15,Champions
53768,129,23,40,4,4,3,11,Loyal Users
54300,5794,16,16,1,3,2,6,Casual Users
54579,94,90,602,4,5,5,14,Champions
54667,4926,5,25,1,1,2,4,Lost
54795,1069,7,31,2,2,2,6,Lost
54859,2418,5,17,1,1,2,4,Lost
54981,1692,11,31,1,2,2,5,Lost
55177,657,25,110,2,4,4,10,At Risk
55361,107,7,9,4,2,1,7,Promising
55537,10,132,266,5,5,5,15,Champions
55918,264,10,19,3,2,2,7,Casual Users
55953,2395,6,10,1,1,1,3,Lost
55986,389,6,9,3,1,1,5,Casual Users
56267,7,30,58,5,4,3,12,Loyal Users
56552,577,24,37,2,4,3,9,At Risk
57252,442,5,12,3,1,1,5,Casual Users
57330,286,25,57,3,4,3,10,Loyal Users
57529,109,14,139,4,3,4,11,Loyal Users
57617,541,9,12,2,2,1,5,Lost
57829,1245,5,7,2,1,1,4,Lost
57900,149,14,64,4,3,4,11,Loyal Users
57924,1426,7,10,1,2,1,4,Lost
57937,290,17,50,3,3,3,9,Loyal Users
58041,531,22,131,2,4,4,10,At Risk
58469,91,6,50,4,1,3,8,Promising
58860,80,76,178,4,5,5,14,Champions
59103,482,14,19,2,3,2,7,Casual Users
59151,1261,15,16,1,3,2,6,Casual Users
59228,615,14,105,2,3,4,9,Casual Users
59396,702,5,6,2,1,1,4,Lost
59481,278,22,26,3,4,2,9,Loyal Users
59605,664,22,93,2,4,4,10,At Risk
59670,132,12,39,4,3,3,10,Loyal Users
59684,31,81,319,5,5,5,15,Champions
61660,380,10,34,3,2,3,8,Casual Users
61922,2116,9,13,1,2,1,4,Lost
62157,454,10,31,3,2,2,7,Casual Users
62186,325,5,13,3,1,1,5,Casual Users
62561,11,151,380,5,5,5,15,Champions
62878,1122,6,13,2,1,1,4,Lost
63002,455,7,34,3,2,3,8,Casual Users
63063,328,36,64,3,4,4,11,Loyal Users
63078,895,6,10,2,1,1,4,Lost
63153,13,130,263,5,5,5,15,Champions
63340,152,19,28,4,3,2,9,Loyal Users
63474,148,95,178,4,5,5,14,Champions
63598,5,82,419,5,5,5,15,Champions
63633,713,7,9,2,2,1,5,Lost
63780,254,28,39,3,4,3,10,Loyal Users
64036,4375,5,5,1,1,1,3,Lost
64094,169,18,21,3,3,2,8,Loyal Users
64106,152,15,19,4,3,2,9,Loyal Users
64244,743,10,13,2,2,1,5,Lost
64653,87,29,149,4,4,5,13,Champions
64802,17,125,231,5,5,5,15,Champions
64834,109,72,402,4,5,5,14,Champions
64877,116,40,279,4,4,5,13,Champions
65109,702,22,79,2,4,4,10,At Risk
65399,366,21,56,3,3,3,9,Loyal Users
52539,71,10,100,4,2,4,10,Promising
52776,1811,17,22,1,3,2,6,Casual Users
52869,277,21,34,3,3,3,9,Loyal Users
52931,11,31,59,5,4,3,12,Loyal Users
52954,838,6,6,2,1,1,4,Lost
53330,52,41,111,5,4,4,13,Champions
53345,44,84,194,5,5,5,15,Champions
53412,410,6,13,3,1,1,5,Casual Users
54141,1372,14,68,1,3,4,8,Casual Users
54328,696,8,11,2,2,1,5,Lost
54347,98,85,308,4,5,5,14,Champions
54369,128,28,51,4,4,3,11,Loyal Users
54403,1233,6,64,2,1,4,7,Lost
54606,743,11,15,2,2,1,5,Lost
54753,119,9,23,4,2,2,8,Promising
55183,2417,9,31,1,2,2,5,Lost
55238,29,74,149,5,5,5,15,Champions
55520,412,14,21,3,3,2,8,Loyal Users
55627,804,11,100,2,2,4,8,Lost
55689,1706,11,25,1,2,2,5,Lost
55736,137,63,140,4,5,4,13,Champions
55746,5886,7,9,1,2,1,4,Lost
55781,1531,16,56,1,3,3,7,Casual Users
55873,1530,7,9,1,2,1,4,Lost
56619,103,65,228,4,5,5,14,Champions
56815,3877,7,23,1,2,2,5,Lost
56960,289,42,126,3,4,4,11,Loyal Users
57071,421,42,172,3,4,5,12,Loyal Users
57237,14,6,6,5,1,1,7,Promising
57915,70,77,424,4,5,5,14,Champions
57949,1397,9,16,1,2,2,5,Lost
58011,62,11,15,5,2,1,8,Promising
58015,112,41,136,4,4,4,12,Champions
58089,2,83,174,5,5,5,15,Champions
58218,231,83,329,3,5,5,13,Loyal Users
58368,577,8,8,2,2,1,5,Lost
58488,478,33,75,2,4,4,10,At Risk
58646,106,7,14,4,2,1,7,Promising
58738,450,16,67,3,3,4,10,Loyal Users
58741,187,108,251,3,5,5,13,Loyal Users
58755,1422,20,58,1,3,3,7,Casual Users
58929,284,34,72,3,4,4,11,Loyal Users
59433,82,25,102,4,4,4,12,Champions
59604,2777,5,5,1,1,1,3,Lost
59702,710,17,68,2,3,4,9,Casual Users
59770,261,6,10,3,1,1,5,Casual Users
59783,14,13,173,5,3,5,13,Loyal Users
60049,88,65,224,4,5,5,14,Champions
60085,292,35,182,3,4,5,12,Loyal Users
60190,412,12,41,3,3,3,9,Loyal Users
60537,23,35,80,5,4,4,13,Champions
61535,331,6,25,3,1,2,6,Casual Users
61754,658,8,66,2,2,4,8,Lost
61779,1080,7,16,2,2,2,6,Lost
62137,5,39,149,5,4,5,14,Champions
62146,139,7,15,4,2,1,7,Promising
62248,3544,10,30,1,2,2,5,Lost
62420,269,101,477,3,5,5,13,Loyal Users
62554,165,19,37,4,3,3,10,Loyal Users
62613,414,40,71,3,4,4,11,Loyal Users
62704,65,12,42,5,3,3,11,Loyal Users
62803,524,11,17,2,2,2,6,Lost
62886,427,35,53,3,4,3,10,Loyal Users
63168,981,20,49,2,3,3,8,Casual Users
63296,101,94,585,4,5,5,14,Champions
63391,248,22,35,3,4,3,10,Loyal Users
63674,278,44,89,3,4,4,11,Loyal Users
63698,5362,11,11,1,2,1,4,Lost
63755,3224,10,14,1,2,1,4,Lost
63954,127,7,13,4,2,1,7,Promising
64181,266,9,34,3,2,3,8,Casual Users
64195,51,24,51,5,4,3,12,Loyal Users
64216,444,11,26,3,2,2,7,Casual Users
64248,322,33,60,3,4,3,10,Loyal Users
64395,15,5,22,5,1,2,8,Promising
64641,50,147,759,5,5,5,15,Champions
64651,162,34,63,4,4,4,12,Champions
64724,937,22,93,2,4,4,10,At Risk
64729,2020,14,46,1,3,3,7,Casual Users
65026,1850,53,149,1,5,5,11,At Risk
65415,15,10,20,5,2,2,9,Promising
52450,1534,9,61,1,2,3,6,Lost
52592,3598,13,63,1,3,4,8,Casual Users
52857,119,124,279,4,5,5,14,Champions
52893,121,22,47,4,4,3,11,Loyal Users
52966,4041,5,6,1,1,1,3,Lost
53016,626,8,21,2,2,2,6,Lost
53066,2548,5,43,1,1,3,5,Lost
53111,3983,13,52,1,3,3,7,Casual Users
53800,1387,5,13,1,1,1,3,Lost
54156,337,112,271,3,5,5,13,Loyal Users
54674,158,14,24,4,3,2,9,Loyal Users
54945,292,33,42,3,4,3,10,Loyal Users
55105,1308,64,191,1,5,5,11,At Risk
55220,592,16,79,2,3,4,9,Casual Users
55526,32,87,587,5,5,5,15,Champions
55677,640,17,29,2,3,2,7,Casual Users
55716,2111,22,60,1,4,3,8,At Risk
56590,21,62,171,5,5,5,15,Champions
56946,146,7,42,4,2,3,9,Promising
57635,121,95,190,4,5,5,14,Champions
58542,1712,9,11,1,2,1,4,Lost
58660,4462,5,12,1,1,1,3,Lost
58705,480,15,23,2,3,2,7,Casual Users
59394,1488,6,24,1,1,2,4,Lost
59432,54,45,74,5,4,4,13,Champions
59768,120,6,8,4,1,1,6,Promising
59773,2020,19,24,1,3,2,6,Casual Users
60521,343,7,15,3,2,1,6,Casual Users
60701,2166,17,44,1,3,3,7,Casual Users
61095,148,18,42,4,3,3,10,Loyal Users
61150,125,8,9,4,2,1,7,Promising
61311,16,118,158,5,5,5,15,Champions
61533,1492,5,5,1,1,1,3,Lost
61854,120,21,36,4,3,3,10,Loyal Users
62284,1106,13,69,2,3,4,9,Casual Users
62405,1489,61,136,1,5,4,10,At Risk
62548,14,148,707,5,5,5,15,Champions
62686,851,12,19,2,3,2,7,Casual Users
62754,810,45,107,2,4,4,10,At Risk
62838,110,25,37,4,4,3,11,Loyal Users
63011,198,7,106,3,2,4,9,Casual Users
63802,85,30,41,4,4,3,11,Loyal Users
64086,1214,6,7,2,1,1,4,Lost
64155,425,11,14,3,2,1,6,Casual Users
64366,2860,7,11,1,2,1,4,Lost
64367,109,30,225,4,4,5,13,Champions
65017,714,6,9,2,1,1,4,Lost
65028,1521,20,112,1,3,4,8,Casual Users
52815,612,23,44,2,4,3,9,At Risk
52861,3008,7,7,1,2,1,4,Lost
52988,2478,7,17,1,2,2,5,Lost
53082,333,45,140,3,4,4,11,Loyal Users
53305,32,12,17,5,3,2,10,Loyal Users
53336,401,18,46,3,3,3,9,Loyal Users
53414,998,5,26,2,1,2,5,Lost
53602,91,41,108,4,4,4,12,Champions
53660,995,33,97,2,4,4,10,At Risk
53886,656,43,102,2,4,4,10,At Risk
54128,412,10,32,3,2,3,8,Casual Users
54176,4408,14,70,1,3,4,8,Casual Users
54462,2643,22,48,1,4,3,8,At Risk
55055,109,27,148,4,4,5,13,Champions
55417,79,35,99,4,4,4,12,Champions
55563,1290,5,17,1,1,2,4,Lost
56011,287,26,32,3,4,3,10,Loyal Users
56538,129,6,18,4,1,2,7,Promising
56730,969,25,59,2,4,3,9,At Risk
56910,1227,6,7,2,1,1,4,Lost
57152,257,38,65,3,4,4,11,Loyal Users
57188,700,18,68,2,3,4,9,Casual Users
57265,1,14,16,5,3,2,10,Loyal Users
57410,195,31,47,3,4,3,10,Loyal Users
57537,1836,33,60,1,4,3,8,At Risk
57554,79,88,347,4,5,5,14,Champions
57593,22,91,415,5,5,5,15,Champions
58003,242,5,7,3,1,1,5,Casual Users
58269,2253,14,31,1,3,2,6,Casual Users
58299,35,10,35,5,2,3,10,Promising
58746,256,27,63,3,4,4,11,Loyal Users
58780,462,21,75,3,3,4,10,Loyal Users
59212,27,35,174,5,4,5,14,Champions
59428,819,6,17,2,1,2,5,Lost
59517,388,8,31,3,2,2,7,Casual Users
59574,307,9,15,3,2,1,6,Casual Users
59908,15,70,212,5,5,5,15,Champions
59912,65,54,247,5,5,5,15,Champions
60373,119,17,67,4,3,4,11,Loyal Users
60386,1124,7,30,2,2,2,6,Lost
60595,1098,14,19,2,3,2,7,Casual Users
61380,303,8,26,3,2,2,7,Casual Users
61550,43,64,167,5,5,5,15,Champions
61580,142,11,86,4,2,4,10,Promising
62071,103,54,381,4,5,5,14,Champions
62169,2650,6,25,1,1,2,4,Lost
62214,2565,8,11,1,2,1,4,Lost
62245,141,15,44,4,3,3,10,Loyal Users
62272,688,7,19,2,2,2,6,Lost
62463,129,90,521,4,5,5,14,Champions
62659,1572,12,23,1,3,2,6,Casual Users
63020,10,8,28,5,2,2,9,Promising
63324,1285,10,15,1,2,1,4,Lost
63386,5,31,65,5,4,4,13,Champions
63607,1713,5,6,1,1,1,3,Lost
63915,29,55,287,5,5,5,15,Champions
64529,15,94,116,5,5,4,14,Champions
65180,165,6,17,4,1,2,7,Promising
52363,39,40,145,5,4,4,13,Champions
52789,676,12,136,2,3,4,9,Casual Users
52818,1326,5,10,1,1,1,3,Lost
53253,77,91,118,4,5,4,13,Champions
53425,1243,15,15,2,3,1,6,Casual Users
53802,116,55,201,4,5,5,14,Champions
53935,574,17,55,2,3,3,8,Casual Users
54115,521,9,26,2,2,2,6,Lost
54185,1083,14,44,2,3,3,8,Casual Users
54202,1959,5,5,1,1,1,3,Lost
54243,571,12,20,2,3,2,7,Casual Users
54407,128,59,190,4,5,5,14,Champions
55235,1126,13,24,2,3,2,7,Casual Users
55386,937,10,71,2,2,4,8,Lost
55452,0,42,110,5,4,4,13,Champions
55516,93,14,23,4,3,2,9,Loyal Users
55583,2997,5,10,1,1,1,3,Lost
55804,30,18,69,5,3,4,12,Loyal Users
56420,1968,6,34,1,1,3,5,Lost
56489,56,13,16,5,3,2,10,Loyal Users
56591,290,67,102,3,5,4,12,Loyal Users
57093,20,71,203,5,5,5,15,Champions
57172,317,22,34,3,4,3,10,Loyal Users
57208,138,12,19,4,3,2,9,Loyal Users
57470,116,28,74,4,4,4,12,Champions
57648,174,75,192,3,5,5,13,Loyal Users
57653,450,6,14,3,1,1,5,Casual Users
58340,133,67,262,4,5,5,14,Champions
58458,17,25,150,5,4,5,14,Champions
58528,0,36,159,5,4,5,14,Champions
58619,133,26,43,4,4,3,11,Loyal Users
58739,1975,7,22,1,2,2,5,Lost
58968,25,56,143,5,5,4,14,Champions
58986,238,37,268,3,4,5,12,Loyal Users
59255,700,13,33,2,3,3,8,Casual Users
59706,2272,8,19,1,2,2,5,Lost
60057,4,14,39,5,3,3,11,Loyal Users
60110,421,8,10,3,2,1,6,Casual Users
60281,2118,9,39,1,2,3,6,Lost
60448,135,72,91,4,5,4,13,Champions
60560,942,6,24,2,1,2,5,Lost
60587,113,62,235,4,5,5,14,Champions
60779,31,51,76,5,5,4,14,Champions
60940,0,52,91,5,5,4,14,Champions
60976,116,50,120,4,5,4,13,Champions
61105,32,23,142,5,4,4,13,Champions
61506,1,91,279,5,5,5,15,Champions
61641,225,31,80,3,4,4,11,Loyal Users
61900,18,48,83,5,5,4,14,Champions
62079,1411,34,155,1,4,5,10,At Risk
62156,17,91,305,5,5,5,15,Champions
62184,124,27,62,4,4,3,11,Loyal Users
62187,93,130,441,4,5,5,14,Champions
62396,1667,6,8,1,1,1,3,Lost
62437,17,28,118,5,4,4,13,Champions
62574,210,96,213,3,5,5,13,Loyal Users
62857,298,45,62,3,4,3,10,Loyal Users
62942,154,38,85,4,4,4,12,Champions
63009,11,55,271,5,5,5,15,Champions
63175,1498,37,275,1,4,5,10,At Risk
63680,16,58,188,5,5,5,15,Champions
63894,943,6,39,2,1,3,6,Lost
63908,1246,9,28,2,2,2,6,Lost
63957,221,73,103,3,5,4,12,Loyal Users
64077,435,31,40,3,4,3,10,Loyal Users
64343,111,129,473,4,5,5,14,Champions
64591,490,28,56,2,4,3,9,At Risk
64683,1294,10,11,1,2,1,4,Lost
64769,92,11,16,4,2,2,8,Promising
64857,172,37,346,3,4,5,12,Loyal Users
65327,101,59,108,4,5,4,13,Champions
52409,364,17,37,3,3,3,9,Loyal Users
52609,1626,14,36,1,3,3,7,Casual Users
52669,48,80,396,5,5,5,15,Champions
53508,100,89,387,4,5,5,14,Champions
53556,234,13,28,3,3,2,8,Loyal Users
53817,403,42,148,3,4,5,12,Loyal Users
54075,130,27,72,4,4,4,12,Champions
54086,96,108,500,4,5,5,14,Champions
54472,2513,97,173,1,5,5,11,At Risk
55271,4478,14,27,1,3,2,6,Casual Users
55330,590,32,75,2,4,4,10,At Risk
55447,14,98,481,5,5,5,15,Champions
55505,2025,9,13,1,2,1,4,Lost
55643,1,7,13,5,2,1,8,Promising
55934,338,6,20,3,1,2,6,Casual Users
55968,271,19,40,3,3,3,9,Loyal Users
56234,2052,6,6,1,1,1,3,Lost
56248,1552,14,24,1,3,2,6,Casual Users
56369,13,68,139,5,5,4,14,Champions
56519,495,11,17,2,2,2,6,Lost
57083,2086,5,11,1,1,1,3,Lost
57120,1699,26,103,1,4,4,9,At Risk
57680,0,83,626,5,5,5,15,Champions
58295,208,24,42,3,4,3,10,Loyal Users
58530,1558,7,16,1,2,2,5,Lost
58549,1076,21,76,2,3,4,9,Casual Users
58620,188,14,26,3,3,2,8,Loyal Users
58632,7,83,279,5,5,5,15,Champions
58714,1294,8,21,1,2,2,5,Lost
58715,713,13,34,2,3,3,8,Casual Users
59158,988,18,26,2,3,2,7,Casual Users
59313,423,15,32,3,3,3,9,Loyal Users
59323,149,12,15,4,3,1,8,Loyal Users
59343,874,46,312,2,5,5,12,At Risk
59429,753,13,15,2,3,1,6,Casual Users
59902,284,12,39,3,3,3,9,Loyal Users
59995,539,6,29,2,1,2,5,Lost
60098,189,112,185,3,5,5,13,Loyal Users
60288,240,8,106,3,2,4,9,Casual Users
60296,134,6,6,4,1,1,6,Promising
60489,244,7,14,3,2,1,6,Casual Users
60529,94,5,7,4,1,1,6,Promising
60680,68,115,303,5,5,5,15,Champions
60691,70,70,320,4,5,5,14,Champions
61069,566,6,8,2,1,1,4,Lost
61343,407,5,7,3,1,1,5,Casual Users
61648,119,5,8,4,1,1,6,Promising
61705,6,130,201,5,5,5,15,Champions
61752,3585,8,9,1,2,1,4,Lost
61849,423,6,10,3,1,1,5,Casual Users
61955,694,19,72,2,3,4,9,Casual Users
61959,174,21,93,3,3,4,10,Loyal Users
62136,2985,11,14,1,2,1,4,Lost
62365,8,14,74,5,3,4,12,Loyal Users
62425,368,57,210,3,5,5,13,Loyal Users
62630,242,56,101,3,5,4,12,Loyal Users
62925,113,51,113,4,5,4,13,Champions
63047,2991,6,17,1,1,2,4,Lost
63609,822,10,33,2,2,3,7,Lost
64034,1,82,468,5,5,5,15,Champions
64322,1048,10,23,2,2,2,6,Lost
64355,388,88,312,3,5,5,13,Loyal Users
64511,17,174,471,5,5,5,15,Champions
64638,415,6,7,3,1,1,5,Casual Users
64941,92,61,181,4,5,5,14,Champions
64949,1947,16,25,1,3,2,6,Casual Users
52389,2704,7,12,1,2,1,4,Lost
53384,82,23,79,4,4,4,12,Champions
53555,1077,10,15,2,2,1,5,Lost
54294,11,26,70,5,4,4,13,Champions
54775,3,49,73,5,5,4,14,Champions
54913,72,63,97,4,5,4,13,Champions
55054,329,18,26,3,3,2,8,Loyal Users
55241,7,38,63,5,4,4,13,Champions
55768,1988,6,18,1,1,2,4,Lost
55954,564,5,6,2,1,1,4,Lost
56713,137,42,155,4,4,5,13,Champions
56830,25,74,257,5,5,5,15,Champions
56892,147,15,146,4,3,4,11,Loyal Users
58303,153,27,51,4,4,3,11,Loyal Users
59021,627,11,17,2,2,2,6,Lost
59468,5652,5,5,1,1,1,3,Lost
59714,263,7,21,3,2,2,7,Casual Users
60124,261,23,97,3,4,4,11,Loyal Users
60240,129,39,102,4,4,4,12,Champions
60801,785,7,20,2,2,2,6,Lost
60971,85,20,62,4,3,3,10,Loyal Users
60996,165,37,60,4,4,3,11,Loyal Users
61121,428,15,31,3,3,2,8,Loyal Users
61269,151,30,54,4,4,3,11,Loyal Users
61589,30,40,72,5,4,4,13,Champions
61884,32,21,59,5,3,3,11,Loyal Users
62287,41,77,259,5,5,5,15,Champions
62506,54,54,172,5,5,5,15,Champions
62978,1431,5,25,1,1,2,4,Lost
63217,1997,11,14,1,2,1,4,Lost
64281,805,5,7,2,1,1,4,Lost
64821,120,72,113,4,5,4,13,Champions
65294,352,37,89,3,4,4,11,Loyal Users
52404,126,66,150,4,5,5,14,Champions
52405,304,5,24,3,1,2,6,Casual Users
52549,581,17,121,2,3,4,9,Casual Users
52568,165,33,47,4,4,3,11,Loyal Users
52600,327,45,70,3,4,4,11,Loyal Users
52720,120,5,9,4,1,1,6,Promising
52737,81,19,24,4,3,2,9,Loyal Users
52743,247,24,139,3,4,4,11,Loyal Users
53271,65,17,24,5,3,2,10,Loyal Users
53357,419,11,28,3,2,2,7,Casual Users
54109,117,22,50,4,4,3,11,Loyal Users
54147,502,8,30,2,2,2,6,Lost
54416,135,15,57,4,3,3,10,Loyal Users
54665,139,24,66,4,4,4,12,Champions
54915,110,79,91,4,5,4,13,Champions
55137,115,24,30,4,4,2,10,Loyal Users
55513,0,117,264,5,5,5,15,Champions
55814,2824,7,7,1,2,1,4,Lost
56013,850,29,105,2,4,4,10,At Risk
56122,1392,25,31,1,4,2,7,At Risk
56124,37,29,71,5,4,4,13,Champions
56499,111,31,144,4,4,4,12,Champions
56556,369,8,17,3,2,2,7,Casual Users
56771,1646,6,26,1,1,2,4,Lost
56810,451,7,11,3,2,1,6,Casual Users
57404,3562,13,22,1,3,2,6,Casual Users
57745,556,5,6,2,1,1,4,Lost
57787,1101,17,145,2,3,4,9,Casual Users
58027,111,88,158,4,5,5,14,Champions
58317,1351,7,8,1,2,1,4,Lost
58699,116,20,154,4,3,5,12,Loyal Users
58826,62,60,161,5,5,5,15,Champions
58966,91,9,17,4,2,2,8,Promising
59230,2,13,24,5,3,2,10,Loyal Users
59254,1,96,367,5,5,5,15,Champions
59776,16,8,24,5,2,2,9,Promising
59952,2749,5,8,1,1,1,3,Lost
60860,2140,17,33,1,3,3,7,Casual Users
61119,285,9,11,3,2,1,6,Casual Users
61423,26,101,389,5,5,5,15,Champions
61518,216,89,221,3,5,5,13,Loyal Users
61832,20,57,81,5,5,4,14,Champions
61887,33,42,219,5,4,5,14,Champions
62188,2782,5,10,1,1,1,3,Lost
62367,4888,6,11,1,1,1,3,Lost
63472,85,45,333,4,4,5,13,Champions
63475,430,10,18,3,2,2,7,Casual Users
63662,924,5,37,2,1,3,6,Lost
64013,84,43,61,4,4,3,11,Loyal Users
64092,8,38,106,5,4,4,13,Champions
64227,28,8,14,5,2,1,8,Promising
64767,266,15,40,3,3,3,9,Loyal Users
64947,393,43,241,3,4,5,12,Loyal Users
65023,205,5,9,3,1,1,5,Casual Users
65266,69,86,455,5,5,5,15,Champions
65332,2978,6,26,1,1,2,4,Lost
65352,123,37,63,4,4,4,12,Champions
52417,120,10,69,4,2,4,10,Promising
52924,85,39,89,4,4,4,12,Champions
53245,433,25,38,3,4,3,10,Loyal Users
53289,238,10,30,3,2,2,7,Casual Users
53335,987,14,18,2,3,2,7,Casual Users
53560,113,34,110,4,4,4,12,Champions
53653,973,6,17,2,1,2,5,Lost
53744,2,6,7,5,1,1,7,Promising
53785,126,8,20,4,2,2,8,Promising
53998,1116,88,260,2,5,5,12,At Risk
54006,149,18,44,4,3,3,10,Loyal Users
54275,6,63,252,5,5,5,15,Champions
54430,893,110,417,2,5,5,12,At Risk
54651,23,30,69,5,4,4,13,Champions
54877,161,26,75,4,4,4,12,Champions
54999,1415,7,12,1,2,1,4,Lost
55078,1268,24,56,1,4,3,8,At Risk
55178,518,11,26,2,2,2,6,Lost
55359,397,85,155,3,5,5,13,Loyal Users
55554,37,21,65,5,3,4,12,Loyal Users
55589,130,9,21,4,2,2,8,Promising
55733,29,5,16,5,1,2,8,Promising
55759,6,36,155,5,4,5,14,Champions
55845,3,106,294,5,5,5,15,Champions
56706,288,57,140,3,5,4,12,Loyal Users
57860,4747,10,24,1,2,2,5,Lost
58108,1456,7,16,1,2,2,5,Lost
58190,134,20,41,4,3,3,10,Loyal Users
58396,110,114,246,4,5,5,14,Champions
58514,44,141,578,5,5,5,15,Champions
58637,2038,8,20,1,2,2,5,Lost
58794,26,92,295,5,5,5,15,Champions
59050,1128,12,101,2,3,4,9,Casual Users
59226,121,9,34,4,2,3,9,Promising
59643,62,28,63,5,4,4,13,Champions
59765,423,41,104,3,4,4,11,Loyal Users
59846,4,117,274,5,5,5,15,Champions
59888,1398,9,19,1,2,2,5,Lost
60071,1876,5,5,1,1,1,3,Lost
60166,47,23,42,5,4,3,12,Loyal Users
60619,84,33,192,4,4,5,13,Champions
61110,49,35,52,5,4,3,12,Loyal Users
61387,35,51,123,5,5,4,14,Champions
61476,326,7,7,3,2,1,6,Casual Users
61633,590,54,198,2,5,5,12,At Risk
61719,6,13,18,5,3,2,10,Loyal Users
62226,3598,5,6,1,1,1,3,Lost
62494,20,86,326,5,5,5,15,Champions
62594,102,64,216,4,5,5,14,Champions
62747,115,30,54,4,4,3,11,Loyal Users
62888,412,38,52,3,4,3,10,Loyal Users
63132,125,117,155,4,5,5,14,Champions
63514,124,11,21,4,2,2,8,Promising
63540,236,14,30,3,3,2,8,Loyal Users
63942,281,11,43,3,2,3,8,Casual Users
64356,571,35,125,2,4,4,10,At Risk
64846,452,54,153,3,5,5,13,Loyal Users
65167,130,60,161,4,5,5,14,Champions
65194,103,109,574,4,5,5,14,Champions
52867,606,9,16,2,2,2,6,Lost
52990,352,5,13,3,1,1,5,Casual Users
53101,170,41,72,3,4,4,11,Loyal Users
53851,777,11,48,2,2,3,7,Lost
53943,36,56,186,5,5,5,15,Champions
53973,293,13,58,3,3,3,9,Loyal Users
54035,19,39,170,5,4,5,14,Champions
54280,120,61,99,4,5,4,13,Champions
54322,13,135,551,5,5,5,15,Champions
54367,105,50,323,4,5,5,14,Champions
54423,542,28,99,2,4,4,10,At Risk
54580,250,35,71,3,4,4,11,Loyal Users
54757,755,17,70,2,3,4,9,Casual Users
55436,99,15,29,4,3,2,9,Loyal Users
55439,215,39,147,3,4,5,12,Loyal Users
55540,3280,5,8,1,1,1,3,Lost
55712,4,74,614,5,5,5,15,Champions
56311,2113,13,58,1,3,3,7,Casual Users
56459,39,26,109,5,4,4,13,Champions
56772,3110,5,10,1,1,1,3,Lost
56798,288,29,108,3,4,4,11,Loyal Users
57356,2276,6,17,1,1,2,4,Lost
57629,991,5,5,2,1,1,4,Lost
57642,283,18,42,3,3,3,9,Loyal Users
57706,3711,5,14,1,1,1,3,Lost
58017,14,14,58,5,3,3,11,Loyal Users
58320,1580,35,83,1,4,4,9,At Risk
58428,1499,8,28,1,2,2,5,Lost
58841,603,8,24,2,2,2,6,Lost
58845,398,12,20,3,3,2,8,Loyal Users
58889,5,76,302,5,5,5,15,Champions
59069,190,36,57,3,4,3,10,Loyal Users
59109,662,22,48,2,4,3,9,At Risk
59137,282,5,25,3,1,2,6,Casual Users
59328,122,11,15,4,2,1,7,Promising
59379,11,72,324,5,5,5,15,Champions
60070,56,43,223,5,4,5,14,Champions
60672,2456,8,21,1,2,2,5,Lost
60929,412,6,10,3,1,1,5,Casual Users
61138,2585,6,29,1,1,2,4,Lost
61143,1623,5,10,1,1,1,3,Lost
61334,2123,10,13,1,2,1,4,Lost
61455,441,10,18,3,2,2,7,Casual Users
61811,2112,8,16,1,2,2,5,Lost
61902,0,48,106,5,5,4,14,Champions
62013,2837,29,58,1,4,3,8,At Risk
62068,1788,5,33,1,1,3,5,Lost
62340,98,39,125,4,4,4,12,Champions
62507,127,85,134,4,5,4,13,Champions
62745,1090,31,202,2,4,5,11,At Risk
62905,2005,5,5,1,1,1,3,Lost
62911,20,77,114,5,5,4,14,Champions
62983,0,74,503,5,5,5,15,Champions
64043,130,83,175,4,5,5,14,Champions
64272,88,32,127,4,4,4,12,Champions
64441,486,17,19,2,3,2,7,Casual Users
65091,840,7,9,2,2,1,5,Lost
65097,95,10,16,4,2,2,8,Promising
65210,0,9,81,5,2,4,11,Promising
65277,10,6,17,5,1,2,8,Promising
52420,2,75,118,5,5,4,14,Champions
52707,22,49,102,5,5,4,14,Champions
52788,1086,9,12,2,2,1,5,Lost
52803,3103,7,11,1,2,1,4,Lost
52935,308,7,12,3,2,1,6,Casual Users
53160,126,27,32,4,4,3,11,Loyal Users
53238,3680,10,10,1,2,1,4,Lost
53379,105,61,94,4,5,4,13,Champions
53483,272,50,95,3,5,4,12,Loyal Users
53559,955,6,18,2,1,2,5,Lost
53633,126,12,89,4,3,4,11,Loyal Users
54153,7,60,223,5,5,5,15,Champions
54236,51,38,113,5,4,4,13,Champions
54596,1283,15,64,1,3,4,8,Casual Users
54854,533,36,44,2,4,3,9,At Risk
55332,520,9,29,2,2,2,6,Lost
56027,1398,8,16,1,2,2,5,Lost
56132,4034,5,19,1,1,2,4,Lost
56140,69,46,78,5,5,4,14,Champions
56573,60,6,9,5,1,1,7,Promising
56913,68,17,88,5,3,4,12,Loyal Users
57017,402,64,81,3,5,4,12,Loyal Users
57018,57,119,661,5,5,5,15,Champions
57084,236,12,33,3,3,3,9,Loyal Users
57154,129,133,371,4,5,5,14,Champions
57341,18,217,414,5,5,5,15,Champions
57610,1070,5,14,2,1,1,4,Lost
57613,110,25,41,4,4,3,11,Loyal Users
57764,752,30,89,2,4,4,10,At Risk
57789,113,63,184,4,5,5,14,Champions
57864,407,26,73,3,4,4,11,Loyal Users
57993,88,14,20,4,3,2,9,Loyal Users
58324,2514,6,17,1,1,2,4,Lost
59386,109,5,10,4,1,1,6,Promising
59933,854,7,11,2,2,1,5,Lost
60069,165,22,39,4,4,3,11,Loyal Users
60087,1609,6,23,1,1,2,4,Lost
60462,22,84,588,5,5,5,15,Champions
60781,2436,7,7,1,2,1,4,Lost
60822,173,16,26,3,3,2,8,Loyal Users
60849,50,94,303,5,5,5,15,Champions
61019,501,9,22,2,2,2,6,Lost
61322,1690,8,110,1,2,4,7,Lost
61466,425,25,38,3,4,3,10,Loyal Users
61791,3743,5,6,1,1,1,3,Lost
62035,3426,11,18,1,2,2,5,Lost
62319,112,16,201,4,3,5,12,Loyal Users
62597,120,108,184,4,5,5,14,Champions
62638,426,23,66,3,4,4,11,Loyal Users
62711,1562,8,11,1,2,1,4,Lost
62732,2693,7,30,1,2,2,5,Lost
62846,974,9,11,2,2,1,5,Lost
62963,2980,9,19,1,2,2,5,Lost
63026,13,12,41,5,3,3,11,Loyal Users
63754,95,11,15,4,2,1,7,Promising
63838,526,14,24,2,3,2,7,Casual Users
63943,432,8,18,3,2,2,7,Casual Users
64028,30,23,73,5,4,4,13,Champions
64051,645,45,66,2,4,4,10,At Risk
64151,276,17,32,3,3,3,9,Loyal Users
64377,2163,29,200,1,4,5,10,At Risk
65068,964,9,17,2,2,2,6,Lost
65114,2850,5,7,1,1,1,3,Lost
65116,74,92,284,4,5,5,14,Champions
52401,138,8,29,4,2,2,8,Promising
52528,1268,11,13,1,2,1,4,Lost
52823,625,8,10,2,2,1,5,Lost
53307,417,42,92,3,4,4,11,Loyal Users
53432,363,79,144,3,5,4,12,Loyal Users
53450,14,9,69,5,2,4,11,Promising
53656,411,5,14,3,1,1,5,Casual Users
53895,254,32,94,3,4,4,11,Loyal Users
54005,1674,9,9,1,2,1,4,Lost
54017,2708,13,37,1,3,3,7,Casual Users
54076,84,50,128,4,5,4,13,Champions
54292,175,15,104,3,3,4,10,Loyal Users
54394,1656,21,36,1,3,3,7,Casual Users
54408,137,48,306,4,5,5,14,Champions
54517,258,5,10,3,1,1,5,Casual Users
54669,1,74,268,5,5,5,15,Champions
54812,4873,26,63,1,4,4,9,At Risk
54828,3,63,302,5,5,5,15,Champions
54857,5010,5,10,1,1,1,3,Lost
54917,1407,8,12,1,2,1,4,Lost
55038,269,38,202,3,4,5,12,Loyal Users
55065,422,5,30,3,1,2,6,Casual Users
55433,274,14,52,3,3,3,9,Loyal Users
55551,151,109,180,4,5,5,14,Champions
55582,3,43,121,5,4,4,13,Champions
55717,78,48,131,4,5,4,13,Champions
56315,118,12,43,4,3,3,10,Loyal Users
56331,130,79,283,4,5,5,14,Champions
56430,5,91,127,5,5,4,14,Champions
56650,1398,14,18,1,3,2,6,Casual Users
56964,123,86,299,4,5,5,14,Champions
56976,1828,7,59,1,2,3,6,Lost
56980,499,68,248,2,5,5,12,At Risk
57258,194,42,183,3,4,5,12,Loyal Users
57763,1470,10,18,1,2,2,5,Lost
58170,369,19,28,3,3,2,8,Loyal Users
58184,3516,5,8,1,1,1,3,Lost
58235,126,13,22,4,3,2,9,Loyal Users
58349,9,103,239,5,5,5,15,Champions
58350,3284,6,27,1,1,2,4,Lost
58454,76,9,22,4,2,2,8,Promising
58497,2133,5,22,1,1,2,4,Lost
58767,4857,8,13,1,2,1,4,Lost
58833,829,9,39,2,2,3,7,Lost
58893,2605,7,9,1,2,1,4,Lost
59013,711,14,65,2,3,4,9,Casual Users
59231,274,18,53,3,3,3,9,Loyal Users
59625,112,32,106,4,4,4,12,Champions
59919,293,25,51,3,4,3,10,Loyal Users
59972,289,24,33,3,4,3,10,Loyal Users
59976,72,88,331,4,5,5,14,Champions
60186,669,6,22,2,1,2,5,Lost
60265,574,8,29,2,2,2,6,Lost
60486,8,24,64,5,4,4,13,Champions
60876,3430,8,12,1,2,1,4,Lost
60959,1877,8,18,1,2,2,5,Lost
60977,190,12,31,3,3,2,8,Loyal Users
61025,886,5,5,2,1,1,4,Lost
61291,160,46,148,4,5,5,14,Champions
61397,403,10,18,3,2,2,7,Casual Users
61521,54,6,7,5,1,1,7,Promising
61747,117,67,134,4,5,4,13,Champions
62110,392,10,24,3,2,2,7,Casual Users
62232,420,15,29,3,3,2,8,Loyal Users
62238,1208,9,12,2,2,1,5,Lost
62529,1312,17,84,1,3,4,8,Casual Users
62572,422,9,39,3,2,3,8,Casual Users
62637,37,120,657,5,5,5,15,Champions
62678,969,6,9,2,1,1,4,Lost
62703,69,8,8,5,2,1,8,Promising
62992,532,15,160,2,3,5,10,Casual Users
63185,1564,34,125,1,4,4,9,At Risk
63194,122,120,309,4,5,5,14,Champions
63278,1847,7,15,1,2,1,4,Lost
63795,1530,10,36,1,2,3,6,Lost
63859,1564,5,8,1,1,1,3,Lost
64068,12,57,89,5,5,4,14,Champions
64152,861,47,169,2,5,5,12,At Risk
64482,115,40,71,4,4,4,12,Champions
64578,852,5,6,2,1,1,4,Lost
64760,33,7,50,5,2,3,10,Promising
64890,783,13,38,2,3,3,8,Casual Users
65034,263,8,19,3,2,2,7,Casual Users
65398,2,77,118,5,5,4,14,Champions
52543,575,24,50,2,4,3,9,At Risk
52684,4671,20,85,1,3,4,8,Casual Users
52735,977,32,64,2,4,4,10,At Risk
52736,432,60,442,3,5,5,13,Loyal Users
52837,8,6,6,5,1,1,7,Promising
53420,155,9,52,4,2,3,9,Promising
53694,79,7,10,4,2,1,7,Promising
53709,239,50,131,3,5,4,12,Loyal Users
54045,509,13,132,2,3,4,9,Casual Users
54182,988,13,47,2,3,3,8,Casual Users
54259,114,36,96,4,4,4,12,Champions
54841,972,18,33,2,3,3,8,Casual Users
55069,4984,13,23,1,3,2,6,Casual Users
55095,97,126,218,4,5,5,14,Champions
55205,155,34,41,4,4,3,11,Loyal Users
55276,836,18,69,2,3,4,9,Casual Users
55288,165,89,133,4,5,4,13,Champions
55293,115,12,62,4,3,3,10,Loyal Users
55633,1731,34,91,1,4,4,9,At Risk
55783,889,5,14,2,1,1,4,Lost
56074,2727,12,16,1,3,2,6,Casual Users
56208,1261,30,108,1,4,4,9,At Risk
56513,459,6,11,3,1,1,5,Casual Users
56955,386,103,342,3,5,5,13,Loyal Users
57067,8,54,201,5,5,5,15,Champions
57075,39,22,36,5,4,3,12,Loyal Users
57151,10,108,380,5,5,5,15,Champions
57684,146,66,250,4,5,5,14,Champions
57838,135,13,33,4,3,3,10,Loyal Users
58126,856,12,15,2,3,1,6,Casual Users
58216,1732,28,89,1,4,4,9,At Risk
58217,260,43,171,3,4,5,12,Loyal Users
58292,706,12,17,2,3,2,7,Casual Users
58313,295,7,11,3,2,1,6,Casual Users
58377,136,54,83,4,5,4,13,Champions
58824,91,32,90,4,4,4,12,Champions
58855,1412,38,111,1,4,4,9,At Risk
59556,507,5,29,2,1,2,5,Lost
59646,44,18,33,5,3,3,11,Loyal Users
59784,284,35,99,3,4,4,11,Loyal Users
59901,0,100,208,5,5,5,15,Champions
60116,119,48,241,4,5,5,14,Champions
60221,1587,42,64,1,4,4,9,At Risk
60230,4,67,96,5,5,4,14,Champions
60948,384,7,17,3,2,2,7,Casual Users
60987,214,7,9,3,2,1,6,Casual Users
61290,406,18,34,3,3,3,9,Loyal Users
61310,3440,6,7,1,1,1,3,Lost
61420,2567,7,27,1,2,2,5,Lost
61432,1105,8,31,2,2,2,6,Lost
61567,76,18,140,4,3,4,11,Loyal Users
61731,365,21,48,3,3,3,9,Loyal Users
61799,1291,68,167,1,5,5,11,At Risk
62615,186,15,27,3,3,2,8,Loyal Users
62701,794,9,34,2,2,3,7,Lost
62804,413,21,45,3,3,3,9,Loyal Users
62861,2562,15,47,1,3,3,7,Casual Users
62868,0,23,85,5,4,4,13,Champions
62967,132,59,97,4,5,4,13,Champions
63131,1796,28,47,1,4,3,8,At Risk
63177,97,133,437,4,5,5,14,Champions
63506,122,32,56,4,4,3,11,Loyal Users
63749,8,22,43,5,4,3,12,Loyal Users
63918,8,63,89,5,5,4,14,Champions
64026,543,10,19,2,2,2,6,Lost
64537,225,29,97,3,4,4,11,Loyal Users
64817,413,26,45,3,4,3,10,Loyal Users
65282,3800,58,149,1,5,5,11,At Risk
52413,107,7,18,4,2,2,8,Promising
52515,148,8,51,4,2,3,9,Promising
52680,1977,10,17,1,2,2,5,Lost
53094,1299,6,10,1,1,1,3,Lost
53136,253,46,68,3,5,4,12,Loyal Users
53272,4410,7,13,1,2,1,4,Lost
53770,308,7,53,3,2,3,8,Casual Users
53791,116,58,301,4,5,5,14,Champions
53887,3977,6,13,1,1,1,3,Lost
53971,2,190,771,5,5,5,15,Champions
54117,32,152,443,5,5,5,15,Champions
54274,676,28,88,2,4,4,10,At Risk
54918,4716,9,30,1,2,2,5,Lost
54924,237,43,104,3,4,4,11,Loyal Users
55067,94,16,39,4,3,3,10,Loyal Users
55076,70,54,118,4,5,4,13,Champions
55567,968,9,20,2,2,2,6,Lost
55592,1386,5,5,1,1,1,3,Lost
55679,446,5,27,3,1,2,6,Casual Users
55688,537,8,12,2,2,1,5,Lost
55769,3141,9,31,1,2,2,5,Lost
55997,1127,6,6,2,1,1,4,Lost
56023,271,8,19,3,2,2,7,Casual Users
56365,844,6,8,2,1,1,4,Lost
56402,1724,45,84,1,4,4,9,At Risk
56494,120,12,39,4,3,3,10,Loyal Users
56763,18,117,986,5,5,5,15,Champions
56842,37,15,35,5,3,3,11,Loyal Users
56926,233,16,36,3,3,3,9,Loyal Users
57108,536,18,30,2,3,2,7,Casual Users
57447,3,101,439,5,5,5,15,Champions
57538,543,9,20,2,2,2,6,Lost
57703,2275,7,17,1,2,2,5,Lost
57714,127,62,428,4,5,5,14,Champions
57780,379,28,46,3,4,3,10,Loyal Users
58159,3685,6,11,1,1,1,3,Lost
58519,1429,13,15,1,3,1,5,Casual Users
58562,402,31,103,3,4,4,11,Loyal Users
58563,9,15,29,5,3,2,10,Loyal Users
58809,250,58,216,3,5,5,13,Loyal Users
59242,2021,5,6,1,1,1,3,Lost
59261,1065,10,22,2,2,2,6,Lost
59320,161,9,21,4,2,2,8,Promising
59804,5,12,18,5,3,2,10,Loyal Users
59905,1267,9,13,1,2,1,4,Lost
60059,124,48,55,4,5,3,12,Loyal Users
60106,102,22,226,4,4,5,13,Champions
60211,14,40,137,5,4,4,13,Champions
60387,3,40,87,5,4,4,13,Champions
60429,156,50,61,4,5,3,12,Loyal Users
60478,38,18,43,5,3,3,11,Loyal Users
60611,1114,24,30,2,4,2,8,At Risk
61207,243,10,60,3,2,3,8,Casual Users
61428,398,7,29,3,2,2,7,Casual Users
61822,441,23,56,3,4,3,10,Loyal Users
61963,1842,7,19,1,2,2,5,Lost
62067,639,8,20,2,2,2,6,Lost
62191,2651,5,8,1,1,1,3,Lost
62262,150,35,175,4,4,5,13,Champions
62288,137,24,62,4,4,3,11,Loyal Users
62834,72,9,39,4,2,3,9,Promising
63275,1049,54,269,2,5,5,12,At Risk
63380,48,90,355,5,5,5,15,Champions
63443,246,12,21,3,3,2,8,Loyal Users
63810,11,53,236,5,5,5,15,Champions
64093,915,8,25,2,2,2,6,Lost
64344,1450,10,78,1,2,4,7,Lost
64743,2653,7,54,1,2,3,6,Lost
64766,182,20,38,3,3,3,9,Loyal Users
65177,245,31,53,3,4,3,10,Loyal Users
52493,142,5,8,4,1,1,6,Promising
52887,563,7,19,2,2,2,6,Lost
52956,153,80,191,4,5,5,14,Champions
53087,6,32,410,5,4,5,14,Champions
53125,1154,20,41,2,3,3,8,Casual Users
53254,411,6,6,3,1,1,5,Casual Users
53429,11,26,53,5,4,3,12,Loyal Users
53579,3,89,272,5,5,5,15,Champions
53853,124,26,262,4,4,5,13,Champions
54279,3,22,61,5,4,3,12,Loyal Users
54295,104,18,42,4,3,3,10,Loyal Users
54373,126,18,27,4,3,2,9,Loyal Users
54468,0,14,39,5,3,3,11,Loyal Users
54557,2571,9,9,1,2,1,4,Lost
54929,252,69,94,3,5,4,12,Loyal Users
55267,1738,12,60,1,3,3,7,Casual Users
55457,516,49,120,2,5,4,11,At Risk
55926,155,37,170,4,4,5,13,Champions
56282,167,47,169,3,5,5,13,Loyal Users
56313,241,6,19,3,1,2,6,Casual Users
56413,679,18,63,2,3,4,9,Casual Users
56777,665,39,66,2,4,4,10,At Risk
57196,1172,14,26,2,3,2,7,Casual Users
57206,10,39,70,5,4,4,13,Champions
57248,78,55,122,4,5,4,13,Champions
57425,1862,20,65,1,3,4,8,Casual Users
57572,1417,5,5,1,1,1,3,Lost
57603,1774,6,19,1,1,2,4,Lost
57634,1187,8,11,2,2,1,5,Lost
57756,2454,6,19,1,1,2,4,Lost
57976,7,35,154,5,4,5,14,Champions
58079,4,19,44,5,3,3,11,Loyal Users
58132,693,57,141,2,5,4,11,At Risk
58135,1743,8,19,1,2,2,5,Lost
58515,3700,5,7,1,1,1,3,Lost
58566,233,85,354,3,5,5,13,Loyal Users
58603,84,6,22,4,1,2,7,Promising
58663,358,5,10,3,1,1,5,Casual Users
58664,3260,12,29,1,3,2,6,Casual Users
58834,568,41,60,2,4,3,9,At Risk
59284,726,5,12,2,1,1,4,Lost
59340,448,70,119,3,5,4,12,Loyal Users
59376,1970,5,6,1,1,1,3,Lost
59738,683,5,5,2,1,1,4,Lost
59842,43,28,92,5,4,4,13,Champions
59889,1120,22,85,2,4,4,10,At Risk
59895,13,12,15,5,3,1,9,Loyal Users
60002,29,13,251,5,3,5,13,Loyal Users
60076,754,13,24,2,3,2,7,Casual Users
60348,1216,5,5,2,1,1,4,Lost
60362,1123,7,7,2,2,1,5,Lost
60466,435,9,21,3,2,2,7,Casual Users
60495,287,6,14,3,1,1,5,Casual Users
60648,435,16,25,3,3,2,8,Loyal Users
60657,395,11,12,3,2,1,6,Casual Users
60919,2099,7,54,1,2,3,6,Lost
61403,34,32,68,5,4,4,13,Champions
61460,632,6,11,2,1,1,4,Lost
61605,287,35,42,3,4,3,10,Loyal Users
61702,19,66,195,5,5,5,15,Champions
61840,24,122,306,5,5,5,15,Champions
62025,27,44,61,5,4,3,12,Loyal Users
62289,119,40,191,4,4,5,13,Champions
62685,33,6,17,5,1,2,8,Promising
62726,2019,14,40,1,3,3,7,Casual Users
63130,264,7,12,3,2,1,6,Casual Users
63295,87,5,21,4,1,2,7,Promising
63532,713,64,108,2,5,4,11,At Risk
63701,10,11,32,5,2,3,10,Promising
63798,2163,7,16,1,2,2,5,Lost
63914,432,14,31,3,3,2,8,Loyal Users
63930,3,37,46,5,4,3,12,Loyal Users
64084,655,7,15,2,2,1,5,Lost
64273,500,17,91,2,3,4,9,Casual Users
64586,120,48,126,4,5,4,13,Champions
64603,9,54,270,5,5,5,15,Champions
64704,290,12,41,3,3,3,9,Loyal Users
64805,3583,22,56,1,4,3,8,At Risk
64839,103,14,65,4,3,4,11,Loyal Users
65255,976,10,23,2,2,2,6,Lost
65307,1212,9,10,2,2,1,5,Lost
52705,66,46,116,5,5,4,14,Champions
52757,522,11,84,2,2,4,8,Lost
52808,1612,5,5,1,1,1,3,Lost
52955,93,41,221,4,4,5,13,Champions
53115,1487,10,20,1,2,2,5,Lost
53197,538,5,15,2,1,1,4,Lost
53213,23,33,73,5,4,4,13,Champions
53226,239,11,16,3,2,2,7,Casual Users
53510,13,17,110,5,3,4,12,Loyal Users
53584,117,40,134,4,4,4,12,Champions
53765,221,15,47,3,3,3,9,Loyal Users
53837,266,7,20,3,2,2,7,Casual Users
54201,4904,21,47,1,3,3,7,Casual Users
54359,24,10,11,5,2,1,8,Promising
54368,778,7,25,2,2,2,6,Lost
54428,11,26,72,5,4,4,13,Champions
54724,1415,9,16,1,2,2,5,Lost
55080,18,49,103,5,5,4,14,Champions
55160,1666,10,41,1,2,3,6,Lost
55260,224,59,93,3,5,4,12,Loyal Users
55304,968,5,8,2,1,1,4,Lost
55699,58,107,394,5,5,5,15,Champions
56077,109,67,168,4,5,5,14,Champions
56213,7,106,462,5,5,5,15,Champions
56332,1853,5,9,1,1,1,3,Lost
56386,274,29,265,3,4,5,12,Loyal Users
56608,62,58,394,5,5,5,15,Champions
56707,4487,27,40,1,4,3,8,At Risk
56737,2128,9,41,1,2,3,6,Lost
56743,714,31,54,2,4,3,9,At Risk
56843,8,7,27,5,2,2,9,Promising
56859,436,5,10,3,1,1,5,Casual Users
57124,858,8,15,2,2,1,5,Lost
57288,2701,7,9,1,2,1,4,Lost
58185,8,45,329,5,4,5,14,Champions
58191,4247,5,40,1,1,3,5,Lost
58201,968,11,30,2,2,2,6,Lost
58244,1269,5,6,1,1,1,3,Lost
58437,160,6,20,4,1,2,7,Promising
58444,412,31,117,3,4,4,11,Loyal Users
58753,1228,12,19,2,3,2,7,Casual Users
59066,380,15,20,3,3,2,8,Loyal Users
59168,972,16,34,2,3,3,8,Casual Users
59350,574,22,75,2,4,4,10,At Risk
59360,418,70,330,3,5,5,13,Loyal Users
59654,114,10,20,4,2,2,8,Promising
59761,1921,10,14,1,2,1,4,Lost
60177,1117,5,26,2,1,2,5,Lost
60352,9,73,111,5,5,4,14,Champions
60461,118,134,513,4,5,5,14,Champions
60581,297,12,41,3,3,3,9,Loyal Users
60654,854,10,29,2,2,2,6,Lost
60747,121,71,197,4,5,5,14,Champions
60884,2262,11,48,1,2,3,6,Lost
61153,156,8,11,4,2,1,7,Promising
61179,90,40,352,4,4,5,13,Champions
61399,12,137,400,5,5,5,15,Champions
61401,685,7,14,2,2,1,5,Lost
61457,1006,43,69,2,4,4,10,At Risk
61852,278,64,103,3,5,4,12,Loyal Users
61938,114,38,201,4,4,5,13,Champions
62224,6,14,16,5,3,2,10,Loyal Users
62388,1562,16,22,1,3,2,6,Casual Users
62433,10,66,115,5,5,4,14,Champions
62460,84,6,9,4,1,1,6,Promising
62700,142,38,56,4,4,3,11,Loyal Users
62830,591,6,7,2,1,1,4,Lost
63169,1260,6,16,1,1,2,4,Lost
64209,458,13,13,3,3,1,7,Loyal Users
64446,120,58,644,4,5,5,14,Champions
64558,3938,5,15,1,1,1,3,Lost
64575,3120,6,10,1,1,1,3,Lost
64615,813,7,35,2,2,3,7,Lost
64674,77,40,74,4,4,4,12,Champions
65012,1709,24,82,1,4,4,9,At Risk
65325,178,15,18,3,3,2,8,Loyal Users
52428,698,12,25,2,3,2,7,Casual Users
52431,105,32,110,4,4,4,12,Champions
52494,2803,6,23,1,1,2,4,Lost
52504,164,22,104,4,4,4,12,Champions
52555,22,72,236,5,5,5,15,Champions
52749,423,19,36,3,3,3,9,Loyal Users
52840,7,85,309,5,5,5,15,Champions
52889,2558,10,20,1,2,2,5,Lost
52960,815,6,7,2,1,1,4,Lost
53008,107,26,91,4,4,4,12,Champions
53097,278,10,46,3,2,3,8,Casual Users
54049,103,28,88,4,4,4,12,Champions
54065,133,34,95,4,4,4,12,Champions
54148,1625,8,13,1,2,1,4,Lost
54209,248,10,73,3,2,4,9,Casual Users
54241,2235,11,14,1,2,1,4,Lost
54271,44,121,338,5,5,5,15,Champions
54311,845,16,57,2,3,3,8,Casual Users
54633,1127,8,8,2,2,1,5,Lost
54705,580,12,22,2,3,2,7,Casual Users
54754,24,124,378,5,5,5,15,Champions
54765,255,11,24,3,2,2,7,Casual Users
54774,93,59,126,4,5,4,13,Champions
54940,27,32,91,5,4,4,13,Champions
54996,71,29,65,4,4,4,12,Champions
55044,412,17,35,3,3,3,9,Loyal Users
55362,879,10,17,2,2,2,6,Lost
55624,356,8,16,3,2,2,7,Casual Users
55905,4595,5,5,1,1,1,3,Lost
55923,114,7,48,4,2,3,9,Promising
55991,590,22,43,2,4,3,9,At Risk
56275,4519,7,11,1,2,1,4,Lost
56471,4602,6,9,1,1,1,3,Lost
56518,600,25,27,2,4,2,8,At Risk
56588,343,13,42,3,3,3,9,Loyal Users
56629,1291,7,19,1,2,2,5,Lost
56681,112,51,205,4,5,5,14,Champions
56711,257,19,41,3,3,3,9,Loyal Users
56914,1205,16,20,2,3,2,7,Casual Users
57501,3726,14,32,1,3,3,7,Casual Users
57569,522,26,106,2,4,4,10,At Risk
57848,40,19,33,5,3,3,11,Loyal Users
58035,1564,8,17,1,2,2,5,Lost
58394,154,28,47,4,4,3,11,Loyal Users
58467,137,22,77,4,4,4,12,Champions
58508,696,7,58,2,2,3,7,Lost
59292,277,19,78,3,3,4,10,Loyal Users
59306,117,87,675,4,5,5,14,Champions
59526,23,163,585,5,5,5,15,Champions
59721,363,5,6,3,1,1,5,Casual Users
60196,1623,25,70,1,4,4,9,At Risk
60251,1550,5,10,1,1,1,3,Lost
60330,123,7,44,4,2,3,9,Promising
60704,141,16,107,4,3,4,11,Loyal Users
60782,852,24,102,2,4,4,10,At Risk
60900,405,26,62,3,4,3,10,Loyal Users
60970,12,18,31,5,3,2,10,Loyal Users
61677,932,9,27,2,2,2,6,Lost
62351,1850,11,21,1,2,2,5,Lost
62646,25,23,34,5,4,3,12,Loyal Users
62668,187,21,30,3,3,2,8,Loyal Users
62716,380,15,47,3,3,3,9,Loyal Users
62795,3817,7,17,1,2,2,5,Lost
63427,539,16,48,2,3,3,8,Casual Users
63471,1590,11,18,1,2,2,5,Lost
64104,1,178,363,5,5,5,15,Champions
64286,1,13,33,5,3,3,11,Loyal Users
64320,5798,8,8,1,2,1,4,Lost
64676,953,13,39,2,3,3,8,Casual Users
64794,90,37,81,4,4,4,12,Champions
64810,5799,6,24,1,1,2,4,Lost
64925,702,49,113,2,5,4,11,At Risk
65133,834,8,15,2,2,1,5,Lost
65185,22,111,552,5,5,5,15,Champions
65390,2305,5,7,1,1,1,3,Lost
52711,0,12,27,5,3,2,10,Loyal Users
53090,707,35,175,2,4,5,11,At Risk
53269,1984,10,93,1,2,4,7,Lost
53740,488,12,40,2,3,3,8,Casual Users
53835,65,55,474,5,5,5,15,Champions
53884,916,13,41,2,3,3,8,Casual Users
54216,1305,5,7,1,1,1,3,Lost
54686,1409,55,320,1,5,5,11,At Risk
54699,115,28,192,4,4,5,13,Champions
55480,519,37,112,2,4,4,10,At Risk
55557,30,54,120,5,5,4,14,Champions
56304,36,57,272,5,5,5,15,Champions
56377,1392,5,6,1,1,1,3,Lost
57037,6,52,89,5,5,4,14,Champions
57229,281,11,93,3,2,4,9,Casual Users
57597,1098,16,33,2,3,3,8,Casual Users
58203,4046,71,104,1,5,4,10,At Risk
58387,733,19,86,2,3,4,9,Casual Users
58613,91,11,33,4,2,3,9,Promising
58623,26,22,41,5,4,3,12,Loyal Users
59162,132,25,96,4,4,4,12,Champions
59704,793,15,47,2,3,3,8,Casual Users
59841,106,6,7,4,1,1,6,Promising
59852,1353,17,104,1,3,4,8,Casual Users
59872,264,24,84,3,4,4,11,Loyal Users
60066,965,41,126,2,4,4,10,At Risk
60473,4,40,80,5,4,4,13,Champions
60515,572,6,8,2,1,1,4,Lost
60879,1284,6,8,1,1,1,3,Lost
61362,123,73,310,4,5,5,14,Champions
61595,36,66,222,5,5,5,15,Champions
61929,120,21,25,4,3,2,9,Loyal Users
62482,7,37,114,5,4,4,13,Champions
62509,840,11,15,2,2,1,5,Lost
62513,51,12,38,5,3,3,11,Loyal Users
62783,3982,14,36,1,3,3,7,Casual Users
63065,23,14,35,5,3,3,11,Loyal Users
63349,277,39,130,3,4,4,11,Loyal Users
63401,252,20,43,3,3,3,9,Loyal Users
63555,24,44,199,5,4,5,14,Champions
63782,287,11,41,3,2,3,8,Casual Users
64381,1698,5,11,1,1,1,3,Lost
64567,351,14,27,3,3,2,8,Loyal Users
64639,1,70,219,5,5,5,15,Champions
65020,278,19,41,3,3,3,9,Loyal Users
65286,9,11,46,5,2,3,10,Promising
65426,236,5,5,3,1,1,5,Casual Users
52531,42,97,190,5,5,5,15,Champions
52547,526,18,61,2,3,3,8,Casual Users
52582,1828,7,37,1,2,3,6,Lost
52725,947,20,40,2,3,3,8,Casual Users
52852,144,19,32,4,3,3,10,Loyal Users
52953,1026,20,49,2,3,3,8,Casual Users
52993,1369,17,57,1,3,3,7,Casual Users
53107,149,72,154,4,5,5,14,Champions
53346,32,6,6,5,1,1,7,Promising
53369,164,42,115,4,4,4,12,Champions
53386,427,12,24,3,3,2,8,Loyal Users
53469,3287,6,9,1,1,1,3,Lost
53568,2444,10,64,1,2,4,7,Lost
53769,123,22,47,4,4,3,11,Loyal Users
53776,709,16,61,2,3,3,8,Casual Users
53880,683,6,7,2,1,1,4,Lost
53924,18,144,540,5,5,5,15,Champions
53994,3023,10,31,1,2,2,5,Lost
54084,1,20,44,5,3,3,11,Loyal Users
54366,855,5,6,2,1,1,4,Lost
54384,325,40,220,3,4,5,12,Loyal Users
54700,823,10,18,2,2,2,6,Lost
54800,120,7,22,4,2,2,8,Promising
54937,1011,6,10,2,1,1,4,Lost
55045,3365,5,15,1,1,1,3,Lost
55418,27,54,182,5,5,5,15,Champions
55518,1685,10,13,1,2,1,4,Lost
55561,431,15,42,3,3,3,9,Loyal Users
55988,138,19,98,4,3,4,11,Loyal Users
56002,548,6,20,2,1,2,5,Lost
56535,107,154,348,4,5,5,14,Champions
56722,1264,7,18,1,2,2,5,Lost
56753,2571,10,18,1,2,2,5,Lost
56767,2260,5,32,1,1,3,5,Lost
56788,326,13,28,3,3,2,8,Loyal Users
57159,398,45,173,3,4,5,12,Loyal Users
57364,266,12,22,3,3,2,8,Loyal Users
57905,22,110,188,5,5,5,15,Champions
58314,847,6,22,2,1,2,5,Lost
58359,133,61,378,4,5,5,14,Champions
58879,1287,13,25,1,3,2,6,Casual Users
59061,4538,13,26,1,3,2,6,Casual Users
59395,1738,6,9,1,1,1,3,Lost
59507,158,6,8,4,1,1,6,Promising
59665,1427,18,30,1,3,2,6,Casual Users
59720,408,13,48,3,3,3,9,Loyal Users
59977,549,10,17,2,2,2,6,Lost
60470,268,35,73,3,4,4,11,Loyal Users
60555,405,8,19,3,2,2,7,Casual Users
61144,1538,18,39,1,3,3,7,Casual Users
61456,225,9,9,3,2,1,6,Casual Users
62926,461,13,20,3,3,2,8,Loyal Users
63051,429,10,11,3,2,1,6,Casual Users
63079,405,8,21,3,2,2,7,Casual Users
63384,394,27,73,3,4,4,11,Loyal Users
63833,694,5,6,2,1,1,4,Lost
64037,600,16,34,2,3,3,8,Casual Users
65406,135,48,227,4,5,5,14,Champions
52410,342,9,33,3,2,3,8,Casual Users
52572,851,6,6,2,1,1,4,Lost
52661,1127,52,88,2,5,4,11,At Risk
52678,1009,10,28,2,2,2,6,Lost
53206,13,136,456,5,5,5,15,Champions
53409,1717,17,68,1,3,4,8,Casual Users
53413,27,34,156,5,4,5,14,Champions
53625,3117,5,7,1,1,1,3,Lost
53686,21,8,10,5,2,1,8,Promising
53793,68,5,13,5,1,1,7,Promising
54611,409,22,43,3,4,3,10,Loyal Users
54689,131,27,112,4,4,4,12,Champions
54806,3503,5,5,1,1,1,3,Lost
54864,1992,6,11,1,1,1,3,Lost
54874,418,16,108,3,3,4,10,Loyal Users
54892,1188,11,30,2,2,2,6,Lost
55056,83,47,162,4,5,5,14,Champions
55191,94,22,48,4,4,3,11,Loyal Users
55423,34,17,22,5,3,2,10,Loyal Users
55606,11,47,242,5,5,5,15,Champions
55644,522,5,6,2,1,1,4,Lost
55740,106,25,51,4,4,3,11,Loyal Users
55758,450,8,34,3,2,3,8,Casual Users
55772,3618,9,33,1,2,3,6,Lost
55795,65,106,504,5,5,5,15,Champions
55894,117,53,122,4,5,4,13,Champions
56329,880,14,43,2,3,3,8,Casual Users
56408,69,52,148,5,5,5,15,Champions
56648,795,15,59,2,3,3,8,Casual Users
56783,1673,8,15,1,2,1,4,Lost
57098,1448,12,29,1,3,2,6,Casual Users
57102,2,18,69,5,3,4,12,Loyal Users
57169,1255,11,15,2,2,1,5,Lost
57303,600,17,24,2,3,2,7,Casual Users
57317,1380,14,46,1,3,3,7,Casual Users
57363,997,5,14,2,1,1,4,Lost
57422,492,28,93,2,4,4,10,At Risk
57662,144,53,128,4,5,4,13,Champions
57775,996,6,6,2,1,1,4,Lost
57896,1278,12,39,1,3,3,7,Casual Users
58363,2222,5,23,1,1,2,4,Lost
58404,440,8,8,3,2,1,6,Casual Users
58831,103,66,213,4,5,5,14,Champions
58861,527,15,72,2,3,4,9,Casual Users
59074,1124,5,9,2,1,1,4,Lost
59106,133,11,16,4,2,2,8,Promising
59175,40,97,139,5,5,4,14,Champions
59303,424,5,5,3,1,1,5,Casual Users
59805,250,118,738,3,5,5,13,Loyal Users
59881,30,13,17,5,3,2,10,Loyal Users
60018,218,15,28,3,3,2,8,Loyal Users
60264,412,7,24,3,2,2,7,Casual Users
60300,68,139,221,5,5,5,15,Champions
60861,875,113,618,2,5,5,12,At Risk
61184,122,20,34,4,3,3,10,Loyal Users
61296,650,21,46,2,3,3,8,Casual Users
61319,463,12,20,3,3,2,8,Loyal Users
61485,2377,13,43,1,3,3,7,Casual Users
61489,140,59,158,4,5,5,14,Champions
61600,25,94,590,5,5,5,15,Champions
61808,3,54,92,5,5,4,14,Champions
61827,873,36,196,2,4,5,11,At Risk
61943,320,9,28,3,2,2,7,Casual Users
62753,24,108,587,5,5,5,15,Champions
64129,470,19,37,3,3,3,9,Loyal Users
64249,5301,21,28,1,3,2,6,Casual Users
64439,108,70,231,4,5,5,14,Champions
64549,656,7,26,2,2,2,6,Lost
64595,65,38,351,5,4,5,14,Champions
64666,5449,5,9,1,1,1,3,Lost
64670,226,6,15,3,1,1,5,Casual Users
64722,8,10,42,5,2,3,10,Promising
64796,24,46,92,5,5,4,14,Champions
52386,2476,5,17,1,1,2,4,Lost
52398,392,9,51,3,2,3,8,Casual Users
53039,119,58,187,4,5,5,14,Champions
53103,557,5,12,2,1,1,4,Lost
53646,1,136,532,5,5,5,15,Champions
54060,3720,6,8,1,1,1,3,Lost
54098,857,8,18,2,2,2,6,Lost
54179,585,8,22,2,2,2,6,Lost
54421,1684,5,8,1,1,1,3,Lost
54466,219,18,56,3,3,3,9,Loyal Users
54748,1130,17,143,2,3,4,9,Casual Users
54907,14,58,147,5,5,5,15,Champions
54911,272,10,19,3,2,2,7,Casual Users
54947,1700,6,9,1,1,1,3,Lost
55017,1134,26,46,2,4,3,9,At Risk
55321,2737,6,12,1,1,1,3,Lost
55348,229,16,26,3,3,2,8,Loyal Users
55458,307,13,50,3,3,3,9,Loyal Users
55552,6,40,171,5,4,5,14,Champions
55811,3974,5,7,1,1,1,3,Lost
55899,110,82,226,4,5,5,14,Champions
55906,101,18,111,4,3,4,11,Loyal Users
56170,783,5,22,2,1,2,5,Lost
56228,9,16,34,5,3,3,11,Loyal Users
56290,306,64,102,3,5,4,12,Loyal Users
56555,2872,7,43,1,2,3,6,Lost
56597,2734,5,10,1,1,1,3,Lost
56770,2244,5,13,1,1,1,3,Lost
57115,3,114,782,5,5,5,15,Champions
57194,2541,45,69,1,4,4,9,At Risk
57302,1543,8,16,1,2,2,5,Lost
57374,1571,5,36,1,1,3,5,Lost
57548,30,86,263,5,5,5,15,Champions
57879,21,63,143,5,5,4,14,Champions
57907,104,13,19,4,3,2,9,Loyal Users
58057,408,12,25,3,3,2,8,Loyal Users
58059,637,10,18,2,2,2,6,Lost
58075,3700,7,54,1,2,3,6,Lost
58206,150,37,51,4,4,3,11,Loyal Users
58274,440,23,80,3,4,4,11,Loyal Users
58375,576,19,51,2,3,3,8,Casual Users
58621,4912,7,12,1,2,1,4,Lost
59520,1754,5,14,1,1,1,3,Lost
59894,9,88,622,5,5,5,15,Champions
59953,392,57,105,3,5,4,12,Loyal Users
60164,158,38,93,4,4,4,12,Champions
60174,140,31,209,4,4,5,13,Champions
60215,363,19,23,3,3,2,8,Loyal Users
60374,428,13,81,3,3,4,10,Loyal Users
60401,89,31,59,4,4,3,11,Loyal Users
60472,361,9,84,3,2,4,9,Casual Users
60548,2420,5,25,1,1,2,4,Lost
60908,568,8,10,2,2,1,5,Lost
60923,26,5,67,5,1,4,10,Promising
61209,3556,10,13,1,2,1,4,Lost
61356,71,48,137,4,5,4,13,Champions
61539,138,29,43,4,4,3,11,Loyal Users
61631,8,127,322,5,5,5,15,Champions
61636,998,6,14,2,1,1,4,Lost
61847,262,18,32,3,3,3,9,Loyal Users
61932,1731,5,7,1,1,1,3,Lost
62228,1,5,6,5,1,1,7,Promising
62384,15,28,46,5,4,3,12,Loyal Users
62477,112,8,8,4,2,1,7,Promising
62616,30,43,155,5,4,5,14,Champions
63044,925,38,82,2,4,4,10,At Risk
63224,718,18,63,2,3,4,9,Casual Users
63308,413,42,258,3,4,5,12,Loyal Users
63360,32,6,21,5,1,2,8,Promising
63457,126,21,77,4,3,4,11,Loyal Users
63889,436,71,294,3,5,5,13,Loyal Users
63938,667,11,14,2,2,1,5,Lost
64172,9,11,19,5,2,2,9,Promising
64312,3,6,11,5,1,1,7,Promising
64316,427,11,26,3,2,2,7,Casual Users
64545,9,13,44,5,3,3,11,Loyal Users
64625,668,67,143,2,5,4,11,At Risk
64711,398,18,163,3,3,5,11,Loyal Users
64888,158,93,303,4,5,5,14,Champions
65315,116,5,23,4,1,2,7,Promising
52436,138,22,75,4,4,4,12,Champions
52602,29,51,138,5,5,4,14,Champions
52721,558,10,61,2,2,3,7,Lost
52812,422,12,14,3,3,1,7,Loyal Users
53031,93,31,104,4,4,4,12,Champions
53113,266,6,8,3,1,1,5,Casual Users
53236,1005,5,7,2,1,1,4,Lost
53438,2982,6,14,1,1,1,3,Lost
54252,255,56,166,3,5,5,13,Loyal Users
54277,149,101,214,4,5,5,14,Champions
54303,341,12,26,3,3,2,8,Loyal Users
54308,123,52,180,4,5,5,14,Champions
54310,250,100,160,3,5,5,13,Loyal Users
54425,5890,12,21,1,3,2,6,Casual Users
54720,162,8,28,4,2,2,8,Promising
54824,1022,11,23,2,2,2,6,Lost
55106,13,86,392,5,5,5,15,Champions
55546,469,31,114,3,4,4,11,Loyal Users
56164,4638,6,7,1,1,1,3,Lost
56429,132,19,42,4,3,3,10,Loyal Users
56432,18,7,11,5,2,1,8,Promising
56457,1003,6,27,2,1,2,5,Lost
56482,985,5,11,2,1,1,4,Lost
56724,70,59,119,4,5,4,13,Champions
56749,791,8,33,2,2,3,7,Lost
57000,978,14,20,2,3,2,7,Casual Users
57129,3,76,214,5,5,5,15,Champions
57293,291,19,27,3,3,2,8,Loyal Users
57458,219,10,21,3,2,2,7,Casual Users
57514,705,5,9,2,1,1,4,Lost
57853,18,26,149,5,4,5,14,Champions
58553,119,28,84,4,4,4,12,Champions
58677,229,13,35,3,3,3,9,Loyal Users
58766,425,35,69,3,4,4,11,Loyal Users
58771,2134,6,11,1,1,1,3,Lost
58800,13,14,25,5,3,2,10,Loyal Users
58867,4,74,339,5,5,5,15,Champions
58939,105,6,8,4,1,1,6,Promising
59027,30,7,16,5,2,2,9,Promising
59119,735,14,47,2,3,3,8,Casual Users
59206,3870,11,25,1,2,2,5,Lost
59436,4227,61,104,1,5,4,10,At Risk
59719,569,12,15,2,3,1,6,Casual Users
59743,303,10,18,3,2,2,7,Casual Users
60037,2079,25,83,1,4,4,9,At Risk
60415,235,6,38,3,1,3,7,Casual Users
60519,139,28,62,4,4,3,11,Loyal Users
60712,122,17,92,4,3,4,11,Loyal Users
60757,648,40,110,2,4,4,10,At Risk
61351,1,43,302,5,4,5,14,Champions
61450,15,9,36,5,2,3,10,Promising
61502,412,18,25,3,3,2,8,Loyal Users
61767,394,7,20,3,2,2,7,Casual Users
61930,857,12,15,2,3,1,6,Casual Users
62051,528,8,77,2,2,4,8,Lost
62209,2472,6,12,1,1,1,3,Lost
62451,60,69,248,5,5,5,15,Champions
62624,495,17,37,2,3,3,8,Casual Users
62797,1393,20,125,1,3,4,8,Casual Users
62917,139,37,77,4,4,4,12,Champions
62937,298,6,12,3,1,1,5,Casual Users
62982,669,5,11,2,1,1,4,Lost
63072,114,99,323,4,5,5,14,Champions
63526,1018,5,6,2,1,1,4,Lost
63862,9,35,155,5,4,5,14,Champions
64118,29,65,118,5,5,4,14,Champions
64189,933,12,32,2,3,3,8,Casual Users
64259,435,77,383,3,5,5,13,Loyal Users
64386,303,14,27,3,3,2,8,Loyal Users
64442,28,56,196,5,5,5,15,Champions
64790,1523,5,88,1,1,4,6,Lost
64854,435,16,30,3,3,2,8,Loyal Users
64892,123,29,53,4,4,3,11,Loyal Users
64968,440,30,44,3,4,3,10,Loyal Users
65119,451,60,138,3,5,4,12,Loyal Users
65229,22,32,48,5,4,3,12,Loyal Users
65273,107,59,243,4,5,5,14,Champions
65301,1297,13,23,1,3,2,6,Casual Users
52438,1468,21,62,1,3,3,7,Casual Users
52693,1455,15,15,1,3,1,5,Casual Users
52780,1139,24,38,2,4,3,9,At Risk
52800,807,7,14,2,2,1,5,Lost
52821,116,17,29,4,3,2,9,Loyal Users
52850,7,68,515,5,5,5,15,Champions
53170,979,16,42,2,3,3,8,Casual Users
53283,3076,5,9,1,1,1,3,Lost
53310,142,7,12,4,2,1,7,Promising
53493,430,5,14,3,1,1,5,Casual Users
53698,239,61,232,3,5,5,13,Loyal Users
53907,132,15,23,4,3,2,9,Loyal Users
54265,8,61,161,5,5,5,15,Champions
54341,191,9,15,3,2,1,6,Casual Users
54435,0,13,132,5,3,4,12,Loyal Users
54925,149,39,192,4,4,5,13,Champions
54992,0,21,38,5,3,3,11,Loyal Users
55221,428,68,254,3,5,5,13,Loyal Users
55231,256,72,119,3,5,4,12,Loyal Users
55543,958,6,12,2,1,1,4,Lost
55565,1140,7,9,2,2,1,5,Lost
55572,283,10,36,3,2,3,8,Casual Users
55771,112,10,26,4,2,2,8,Promising
56063,696,29,38,2,4,3,9,At Risk
56095,132,60,190,4,5,5,14,Champions
56439,2864,7,11,1,2,1,4,Lost
56596,208,29,226,3,4,5,12,Loyal Users
56833,417,34,175,3,4,5,12,Loyal Users
56848,4,119,202,5,5,5,15,Champions
57451,878,5,14,2,1,1,4,Lost
57507,22,82,152,5,5,5,15,Champions
57563,143,40,124,4,4,4,12,Champions
57578,27,88,250,5,5,5,15,Champions
57614,105,93,207,4,5,5,14,Champions
57670,105,13,73,4,3,4,11,Loyal Users
57746,81,109,160,4,5,5,14,Champions
57811,3705,12,15,1,3,1,5,Casual Users
57930,2481,7,18,1,2,2,5,Lost
57963,424,24,28,3,4,2,9,Loyal Users
58301,292,9,18,3,2,2,7,Casual Users
58737,1611,5,15,1,1,1,3,Lost
58770,834,15,110,2,3,4,9,Casual Users
59011,102,11,20,4,2,2,8,Promising
59220,3748,7,8,1,2,1,4,Lost
59417,956,18,99,2,3,4,9,Casual Users
59700,112,10,41,4,2,3,9,Promising
60316,510,6,24,2,1,2,5,Lost
60366,847,6,16,2,1,2,5,Lost
60821,106,34,163,4,4,5,13,Champions
61098,340,16,127,3,3,4,10,Loyal Users
61494,1421,5,11,1,1,1,3,Lost
61642,125,6,9,4,1,1,6,Promising
62089,1146,6,23,2,1,2,5,Lost
62134,242,32,51,3,4,3,10,Loyal Users
62346,147,43,234,4,4,5,13,Champions
62350,26,15,24,5,3,2,10,Loyal Users
62414,572,5,9,2,1,1,4,Lost
62906,389,32,122,3,4,4,11,Loyal Users
62974,9,83,224,5,5,5,15,Champions
63687,173,7,13,3,2,1,6,Casual Users
63691,237,7,21,3,2,2,7,Casual Users
63761,779,7,8,2,2,1,5,Lost
63872,1495,5,22,1,1,2,4,Lost
64914,1,42,72,5,4,4,13,Champions
64936,1235,11,58,2,2,3,7,Lost
65050,2389,8,12,1,2,1,4,Lost
65339,321,7,10,3,2,1,6,Casual Users
65377,5,28,39,5,4,3,12,Loyal Users
52782,118,80,190,4,5,5,14,Champions
52866,127,7,10,4,2,1,7,Promising
53037,1160,11,38,2,2,3,7,Lost
53135,4517,12,43,1,3,3,7,Casual Users
53239,833,7,63,2,2,4,8,Lost
53256,428,7,10,3,2,1,6,Casual Users
53912,271,33,85,3,4,4,11,Loyal Users
53967,566,8,15,2,2,1,5,Lost
54031,130,22,30,4,4,2,10,Loyal Users
54192,478,15,43,2,3,3,8,Casual Users
54536,2012,11,81,1,2,4,7,Lost
54638,590,39,134,2,4,4,10,At Risk
54679,2708,14,65,1,3,4,8,Casual Users
54799,476,31,129,2,4,4,10,At Risk
54810,542,14,43,2,3,3,8,Casual Users
54853,376,9,19,3,2,2,7,Casual Users
55415,1857,5,27,1,1,2,4,Lost
55432,7,93,681,5,5,5,15,Champions
55507,23,131,308,5,5,5,15,Champions
55601,996,6,17,2,1,2,5,Lost
55693,706,6,9,2,1,1,4,Lost
55711,110,12,36,4,3,3,10,Loyal Users
56252,2121,9,22,1,2,2,5,Lost
56321,580,8,21,2,2,2,6,Lost
56399,168,14,26,3,3,2,8,Loyal Users
56539,273,50,96,3,5,4,12,Loyal Users
56726,72,34,87,4,4,4,12,Champions
57063,906,70,209,2,5,5,12,At Risk
57222,7,33,77,5,4,4,13,Champions
57565,132,189,643,4,5,5,14,Champions
57602,1263,8,13,1,2,1,4,Lost
57827,4694,18,31,1,3,2,6,Casual Users
57876,1723,6,22,1,1,2,4,Lost
57898,2400,7,18,1,2,2,5,Lost
58029,15,130,684,5,5,5,15,Champions
58326,159,19,33,4,3,3,10,Loyal Users
58641,496,17,57,2,3,3,8,Casual Users
58728,174,44,99,3,4,4,11,Loyal Users
58832,1400,10,16,1,2,2,5,Lost
58915,2327,5,11,1,1,1,3,Lost
59032,53,5,18,5,1,2,8,Promising
59121,813,5,10,2,1,1,4,Lost
59140,280,6,6,3,1,1,5,Casual Users
59197,153,11,17,4,2,2,8,Promising
59263,3,5,11,5,1,1,7,Promising
59277,114,6,24,4,1,2,7,Promising
59451,1399,9,19,1,2,2,5,Lost
59563,2408,10,24,1,2,2,5,Lost
59621,68,49,210,5,5,5,15,Champions
59759,1064,42,88,2,4,4,10,At Risk
59967,128,78,268,4,5,5,14,Champions
60014,18,17,121,5,3,4,12,Loyal Users
60216,418,7,25,3,2,2,7,Casual Users
60246,4909,5,20,1,1,2,4,Lost
60282,1454,11,42,1,2,3,6,Lost
60354,853,5,21,2,1,2,5,Lost
60676,448,36,219,3,4,5,12,Loyal Users
61350,860,33,136,2,4,4,10,At Risk
61530,20,74,142,5,5,4,14,Champions
61531,485,32,209,2,4,5,11,At Risk
61644,2767,19,32,1,3,3,7,Casual Users
62252,25,111,670,5,5,5,15,Champions
62310,850,23,105,2,4,4,10,At Risk
62364,115,20,38,4,3,3,10,Loyal Users
62406,226,171,458,3,5,5,13,Loyal Users
62528,359,16,22,3,3,2,8,Loyal Users
62639,400,28,56,3,4,3,10,Loyal Users
62889,99,5,7,4,1,1,6,Promising
63043,142,10,66,4,2,4,10,Promising
63119,414,8,20,3,2,2,7,Casual Users
63576,549,9,106,2,2,4,8,Lost
64027,2883,23,50,1,4,3,8,At Risk
64315,728,8,20,2,2,2,6,Lost
64398,40,11,16,5,2,2,9,Promising
64517,30,81,448,5,5,5,15,Champions
64787,0,84,423,5,5,5,15,Champions
65326,2448,29,37,1,4,3,8,At Risk
52621,3535,19,29,1,3,2,6,Casual Users
52650,265,8,24,3,2,2,7,Casual Users
52653,287,10,52,3,2,3,8,Casual Users
52811,135,12,15,4,3,1,8,Loyal Users
52836,1293,10,10,1,2,1,4,Lost
52903,443,6,19,3,1,2,6,Casual Users
52989,1513,6,21,1,1,2,4,Lost
53063,4403,6,10,1,1,1,3,Lost
53454,19,42,217,5,4,5,14,Champions
53956,118,39,67,4,4,4,12,Champions
55103,1015,6,11,2,1,1,4,Lost
55940,138,15,22,4,3,2,9,Loyal Users
55978,783,15,88,2,3,4,9,Casual Users
56152,1015,8,65,2,2,4,8,Lost
56473,239,13,16,3,3,2,8,Loyal Users
57719,839,21,134,2,3,4,9,Casual Users
58002,1813,5,8,1,1,1,3,Lost
58357,425,18,94,3,3,4,10,Loyal Users
58461,25,88,621,5,5,5,15,Champions
58511,727,49,357,2,5,5,12,At Risk
58651,16,73,379,5,5,5,15,Champions
58775,2846,16,93,1,3,4,8,Casual Users
58806,125,7,20,4,2,2,8,Promising
59046,159,40,190,4,4,5,13,Champions
59165,23,145,511,5,5,5,15,Champions
59304,17,19,30,5,3,2,10,Loyal Users
59730,89,55,124,4,5,4,13,Champions
59874,130,19,60,4,3,3,10,Loyal Users
60025,15,91,180,5,5,5,15,Champions
60699,456,61,166,3,5,5,13,Loyal Users
61182,30,32,289,5,4,5,14,Champions
61227,166,14,20,3,3,2,8,Loyal Users
61249,491,13,18,2,3,2,7,Casual Users
61278,19,41,81,5,4,4,13,Champions
61307,115,67,416,4,5,5,14,Champions
61532,159,67,264,4,5,5,14,Champions
61782,632,22,31,2,4,2,8,At Risk
62075,1425,5,30,1,1,2,4,Lost
62204,477,12,16,2,3,2,7,Casual Users
62374,1303,6,8,1,1,1,3,Lost
62902,343,49,57,3,5,3,11,Loyal Users
62931,180,90,353,3,5,5,13,Loyal Users
63059,845,9,16,2,2,2,6,Lost
63245,224,28,76,3,4,4,11,Loyal Users
63311,4748,19,55,1,3,3,7,Casual Users
63553,1812,5,6,1,1,1,3,Lost
63700,2229,6,11,1,1,1,3,Lost
63995,2559,9,18,1,2,2,5,Lost
64135,157,12,29,4,3,2,9,Loyal Users
64284,1526,31,120,1,4,4,9,At Risk
64852,254,48,79,3,5,4,12,Loyal Users
64959,133,53,269,4,5,5,14,Champions
65081,659,14,43,2,3,3,8,Casual Users
65364,1147,8,12,2,2,1,5,Lost
52633,60,80,617,5,5,5,15,Champions
53501,252,19,84,3,3,4,10,Loyal Users
53566,2444,6,32,1,1,3,5,Lost
54113,570,58,190,2,5,5,12,At Risk
54389,1237,5,5,2,1,1,4,Lost
54531,2,147,685,5,5,5,15,Champions
54749,102,26,98,4,4,4,12,Champions
54872,801,12,19,2,3,2,7,Casual Users
55004,415,99,260,3,5,5,13,Loyal Users
55196,294,90,434,3,5,5,13,Loyal Users
55462,1148,20,48,2,3,3,8,Casual Users
55613,1265,6,26,1,1,2,4,Lost
55695,3404,5,5,1,1,1,3,Lost
56010,21,36,215,5,4,5,14,Champions
56306,228,10,18,3,2,2,7,Casual Users
56658,38,15,133,5,3,4,12,Loyal Users
56700,2,38,126,5,4,4,13,Champions
56897,427,9,30,3,2,2,7,Casual Users
56963,128,20,41,4,3,3,10,Loyal Users
57300,44,12,53,5,3,3,11,Loyal Users
57347,267,33,89,3,4,4,11,Loyal Users
57497,297,23,222,3,4,5,12,Loyal Users
57666,410,49,113,3,5,4,12,Loyal Users
57897,3160,10,28,1,2,2,5,Lost
57910,421,28,63,3,4,4,11,Loyal Users
58018,91,25,75,4,4,4,12,Champions
58194,686,5,22,2,1,2,5,Lost
58426,1988,8,10,1,2,1,4,Lost
58658,13,81,338,5,5,5,15,Champions
59344,1021,32,201,2,4,5,11,At Risk
59458,90,9,80,4,2,4,10,Promising
59469,36,5,6,5,1,1,7,Promising
59533,3416,5,6,1,1,1,3,Lost
59587,1144,5,14,2,1,1,4,Lost
59620,0,11,37,5,2,3,10,Promising
59735,3599,6,49,1,1,3,5,Lost
59836,22,52,94,5,5,4,14,Champions
59848,21,10,20,5,2,2,9,Promising
60006,128,67,677,4,5,5,14,Champions
60007,88,9,9,4,2,1,7,Promising
60302,3239,5,20,1,1,2,4,Lost
60496,2142,5,6,1,1,1,3,Lost
60612,14,169,521,5,5,5,15,Champions
60899,405,8,15,3,2,1,6,Casual Users
60960,280,16,29,3,3,2,8,Loyal Users
61022,364,6,9,3,1,1,5,Casual Users
61189,130,93,489,4,5,5,14,Champions
61369,14,25,115,5,4,4,13,Champions
61857,640,6,6,2,1,1,4,Lost
61928,174,23,49,3,4,3,10,Loyal Users
61942,85,212,529,4,5,5,14,Champions
62023,173,24,74,3,4,4,11,Loyal Users
62105,550,37,126,2,4,4,10,At Risk
62356,135,35,54,4,4,3,11,Loyal Users
62423,69,50,55,5,5,3,13,Loyal Users
62498,238,112,374,3,5,5,13,Loyal Users
62664,61,20,55,5,3,3,11,Loyal Users
63057,1582,5,18,1,1,2,4,Lost
63442,36,40,112,5,4,4,13,Champions
63707,3530,9,26,1,2,2,5,Lost
63861,2265,15,54,1,3,3,7,Casual Users
63980,393,52,89,3,5,4,12,Loyal Users
64065,2124,5,16,1,1,2,4,Lost
64188,147,17,52,4,3,3,10,Loyal Users
65310,2604,9,36,1,2,3,6,Lost
65350,1708,6,32,1,1,3,5,Lost
52374,958,9,15,2,2,1,5,Lost
52456,117,28,62,4,4,3,11,Loyal Users
52760,411,10,32,3,2,3,8,Casual Users
52768,455,12,116,3,3,4,10,Loyal Users
52860,2,36,95,5,4,4,13,Champions
52941,818,56,129,2,5,4,11,At Risk
53216,482,21,131,2,3,4,9,Casual Users
53400,11,52,90,5,5,4,14,Champions
53650,815,5,6,2,1,1,4,Lost
53848,715,13,17,2,3,2,7,Casual Users
53915,4,18,58,5,3,3,11,Loyal Users
54170,432,63,122,3,5,4,12,Loyal Users
54339,421,12,20,3,3,2,8,Loyal Users
54539,416,7,37,3,2,3,8,Casual Users
54879,1116,8,11,2,2,1,5,Lost
54951,3575,5,26,1,1,2,4,Lost
55145,0,197,453,5,5,5,15,Champions
55438,259,63,91,3,5,4,12,Loyal Users
55585,81,130,271,4,5,5,14,Champions
56028,149,26,182,4,4,5,13,Champions
56470,107,14,24,4,3,2,9,Loyal Users
56607,534,17,22,2,3,2,7,Casual Users
56863,5277,6,11,1,1,1,3,Lost
56872,889,21,84,2,3,4,9,Casual Users
57132,428,26,49,3,4,3,10,Loyal Users
57138,569,21,39,2,3,3,8,Casual Users
57198,13,19,51,5,3,3,11,Loyal Users
57253,539,15,19,2,3,2,7,Casual Users
57337,410,24,76,3,4,4,11,Loyal Users
58265,1985,5,6,1,1,1,3,Lost
58828,699,5,16,2,1,2,5,Lost
58964,148,131,326,4,5,5,14,Champions
59080,1429,12,50,1,3,3,7,Casual Users
59091,4988,5,7,1,1,1,3,Lost
59099,828,8,30,2,2,2,6,Lost
59204,606,7,21,2,2,2,6,Lost
59362,127,8,11,4,2,1,7,Promising
59551,2,38,169,5,4,5,14,Champions
59580,132,25,62,4,4,3,11,Loyal Users
59656,95,131,787,4,5,5,14,Champions
59703,273,54,158,3,5,5,13,Loyal Users
60042,369,5,10,3,1,1,5,Casual Users
60169,37,11,15,5,2,1,8,Promising
60171,0,254,642,5,5,5,15,Champions
60629,51,68,279,5,5,5,15,Champions
61013,3230,5,23,1,1,2,4,Lost
61151,180,63,260,3,5,5,13,Loyal Users
61443,2623,5,6,1,1,1,3,Lost
61540,14,8,24,5,2,2,9,Promising
61542,103,8,26,4,2,2,8,Promising
61640,444,21,25,3,3,2,8,Loyal Users
61820,1349,6,16,1,1,2,4,Lost
62269,79,19,41,4,3,3,10,Loyal Users
62360,913,33,41,2,4,3,9,At Risk
62371,6,236,558,5,5,5,15,Champions
63082,1113,6,11,2,1,1,4,Lost
63377,109,10,60,4,2,3,9,Promising
63518,1006,6,14,2,1,1,4,Lost
63666,3,8,28,5,2,2,9,Promising
63732,353,30,60,3,4,3,10,Loyal Users
63825,45,60,170,5,5,5,15,Champions
63993,111,9,46,4,2,3,9,Promising
64134,273,14,24,3,3,2,8,Loyal Users
64299,3539,72,185,1,5,5,11,At Risk
64313,59,39,109,5,4,4,13,Champions
64915,2106,7,15,1,2,1,4,Lost
65003,24,27,55,5,4,3,12,Loyal Users
65272,44,31,205,5,4,5,14,Champions
52415,379,17,45,3,3,3,9,Loyal Users
52545,103,9,28,4,2,2,8,Promising
53050,759,69,254,2,5,5,12,At Risk
53182,412,11,18,3,2,2,7,Casual Users
53252,146,34,106,4,4,4,12,Champions
53442,1549,10,47,1,2,3,6,Lost
53466,1295,8,18,1,2,2,5,Lost
53701,1959,11,50,1,2,3,6,Lost
53952,42,23,119,5,4,4,13,Champions
54040,272,32,50,3,4,3,10,Loyal Users
54169,188,5,12,3,1,1,5,Casual Users
54378,90,11,20,4,2,2,8,Promising
54385,434,9,35,3,2,3,8,Casual Users
54712,1282,18,58,1,3,3,7,Casual Users
54718,8,112,455,5,5,5,15,Champions
54797,3,23,42,5,4,3,12,Loyal Users
54870,2426,13,29,1,3,2,6,Casual Users
55005,137,87,238,4,5,5,14,Champions
55012,56,19,30,5,3,2,10,Loyal Users
55286,1095,13,34,2,3,3,8,Casual Users
55302,410,12,19,3,3,2,8,Loyal Users
55586,4831,24,78,1,4,4,9,At Risk
55588,694,8,10,2,2,1,5,Lost
55621,872,9,15,2,2,1,5,Lost
56037,429,68,117,3,5,4,12,Loyal Users
56040,1838,8,19,1,2,2,5,Lost
56310,434,5,11,3,1,1,5,Casual Users
56492,79,27,96,4,4,4,12,Champions
56578,46,7,30,5,2,2,9,Promising
56592,104,54,156,4,5,5,14,Champions
56662,106,50,239,4,5,5,14,Champions
57081,1799,15,54,1,3,3,7,Casual Users
57096,425,22,54,3,4,3,10,Loyal Users
57143,302,12,13,3,3,1,7,Loyal Users
57358,76,45,92,4,4,4,12,Champions
57676,129,29,78,4,4,4,12,Champions
57794,785,19,99,2,3,4,9,Casual Users
57828,3316,8,18,1,2,2,5,Lost
57904,38,87,239,5,5,5,15,Champions
58236,475,5,41,2,1,3,6,Lost
58380,1620,16,22,1,3,2,6,Casual Users
58408,3,93,184,5,5,5,15,Champions
58470,160,18,45,4,3,3,10,Loyal Users
58695,76,44,238,4,4,5,13,Champions
58873,3003,9,49,1,2,3,6,Lost
58972,1,45,201,5,4,5,14,Champions
59273,460,21,28,3,3,2,8,Loyal Users
59375,1019,8,11,2,2,1,5,Lost
59397,12,76,207,5,5,5,15,Champions
59586,406,42,271,3,4,5,12,Loyal Users
59937,86,13,56,4,3,3,10,Loyal Users
60262,282,32,51,3,4,3,10,Loyal Users
60319,104,78,282,4,5,5,14,Champions
60333,1,57,234,5,5,5,15,Champions
60421,143,56,301,4,5,5,14,Champions
60449,2,19,89,5,3,4,12,Loyal Users
60532,269,14,64,3,3,4,10,Loyal Users
60845,4562,6,14,1,1,1,3,Lost
61012,3123,29,140,1,4,4,9,At Risk
61028,1571,6,9,1,1,1,3,Lost
61279,195,50,90,3,5,4,12,Loyal Users
61316,123,46,189,4,5,5,14,Champions
61331,261,18,41,3,3,3,9,Loyal Users
61404,405,15,30,3,3,2,8,Loyal Users
62235,3866,7,11,1,2,1,4,Lost
62503,108,23,51,4,4,3,11,Loyal Users
62833,584,26,43,2,4,3,9,At Risk
62877,5278,21,84,1,3,4,8,Casual Users
63035,654,5,17,2,1,2,5,Lost
63399,175,13,20,3,3,2,8,Loyal Users
63409,419,18,35,3,3,3,9,Loyal Users
63476,21,57,212,5,5,5,15,Champions
63660,661,7,14,2,2,1,5,Lost
63762,28,58,163,5,5,5,15,Champions
64082,2007,6,8,1,1,1,3,Lost
64099,427,9,18,3,2,2,7,Casual Users
64414,4832,25,35,1,4,3,8,At Risk
64431,92,22,103,4,4,4,12,Champions
64494,139,10,29,4,2,2,8,Promising
64538,92,63,212,4,5,5,14,Champions
64813,959,5,9,2,1,1,4,Lost
64858,114,75,156,4,5,5,14,Champions
65069,26,27,154,5,4,5,14,Champions
65178,1025,7,16,2,2,2,6,Lost
65231,2221,5,23,1,1,2,4,Lost
65254,268,5,5,3,1,1,5,Casual Users
65383,1288,15,22,1,3,2,6,Casual Users
52406,1119,9,69,2,2,4,8,Lost
52617,141,10,13,4,2,1,7,Promising
52750,3667,11,17,1,2,2,5,Lost
52967,350,11,45,3,2,3,8,Casual Users
53034,3400,7,9,1,2,1,4,Lost
53073,379,55,247,3,5,5,13,Loyal Users
53099,563,13,17,2,3,2,7,Casual Users
53129,2248,18,28,1,3,2,6,Casual Users
53529,0,129,311,5,5,5,15,Champions
54388,1011,8,20,2,2,2,6,Lost
54453,1301,9,27,1,2,2,5,Lost
54581,847,219,703,2,5,5,12,At Risk
54852,225,13,66,3,3,4,10,Loyal Users
55016,1856,54,161,1,5,5,11,At Risk
55210,579,5,12,2,1,1,4,Lost
55481,3252,29,87,1,4,4,9,At Risk
55634,1133,24,56,2,4,3,9,At Risk
55872,1271,22,43,1,4,3,8,At Risk
55895,390,34,69,3,4,4,11,Loyal Users
56256,314,6,9,3,1,1,5,Casual Users
56397,16,45,185,5,4,5,14,Champions
56441,5374,5,5,1,1,1,3,Lost
56510,1731,19,56,1,3,3,7,Casual Users
56667,2486,17,55,1,3,3,7,Casual Users
56676,82,5,7,4,1,1,6,Promising
56692,4,77,161,5,5,5,15,Champions
56698,545,67,138,2,5,4,11,At Risk
56718,825,8,32,2,2,3,7,Lost
56858,230,39,137,3,4,4,11,Loyal Users
57185,4513,5,5,1,1,1,3,Lost
57336,5,78,116,5,5,4,14,Champions
57493,113,112,169,4,5,5,14,Champions
57601,259,5,11,3,1,1,5,Casual Users
57702,104,69,459,4,5,5,14,Champions
57707,410,23,84,3,4,4,11,Loyal Users
58284,517,9,16,2,2,2,6,Lost
58319,193,17,62,3,3,3,9,Loyal Users
58975,672,16,82,2,3,4,9,Casual Users
59056,220,16,83,3,3,4,10,Loyal Users
59101,3462,5,15,1,1,1,3,Lost
59259,125,49,201,4,5,5,14,Champions
59709,67,28,186,5,4,5,14,Champions
60074,392,7,9,3,2,1,6,Casual Users
60323,6,5,14,5,1,1,7,Promising
60552,134,65,181,4,5,5,14,Champions
60641,527,9,55,2,2,3,7,Lost
60755,4157,6,6,1,1,1,3,Lost
60758,41,115,501,5,5,5,15,Champions
60961,825,9,16,2,2,2,6,Lost
61524,106,59,133,4,5,4,13,Champions
61743,987,10,14,2,2,1,5,Lost
61798,286,50,82,3,5,4,12,Loyal Users
61937,222,71,527,3,5,5,13,Loyal Users
61983,1407,7,9,1,2,1,4,Lost
62128,2,239,446,5,5,5,15,Champions
62300,17,8,76,5,2,4,11,Promising
62313,1729,7,15,1,2,1,4,Lost
63038,191,46,90,3,5,4,12,Loyal Users
63383,122,116,347,4,5,5,14,Champions
63549,4516,7,14,1,2,1,4,Lost
63725,143,33,83,4,4,4,12,Champions
63750,101,21,86,4,3,4,11,Loyal Users
63945,490,7,47,2,2,3,7,Lost
63976,40,77,587,5,5,5,15,Champions
65025,1130,11,24,2,2,2,6,Lost
65046,366,15,60,3,3,3,9,Loyal Users
65227,84,6,12,4,1,1,6,Promising
52668,4029,6,8,1,1,1,3,Lost
52689,63,15,38,5,3,3,11,Loyal Users
52802,98,42,74,4,4,4,12,Champions
53195,743,5,9,2,1,1,4,Lost
53202,709,26,38,2,4,3,9,At Risk
53298,17,15,45,5,3,3,11,Loyal Users
53476,291,9,50,3,2,3,8,Casual Users
53561,1688,8,33,1,2,3,6,Lost
53580,65,92,285,5,5,5,15,Champions
53670,270,12,35,3,3,3,9,Loyal Users
53718,39,28,90,5,4,4,13,Champions
53804,77,24,55,4,4,3,11,Loyal Users
53870,13,9,35,5,2,3,10,Promising
54402,673,7,9,2,2,1,5,Lost
54495,0,30,95,5,4,4,13,Champions
54562,294,43,66,3,4,4,11,Loyal Users
54571,1276,6,9,1,1,1,3,Lost
54605,748,7,28,2,2,2,6,Lost
54654,834,44,232,2,4,5,11,At Risk
54731,610,6,18,2,1,2,5,Lost
54814,457,11,84,3,2,4,9,Casual Users
55025,145,56,404,4,5,5,14,Champions
55228,421,9,16,3,2,2,7,Casual Users
55289,429,83,210,3,5,5,13,Loyal Users
55409,1557,7,8,1,2,1,4,Lost
55559,124,30,84,4,4,4,12,Champions
55788,21,54,159,5,5,5,15,Champions
56744,252,54,212,3,5,5,13,Loyal Users
56808,679,58,256,2,5,5,12,At Risk
57009,269,6,15,3,1,1,5,Casual Users
57192,1116,22,137,2,4,4,10,At Risk
57480,563,39,47,2,4,3,9,At Risk
57739,833,5,54,2,1,3,6,Lost
57944,124,18,92,4,3,4,11,Loyal Users
58226,1087,7,65,2,2,4,8,Lost
58286,498,13,20,2,3,2,7,Casual Users
58432,466,33,59,3,4,3,10,Loyal Users
58527,1937,5,6,1,1,1,3,Lost
58854,89,103,453,4,5,5,14,Champions
59190,233,74,416,3,5,5,13,Loyal Users
59257,2543,7,29,1,2,2,5,Lost
59645,133,8,38,4,2,3,9,Promising
59728,1607,9,27,1,2,2,5,Lost
60220,3398,5,40,1,1,3,5,Lost
60544,92,6,12,4,1,1,6,Promising
60569,101,43,52,4,4,3,11,Loyal Users
60934,565,28,43,2,4,3,9,At Risk
60951,464,10,28,3,2,2,7,Casual Users
61372,426,7,48,3,2,3,8,Casual Users
61426,0,49,93,5,5,4,14,Champions
61431,162,13,45,4,3,3,10,Loyal Users
61440,3662,9,9,1,2,1,4,Lost
61994,57,24,49,5,4,3,12,Loyal Users
62271,770,17,75,2,3,4,9,Casual Users
62450,668,23,105,2,4,4,10,At Risk
62545,186,22,112,3,4,4,11,Loyal Users
62658,36,63,166,5,5,5,15,Champions
62810,132,13,26,4,3,2,9,Loyal Users
62862,2398,7,11,1,2,1,4,Lost
62903,419,5,5,3,1,1,5,Casual Users
63257,451,51,222,3,5,5,13,Loyal Users
63416,417,10,24,3,2,2,7,Casual Users
63953,121,6,19,4,1,2,7,Promising
64169,1838,6,40,1,1,3,5,Lost
64425,303,14,17,3,3,2,8,Loyal Users
64432,345,19,24,3,3,2,8,Loyal Users
64557,1985,16,19,1,3,2,6,Casual Users
64707,171,56,290,3,5,5,13,Loyal Users
64756,15,23,77,5,4,4,13,Champions
65216,81,6,8,4,1,1,6,Promising
52396,1674,32,34,1,4,3,8,At Risk
52738,1733,8,14,1,2,1,4,Lost
52763,0,218,382,5,5,5,15,Champions
53156,160,22,83,4,4,4,12,Champions
53232,3121,5,6,1,1,1,3,Lost
53262,1838,11,28,1,2,2,5,Lost
53359,2378,10,13,1,2,1,4,Lost
53852,24,165,633,5,5,5,15,Champions
53968,29,10,177,5,2,5,12,Promising
54191,282,30,38,3,4,3,10,Loyal Users
54283,541,7,10,2,2,1,5,Lost
54497,181,59,530,3,5,5,13,Loyal Users
54522,3137,7,30,1,2,2,5,Lost
55046,14,19,38,5,3,3,11,Loyal Users
55544,91,16,28,4,3,2,9,Loyal Users
56125,537,32,46,2,4,3,9,At Risk
56221,105,8,20,4,2,2,8,Promising
57243,38,44,91,5,4,4,13,Champions
57473,407,20,89,3,3,4,10,Loyal Users
57528,514,7,10,2,2,1,5,Lost
57716,140,87,136,4,5,4,13,Champions
57863,195,18,62,3,3,3,9,Loyal Users
58073,78,37,52,4,4,3,11,Loyal Users
58183,518,5,5,2,1,1,4,Lost
58316,573,27,29,2,4,2,8,At Risk
58321,56,7,14,5,2,1,8,Promising
58684,570,5,12,2,1,1,4,Lost
59192,34,55,113,5,5,4,14,Champions
59275,304,118,235,3,5,5,13,Loyal Users
60248,23,53,115,5,5,4,14,Champions
60502,189,21,33,3,3,3,9,Loyal Users
61023,137,12,48,4,3,3,10,Loyal Users
61073,80,25,42,4,4,3,11,Loyal Users
61598,1288,15,21,1,3,2,6,Casual Users
61650,6,89,401,5,5,5,15,Champions
61661,1951,6,17,1,1,2,4,Lost
61796,1020,15,80,2,3,4,9,Casual Users
62029,1101,5,8,2,1,1,4,Lost
62049,96,61,173,4,5,5,14,Champions
62413,13,39,138,5,4,4,13,Champions
62533,20,5,9,5,1,1,7,Promising
62922,546,5,10,2,1,1,4,Lost
63039,271,34,78,3,4,4,11,Loyal Users
63292,96,15,16,4,3,2,9,Loyal Users
63385,1157,14,15,2,3,1,6,Casual Users
63406,258,28,85,3,4,4,11,Loyal Users
63738,4107,7,26,1,2,2,5,Lost
63892,3241,9,9,1,2,1,4,Lost
64050,111,5,6,4,1,1,6,Promising
64228,135,121,219,4,5,5,14,Champions
64283,846,15,15,2,3,1,6,Casual Users
64452,604,27,65,2,4,4,10,At Risk
65014,243,8,40,3,2,3,8,Casual Users
65090,278,5,10,3,1,1,5,Casual Users
65239,102,13,88,4,3,4,11,Loyal Users
65323,534,6,12,2,1,1,4,Lost
52418,4,130,287,5,5,5,15,Champions
52665,847,5,11,2,1,1,4,Lost
52691,1,29,81,5,4,4,13,Champions
52726,7,34,174,5,4,5,14,Champions
52790,118,43,56,4,4,3,11,Loyal Users
52918,2,68,197,5,5,5,15,Champions
53223,533,10,18,2,2,2,6,Lost
53325,85,53,68,4,5,4,13,Champions
53460,97,122,239,4,5,5,14,Champions
53520,86,22,139,4,4,4,12,Champions
53893,1851,13,17,1,3,2,6,Casual Users
53930,123,53,126,4,5,4,13,Champions
54352,43,115,222,5,5,5,15,Champions
54615,411,6,13,3,1,1,5,Casual Users
54721,35,13,22,5,3,2,10,Loyal Users
54809,265,17,50,3,3,3,9,Loyal Users
54946,0,160,321,5,5,5,15,Champions
55123,123,44,65,4,4,4,12,Champions
55558,143,9,34,4,2,3,9,Promising
56223,0,125,475,5,5,5,15,Champions
56300,420,27,32,3,4,3,10,Loyal Users
56333,2423,8,11,1,2,1,4,Lost
56585,417,11,81,3,2,4,9,Casual Users
56894,113,87,205,4,5,5,14,Champions
57052,7,115,142,5,5,4,14,Champions
57455,3,54,148,5,5,5,15,Champions
57468,99,6,7,4,1,1,6,Promising
57599,3991,8,15,1,2,1,4,Lost
57604,1694,6,54,1,1,3,5,Lost
57618,521,7,14,2,2,1,5,Lost
57685,1974,12,23,1,3,2,6,Casual Users
57925,1818,9,23,1,2,2,5,Lost
58067,176,12,40,3,3,3,9,Loyal Users
58330,289,10,26,3,2,2,7,Casual Users
58358,355,8,9,3,2,1,6,Casual Users
58423,129,47,217,4,5,5,14,Champions
58441,2,88,181,5,5,5,15,Champions
58590,1037,6,14,2,1,1,4,Lost
58731,395,9,16,3,2,2,7,Casual Users
58864,587,25,47,2,4,3,9,At Risk
59070,81,7,10,4,2,1,7,Promising
59094,3891,11,21,1,2,2,5,Lost
59174,1685,17,42,1,3,3,7,Casual Users
59235,499,31,53,2,4,3,9,At Risk
59258,856,5,6,2,1,1,4,Lost
59327,3126,5,10,1,1,1,3,Lost
59579,2319,5,11,1,1,1,3,Lost
60446,3,60,407,5,5,5,15,Champions
60524,178,103,337,3,5,5,13,Loyal Users
60690,1001,20,43,2,3,3,8,Casual Users
60825,984,8,14,2,2,1,5,Lost
61052,4217,7,12,1,2,1,4,Lost
61085,37,15,29,5,3,2,10,Loyal Users
61133,252,33,104,3,4,4,11,Loyal Users
61678,568,12,39,2,3,3,8,Casual Users
61742,295,20,31,3,3,2,8,Loyal Users
61999,97,86,168,4,5,5,14,Champions
62001,280,89,387,3,5,5,13,Loyal Users
62143,3907,13,27,1,3,2,6,Casual Users
62438,440,20,97,3,3,4,10,Loyal Users
62552,819,32,110,2,4,4,10,At Risk
62625,1554,23,73,1,4,4,9,At Risk
62657,11,23,35,5,4,3,12,Loyal Users
62808,416,19,23,3,3,2,8,Loyal Users
62910,753,7,9,2,2,1,5,Lost
63208,1484,15,69,1,3,4,8,Casual Users
63375,2652,15,29,1,3,2,6,Casual Users
63952,29,32,56,5,4,3,12,Loyal Users
63972,1123,6,7,2,1,1,4,Lost
64022,284,77,254,3,5,5,13,Loyal Users
64096,2,106,221,5,5,5,15,Champions
64133,11,6,10,5,1,1,7,Promising
64243,2155,13,56,1,3,3,7,Casual Users
64341,579,12,18,2,3,2,7,Casual Users
64598,3144,9,12,1,2,1,4,Lost
64820,113,127,329,4,5,5,14,Champions
65079,44,88,234,5,5,5,15,Champions
52439,3273,10,10,1,2,1,4,Lost
52801,775,17,132,2,3,4,9,Casual Users
52970,86,20,40,4,3,3,10,Loyal Users
53185,4,76,263,5,5,5,15,Champions
53352,9,7,11,5,2,1,8,Promising
53518,125,28,137,4,4,4,12,Champions
53824,411,12,74,3,3,4,10,Loyal Users
53934,232,14,24,3,3,2,8,Loyal Users
54158,86,85,158,4,5,5,14,Champions
54485,769,18,29,2,3,2,7,Casual Users
54617,26,51,188,5,5,5,15,Champions
54887,185,6,12,3,1,1,5,Casual Users
54904,840,17,62,2,3,3,8,Casual Users
55401,308,17,45,3,3,3,9,Loyal Users
55960,463,6,7,3,1,1,5,Casual Users
56033,9,39,101,5,4,4,13,Champions
56080,2,19,48,5,3,3,11,Loyal Users
56146,408,20,25,3,3,2,8,Loyal Users
56336,2429,6,12,1,1,1,3,Lost
56564,32,23,59,5,4,3,12,Loyal Users
57163,117,39,91,4,4,4,12,Champions
57235,123,6,7,4,1,1,6,Promising
57452,188,9,55,3,2,3,8,Casual Users
57607,3894,6,11,1,1,1,3,Lost
58179,18,80,184,5,5,5,15,Champions
58252,965,5,8,2,1,1,4,Lost
58580,3476,13,47,1,3,3,7,Casual Users
58717,4015,9,19,1,2,2,5,Lost
58749,1247,8,16,2,2,2,6,Lost
58763,16,16,22,5,3,2,10,Loyal Users
59079,965,9,23,2,2,2,6,Lost
59156,116,87,265,4,5,5,14,Champions
59164,1079,10,16,2,2,2,6,Lost
59408,5848,6,23,1,1,2,4,Lost
59845,138,32,112,4,4,4,12,Champions
60436,116,57,203,4,5,5,14,Champions
60631,1112,9,27,2,2,2,6,Lost
60738,588,16,79,2,3,4,9,Casual Users
60918,2706,7,10,1,2,1,4,Lost
60956,1468,11,38,1,2,3,6,Lost
61607,2552,5,46,1,1,3,5,Lost
61810,1712,20,36,1,3,3,7,Casual Users
61851,1012,16,20,2,3,2,7,Casual Users
61944,3115,8,15,1,2,1,4,Lost
62932,116,38,321,4,4,5,13,Champions
63370,1270,6,15,1,1,1,3,Lost
63408,408,18,94,3,3,4,10,Loyal Users
63965,268,20,45,3,3,3,9,Loyal Users
64360,0,20,48,5,3,3,11,Loyal Users
64371,387,44,80,3,4,4,11,Loyal Users
64475,902,5,8,2,1,1,4,Lost
64630,229,31,49,3,4,3,10,Loyal Users
64715,1015,13,22,2,3,2,7,Casual Users
64776,1896,6,9,1,1,1,3,Lost
64986,55,26,78,5,4,4,13,Champions
52390,1,19,44,5,3,3,11,Loyal Users
52458,682,15,35,2,3,3,8,Casual Users
52784,169,5,5,3,1,1,5,Casual Users
52978,1950,16,42,1,3,3,7,Casual Users
52986,84,25,58,4,4,3,11,Loyal Users
53374,1658,8,11,1,2,1,4,Lost
53485,153,8,33,4,2,3,9,Promising
54193,85,80,217,4,5,5,14,Champions
54269,1800,37,115,1,4,4,9,At Risk
54512,228,13,24,3,3,2,8,Loyal Users
54767,63,144,434,5,5,5,15,Champions
54886,2217,5,9,1,1,1,3,Lost
55390,1742,21,36,1,3,3,7,Casual Users
55400,2294,8,20,1,2,2,5,Lost
55402,5055,5,16,1,1,2,4,Lost
55947,1002,15,15,2,3,1,6,Casual Users
56320,977,11,14,2,2,1,5,Lost
56403,5,34,69,5,4,4,13,Champions
56541,1519,14,135,1,3,4,8,Casual Users
56886,411,13,34,3,3,3,9,Loyal Users
56901,424,20,131,3,3,4,10,Loyal Users
56907,1328,35,142,1,4,4,9,At Risk
56983,108,69,600,4,5,5,14,Champions
57321,13,99,327,5,5,5,15,Champions
57435,135,43,147,4,4,5,13,Champions
57550,95,18,24,4,3,2,9,Loyal Users
58449,110,33,206,4,4,5,13,Champions
58502,593,18,28,2,3,2,7,Casual Users
58667,3996,7,33,1,2,3,6,Lost
58852,403,15,22,3,3,2,8,Loyal Users
59057,1011,5,22,2,1,2,5,Lost
59243,105,28,86,4,4,4,12,Champions
59414,82,13,22,4,3,2,9,Loyal Users
59535,2417,5,7,1,1,1,3,Lost
59571,120,11,18,4,2,2,8,Promising
59631,93,113,535,4,5,5,14,Champions
59677,2028,9,9,1,2,1,4,Lost
59717,227,16,75,3,3,4,10,Loyal Users
60056,587,15,52,2,3,3,8,Casual Users
60158,566,16,33,2,3,3,8,Casual Users
60205,264,11,28,3,2,2,7,Casual Users
60433,29,42,115,5,4,4,13,Champions
60464,243,11,17,3,2,2,7,Casual Users
60894,2132,15,96,1,3,4,8,Casual Users
60912,688,5,5,2,1,1,4,Lost
61038,101,52,111,4,5,4,13,Champions
61041,543,60,299,2,5,5,12,At Risk
61055,115,27,170,4,4,5,13,Champions
61106,5389,18,71,1,3,4,8,Casual Users
61299,105,51,463,4,5,5,14,Champions
61407,405,15,32,3,3,3,9,Loyal Users
61666,49,42,135,5,4,4,13,Champions
62130,297,35,58,3,4,3,10,Loyal Users
62166,347,8,50,3,2,3,8,Casual Users
62170,57,29,48,5,4,3,12,Loyal Users
62182,76,38,471,4,4,5,13,Champions
62198,1448,25,36,1,4,3,8,At Risk
62297,36,36,91,5,4,4,13,Champions
62298,277,14,21,3,3,2,8,Loyal Users
62748,13,114,581,5,5,5,15,Champions
62845,1617,10,10,1,2,1,4,Lost
63041,357,46,124,3,5,4,12,Loyal Users
63361,419,5,16,3,1,2,6,Casual Users
63519,22,42,68,5,4,4,13,Champions
63625,77,12,114,4,3,4,11,Loyal Users
64116,124,74,129,4,5,4,13,Champions
64174,103,52,190,4,5,5,14,Champions
64210,278,10,46,3,2,3,8,Casual Users
64512,3533,5,6,1,1,1,3,Lost
64611,107,54,121,4,5,4,13,Champions
64684,2649,13,23,1,3,2,6,Casual Users
64809,136,9,23,4,2,2,8,Promising
65412,657,17,32,2,3,3,8,Casual Users
52508,409,8,17,3,2,2,7,Casual Users
52606,1011,7,25,2,2,2,6,Lost
52706,46,142,266,5,5,5,15,Champions
52958,8,21,59,5,3,3,11,Loyal Users
53333,1004,7,10,2,2,1,5,Lost
53353,409,16,21,3,3,2,8,Loyal Users
53463,2369,101,299,1,5,5,11,At Risk
53639,559,39,145,2,4,4,10,At Risk
53641,561,9,27,2,2,2,6,Lost
53885,1437,8,12,1,2,1,4,Lost
53981,2,83,652,5,5,5,15,Champions
53999,419,11,38,3,2,3,8,Casual Users
54223,532,20,117,2,3,4,9,Casual Users
54287,414,9,26,3,2,2,7,Casual Users
54326,69,9,24,5,2,2,9,Promising
54370,1023,5,17,2,1,2,5,Lost
54914,268,67,114,3,5,4,12,Loyal Users
54979,283,15,24,3,3,2,8,Loyal Users
55323,429,21,130,3,3,4,10,Loyal Users
55372,454,10,10,3,2,1,6,Casual Users
55849,2243,6,6,1,1,1,3,Lost
55919,7,62,144,5,5,4,14,Champions
56440,414,7,7,3,2,1,6,Casual Users
56476,1567,27,82,1,4,4,9,At Risk
56708,9,40,102,5,4,4,13,Champions
56801,89,6,18,4,1,2,7,Promising
57073,1664,5,22,1,1,2,4,Lost
57097,1137,6,18,2,1,2,5,Lost
57225,4741,6,37,1,1,3,5,Lost
57227,548,17,39,2,3,3,8,Casual Users
57234,675,7,8,2,2,1,5,Lost
57462,0,141,304,5,5,5,15,Champions
57484,107,7,37,4,2,3,9,Promising
57506,26,14,37,5,3,3,11,Loyal Users
57536,3,17,92,5,3,4,12,Loyal Users
57658,556,16,48,2,3,3,8,Casual Users
57791,173,40,85,3,4,4,11,Loyal Users
57931,395,10,16,3,2,2,7,Casual Users
58152,3,62,239,5,5,5,15,Champions
58283,137,8,24,4,2,2,8,Promising
58289,674,20,35,2,3,3,8,Casual Users
58304,3695,13,46,1,3,3,7,Casual Users
59105,2016,6,6,1,1,1,3,Lost
59279,550,13,13,2,3,1,6,Casual Users
59352,582,43,111,2,4,4,10,At Risk
59456,862,6,9,2,1,1,4,Lost
59980,115,7,45,4,2,3,9,Promising
60112,9,40,194,5,4,5,14,Champions
60594,167,15,44,3,3,3,9,Loyal Users
60784,981,11,18,2,2,2,6,Lost
60837,862,13,37,2,3,3,8,Casual Users
60933,742,7,13,2,2,1,5,Lost
61047,40,21,136,5,3,4,12,Loyal Users
61281,0,103,349,5,5,5,15,Champions
61689,171,8,17,3,2,2,7,Casual Users
62006,72,23,143,4,4,4,12,Champions
62093,542,19,34,2,3,3,8,Casual Users
62302,1409,47,130,1,5,4,10,At Risk
62368,1923,34,125,1,4,4,9,At Risk
62483,253,35,84,3,4,4,11,Loyal Users
62603,1470,21,48,1,3,3,7,Casual Users
62761,133,50,110,4,5,4,13,Champions
63198,130,9,21,4,2,2,8,Promising
63396,82,62,218,4,5,5,14,Champions
64085,665,6,19,2,1,2,5,Lost
64184,20,29,118,5,4,4,13,Champions
64708,50,22,69,5,4,4,13,Champions
64757,2417,6,15,1,1,1,3,Lost
65007,247,16,24,3,3,2,8,Loyal Users
65075,2233,48,172,1,5,5,11,At Risk
65124,126,59,177,4,5,5,14,Champions
65331,3078,6,8,1,1,1,3,Lost
65394,742,15,58,2,3,3,8,Casual Users
65396,423,76,466,3,5,5,13,Loyal Users
65411,92,19,21,4,3,2,9,Loyal Users
53000,1088,39,120,2,4,4,10,At Risk
53593,302,60,260,3,5,5,13,Loyal Users
53606,3131,5,7,1,1,1,3,Lost
54196,1503,15,61,1,3,3,7,Casual Users
54247,121,54,252,4,5,5,14,Champions
54471,590,6,21,2,1,2,5,Lost
54543,842,16,55,2,3,3,8,Casual Users
54927,81,23,49,4,4,3,11,Loyal Users
55296,850,11,16,2,2,2,6,Lost
55787,3137,7,18,1,2,2,5,Lost
56061,667,14,21,2,3,2,7,Casual Users
56126,3103,8,16,1,2,2,5,Lost
56129,238,38,62,3,4,3,10,Loyal Users
56383,251,23,154,3,4,5,12,Loyal Users
56446,260,6,69,3,1,4,8,Casual Users
56807,1895,5,14,1,1,1,3,Lost
57826,263,27,134,3,4,4,11,Loyal Users
58056,297,8,21,3,2,2,7,Casual Users
58124,12,24,90,5,4,4,13,Champions
58605,414,6,7,3,1,1,5,Casual Users
58892,677,5,5,2,1,1,4,Lost
58952,238,66,123,3,5,4,12,Loyal Users
58965,1860,31,76,1,4,4,9,At Risk
59112,650,6,7,2,1,1,4,Lost
59247,8,59,340,5,5,5,15,Champions
59309,130,9,100,4,2,4,10,Promising
59486,2082,7,7,1,2,1,4,Lost
59541,6,80,301,5,5,5,15,Champions
59946,602,17,70,2,3,4,9,Casual Users
59949,3876,13,17,1,3,2,6,Casual Users
60311,793,40,95,2,4,4,10,At Risk
60423,437,19,43,3,3,3,9,Loyal Users
60434,1988,9,23,1,2,2,5,Lost
60608,121,17,75,4,3,4,11,Loyal Users
60936,144,23,83,4,4,4,12,Champions
61360,796,56,202,2,5,5,12,At Risk
61939,719,5,23,2,1,2,5,Lost
62014,721,9,11,2,2,1,5,Lost
62276,39,40,130,5,4,4,13,Champions
62492,39,22,77,5,4,4,13,Champions
63128,194,5,9,3,1,1,5,Casual Users
63179,86,5,6,4,1,1,6,Promising
63210,52,57,80,5,5,4,14,Champions
63428,533,15,19,2,3,2,7,Casual Users
63659,3052,13,17,1,3,2,6,Casual Users
63907,659,63,131,2,5,4,11,At Risk
63909,2264,5,29,1,1,2,4,Lost
64238,250,5,18,3,1,2,6,Casual Users
64242,145,29,61,4,4,3,11,Loyal Users
64352,723,7,42,2,2,3,7,Lost
64407,296,13,174,3,3,5,11,Loyal Users
64417,5671,6,11,1,1,1,3,Lost
64471,239,48,85,3,5,4,12,Loyal Users
64876,320,69,106,3,5,4,12,Loyal Users
65031,2,50,242,5,5,5,15,Champions
65093,314,5,7,3,1,1,5,Casual Users
65115,1222,9,13,2,2,1,5,Lost
65275,136,31,81,4,4,4,12,Champions
65299,1089,10,10,2,2,1,5,Lost
52694,45,138,927,5,5,5,15,Champions
52781,87,80,121,4,5,4,13,Champions
52798,5528,7,13,1,2,1,4,Lost
52890,265,9,11,3,2,1,6,Casual Users
53036,118,21,44,4,3,3,10,Loyal Users
53190,97,115,204,4,5,5,14,Champions
53201,5024,21,47,1,3,3,7,Casual Users
53260,321,70,200,3,5,5,13,Loyal Users
53356,114,9,32,4,2,3,9,Promising
53361,79,99,175,4,5,5,14,Champions
54003,107,148,262,4,5,5,14,Champions
54417,1358,7,12,1,2,1,4,Lost
54569,1436,92,114,1,5,4,10,At Risk
55041,44,59,257,5,5,5,15,Champions
55115,5591,9,20,1,2,2,5,Lost
55797,3,43,70,5,4,4,13,Champions
55914,417,26,42,3,4,3,10,Loyal Users
56053,1,29,46,5,4,3,12,Loyal Users
56235,7,9,31,5,2,2,9,Promising
56269,38,116,245,5,5,5,15,Champions
56391,1858,5,14,1,1,1,3,Lost
56393,846,6,26,2,1,2,5,Lost
56436,695,9,13,2,2,1,5,Lost
56559,404,9,13,3,2,1,6,Casual Users
56679,178,6,9,3,1,1,5,Casual Users
56733,227,16,24,3,3,2,8,Loyal Users
57160,350,57,130,3,5,4,12,Loyal Users
57590,270,10,33,3,2,3,8,Casual Users
57768,1119,5,13,2,1,1,4,Lost
58293,256,90,135,3,5,4,12,Loyal Users
58297,115,23,38,4,4,3,11,Loyal Users
58868,446,13,21,3,3,2,8,Loyal Users
58990,502,9,13,2,2,1,5,Lost
59159,133,40,42,4,4,3,11,Loyal Users
59223,93,69,292,4,5,5,14,Champions
59224,15,33,262,5,4,5,14,Champions
59225,566,5,8,2,1,1,4,Lost
59482,173,93,172,3,5,5,13,Loyal Users
59767,53,24,89,5,4,4,13,Champions
59780,692,33,67,2,4,4,10,At Risk
60016,728,11,15,2,2,1,5,Lost
60044,2277,10,17,1,2,2,5,Lost
60269,56,89,343,5,5,5,15,Champions
60285,1282,9,38,1,2,3,6,Lost
60649,1374,20,33,1,3,3,7,Casual Users
60846,827,9,55,2,2,3,7,Lost
60974,260,9,20,3,2,2,7,Casual Users
61198,636,5,5,2,1,1,4,Lost
61204,265,17,43,3,3,3,9,Loyal Users
61216,408,43,155,3,4,5,12,Loyal Users
61267,409,22,67,3,4,4,11,Loyal Users
61896,433,26,42,3,4,3,10,Loyal Users
62062,122,109,139,4,5,4,13,Champions
62537,1027,5,14,2,1,1,4,Lost
62633,119,86,191,4,5,5,14,Champions
62798,2465,7,10,1,2,1,4,Lost
63046,1468,8,49,1,2,3,6,Lost
63060,538,17,58,2,3,3,8,Casual Users
63227,87,83,225,4,5,5,14,Champions
63397,1755,12,14,1,3,1,5,Casual Users
63901,51,86,801,5,5,5,15,Champions
64008,269,31,104,3,4,4,11,Loyal Users
64042,576,27,38,2,4,3,9,At Risk
64130,78,103,309,4,5,5,14,Champions
64851,445,12,50,3,3,3,9,Loyal Users
52523,3283,54,170,1,5,5,11,At Risk
52526,30,15,34,5,3,3,11,Loyal Users
52636,58,78,220,5,5,5,15,Champions
53266,68,101,326,5,5,5,15,Champions
53443,1099,50,224,2,5,5,12,At Risk
53455,1543,17,53,1,3,3,7,Casual Users
53610,3123,7,7,1,2,1,4,Lost
53619,1761,6,14,1,1,1,3,Lost
53737,22,23,40,5,4,3,12,Loyal Users
53815,130,39,97,4,4,4,12,Champions
53847,3581,14,52,1,3,3,7,Casual Users
54048,455,96,122,3,5,4,12,Loyal Users
54136,566,9,17,2,2,2,6,Lost
54224,566,24,68,2,4,4,10,At Risk
54296,155,16,31,4,3,2,9,Loyal Users
54695,117,49,62,4,5,3,12,Loyal Users
54813,145,6,18,4,1,2,7,Promising
55089,109,66,147,4,5,5,14,Champions
55256,121,13,26,4,3,2,9,Loyal Users
55385,130,31,98,4,4,4,12,Champions
55519,272,8,10,3,2,1,6,Casual Users
55615,270,11,16,3,2,2,7,Casual Users
56222,1727,5,11,1,1,1,3,Lost
56298,104,45,141,4,4,4,12,Champions
56416,988,30,41,2,4,3,9,At Risk
56818,1860,6,29,1,1,2,4,Lost
56820,3500,11,67,1,2,4,7,Lost
56877,538,11,12,2,2,1,5,Lost
57137,703,10,14,2,2,1,5,Lost
57521,26,20,43,5,3,3,11,Loyal Users
57691,1150,5,7,2,1,1,4,Lost
57985,26,143,256,5,5,5,15,Champions
58172,101,13,52,4,3,3,10,Loyal Users
58390,287,5,17,3,1,2,6,Casual Users
58576,2476,7,13,1,2,1,4,Lost
59613,2,48,186,5,5,5,15,Champions
59948,23,118,243,5,5,5,15,Champions
60017,915,14,109,2,3,4,9,Casual Users
60141,13,109,326,5,5,5,15,Champions
60345,12,41,66,5,4,4,13,Champions
60468,413,6,44,3,1,3,7,Casual Users
60827,1008,7,18,2,2,2,6,Lost
61062,696,7,9,2,2,1,5,Lost
61126,315,30,81,3,4,4,11,Loyal Users
61576,33,55,77,5,5,4,14,Champions
61638,88,42,97,4,4,4,12,Champions
61656,34,39,56,5,4,3,12,Loyal Users
61669,56,8,54,5,2,3,10,Promising
61704,8,15,23,5,3,2,10,Loyal Users
61732,82,19,43,4,3,3,10,Loyal Users
61748,408,13,32,3,3,3,9,Loyal Users
62251,325,15,18,3,3,2,8,Loyal Users
62573,229,92,295,3,5,5,13,Loyal Users
62979,278,15,51,3,3,3,9,Loyal Users
63206,826,6,9,2,1,1,4,Lost
63329,26,8,14,5,2,1,8,Promising
63365,2692,5,8,1,1,1,3,Lost
63581,524,6,7,2,1,1,4,Lost
63622,151,9,25,4,2,2,8,Promising
63670,868,9,10,2,2,1,5,Lost
64150,124,13,64,4,3,4,11,Loyal Users
64192,128,18,25,4,3,2,9,Loyal Users
64203,1678,15,60,1,3,3,7,Casual Users
64302,846,6,16,2,1,2,5,Lost
64406,1985,11,13,1,2,1,4,Lost
64819,681,12,57,2,3,3,8,Casual Users
65061,575,11,25,2,2,2,6,Lost
65328,121,11,25,4,2,2,8,Promising
65362,414,6,35,3,1,3,7,Casual Users
52777,1475,8,10,1,2,1,4,Lost
52911,3134,5,16,1,1,2,4,Lost
53484,489,8,27,2,2,2,6,Lost
53491,42,103,919,5,5,5,15,Champions
53590,1,161,461,5,5,5,15,Champions
54052,233,51,192,3,5,5,13,Loyal Users
54112,109,132,476,4,5,5,14,Champions
54118,99,80,366,4,5,5,14,Champions
54175,0,165,476,5,5,5,15,Champions
54400,1336,6,6,1,1,1,3,Lost
54556,125,31,56,4,4,3,11,Loyal Users
54575,18,107,234,5,5,5,15,Champions
54576,69,12,73,5,3,4,12,Loyal Users
54594,569,32,67,2,4,4,10,At Risk
54982,271,24,25,3,4,2,9,Loyal Users
55009,240,7,41,3,2,3,8,Casual Users
55018,312,16,70,3,3,4,10,Loyal Users
55169,126,19,40,4,3,3,10,Loyal Users
55590,697,25,140,2,4,4,10,At Risk
55646,26,6,32,5,1,3,9,Promising
55691,3037,14,24,1,3,2,6,Casual Users
55911,410,192,243,3,5,5,13,Loyal Users
56151,0,59,176,5,5,5,15,Champions
56379,567,17,46,2,3,3,8,Casual Users
56506,1559,5,62,1,1,3,5,Lost
56514,2017,12,18,1,3,2,6,Casual Users
57406,96,59,110,4,5,4,13,Champions
57407,382,66,113,3,5,4,12,Loyal Users
57667,2718,5,16,1,1,2,4,Lost
58158,1410,21,58,1,3,3,7,Casual Users
58462,1012,9,42,2,2,3,7,Lost
58533,297,41,200,3,4,5,12,Loyal Users
58774,286,11,18,3,2,2,7,Casual Users
59152,102,56,294,4,5,5,14,Champions
59523,4260,8,8,1,2,1,4,Lost
59981,2754,15,30,1,3,2,6,Casual Users
60062,251,16,43,3,3,3,9,Loyal Users
60077,1,24,65,5,4,4,13,Champions
60194,84,112,139,4,5,4,13,Champions
60376,233,11,38,3,2,3,8,Casual Users
60391,6,115,308,5,5,5,15,Champions
60916,935,7,13,2,2,1,5,Lost
61137,67,14,84,5,3,4,12,Loyal Users
61496,81,71,449,4,5,5,14,Champions
61522,6,94,279,5,5,5,15,Champions
61936,25,17,85,5,3,4,12,Loyal Users
62080,1854,7,19,1,2,2,5,Lost
62392,984,24,52,2,4,3,9,At Risk
62424,123,27,191,4,4,5,13,Champions
62807,2093,12,32,1,3,3,7,Casual Users
63099,59,34,96,5,4,4,13,Champions
63480,383,126,278,3,5,5,13,Loyal Users
63604,165,42,106,4,4,4,12,Champions
63636,525,5,26,2,1,2,5,Lost
63873,313,38,53,3,4,3,10,Loyal Users
64144,1985,18,35,1,3,3,7,Casual Users
64275,515,57,283,2,5,5,12,At Risk
64692,234,64,127,3,5,4,12,Loyal Users
64717,1115,8,11,2,2,1,5,Lost
64745,496,6,8,2,1,1,4,Lost
64792,2966,20,45,1,3,3,7,Casual Users
64869,1614,18,74,1,3,4,8,Casual Users
52875,7,61,152,5,5,5,15,Champions
53163,1416,12,54,1,3,3,7,Casual Users
53181,2,42,100,5,4,4,13,Champions
53233,631,89,384,2,5,5,12,At Risk
53342,3129,8,23,1,2,2,5,Lost
53668,25,66,448,5,5,5,15,Champions
54445,9,68,213,5,5,5,15,Champions
54597,3,26,107,5,4,4,13,Champions
54625,45,145,494,5,5,5,15,Champions
54716,105,38,80,4,4,4,12,Champions
54758,690,8,21,2,2,2,6,Lost
54796,3392,17,60,1,3,3,7,Casual Users
54830,1829,5,32,1,1,3,5,Lost
55102,137,32,71,4,4,4,12,Champions
55133,276,22,39,3,4,3,10,Loyal Users
55207,293,9,22,3,2,2,7,Casual Users
55694,547,10,29,2,2,2,6,Lost
55856,512,29,47,2,4,3,9,At Risk
55944,85,52,72,4,5,4,13,Champions
56418,123,10,24,4,2,2,8,Promising
56444,293,23,87,3,4,4,11,Loyal Users
56696,4,18,77,5,3,4,12,Loyal Users
56732,57,73,425,5,5,5,15,Champions
56938,1008,6,14,2,1,1,4,Lost
57027,1562,6,11,1,1,1,3,Lost
57049,39,122,200,5,5,5,15,Champions
57077,1448,6,12,1,1,1,3,Lost
57131,111,6,7,4,1,1,6,Promising
57200,389,11,29,3,2,2,7,Casual Users
57433,1142,10,96,2,2,4,8,Lost
57516,214,81,106,3,5,4,12,Loyal Users
58239,15,92,289,5,5,5,15,Champions
58523,72,20,68,4,3,4,11,Loyal Users
58692,1,30,76,5,4,4,13,Champions
58808,8,13,101,5,3,4,12,Loyal Users
59802,839,9,25,2,2,2,6,Lost
60235,124,12,122,4,3,4,11,Loyal Users
60695,934,29,60,2,4,3,9,At Risk
61226,9,77,355,5,5,5,15,Champions
61241,112,20,35,4,3,3,10,Loyal Users
61547,28,19,21,5,3,2,10,Loyal Users
62293,2415,6,15,1,1,1,3,Lost
62378,156,16,49,4,3,3,10,Loyal Users
62522,102,10,21,4,2,2,8,Promising
62544,1273,5,10,1,1,1,3,Lost
62837,3,15,23,5,3,2,10,Loyal Users
62900,33,64,179,5,5,5,15,Champions
63024,16,14,21,5,3,2,10,Loyal Users
63108,414,5,9,3,1,1,5,Casual Users
63531,2008,7,16,1,2,2,5,Lost
63708,116,101,193,4,5,5,14,Champions
63742,610,59,141,2,5,4,11,At Risk
63745,128,88,559,4,5,5,14,Champions
63777,270,61,160,3,5,5,13,Loyal Users
63951,1543,11,16,1,2,2,5,Lost
63974,65,7,24,5,2,2,9,Promising
64041,2241,9,25,1,2,2,5,Lost
64303,64,77,217,5,5,5,15,Champions
64759,460,38,184,3,4,5,12,Loyal Users
52824,5,110,268,5,5,5,15,Champions
52833,271,47,83,3,5,4,12,Loyal Users
53132,286,33,59,3,4,3,10,Loyal Users
53273,549,5,5,2,1,1,4,Lost
53292,72,88,341,4,5,5,14,Champions
53303,43,50,277,5,5,5,15,Champions
53317,10,18,62,5,3,3,11,Loyal Users
53527,110,10,75,4,2,4,10,Promising
53923,8,72,285,5,5,5,15,Champions
54213,529,11,36,2,2,3,7,Lost
54315,97,115,156,4,5,5,14,Champions
54412,2220,6,11,1,1,1,3,Lost
54595,75,67,181,4,5,5,14,Champions
54684,109,34,66,4,4,4,12,Champions
55136,1414,17,42,1,3,3,7,Casual Users
55292,81,18,66,4,3,4,11,Loyal Users
55308,442,7,17,3,2,2,7,Casual Users
55340,112,41,135,4,4,4,12,Champions
55533,416,16,29,3,3,2,8,Loyal Users
55999,1431,6,12,1,1,1,3,Lost
56036,116,10,31,4,2,2,8,Promising
56254,3133,6,9,1,1,1,3,Lost
56406,731,5,14,2,1,1,4,Lost
56426,139,16,33,4,3,3,10,Loyal Users
56442,454,11,65,3,2,4,9,Casual Users
56454,462,27,183,3,4,5,12,Loyal Users
56944,736,31,88,2,4,4,10,At Risk
56947,13,18,42,5,3,3,11,Loyal Users
57299,881,7,8,2,2,1,5,Lost
57784,865,11,34,2,2,3,7,Lost
57820,1416,7,30,1,2,2,5,Lost
58147,246,5,52,3,1,3,7,Casual Users
58178,625,30,154,2,4,5,11,At Risk
58389,278,41,55,3,4,3,10,Loyal Users
58392,1032,18,26,2,3,2,7,Casual Users
58544,1655,6,35,1,1,3,5,Lost
58546,5011,8,41,1,2,3,6,Lost
58880,709,12,37,2,3,3,8,Casual Users
58910,1559,9,15,1,2,1,4,Lost
59404,92,34,128,4,4,4,12,Champions
59722,280,60,407,3,5,5,13,Loyal Users
60086,139,63,114,4,5,4,13,Champions
60561,124,14,32,4,3,3,10,Loyal Users
60622,545,11,21,2,2,2,6,Lost
60772,10,100,368,5,5,5,15,Champions
60828,11,116,198,5,5,5,15,Champions
60969,101,29,32,4,4,3,11,Loyal Users
61049,83,26,71,4,4,4,12,Champions
61146,405,9,25,3,2,2,7,Casual Users
61222,5109,5,49,1,1,3,5,Lost
61303,18,64,143,5,5,4,14,Champions
61324,411,21,75,3,3,4,10,Loyal Users
61347,872,98,325,2,5,5,12,At Risk
61751,673,7,7,2,2,1,5,Lost
62031,428,125,310,3,5,5,13,Loyal Users
62331,548,11,28,2,2,2,6,Lost
62349,113,11,34,4,2,3,9,Promising
62698,259,55,90,3,5,4,12,Loyal Users
62712,5439,19,19,1,3,2,6,Casual Users
62785,253,18,53,3,3,3,9,Loyal Users
63015,268,36,85,3,4,4,11,Loyal Users
63107,142,9,36,4,2,3,9,Promising
63334,127,28,47,4,4,3,11,Loyal Users
63433,184,23,47,3,4,3,10,Loyal Users
63678,12,32,263,5,4,5,14,Champions
63733,158,6,25,4,1,2,7,Promising
64076,642,6,7,2,1,1,4,Lost
64253,1868,7,43,1,2,3,6,Lost
64424,7,17,111,5,3,4,12,Loyal Users
64803,993,8,8,2,2,1,5,Lost
64924,103,30,84,4,4,4,12,Champions
65347,150,36,237,4,4,5,13,Champions
52512,194,103,294,3,5,5,13,Loyal Users
52676,135,14,44,4,3,3,10,Loyal Users
52843,75,62,164,4,5,5,14,Champions
53293,272,13,33,3,3,3,9,Loyal Users
53324,135,7,18,4,2,2,8,Promising
53583,46,20,32,5,3,3,11,Loyal Users
53807,78,137,599,4,5,5,14,Champions
54652,1003,11,32,2,2,3,7,Lost
54755,884,6,14,2,1,1,4,Lost
55022,145,5,5,4,1,1,6,Promising
55208,1997,25,26,1,4,2,7,At Risk
55339,29,5,7,5,1,1,7,Promising
55392,1939,72,265,1,5,5,11,At Risk
55468,874,29,132,2,4,4,10,At Risk
55482,870,8,23,2,2,2,6,Lost
55941,133,44,103,4,4,4,12,Champions
56161,1002,52,75,2,5,4,11,At Risk
56428,2818,6,14,1,1,1,3,Lost
56677,410,26,119,3,4,4,11,Loyal Users
57001,2018,6,74,1,1,4,6,Lost
57042,90,47,99,4,5,4,13,Champions
57522,1770,13,19,1,3,2,6,Casual Users
57744,17,28,77,5,4,4,13,Champions
58198,138,15,34,4,3,3,10,Loyal Users
58205,12,54,144,5,5,4,14,Champions
58342,436,11,54,3,2,3,8,Casual Users
58448,0,17,85,5,3,4,12,Loyal Users
58465,2821,49,127,1,5,4,10,At Risk
58598,859,11,15,2,2,1,5,Lost
58697,637,5,16,2,1,2,5,Lost
58786,239,24,62,3,4,3,10,Loyal Users
58916,731,10,58,2,2,3,7,Lost
59637,1363,17,33,1,3,3,7,Casual Users
59660,5347,18,32,1,3,3,7,Casual Users
59968,3,23,48,5,4,3,12,Loyal Users
59998,994,8,13,2,2,1,5,Lost
60289,22,64,100,5,5,4,14,Champions
60437,1702,17,37,1,3,3,7,Casual Users
60452,737,10,86,2,2,4,8,Lost
60516,18,55,377,5,5,5,15,Champions
60539,2247,5,24,1,1,2,4,Lost
60558,3234,8,10,1,2,1,4,Lost
60579,912,5,10,2,1,1,4,Lost
60582,366,82,177,3,5,5,13,Loyal Users
60589,884,15,23,2,3,2,7,Casual Users
60931,668,19,53,2,3,3,8,Casual Users
60932,3431,12,12,1,3,1,5,Casual Users
61149,109,47,136,4,5,4,13,Champions
61602,538,16,37,2,3,3,8,Casual Users
61761,395,5,7,3,1,1,5,Casual Users
62007,2981,5,22,1,1,2,4,Lost
62127,15,59,192,5,5,5,15,Champions
63104,122,25,78,4,4,4,12,Champions
63182,775,17,139,2,3,4,9,Casual Users
63354,2,103,309,5,5,5,15,Champions
63803,1920,6,38,1,1,3,5,Lost
63919,3502,5,5,1,1,1,3,Lost
64011,152,21,76,4,3,4,11,Loyal Users
64109,55,24,51,5,4,3,12,Loyal Users
64378,113,109,353,4,5,5,14,Champions
64429,112,6,20,4,1,2,7,Promising
64836,138,21,203,4,3,5,12,Loyal Users
64862,144,126,401,4,5,5,14,Champions
64873,521,32,56,2,4,3,9,At Risk
65337,1043,10,54,2,2,3,7,Lost
52383,857,7,11,2,2,1,5,Lost
52495,259,9,68,3,2,4,9,Casual Users
52959,220,5,14,3,1,1,5,Casual Users
53448,7,23,105,5,4,4,13,Champions
53713,693,21,83,2,3,4,9,Casual Users
53719,988,7,32,2,2,3,7,Lost
53763,104,106,268,4,5,5,14,Champions
53964,2048,5,26,1,1,2,4,Lost
54058,793,11,148,2,2,5,9,Lost
54222,79,9,13,4,2,1,7,Promising
55062,25,13,41,5,3,3,11,Loyal Users
55249,60,39,55,5,4,3,12,Loyal Users
55521,406,8,35,3,2,3,8,Casual Users
55535,297,15,34,3,3,3,9,Loyal Users
55587,652,9,17,2,2,2,6,Lost
55770,419,29,58,3,4,3,10,Loyal Users
55852,18,24,151,5,4,5,14,Champions
55931,1133,7,11,2,2,1,5,Lost
55992,109,10,28,4,2,2,8,Promising
56062,962,61,389,2,5,5,12,At Risk
56293,30,20,55,5,3,3,11,Loyal Users
56472,0,51,145,5,5,4,14,Champions
56566,11,16,56,5,3,3,11,Loyal Users
56609,109,116,173,4,5,5,14,Champions
56666,1870,8,10,1,2,1,4,Lost
56723,25,37,120,5,4,4,13,Champions
56809,1260,64,130,1,5,4,10,At Risk
56966,95,16,84,4,3,4,11,Loyal Users
57004,1559,8,41,1,2,3,6,Lost
57054,149,30,69,4,4,4,12,Champions
57078,4407,10,14,1,2,1,4,Lost
57226,1294,5,7,1,1,1,3,Lost
57353,158,20,131,4,3,4,11,Loyal Users
57376,82,18,176,4,3,5,12,Loyal Users
57393,141,21,40,4,3,3,10,Loyal Users
57621,205,79,358,3,5,5,13,Loyal Users
57921,1371,6,7,1,1,1,3,Lost
57950,148,78,271,4,5,5,14,Champions
58381,165,92,314,4,5,5,14,Champions
58596,770,13,129,2,3,4,9,Casual Users
58611,5,6,44,5,1,3,9,Promising
59253,45,54,175,5,5,5,15,Champions
59614,2,11,24,5,2,2,9,Promising
59904,1979,89,248,1,5,5,11,At Risk
59909,1587,9,26,1,2,2,5,Lost
60705,3283,15,21,1,3,2,6,Casual Users
60736,164,5,12,4,1,1,6,Promising
60832,1509,12,69,1,3,4,8,Casual Users
61883,5899,6,12,1,1,1,3,Lost
62020,49,19,31,5,3,2,10,Loyal Users
62249,52,37,68,5,4,4,13,Champions
62890,1729,8,39,1,2,3,6,Lost
63095,862,20,40,2,3,3,8,Casual Users
63213,2302,7,72,1,2,4,7,Lost
63376,57,16,65,5,3,4,12,Loyal Users
63849,178,9,20,3,2,2,7,Casual Users
63935,703,26,86,2,4,4,10,At Risk
63959,1083,13,67,2,3,4,9,Casual Users
64373,175,18,58,3,3,3,9,Loyal Users
64403,109,12,52,4,3,3,10,Loyal Users
64489,119,16,47,4,3,3,10,Loyal Users
64552,521,12,16,2,3,2,7,Casual Users
64627,123,105,701,4,5,5,14,Champions
64744,36,81,174,5,5,5,15,Champions
64875,831,5,7,2,1,1,4,Lost
65108,150,18,87,4,3,4,11,Loyal Users
65208,7,20,54,5,3,3,11,Loyal Users
52403,3111,6,53,1,1,3,5,Lost
52525,333,16,37,3,3,3,9,Loyal Users
52774,1086,7,45,2,2,3,7,Lost
53144,50,37,103,5,4,4,13,Champions
53280,715,38,52,2,4,3,9,At Risk
53403,2417,6,38,1,1,3,5,Lost
53422,935,14,18,2,3,2,7,Casual Users
53586,106,21,92,4,3,4,11,Loyal Users
53747,44,101,655,5,5,5,15,Champions
53783,4690,22,44,1,4,3,8,At Risk
53954,3272,14,49,1,3,3,7,Casual Users
53992,9,93,443,5,5,5,15,Champions
54008,418,8,10,3,2,1,6,Casual Users
54014,822,22,127,2,4,4,10,At Risk
54431,1710,14,46,1,3,3,7,Casual Users
54438,2063,5,5,1,1,1,3,Lost
54507,566,5,7,2,1,1,4,Lost
54513,447,5,29,3,1,2,6,Casual Users
54987,1430,10,14,1,2,1,4,Lost
55030,196,37,205,3,4,5,12,Loyal Users
55421,1743,8,13,1,2,1,4,Lost
55456,0,74,104,5,5,4,14,Champions
55483,841,7,36,2,2,3,7,Lost
55737,165,28,41,4,4,3,11,Loyal Users
55942,108,53,105,4,5,4,13,Champions
55956,4,97,421,5,5,5,15,Champions
56024,402,6,18,3,1,2,6,Casual Users
56084,134,13,20,4,3,2,9,Loyal Users
57203,85,8,37,4,2,3,9,Promising
57325,30,37,161,5,4,5,14,Champions
57873,418,9,20,3,2,2,7,Casual Users
58151,5553,11,16,1,2,2,5,Lost
58186,212,5,9,3,1,1,5,Casual Users
58298,3,26,36,5,4,3,12,Loyal Users
58472,65,61,555,5,5,5,15,Champions
58856,421,25,75,3,4,4,11,Loyal Users
59102,626,26,59,2,4,3,9,At Risk
59116,1699,6,13,1,1,1,3,Lost
59380,123,31,78,4,4,4,12,Champions
59467,697,9,52,2,2,3,7,Lost
59470,922,5,23,2,1,2,5,Lost
59920,110,28,98,4,4,4,12,Champions
59930,581,14,15,2,3,1,6,Casual Users
60403,750,11,18,2,2,2,6,Lost
60499,1160,11,47,2,2,3,7,Lost
61054,22,40,204,5,4,5,14,Champions
61558,30,92,631,5,5,5,15,Champions
61671,1018,6,18,2,1,2,5,Lost
61703,85,45,110,4,4,4,12,Champions
62109,106,7,9,4,2,1,7,Promising
62443,2647,6,9,1,1,1,3,Lost
62582,3,6,11,5,1,1,7,Promising
62964,4604,6,6,1,1,1,3,Lost
63122,724,36,78,2,4,4,10,At Risk
63343,4713,8,11,1,2,1,4,Lost
63563,8,91,216,5,5,5,15,Champions
63632,719,23,76,2,4,4,10,At Risk
63746,410,36,75,3,4,4,11,Loyal Users
63820,124,77,338,4,5,5,14,Champions
64107,2958,9,22,1,2,2,5,Lost
64385,801,13,22,2,3,2,7,Casual Users
64462,1115,9,25,2,2,2,6,Lost
64543,2047,10,17,1,2,2,5,Lost
64607,3286,15,71,1,3,4,8,Casual Users
64771,423,22,78,3,4,4,11,Loyal Users
64808,402,8,14,3,2,1,6,Casual Users
52464,966,30,82,2,4,4,10,At Risk
52516,129,22,33,4,4,3,11,Loyal Users
53779,20,20,81,5,3,4,12,Loyal Users
53826,1799,5,8,1,1,1,3,Lost
53841,785,7,41,2,2,3,7,Lost
54099,138,39,62,4,4,3,11,Loyal Users
54168,114,26,64,4,4,4,12,Champions
54188,470,9,26,3,2,2,7,Casual Users
54742,23,78,399,5,5,5,15,Champions
54884,122,20,55,4,3,3,10,Loyal Users
55130,6,44,69,5,4,4,13,Champions
55358,82,5,18,4,1,2,7,Promising
55922,1763,11,15,1,2,1,4,Lost
56346,275,5,9,3,1,1,5,Casual Users
56577,871,12,52,2,3,3,8,Casual Users
56623,232,18,53,3,3,3,9,Loyal Users
56639,120,78,415,4,5,5,14,Champions
56786,38,11,47,5,2,3,10,Promising
56893,876,7,54,2,2,3,7,Lost
57221,45,84,284,5,5,5,15,Champions
57456,162,13,35,4,3,3,10,Loyal Users
57495,2716,5,6,1,1,1,3,Lost
57785,480,6,6,2,1,1,4,Lost
58411,405,10,30,3,2,2,7,Casual Users
58424,6,31,113,5,4,4,13,Champions
58438,858,26,43,2,4,3,9,At Risk
58481,1009,47,145,2,5,4,11,At Risk
58807,6,35,136,5,4,4,13,Champions
59059,142,17,63,4,3,4,11,Loyal Users
59150,436,10,10,3,2,1,6,Casual Users
59184,86,8,10,4,2,1,7,Promising
59209,253,39,202,3,4,5,12,Loyal Users
59301,13,9,24,5,2,2,9,Promising
59389,263,94,208,3,5,5,13,Loyal Users
60030,122,14,22,4,3,2,9,Loyal Users
60365,3,27,60,5,4,3,12,Loyal Users
60458,44,35,111,5,4,4,13,Champions
60843,131,10,21,4,2,2,8,Promising
60981,24,236,455,5,5,5,15,Champions
61653,618,11,91,2,2,4,8,Lost
62078,1259,86,306,1,5,5,11,At Risk
62216,1558,8,21,1,2,2,5,Lost
62316,129,42,76,4,4,4,12,Champions
62341,35,19,35,5,3,3,11,Loyal Users
62389,2,133,488,5,5,5,15,Champions
62519,164,14,17,4,3,2,9,Loyal Users
62720,279,11,40,3,2,3,8,Casual Users
62766,93,11,32,4,2,3,9,Promising
62907,798,5,7,2,1,1,4,Lost
63211,2121,6,10,1,1,1,3,Lost
63548,581,5,10,2,1,1,4,Lost
63800,2413,8,20,1,2,2,5,Lost
63876,3041,7,17,1,2,2,5,Lost
63878,15,5,15,5,1,1,7,Promising
63881,2067,7,8,1,2,1,4,Lost
64222,994,7,10,2,2,1,5,Lost
64235,1340,15,26,1,3,2,6,Casual Users
64271,2702,65,132,1,5,4,10,At Risk
64420,1262,17,46,1,3,3,7,Casual Users
64799,265,29,164,3,4,5,12,Loyal Users
64920,276,11,32,3,2,3,8,Casual Users
65271,281,57,232,3,5,5,13,Loyal Users
65334,120,29,205,4,4,5,13,Champions
52372,30,25,96,5,4,4,13,Champions
52791,1614,7,29,1,2,2,5,Lost
52909,544,7,9,2,2,1,5,Lost
52937,2135,11,15,1,2,1,4,Lost
53010,77,92,413,4,5,5,14,Champions
53120,697,19,37,2,3,3,8,Casual Users
53199,148,17,37,4,3,3,10,Loyal Users
53320,325,9,9,3,2,1,6,Casual Users
53535,851,14,21,2,3,2,7,Casual Users
53922,604,5,7,2,1,1,4,Lost
54047,2173,38,124,1,4,4,9,At Risk
54327,2668,10,19,1,2,2,5,Lost
54550,553,15,101,2,3,4,9,Casual Users
54840,2679,10,14,1,2,1,4,Lost
54953,151,41,54,4,4,3,11,Loyal Users
55000,1167,24,47,2,4,3,9,At Risk
55010,227,29,39,3,4,3,10,Loyal Users
55349,1128,8,12,2,2,1,5,Lost
55727,144,44,162,4,4,5,13,Champions
55731,740,12,44,2,3,3,8,Casual Users
55754,4,51,77,5,5,4,14,Champions
55800,1157,13,18,2,3,2,7,Casual Users
56069,137,26,36,4,4,3,11,Loyal Users
56239,108,34,125,4,4,4,12,Champions
56242,216,32,92,3,4,4,11,Loyal Users
56270,402,37,62,3,4,3,10,Loyal Users
56812,1699,17,29,1,3,2,6,Casual Users
56952,1104,5,13,2,1,1,4,Lost
56954,27,32,63,5,4,4,13,Champions
57283,106,66,131,4,5,4,13,Champions
57439,1926,23,31,1,4,2,7,At Risk
57441,936,23,25,2,4,2,8,At Risk
57476,677,8,14,2,2,1,5,Lost
57532,277,21,79,3,3,4,10,Loyal Users
57881,105,8,8,4,2,1,7,Promising
58169,424,18,32,3,3,3,9,Loyal Users
58407,270,23,164,3,4,5,12,Loyal Users
59028,263,10,23,3,2,2,7,Casual Users
59371,12,15,69,5,3,4,12,Loyal Users
59399,107,49,369,4,5,5,14,Champions
59462,715,8,11,2,2,1,5,Lost
59576,1122,5,8,2,1,1,4,Lost
59875,563,5,8,2,1,1,4,Lost
59924,281,11,37,3,2,3,8,Casual Users
60096,995,17,60,2,3,3,8,Casual Users
60298,67,24,52,5,4,3,12,Loyal Users
60417,4876,19,138,1,3,4,8,Casual Users
60578,135,17,95,4,3,4,11,Loyal Users
60886,2517,9,13,1,2,1,4,Lost
60909,295,16,31,3,3,2,8,Loyal Users
61050,33,82,352,5,5,5,15,Champions
61080,276,25,60,3,4,3,10,Loyal Users
61414,872,14,48,2,3,3,8,Casual Users
61452,5,32,129,5,4,4,13,Champions
61498,2003,8,28,1,2,2,5,Lost
61553,1129,21,124,2,3,4,9,Casual Users
61965,384,37,294,3,4,5,12,Loyal Users
61996,59,85,203,5,5,5,15,Champions
62085,38,77,214,5,5,5,15,Champions
62733,104,30,106,4,4,4,12,Champions
62946,5458,5,5,1,1,1,3,Lost
63001,1318,22,73,1,4,4,9,At Risk
63439,2446,10,39,1,2,3,6,Lost
63735,442,21,322,3,3,5,11,Loyal Users
63884,92,22,45,4,4,3,11,Loyal Users
64031,969,11,22,2,2,2,6,Lost
64038,3408,5,8,1,1,1,3,Lost
64080,2589,9,18,1,2,2,5,Lost
64163,1078,6,7,2,1,1,4,Lost
64347,112,76,169,4,5,5,14,Champions
64556,1350,26,49,1,4,3,8,At Risk
64784,23,141,313,5,5,5,15,Champions
65175,148,43,226,4,4,5,13,Champions
65384,662,28,70,2,4,4,10,At Risk
52378,130,40,199,4,4,5,13,Champions
52385,2688,7,7,1,2,1,4,Lost
52596,0,67,214,5,5,5,15,Champions
52699,39,110,167,5,5,5,15,Champions
52754,426,15,18,3,3,2,8,Loyal Users
53013,116,24,73,4,4,4,12,Champions
53257,260,9,22,3,2,2,7,Casual Users
53314,412,12,16,3,3,2,8,Loyal Users
53430,299,26,129,3,4,4,11,Loyal Users
53516,114,22,41,4,4,3,11,Loyal Users
53534,461,6,6,3,1,1,5,Casual Users
53543,132,41,280,4,4,5,13,Champions
53692,690,11,78,2,2,4,8,Lost
53900,645,5,11,2,1,1,4,Lost
54702,78,122,469,4,5,5,14,Champions
54728,157,64,133,4,5,4,13,Champions
54761,393,6,7,3,1,1,5,Casual Users
55327,16,22,32,5,4,3,12,Loyal Users
55426,847,6,14,2,1,1,4,Lost
55445,2,55,75,5,5,4,14,Champions
55508,2969,8,18,1,2,2,5,Lost
55515,626,11,26,2,2,2,6,Lost
55568,33,32,53,5,4,3,12,Loyal Users
55574,652,30,42,2,4,3,9,At Risk
55749,583,13,30,2,3,2,7,Casual Users
55897,5886,22,36,1,4,3,8,At Risk
56133,713,10,20,2,2,2,6,Lost
56200,5270,5,5,1,1,1,3,Lost
56503,288,19,94,3,3,4,10,Loyal Users
56521,3469,5,40,1,1,3,5,Lost
57214,1968,8,11,1,2,1,4,Lost
57471,253,36,53,3,4,3,10,Loyal Users
59045,78,23,30,4,4,2,10,Loyal Users
59982,68,51,174,5,5,5,15,Champions
59992,539,6,21,2,1,2,5,Lost
60132,144,9,22,4,2,2,8,Promising
60393,89,20,29,4,3,2,9,Loyal Users
60418,30,10,33,5,2,3,10,Promising
60441,484,30,68,2,4,4,10,At Risk
60538,127,49,86,4,5,4,13,Champions
60545,751,52,172,2,5,5,12,At Risk
60585,4719,17,60,1,3,3,7,Casual Users
60902,694,9,49,2,2,3,7,Lost
61061,83,90,174,4,5,5,14,Champions
61157,723,11,64,2,2,4,8,Lost
61340,0,7,13,5,2,1,8,Promising
61451,12,34,51,5,4,3,12,Loyal Users
61459,67,10,35,5,2,3,10,Promising
61775,1480,6,16,1,1,2,4,Lost
61843,16,80,172,5,5,5,15,Champions
62278,136,57,165,4,5,5,14,Champions
62461,893,22,43,2,4,3,9,At Risk
62470,838,12,20,2,3,2,7,Casual Users
62472,980,29,150,2,4,5,11,At Risk
63073,2713,8,8,1,2,1,4,Lost
63405,114,69,190,4,5,5,14,Champions
63647,2885,7,7,1,2,1,4,Lost
63920,20,72,274,5,5,5,15,Champions
63924,131,199,378,4,5,5,14,Champions
63977,569,7,8,2,2,1,5,Lost
64566,35,7,16,5,2,2,9,Promising
64629,74,69,186,4,5,5,14,Champions
64746,1135,15,84,2,3,4,9,Casual Users
65246,2587,8,57,1,2,3,6,Lost
65403,75,52,83,4,5,4,13,Champions
52369,155,5,17,4,1,2,7,Promising
52437,400,32,53,3,4,3,10,Loyal Users
52467,782,29,32,2,4,3,9,At Risk
52586,907,12,26,2,3,2,7,Casual Users
52885,129,22,53,4,4,3,11,Loyal Users
52912,71,124,542,4,5,5,14,Champions
53035,579,6,16,2,1,2,5,Lost
53124,7,10,48,5,2,3,10,Promising
53398,3551,10,17,1,2,2,5,Lost
53452,2855,6,17,1,1,2,4,Lost
53818,16,75,433,5,5,5,15,Champions
53892,116,29,70,4,4,4,12,Champions
54097,5,17,131,5,3,4,12,Loyal Users
54593,163,100,153,4,5,5,14,Champions
54612,120,62,94,4,5,4,13,Champions
54818,796,15,52,2,3,3,8,Casual Users
54976,13,17,48,5,3,3,11,Loyal Users
55344,237,8,21,3,2,2,7,Casual Users
55834,2222,5,5,1,1,1,3,Lost
56075,18,20,38,5,3,3,11,Loyal Users
56289,1975,5,24,1,1,2,4,Lost
56461,25,9,29,5,2,2,9,Promising
56669,3271,8,8,1,2,1,4,Lost
56715,298,6,17,3,1,2,6,Casual Users
56773,101,128,586,4,5,5,14,Champions
56802,132,55,255,4,5,5,14,Champions
56825,3132,10,53,1,2,3,6,Lost
56881,4,11,46,5,2,3,10,Promising
56985,290,13,27,3,3,2,8,Loyal Users
57155,3968,7,30,1,2,2,5,Lost
57260,128,12,20,4,3,2,9,Loyal Users
57290,2528,20,31,1,3,2,6,Casual Users
57340,529,16,74,2,3,4,9,Casual Users
57492,78,8,25,4,2,2,8,Promising
58100,87,16,67,4,3,4,11,Loyal Users
58139,536,24,133,2,4,4,10,At Risk
58163,245,7,10,3,2,1,6,Casual Users
58210,376,30,103,3,4,4,11,Loyal Users
58335,4,92,126,5,5,4,14,Champions
58354,41,80,124,5,5,4,14,Champions
58383,5,31,48,5,4,3,12,Loyal Users
58693,1,91,175,5,5,5,15,Champions
58911,2565,12,15,1,3,1,5,Casual Users
58945,935,11,37,2,2,3,7,Lost
59282,405,15,37,3,3,3,9,Loyal Users
59609,104,10,25,4,2,2,8,Promising
59835,67,91,188,5,5,5,15,Champions
60022,382,13,129,3,3,4,10,Loyal Users
60635,1,109,387,5,5,5,15,Champions
60692,289,6,14,3,1,1,5,Casual Users
60727,39,15,101,5,3,4,12,Loyal Users
60979,426,8,11,3,2,1,6,Casual Users
61208,125,10,26,4,2,2,8,Promising
61463,1444,5,29,1,1,2,4,Lost
61486,264,24,82,3,4,4,11,Loyal Users
61503,68,99,334,5,5,5,15,Champions
61507,1000,7,13,2,2,1,5,Lost
61618,405,7,10,3,2,1,6,Casual Users
61721,424,10,23,3,2,2,7,Casual Users
61816,590,11,27,2,2,2,6,Lost
62267,38,146,545,5,5,5,15,Champions
62280,1080,7,87,2,2,4,8,Lost
62755,3527,6,19,1,1,2,4,Lost
62756,51,8,9,5,2,1,8,Promising
62799,413,20,49,3,3,3,9,Loyal Users
62923,17,6,34,5,1,3,9,Promising
64157,283,19,38,3,3,3,9,Loyal Users
64308,116,18,22,4,3,2,9,Loyal Users
64620,32,7,19,5,2,2,9,Promising
64927,393,16,30,3,3,2,8,Loyal Users
64977,595,97,303,2,5,5,12,At Risk
52487,849,19,25,2,3,2,7,Casual Users
52546,1652,6,13,1,1,1,3,Lost
52611,411,20,33,3,3,3,9,Loyal Users
52943,128,33,71,4,4,4,12,Champions
53043,1395,7,14,1,2,1,4,Lost
53313,132,15,20,4,3,2,9,Loyal Users
53354,437,17,19,3,3,2,8,Loyal Users
53531,5117,5,9,1,1,1,3,Lost
53654,143,16,73,4,3,4,11,Loyal Users
53659,405,30,102,3,4,4,11,Loyal Users
53714,1595,6,6,1,1,1,3,Lost
53743,211,20,47,3,3,3,9,Loyal Users
54027,95,54,104,4,5,4,13,Champions
54506,730,15,37,2,3,3,8,Casual Users
54627,76,99,386,4,5,5,14,Champions
54833,6,83,263,5,5,5,15,Champions
54899,288,17,70,3,3,4,10,Loyal Users
54998,66,29,53,5,4,3,12,Loyal Users
55057,174,35,77,3,4,4,11,Loyal Users
55523,0,124,456,5,5,5,15,Champions
55609,90,99,576,4,5,5,14,Champions
55636,71,58,169,4,5,5,14,Champions
55896,4100,5,5,1,1,1,3,Lost
56017,173,6,25,3,1,2,6,Casual Users
56070,985,5,5,2,1,1,4,Lost
56087,68,17,38,5,3,3,11,Loyal Users
56182,843,8,19,2,2,2,6,Lost
56312,386,62,115,3,5,4,12,Loyal Users
56632,147,52,133,4,5,4,13,Champions
56693,360,21,134,3,3,4,10,Loyal Users
56953,382,18,24,3,3,2,8,Loyal Users
56989,127,82,339,4,5,5,14,Champions
57411,125,68,126,4,5,4,13,Champions
57543,2259,11,24,1,2,2,5,Lost
57854,239,12,38,3,3,3,9,Loyal Users
57983,678,10,20,2,2,2,6,Lost
58631,100,83,176,4,5,5,14,Champions
59038,4,64,221,5,5,5,15,Champions
59236,2278,31,154,1,4,5,10,At Risk
59342,143,11,42,4,2,3,9,Promising
59359,2420,9,13,1,2,1,4,Lost
59431,454,33,87,3,4,4,11,Loyal Users
60137,1119,13,85,2,3,4,9,Casual Users
60343,1803,15,48,1,3,3,7,Casual Users
60490,1589,5,5,1,1,1,3,Lost
60874,61,28,39,5,4,3,12,Loyal Users
61053,5,39,42,5,4,3,12,Loyal Users
61712,158,31,44,4,4,3,11,Loyal Users
61817,405,5,11,3,1,1,5,Casual Users
61917,50,76,175,5,5,5,15,Champions
61976,7,19,27,5,3,2,10,Loyal Users
62126,72,15,36,4,3,3,10,Loyal Users
62286,3140,5,12,1,1,1,3,Lost
62393,13,20,138,5,3,4,12,Loyal Users
62609,982,39,48,2,4,3,9,At Risk
62694,2411,5,10,1,1,1,3,Lost
62724,140,5,5,4,1,1,6,Promising
63916,254,87,486,3,5,5,13,Loyal Users
63979,391,20,37,3,3,3,9,Loyal Users
64002,1075,13,73,2,3,4,9,Casual Users
64140,14,16,55,5,3,3,11,Loyal Users
64278,122,43,231,4,4,5,13,Champions
64525,539,19,41,2,3,3,8,Casual Users
64642,271,74,198,3,5,5,13,Loyal Users
65056,85,11,11,4,2,1,7,Promising
65063,132,12,21,4,3,2,9,Loyal Users
65149,56,48,75,5,5,4,14,Champions
65155,15,61,320,5,5,5,15,Champions
65261,49,67,287,5,5,5,15,Champions
65416,135,41,89,4,4,4,12,Champions
52434,189,23,30,3,4,2,9,Loyal Users
53028,518,22,25,2,4,2,8,At Risk
53093,685,7,97,2,2,4,8,Lost
53605,1443,5,16,1,1,2,4,Lost
53627,24,115,357,5,5,5,15,Champions
53754,13,8,13,5,2,1,8,Promising
53917,44,105,698,5,5,5,15,Champions
53958,2977,6,6,1,1,1,3,Lost
54491,462,19,21,3,3,2,8,Loyal Users
54528,97,24,75,4,4,4,12,Champions
54780,633,6,18,2,1,2,5,Lost
54791,1,68,265,5,5,5,15,Champions
54967,52,41,72,5,4,4,13,Champions
55050,16,107,395,5,5,5,15,Champions
55499,132,14,34,4,3,3,10,Loyal Users
55932,421,10,36,3,2,3,8,Casual Users
56153,295,72,193,3,5,5,13,Loyal Users
56179,3,58,114,5,5,4,14,Champions
56411,181,12,17,3,3,2,8,Loyal Users
56561,258,89,137,3,5,4,12,Loyal Users
56891,3056,21,111,1,3,4,8,Casual Users
57220,8,7,20,5,2,2,9,Promising
57266,1554,5,13,1,1,1,3,Lost
57315,113,68,296,4,5,5,14,Champions
57365,3824,10,12,1,2,1,4,Lost
57440,111,5,10,4,1,1,6,Promising
57557,5143,5,22,1,1,2,4,Lost
57997,111,7,13,4,2,1,7,Promising
58557,104,56,111,4,5,4,13,Champions
59155,1008,7,10,2,2,1,5,Lost
59248,1435,6,13,1,1,1,3,Lost
59855,147,36,71,4,4,4,12,Champions
60015,33,37,105,5,4,4,13,Champions
60139,2285,27,90,1,4,4,9,At Risk
60187,422,32,116,3,4,4,11,Loyal Users
60321,3,23,33,5,4,3,12,Loyal Users
60481,96,15,32,4,3,3,10,Loyal Users
60513,241,19,40,3,3,3,9,Loyal Users
60573,117,35,55,4,4,3,11,Loyal Users
60777,246,28,140,3,4,4,11,Loyal Users
61066,81,34,91,4,4,4,12,Champions
61194,1587,18,38,1,3,3,7,Casual Users
61213,123,79,155,4,5,5,14,Champions
61309,3,118,162,5,5,5,15,Champions
61695,90,55,301,4,5,5,14,Champions
62112,15,144,360,5,5,5,15,Champions
62217,100,56,113,4,5,4,13,Champions
62218,2964,11,34,1,2,3,6,Lost
62669,812,16,50,2,3,3,8,Casual Users
62820,117,7,11,4,2,1,7,Promising
62876,1274,5,12,1,1,1,3,Lost
63828,1562,6,6,1,1,1,3,Lost
63903,19,24,90,5,4,4,13,Champions
64600,4041,14,15,1,3,1,5,Casual Users
64950,2454,6,26,1,1,2,4,Lost
65077,165,11,36,4,2,3,9,Promising
65293,11,41,70,5,4,4,13,Champions
65425,2246,57,163,1,5,5,11,At Risk
52527,2432,6,16,1,1,2,4,Lost
53096,23,50,194,5,5,5,15,Champions
53312,107,55,215,4,5,5,14,Champions
53472,166,9,24,3,2,2,7,Casual Users
53523,1341,21,68,1,3,4,8,Casual Users
53905,104,243,629,4,5,5,14,Champions
54324,283,5,38,3,1,3,7,Casual Users
54330,283,5,8,3,1,1,5,Casual Users
54635,2,34,65,5,4,4,13,Champions
55280,845,5,17,2,1,2,5,Lost
55381,477,21,103,2,3,4,9,Casual Users
55497,412,20,33,3,3,3,9,Loyal Users
55640,730,15,52,2,3,3,8,Casual Users
55661,273,11,26,3,2,2,7,Casual Users
55793,535,5,15,2,1,1,4,Lost
56064,1410,10,49,1,2,3,6,Lost
56322,833,19,28,2,3,2,7,Casual Users
56349,1876,24,36,1,4,3,8,At Risk
56703,829,14,31,2,3,2,7,Casual Users
56756,324,35,170,3,4,5,12,Loyal Users
57139,126,20,27,4,3,2,9,Loyal Users
57305,1,69,223,5,5,5,15,Champions
57391,4838,6,7,1,1,1,3,Lost
57408,1572,5,6,1,1,1,3,Lost
57598,615,22,102,2,4,4,10,At Risk
57813,122,40,170,4,4,5,13,Champions
58025,0,123,436,5,5,5,15,Champions
58177,117,7,14,4,2,1,7,Promising
58242,117,30,162,4,4,5,13,Champions
58582,114,6,13,4,1,1,6,Promising
58624,81,48,109,4,5,4,13,Champions
58672,838,35,83,2,4,4,10,At Risk
58682,412,21,104,3,3,4,10,Loyal Users
59125,24,8,12,5,2,1,8,Promising
59148,83,154,297,4,5,5,14,Champions
59188,1166,8,30,2,2,2,6,Lost
59241,1876,10,15,1,2,1,4,Lost
59286,90,61,88,4,5,4,13,Champions
59329,5705,40,73,1,4,4,9,At Risk
59744,1541,6,21,1,1,2,4,Lost
59944,11,132,644,5,5,5,15,Champions
59954,3526,20,49,1,3,3,7,Casual Users
60045,826,32,88,2,4,4,10,At Risk
60258,971,14,40,2,3,3,8,Casual Users
60652,2682,16,90,1,3,4,8,Casual Users
60816,6,64,258,5,5,5,15,Champions
60892,2410,26,37,1,4,3,8,At Risk
61175,176,63,528,3,5,5,13,Loyal Users
61763,3101,7,19,1,2,2,5,Lost
61830,481,7,33,2,2,3,7,Lost
61855,3515,7,11,1,2,1,4,Lost
62111,738,13,112,2,3,4,9,Casual Users
62881,567,38,68,2,4,4,10,At Risk
63350,5836,7,10,1,2,1,4,Lost
63550,70,11,31,4,2,2,8,Promising
63566,810,16,70,2,3,4,9,Casual Users
64290,1443,7,26,1,2,2,5,Lost
64422,7,9,51,5,2,3,10,Promising
64553,696,6,15,2,1,1,4,Lost
64955,823,5,5,2,1,1,4,Lost
65141,76,180,646,4,5,5,14,Champions
65143,10,56,106,5,5,4,14,Champions
52498,566,21,35,2,3,3,8,Casual Users
53237,3231,11,12,1,2,1,4,Lost
53404,147,62,182,4,5,5,14,Champions
53581,650,17,44,2,3,3,8,Casual Users
53720,2115,40,135,1,4,4,9,At Risk
53732,11,75,192,5,5,5,15,Champions
53936,7,41,50,5,4,3,12,Loyal Users
54062,1,82,299,5,5,5,15,Champions
54069,2875,29,46,1,4,3,8,At Risk
54338,368,16,66,3,3,4,10,Loyal Users
54350,198,5,9,3,1,1,5,Casual Users
54396,1334,7,9,1,2,1,4,Lost
54779,1650,5,28,1,1,2,4,Lost
54890,14,152,486,5,5,5,15,Champions
54908,106,16,65,4,3,4,11,Loyal Users
55244,177,7,17,3,2,2,7,Casual Users
55320,1118,12,15,2,3,1,6,Casual Users
55407,14,66,125,5,5,4,14,Champions
55517,20,36,51,5,4,3,12,Loyal Users
55774,4458,11,12,1,2,1,4,Lost
55843,114,33,49,4,4,3,11,Loyal Users
56072,554,11,13,2,2,1,5,Lost
56090,319,7,11,3,2,1,6,Casual Users
56412,367,23,29,3,4,2,9,Loyal Users
56453,30,43,116,5,4,4,13,Champions
56705,4395,7,13,1,2,1,4,Lost
56828,68,126,540,5,5,5,15,Champions
56984,730,6,7,2,1,1,4,Lost
57231,66,22,88,5,4,4,13,Champions
57366,154,38,58,4,4,3,11,Loyal Users
57628,2122,5,9,1,1,1,3,Lost
57649,416,24,43,3,4,3,10,Loyal Users
57697,1320,20,76,1,3,4,8,Casual Users
57747,1191,21,49,2,3,3,8,Casual Users
57903,168,61,146,3,5,4,12,Loyal Users
58016,6,20,40,5,3,3,11,Loyal Users
58044,95,49,238,4,5,5,14,Champions
58650,139,6,8,4,1,1,6,Promising
58679,2856,8,13,1,2,1,4,Lost
59290,210,80,124,3,5,4,12,Loyal Users
59335,1238,18,43,2,3,3,8,Casual Users
59365,282,16,58,3,3,3,9,Loyal Users
59592,1831,9,28,1,2,2,5,Lost
59887,992,6,29,2,1,2,5,Lost
59942,2558,30,71,1,4,4,9,At Risk
60214,89,8,28,4,2,2,8,Promising
60286,719,39,171,2,4,5,11,At Risk
60414,993,6,12,2,1,1,4,Lost
60684,1699,7,10,1,2,1,4,Lost
61465,417,42,62,3,4,3,10,Loyal Users
61551,2485,6,10,1,1,1,3,Lost
61789,2132,5,17,1,1,2,4,Lost
61819,3679,9,19,1,2,2,5,Lost
62057,1279,6,10,1,1,1,3,Lost
62290,4,35,77,5,4,4,13,Champions
62580,81,60,141,4,5,4,13,Champions
62610,132,67,134,4,5,4,13,Champions
62631,594,13,36,2,3,3,8,Casual Users
62683,110,25,37,4,4,3,11,Loyal Users
63722,285,15,34,3,3,3,9,Loyal Users
63922,115,163,340,4,5,5,14,Champions
64060,134,43,73,4,4,4,12,Champions
64069,648,45,134,2,4,4,10,At Risk
64143,4061,7,12,1,2,1,4,Lost
64149,423,15,54,3,3,3,9,Loyal Users
64510,1341,6,8,1,1,1,3,Lost
64614,85,5,9,4,1,1,6,Promising
64680,74,48,140,4,5,4,13,Champions
64793,2,71,654,5,5,5,15,Champions
64855,700,5,11,2,1,1,4,Lost
65049,5235,5,17,1,1,2,4,Lost
65176,124,18,88,4,3,4,11,Loyal Users
65369,101,11,27,4,2,2,8,Promising
52448,6,58,102,5,5,4,14,Champions
52460,222,96,155,3,5,5,13,Loyal Users
52663,172,73,91,3,5,4,12,Loyal Users
52883,132,22,53,4,4,3,11,Loyal Users
52985,425,39,63,3,4,4,11,Loyal Users
53018,1090,10,12,2,2,1,5,Lost
53030,21,48,98,5,5,4,14,Champions
53228,508,17,35,2,3,3,8,Casual Users
53426,435,10,14,3,2,1,6,Casual Users
54151,385,13,25,3,3,2,8,Loyal Users
54419,292,5,11,3,1,1,5,Casual Users
54482,676,9,14,2,2,1,5,Lost
54572,139,14,43,4,3,3,10,Loyal Users
54703,1744,5,6,1,1,1,3,Lost
54909,1327,15,24,1,3,2,6,Casual Users
55564,139,7,44,4,2,3,9,Promising
55610,317,23,75,3,4,4,11,Loyal Users
55962,267,17,25,3,3,2,8,Loyal Users
55974,272,9,71,3,2,4,9,Casual Users
56624,1826,8,13,1,2,1,4,Lost
57134,421,15,30,3,3,2,8,Loyal Users
57207,154,28,48,4,4,3,11,Loyal Users
57582,122,12,39,4,3,3,10,Loyal Users
57623,800,14,64,2,3,4,9,Casual Users
57726,1626,10,23,1,2,2,5,Lost
57953,97,11,19,4,2,2,8,Promising
57978,688,19,45,2,3,3,8,Casual Users
58267,4428,31,87,1,4,4,9,At Risk
58434,1126,17,26,2,3,2,7,Casual Users
58719,34,41,370,5,4,5,14,Champions
58954,1,98,320,5,5,5,15,Champions
59149,16,142,251,5,5,5,15,Champions
59962,1515,7,8,1,2,1,4,Lost
59983,589,12,36,2,3,3,8,Casual Users
60279,110,13,94,4,3,4,11,Loyal Users
60335,298,29,77,3,4,4,11,Loyal Users
60567,1848,11,14,1,2,1,4,Lost
60791,1133,15,96,2,3,4,9,Casual Users
60857,134,29,151,4,4,5,13,Champions
60939,305,41,155,3,4,5,12,Loyal Users
60986,204,8,9,3,2,1,6,Casual Users
61203,527,22,191,2,4,5,11,At Risk
61236,112,20,55,4,3,3,10,Loyal Users
61402,44,119,349,5,5,5,15,Champions
61472,408,6,14,3,1,1,5,Casual Users
61812,409,9,9,3,2,1,6,Casual Users
61978,860,9,29,2,2,2,6,Lost
62589,17,112,240,5,5,5,15,Champions
62670,2014,5,17,1,1,2,4,Lost
63052,6,19,27,5,3,2,10,Loyal Users
63154,24,52,188,5,5,5,15,Champions
63276,6,112,234,5,5,5,15,Champions
63794,149,59,111,4,5,4,13,Champions
63921,154,8,13,4,2,1,7,Promising
63958,162,18,49,4,3,3,10,Loyal Users
64218,106,56,125,4,5,4,13,Champions
64467,4,110,137,5,5,4,14,Champions
64499,3554,5,55,1,1,3,5,Lost
64521,346,7,8,3,2,1,6,Casual Users
64532,123,35,57,4,4,3,11,Loyal Users
64571,337,6,6,3,1,1,5,Casual Users
64582,0,17,25,5,3,2,10,Loyal Users
64775,274,21,26,3,3,2,8,Loyal Users
64934,14,38,95,5,4,4,13,Champions
65161,655,8,36,2,2,3,7,Lost
52459,174,15,35,3,3,3,9,Loyal Users
52595,957,64,189,2,5,5,12,At Risk
52945,1665,9,33,1,2,3,6,Lost
53240,24,20,116,5,3,4,12,Loyal Users
53258,170,7,28,3,2,2,7,Casual Users
53285,4653,6,6,1,1,1,3,Lost
53621,2685,7,9,1,2,1,4,Lost
53696,30,49,202,5,5,5,15,Champions
53777,2,62,191,5,5,5,15,Champions
54164,1433,7,20,1,2,2,5,Lost
54178,2747,8,8,1,2,1,4,Lost
54449,2407,9,17,1,2,2,5,Lost
54459,24,38,58,5,4,3,12,Loyal Users
54646,33,51,101,5,5,4,14,Champions
54729,1558,17,29,1,3,2,6,Casual Users
54820,677,85,313,2,5,5,12,At Risk
54843,589,14,20,2,3,2,7,Casual Users
54916,11,26,102,5,4,4,13,Champions
55450,116,96,310,4,5,5,14,Champions
55581,105,135,556,4,5,5,14,Champions
55625,63,11,83,5,2,4,11,Promising
55806,308,31,68,3,4,4,11,Loyal Users
55958,267,5,5,3,1,1,5,Casual Users
56020,3222,8,8,1,2,1,4,Lost
56030,236,31,61,3,4,3,10,Loyal Users
56647,648,13,23,2,3,2,7,Casual Users
57241,14,68,101,5,5,4,14,Champions
57352,2425,10,29,1,2,2,5,Lost
57438,905,10,76,2,2,4,8,Lost
57575,424,19,27,3,3,2,8,Loyal Users
57668,734,10,31,2,2,2,6,Lost
57681,688,11,27,2,2,2,6,Lost
57772,258,21,81,3,3,4,10,Loyal Users
57778,280,20,72,3,3,4,10,Loyal Users
57812,15,12,28,5,3,2,10,Loyal Users
57961,2835,21,45,1,3,3,7,Casual Users
58084,739,9,14,2,2,1,5,Lost
58427,245,28,71,3,4,4,11,Loyal Users
58485,324,11,101,3,2,4,9,Casual Users
58734,55,75,199,5,5,5,15,Champions
58735,1885,8,28,1,2,2,5,Lost
58937,13,44,81,5,4,4,13,Champions
58989,995,11,22,2,2,2,6,Lost
59042,601,15,134,2,3,4,9,Casual Users
59466,141,5,13,4,1,1,6,Promising
59536,2134,8,23,1,2,2,5,Lost
59546,13,12,65,5,3,4,12,Loyal Users
59687,0,38,73,5,4,4,13,Champions
59820,127,89,255,4,5,5,14,Champions
60259,1008,27,50,2,4,3,9,At Risk
60299,4610,12,22,1,3,2,6,Casual Users
60901,119,17,58,4,3,3,10,Loyal Users
60925,844,65,124,2,5,4,11,At Risk
61833,3564,6,11,1,1,1,3,Lost
61934,127,14,37,4,3,3,10,Loyal Users
62074,223,5,21,3,1,2,6,Casual Users
62144,216,66,138,3,5,4,12,Loyal Users
62227,1981,5,20,1,1,2,4,Lost
62382,44,42,305,5,4,5,14,Champions
62512,547,7,26,2,2,2,6,Lost
62750,91,10,35,4,2,3,9,Promising
63259,394,5,11,3,1,1,5,Casual Users
63404,143,70,253,4,5,5,14,Champions
63571,153,23,78,4,4,4,12,Champions
63610,378,44,297,3,4,5,12,Loyal Users
63716,77,85,286,4,5,5,14,Champions
64289,450,13,48,3,3,3,9,Loyal Users
64370,2390,8,30,1,2,2,5,Lost
64426,309,56,105,3,5,4,12,Loyal Users
64621,386,5,12,3,1,1,5,Casual Users
64762,107,61,138,4,5,4,13,Champions
65107,3161,18,35,1,3,3,7,Casual Users
52365,308,16,21,3,3,2,8,Loyal Users
52433,542,25,107,2,4,4,10,At Risk
52511,426,44,76,3,4,4,11,Loyal Users
52902,573,5,8,2,1,1,4,Lost
52922,824,6,9,2,1,1,4,Lost
53618,1401,28,103,1,4,4,9,At Risk
53655,107,64,387,4,5,5,14,Champions
54030,880,29,56,2,4,3,9,At Risk
54032,135,41,227,4,4,5,13,Champions
54666,1,68,150,5,5,5,15,Champions
54730,998,10,43,2,2,3,7,Lost
54787,972,25,67,2,4,4,10,At Risk
54888,684,16,38,2,3,3,8,Casual Users
55088,256,50,120,3,5,4,12,Loyal Users
55682,7,153,318,5,5,5,15,Champions
55850,566,8,24,2,2,2,6,Lost
56341,422,8,18,3,2,2,7,Casual Users
56358,871,6,41,2,1,3,6,Lost
56505,68,14,39,5,3,3,11,Loyal Users
56631,300,28,33,3,4,3,10,Loyal Users
56740,2681,7,7,1,2,1,4,Lost
57006,2566,5,9,1,1,1,3,Lost
57263,169,43,114,3,4,4,11,Loyal Users
57427,882,25,56,2,4,3,9,At Risk
57469,694,17,26,2,3,2,7,Casual Users
57687,115,16,131,4,3,4,11,Loyal Users
57757,729,6,38,2,1,3,6,Lost
58220,270,12,31,3,3,2,8,Loyal Users
58373,406,8,20,3,2,2,7,Casual Users
58386,61,76,129,5,5,4,14,Champions
58416,248,15,56,3,3,3,9,Loyal Users
58983,3549,7,12,1,2,1,4,Lost
59509,38,94,388,5,5,5,15,Champions
59753,72,140,566,4,5,5,14,Champions
59843,643,9,13,2,2,1,5,Lost
59970,15,14,42,5,3,3,11,Loyal Users
60029,8,42,156,5,4,5,14,Champions
60079,270,5,14,3,1,1,5,Casual Users
60278,415,11,25,3,2,2,7,Casual Users
60945,3,94,477,5,5,5,15,Champions
61000,68,63,140,5,5,4,14,Champions
61107,2114,5,9,1,1,1,3,Lost
61231,264,12,25,3,3,2,8,Loyal Users
61694,366,48,95,3,5,4,12,Loyal Users
61823,1078,20,110,2,3,4,9,Casual Users
61844,674,5,36,2,1,3,6,Lost
61913,664,65,125,2,5,4,11,At Risk
62052,35,54,404,5,5,5,15,Champions
62060,1421,15,26,1,3,2,6,Casual Users
62324,118,57,82,4,5,4,13,Champions
62873,289,10,11,3,2,1,6,Casual Users
62879,113,8,36,4,2,3,9,Promising
62990,2315,5,16,1,1,2,4,Lost
63212,1703,6,9,1,1,1,3,Lost
63289,158,43,111,4,4,4,12,Champions
63363,132,8,58,4,2,3,9,Promising
63508,98,90,220,4,5,5,14,Champions
63807,1546,16,30,1,3,2,6,Casual Users
64058,46,16,50,5,3,3,11,Loyal Users
64088,806,15,72,2,3,4,9,Casual Users
64392,97,72,166,4,5,5,14,Champions
64520,515,26,152,2,4,5,11,At Risk
64526,170,6,7,3,1,1,5,Casual Users
64548,4,5,9,5,1,1,7,Promising
64652,676,16,32,2,3,3,8,Casual Users
65173,160,14,72,4,3,4,11,Loyal Users
65183,2,52,515,5,5,5,15,Champions
52605,445,20,46,3,3,3,9,Loyal Users
52646,139,23,26,4,4,2,10,Loyal Users
52659,4,9,37,5,2,3,10,Promising
52690,371,47,175,3,5,5,13,Loyal Users
52923,2,109,462,5,5,5,15,Champions
52979,108,21,125,4,3,4,11,Loyal Users
53166,239,46,184,3,5,5,13,Loyal Users
53343,136,124,501,4,5,5,14,Champions
53367,1704,6,8,1,1,1,3,Lost
53790,148,21,172,4,3,5,12,Loyal Users
53962,625,112,188,2,5,5,12,At Risk
53993,74,45,161,4,4,5,13,Champions
54012,109,24,45,4,4,3,11,Loyal Users
54016,81,23,60,4,4,3,11,Loyal Users
54019,2563,17,26,1,3,2,6,Casual Users
54093,168,23,113,3,4,4,11,Loyal Users
54790,281,35,59,3,4,3,10,Loyal Users
54906,3,15,22,5,3,2,10,Loyal Users
55007,680,15,37,2,3,3,8,Casual Users
55126,522,6,7,2,1,1,4,Lost
55306,119,23,53,4,4,3,11,Loyal Users
55403,3422,9,16,1,2,2,5,Lost
55656,364,6,39,3,1,3,7,Casual Users
55860,129,64,125,4,5,4,13,Champions
56021,339,8,61,3,2,3,8,Casual Users
56171,1420,7,21,1,2,2,5,Lost
56353,510,9,12,2,2,1,5,Lost
56565,133,5,10,4,1,1,6,Promising
56602,36,11,11,5,2,1,8,Promising
56627,146,15,57,4,3,3,10,Loyal Users
56974,186,11,23,3,2,2,7,Casual Users
57011,10,154,328,5,5,5,15,Champions
57135,667,5,10,2,1,1,4,Lost
57146,537,11,20,2,2,2,6,Lost
57165,0,10,30,5,2,2,9,Promising
57449,3435,10,23,1,2,2,5,Lost
57928,282,23,55,3,4,3,10,Loyal Users
57971,110,7,12,4,2,1,7,Promising
58456,395,27,91,3,4,4,11,Loyal Users
58585,14,7,17,5,2,2,9,Promising
58633,36,182,344,5,5,5,15,Champions
58844,21,57,147,5,5,5,15,Champions
58958,107,5,5,4,1,1,6,Promising
58973,2901,8,8,1,2,1,4,Lost
59062,129,54,142,4,5,4,13,Champions
59182,71,62,150,4,5,5,14,Champions
59623,1317,5,9,1,1,1,3,Lost
59633,8,73,147,5,5,5,15,Champions
59711,2171,34,161,1,4,5,10,At Risk
59801,3461,8,15,1,2,1,4,Lost
59879,1144,16,38,2,3,3,8,Casual Users
59885,2043,5,9,1,1,1,3,Lost
59897,97,57,145,4,5,4,13,Champions
60136,12,65,201,5,5,5,15,Champions
60406,1852,6,10,1,1,1,3,Lost
60443,721,5,7,2,1,1,4,Lost
60813,63,30,152,5,4,5,14,Champions
60907,62,47,282,5,5,5,15,Champions
60952,2678,11,11,1,2,1,4,Lost
61318,98,83,273,4,5,5,14,Champions
61405,434,7,10,3,2,1,6,Casual Users
61556,478,12,16,2,3,2,7,Casual Users
61979,387,16,42,3,3,3,9,Loyal Users
61986,138,7,15,4,2,1,7,Promising
62139,132,61,141,4,5,4,13,Champions
62254,1223,8,27,2,2,2,6,Lost
62312,1380,12,71,1,3,4,8,Casual Users
62717,102,94,176,4,5,5,14,Champions
63456,73,35,53,4,4,3,11,Loyal Users
63808,121,10,15,4,2,1,7,Promising
64292,295,40,191,3,4,5,12,Loyal Users
64305,21,59,248,5,5,5,15,Champions
65057,275,30,118,3,4,4,11,Loyal Users
65064,7,35,152,5,4,5,14,Champions
52957,43,26,53,5,4,3,12,Loyal Users
53205,3149,39,80,1,4,4,9,At Risk
53421,1024,6,24,2,1,2,5,Lost
53451,4,103,568,5,5,5,15,Champions
53489,9,71,145,5,5,4,14,Champions
53604,401,21,76,3,3,4,10,Loyal Users
53758,1285,8,11,1,2,1,4,Lost
53803,85,212,530,4,5,5,14,Champions
53928,10,32,175,5,4,5,14,Champions
54021,260,20,41,3,3,3,9,Loyal Users
54387,238,31,129,3,4,4,11,Loyal Users
54694,412,5,8,3,1,1,5,Casual Users
54741,150,39,86,4,4,4,12,Champions
54950,25,30,41,5,4,3,12,Loyal Users
55200,1135,8,11,2,2,1,5,Lost
55242,211,15,26,3,3,2,8,Loyal Users
55877,3408,6,10,1,1,1,3,Lost
56536,809,13,49,2,3,3,8,Casual Users
56990,169,10,45,3,2,3,8,Casual Users
57062,0,36,91,5,4,4,13,Champions
57242,1028,5,9,2,1,1,4,Lost
57500,1374,22,25,1,4,2,7,At Risk
57698,529,140,529,2,5,5,12,At Risk
57720,219,42,140,3,4,4,11,Loyal Users
57793,330,42,259,3,4,5,12,Loyal Users
57804,864,17,30,2,3,2,7,Casual Users
57837,86,9,14,4,2,1,7,Promising
58230,61,52,147,5,5,5,15,Champions
58336,1118,9,15,2,2,1,5,Lost
58451,31,9,14,5,2,1,8,Promising
58709,123,51,117,4,5,4,13,Champions
58921,0,140,401,5,5,5,15,Champions
59012,101,158,318,4,5,5,14,Champions
59127,20,26,52,5,4,3,12,Loyal Users
59374,128,15,50,4,3,3,10,Loyal Users
59415,3224,23,32,1,4,3,8,At Risk
60212,4,128,333,5,5,5,15,Champions
60687,483,5,5,2,1,1,4,Lost
61039,708,9,50,2,2,3,7,Lost
61060,133,14,16,4,3,2,9,Loyal Users
61064,769,5,7,2,1,1,4,Lost
61292,247,21,76,3,3,4,10,Loyal Users
61473,99,15,62,4,3,3,10,Loyal Users
61566,704,7,26,2,2,2,6,Lost
61831,164,61,270,4,5,5,14,Champions
61895,53,26,37,5,4,3,12,Loyal Users
62225,407,20,41,3,3,3,9,Loyal Users
62693,25,95,170,5,5,5,15,Champions
63327,53,121,394,5,5,5,15,Champions
63455,432,29,66,3,4,4,11,Loyal Users
63459,844,6,7,2,1,1,4,Lost
63600,4,6,17,5,1,2,8,Promising
64018,2224,7,39,1,2,3,6,Lost
64279,704,13,29,2,3,2,7,Casual Users
64472,647,20,40,2,3,3,8,Casual Users
52597,16,7,8,5,2,1,8,Promising
52631,35,24,99,5,4,4,13,Champions
52992,151,13,85,4,3,4,11,Loyal Users
53615,105,73,218,4,5,5,14,Champions
53723,511,43,59,2,4,3,9,At Risk
53927,2130,10,14,1,2,1,4,Lost
54245,447,13,13,3,3,1,7,Loyal Users
54278,839,33,90,2,4,4,10,At Risk
54478,658,11,42,2,2,3,7,Lost
55068,129,57,244,4,5,5,14,Champions
55071,509,9,21,2,2,2,6,Lost
55158,54,27,55,5,4,3,12,Loyal Users
55217,129,7,18,4,2,2,8,Promising
55294,697,70,153,2,5,5,12,At Risk
55891,408,14,29,3,3,2,8,Loyal Users
55912,130,184,445,4,5,5,14,Champions
56185,128,25,33,4,4,3,11,Loyal Users
56655,15,138,549,5,5,5,15,Champions
57029,603,12,18,2,3,2,7,Casual Users
57475,462,6,13,3,1,1,5,Casual Users
57722,910,8,13,2,2,1,5,Lost
57807,3890,5,18,1,1,2,4,Lost
57814,272,24,34,3,4,3,10,Loyal Users
57968,302,60,226,3,5,5,13,Loyal Users
58097,2383,9,23,1,2,2,5,Lost
58654,1501,32,180,1,4,5,10,At Risk
58848,3538,6,18,1,1,2,4,Lost
58849,691,8,16,2,2,2,6,Lost
59406,2167,6,9,1,1,1,3,Lost
59593,0,34,89,5,4,4,13,Champions
59653,995,6,9,2,1,1,4,Lost
60013,129,120,134,4,5,4,13,Champions
60088,112,25,48,4,4,3,11,Loyal Users
60675,1289,11,47,1,2,3,6,Lost
60897,59,7,24,5,2,2,9,Promising
60988,153,127,564,4,5,5,14,Champions
61394,870,10,77,2,2,4,8,Lost
61759,5064,7,10,1,2,1,4,Lost
61777,500,38,75,2,4,4,10,At Risk
61906,1398,17,141,1,3,4,8,Casual Users
61911,550,14,24,2,3,2,7,Casual Users
62200,643,15,21,2,3,2,7,Casual Users
62311,212,67,213,3,5,5,13,Loyal Users
62531,1834,11,25,1,2,2,5,Lost
62871,357,11,75,3,2,4,9,Casual Users
62897,848,8,20,2,2,2,6,Lost
63056,73,5,28,4,1,2,7,Promising
63088,1116,6,31,2,1,2,5,Lost
63484,12,10,15,5,2,1,8,Promising
63661,399,8,8,3,2,1,6,Casual Users
63896,2,6,6,5,1,1,7,Promising
63899,496,20,41,2,3,3,8,Casual Users
63904,2241,30,31,1,4,2,7,At Risk
64029,432,6,15,3,1,1,5,Casual Users
64054,112,69,563,4,5,5,14,Champions
64563,5,7,10,5,2,1,8,Promising
64587,2251,6,6,1,1,1,3,Lost
64699,1523,9,34,1,2,3,6,Lost
64990,99,7,34,4,2,3,9,Promising
65076,142,5,9,4,1,1,6,Promising
65217,45,93,242,5,5,5,15,Champions
52414,124,16,75,4,3,4,11,Loyal Users
52904,1988,14,15,1,3,1,5,Casual Users
53477,9,130,1007,5,5,5,15,Champions
53742,128,28,29,4,4,2,10,Loyal Users
53881,528,8,9,2,2,1,5,Lost
53953,7,51,109,5,5,4,14,Champions
53966,49,41,191,5,4,5,14,Champions
54309,1621,8,20,1,2,2,5,Lost
54356,260,140,206,3,5,5,13,Loyal Users
54442,1297,13,33,1,3,3,7,Casual Users
54534,1367,7,18,1,2,2,5,Lost
54735,1027,9,14,2,2,1,5,Lost
54921,315,59,142,3,5,4,12,Loyal Users
55113,1825,12,20,1,3,2,6,Casual Users
55315,975,14,27,2,3,2,7,Casual Users
55453,4265,9,23,1,2,2,5,Lost
55496,90,17,147,4,3,5,12,Loyal Users
55560,68,19,28,5,3,2,10,Loyal Users
55866,978,7,10,2,2,1,5,Lost
56018,259,6,12,3,1,1,5,Casual Users
56317,1243,10,29,2,2,2,6,Lost
56530,5,111,836,5,5,5,15,Champions
56576,859,11,26,2,2,2,6,Lost
56717,839,10,33,2,2,3,7,Lost
56803,289,28,46,3,4,3,10,Loyal Users
56950,3141,5,6,1,1,1,3,Lost
57257,309,14,25,3,3,2,8,Loyal Users
57346,12,57,226,5,5,5,15,Champions
57419,724,12,19,2,3,2,7,Casual Users
57421,24,126,794,5,5,5,15,Champions
57442,1406,5,8,1,1,1,3,Lost
57525,35,31,66,5,4,4,13,Champions
57669,1261,10,11,1,2,1,4,Lost
57808,131,54,133,4,5,4,13,Champions
57912,133,9,16,4,2,2,8,Promising
57991,373,11,34,3,2,3,8,Casual Users
58078,125,19,84,4,3,4,11,Loyal Users
58149,698,7,11,2,2,1,5,Lost
58268,122,106,182,4,5,5,14,Champions
58534,75,133,641,4,5,5,14,Champions
58539,2242,5,18,1,1,2,4,Lost
58569,382,54,217,3,5,5,13,Loyal Users
58730,71,143,316,4,5,5,14,Champions
58750,3591,11,19,1,2,2,5,Lost
58776,807,10,31,2,2,2,6,Lost
58827,569,48,63,2,5,4,11,At Risk
58888,2149,23,28,1,4,2,7,At Risk
59005,41,7,21,5,2,2,9,Promising
59016,1963,10,16,1,2,2,5,Lost
59366,5528,5,34,1,1,3,5,Lost
59629,263,5,19,3,1,2,6,Casual Users
59636,168,70,216,3,5,5,13,Loyal Users
59727,989,5,43,2,1,3,6,Lost
59794,1834,7,13,1,2,1,4,Lost
59833,1567,5,5,1,1,1,3,Lost
59882,264,43,73,3,4,4,11,Loyal Users
59988,38,75,170,5,5,5,15,Champions
60168,422,23,28,3,4,2,9,Loyal Users
60351,118,80,341,4,5,5,14,Champions
60713,1357,23,73,1,4,4,9,At Risk
60910,17,65,143,5,5,4,14,Champions
61058,1231,5,9,2,1,1,4,Lost
61243,126,127,367,4,5,5,14,Champions
61639,87,131,641,4,5,5,14,Champions
61846,4054,7,17,1,2,2,5,Lost
61974,105,52,73,4,5,4,13,Champions
62231,1,106,349,5,5,5,15,Champions
62243,106,6,6,4,1,1,6,Promising
62636,124,43,130,4,4,4,12,Champions
62648,197,32,110,3,4,4,11,Loyal Users
62688,1087,59,183,2,5,5,12,At Risk
62997,2255,6,21,1,1,2,4,Lost
63256,150,61,91,4,5,4,13,Champions
63282,59,46,105,5,5,4,14,Champions
63440,835,14,25,2,3,2,7,Casual Users
64132,98,11,23,4,2,2,8,Promising
64171,1287,17,41,1,3,3,7,Casual Users
64263,655,5,5,2,1,1,4,Lost
64416,270,15,21,3,3,2,8,Loyal Users
64634,3114,32,48,1,4,3,8,At Risk
64861,2665,8,8,1,2,1,4,Lost
65029,53,38,80,5,4,4,13,Champions
52480,127,100,190,4,5,5,14,Champions
52585,123,20,94,4,3,4,11,Loyal Users
52612,534,30,147,2,4,5,11,At Risk
52810,1096,11,11,2,2,1,5,Lost
53140,90,91,332,4,5,5,14,Champions
53270,3,85,210,5,5,5,15,Champions
53331,11,49,151,5,5,5,15,Champions
53406,135,39,60,4,4,3,11,Loyal Users
53495,75,32,298,4,4,5,13,Champions
54319,2337,6,16,1,1,2,4,Lost
54628,1518,47,121,1,5,4,10,At Risk
55342,1742,5,8,1,1,1,3,Lost
55645,5179,7,8,1,2,1,4,Lost
55697,281,17,64,3,3,4,10,Loyal Users
55820,0,57,351,5,5,5,15,Champions
55952,261,15,36,3,3,3,9,Loyal Users
56135,253,54,115,3,5,4,12,Loyal Users
56942,3870,5,6,1,1,1,3,Lost
57277,270,6,37,3,1,3,7,Casual Users
57673,412,31,42,3,4,3,10,Loyal Users
57859,3280,5,11,1,1,1,3,Lost
58279,10,13,36,5,3,3,11,Loyal Users
58567,566,13,25,2,3,2,7,Casual Users
58638,1718,9,23,1,2,2,5,Lost
59245,2690,9,23,1,2,2,5,Lost
59658,610,20,162,2,3,5,10,Casual Users
59710,260,26,98,3,4,4,11,Loyal Users
59869,1230,12,12,2,3,1,6,Casual Users
60117,672,5,7,2,1,1,4,Lost
60145,14,15,43,5,3,3,11,Loyal Users
60390,4596,5,13,1,1,1,3,Lost
60500,920,12,61,2,3,3,8,Casual Users
60504,258,7,21,3,2,2,7,Casual Users
60752,2969,99,287,1,5,5,11,At Risk
60968,3,49,113,5,5,4,14,Champions
61027,422,7,13,3,2,1,6,Casual Users
61388,601,21,41,2,3,3,8,Casual Users
61421,5,27,69,5,4,4,13,Champions
61891,12,12,16,5,3,2,10,Loyal Users
61894,791,8,27,2,2,2,6,Lost
61921,1691,5,16,1,1,2,4,Lost
62595,164,16,21,4,3,2,9,Loyal Users
63418,0,16,61,5,3,3,11,Loyal Users
63603,575,12,15,2,3,1,6,Casual Users
63613,264,12,17,3,3,2,8,Loyal Users
63932,79,73,241,4,5,5,14,Champions
64277,1289,25,58,1,4,3,8,At Risk
64470,2518,10,23,1,2,2,5,Lost
64491,0,175,809,5,5,5,15,Champions
64952,2169,10,40,1,2,3,6,Lost
65048,3008,19,28,1,3,2,6,Casual Users
65073,1,46,100,5,5,4,14,Champions
65159,418,9,17,3,2,2,7,Casual Users
65199,649,6,11,2,1,1,4,Lost
65223,439,8,40,3,2,3,8,Casual Users
65312,87,24,52,4,4,3,11,Loyal Users
65402,42,136,316,5,5,5,15,Champions
52673,129,11,12,4,2,1,7,Promising
52713,438,15,31,3,3,2,8,Loyal Users
53244,3882,11,89,1,2,4,7,Lost
53434,16,9,27,5,2,2,9,Promising
53640,1194,36,86,2,4,4,10,At Risk
53676,158,20,28,4,3,2,9,Loyal Users
54081,417,5,8,3,1,1,5,Casual Users
54463,145,72,120,4,5,4,13,Champions
54488,247,6,6,3,1,1,5,Casual Users
54763,247,9,28,3,2,2,7,Casual Users
54816,636,16,18,2,3,2,7,Casual Users
55040,2853,11,18,1,2,2,5,Lost
55366,28,11,89,5,2,4,11,Promising
55977,2690,5,13,1,1,1,3,Lost
56127,445,26,43,3,4,3,10,Loyal Users
56520,584,14,72,2,3,4,9,Casual Users
56799,2392,20,31,1,3,2,6,Casual Users
57182,8,118,318,5,5,5,15,Champions
57414,231,16,19,3,3,2,8,Loyal Users
57817,382,8,18,3,2,2,7,Casual Users
57945,71,117,271,4,5,5,14,Champions
58501,33,83,283,5,5,5,15,Champions
59849,232,16,22,3,3,2,8,Loyal Users
59899,1323,10,11,1,2,1,4,Lost
60084,432,46,93,3,5,4,12,Loyal Users
60200,1,29,86,5,4,4,13,Champions
60767,45,5,19,5,1,2,8,Promising
61024,646,5,14,2,1,1,4,Lost
61035,1600,12,37,1,3,3,7,Casual Users
61277,2684,12,22,1,3,2,6,Casual Users
62077,261,10,71,3,2,4,9,Casual Users
62211,683,5,14,2,1,1,4,Lost
62493,42,66,403,5,5,5,15,Champions
62721,4469,8,10,1,2,1,4,Lost
62981,409,20,109,3,3,4,10,Loyal Users
63164,1694,6,17,1,1,2,4,Lost
63300,1,8,28,5,2,2,9,Promising
63435,3286,19,40,1,3,3,7,Casual Users
63500,795,5,14,2,1,1,4,Lost
63683,210,13,27,3,3,2,8,Loyal Users
64078,172,9,28,3,2,2,7,Casual Users
64125,101,9,34,4,2,3,9,Promising
64455,11,79,105,5,5,4,14,Champions
64559,414,15,15,3,3,1,7,Loyal Users
65279,422,8,49,3,2,3,8,Casual Users
52520,126,17,56,4,3,3,10,Loyal Users
52674,488,6,25,2,1,2,5,Lost
52995,18,5,7,5,1,1,7,Promising
53044,486,109,177,2,5,5,12,At Risk
53771,1094,5,14,2,1,1,4,Lost
53894,414,17,47,3,3,3,9,Loyal Users
54020,2662,14,21,1,3,2,6,Casual Users
54521,15,11,15,5,2,1,8,Promising
54744,120,133,312,4,5,5,14,Champions
55093,294,20,34,3,3,3,9,Loyal Users
55112,92,117,177,4,5,5,14,Champions
55354,2775,15,25,1,3,2,6,Casual Users
55388,123,41,143,4,4,4,12,Champions
55459,14,5,18,5,1,2,8,Promising
55549,0,8,24,5,2,2,9,Promising
55848,272,11,19,3,2,2,7,Casual Users
56145,1119,5,18,2,1,2,5,Lost
56525,121,22,37,4,4,3,11,Loyal Users
56651,140,6,8,4,1,1,6,Promising
56873,1806,6,10,1,1,1,3,Lost
57047,2491,15,21,1,3,2,6,Casual Users
57268,395,6,6,3,1,1,5,Casual Users
57385,119,71,206,4,5,5,14,Champions
57589,425,38,72,3,4,4,11,Loyal Users
57936,1707,7,8,1,2,1,4,Lost
58495,282,10,24,3,2,2,7,Casual Users
58504,1852,14,24,1,3,2,6,Casual Users
58736,15,15,112,5,3,4,12,Loyal Users
58865,586,17,23,2,3,2,7,Casual Users
60236,1276,5,6,1,1,1,3,Lost
60318,232,99,176,3,5,5,13,Loyal Users
60517,25,13,86,5,3,4,12,Loyal Users
60823,276,13,83,3,3,4,10,Loyal Users
60927,84,34,80,4,4,4,12,Champions
61167,828,5,7,2,1,1,4,Lost
61301,121,67,210,4,5,5,14,Champions
61327,2157,7,11,1,2,1,4,Lost
61355,191,10,11,3,2,1,6,Casual Users
61681,520,24,31,2,4,2,8,At Risk
62108,1266,27,45,1,4,3,8,At Risk
62689,78,40,66,4,4,4,12,Champions
63590,4850,8,11,1,2,1,4,Lost
63654,408,13,36,3,3,3,9,Loyal Users
63815,110,34,54,4,4,3,11,Loyal Users
64388,895,9,13,2,2,1,5,Lost
64827,37,120,362,5,5,5,15,Champions
64964,579,5,8,2,1,1,4,Lost
65094,137,41,154,4,4,5,13,Champions
65179,41,30,70,5,4,4,13,Champions
65259,143,16,55,4,3,3,10,Loyal Users
65417,126,13,59,4,3,3,10,Loyal Users
52391,89,28,81,4,4,4,12,Champions
52416,677,21,42,2,3,3,8,Casual Users
52565,11,27,68,5,4,4,13,Champions
53054,45,83,588,5,5,5,15,Champions
53079,704,5,7,2,1,1,4,Lost
54025,11,179,608,5,5,5,15,Champions
54133,264,14,47,3,3,3,9,Loyal Users
54237,1357,5,22,1,1,2,4,Lost
54375,113,10,40,4,2,3,9,Promising
54508,866,5,10,2,1,1,4,Lost
54961,97,17,31,4,3,2,9,Loyal Users
55072,426,5,12,3,1,1,5,Casual Users
55148,1123,5,6,2,1,1,4,Lost
55524,522,11,22,2,2,2,6,Lost
56059,726,5,33,2,1,3,6,Lost
56438,3831,5,10,1,1,1,3,Lost
56620,501,17,24,2,3,2,7,Casual Users
57375,92,8,13,4,2,1,7,Promising
57467,245,15,73,3,3,4,10,Loyal Users
57587,123,66,91,4,5,4,13,Champions
57672,156,17,24,4,3,2,9,Loyal Users
57675,44,93,198,5,5,5,15,Champions
57836,3009,5,13,1,1,1,3,Lost
57918,3676,9,14,1,2,1,4,Lost
58071,107,59,308,4,5,5,14,Champions
58410,632,41,90,2,4,4,10,At Risk
58476,1582,7,7,1,2,1,4,Lost
59049,1557,16,48,1,3,3,7,Casual Users
59403,553,26,61,2,4,3,9,At Risk
59532,742,5,7,2,1,1,4,Lost
59638,2165,10,20,1,2,2,5,Lost
59640,719,10,24,2,2,2,6,Lost
59644,275,17,83,3,3,4,10,Loyal Users
59786,3,64,178,5,5,5,15,Champions
59813,243,40,87,3,4,4,11,Loyal Users
59941,31,12,15,5,3,1,9,Loyal Users
60176,737,22,179,2,4,5,11,At Risk
60955,335,51,91,3,5,4,12,Loyal Users
60994,3221,7,24,1,2,2,5,Lost
61001,17,23,77,5,4,4,13,Champions
61264,128,96,204,4,5,5,14,Champions
61475,116,16,78,4,3,4,11,Loyal Users
62124,433,9,39,3,2,3,8,Casual Users
62277,92,9,30,4,2,2,8,Promising
62295,241,40,89,3,4,4,11,Loyal Users
63019,628,5,25,2,1,2,5,Lost
63290,237,10,46,3,2,3,8,Casual Users
63341,98,16,69,4,3,4,11,Loyal Users
63344,646,7,21,2,2,2,6,Lost
63760,738,27,46,2,4,3,9,At Risk
64089,958,12,20,2,3,2,7,Casual Users
64213,415,39,345,3,4,5,12,Loyal Users
64255,195,22,35,3,4,3,10,Loyal Users
64443,102,7,28,4,2,2,8,Promising
64780,268,10,12,3,2,1,6,Casual Users
65137,285,54,97,3,5,4,12,Loyal Users
65250,234,5,10,3,1,1,5,Casual Users
52427,671,11,75,2,2,4,8,Lost
53021,405,31,58,3,4,3,10,Loyal Users
53131,228,42,61,3,4,3,10,Loyal Users
53464,423,66,274,3,5,5,13,Loyal Users
53480,30,98,124,5,5,4,14,Champions
53500,855,8,15,2,2,1,5,Lost
53600,1935,6,6,1,1,1,3,Lost
53677,30,8,17,5,2,2,9,Promising
54165,483,7,12,2,2,1,5,Lost
54452,1698,10,15,1,2,1,4,Lost
54900,221,12,149,3,3,5,11,Loyal Users
55333,567,14,146,2,3,4,9,Casual Users
55654,94,24,71,4,4,4,12,Champions
55864,124,15,75,4,3,4,11,Loyal Users
56149,278,26,51,3,4,3,10,Loyal Users
56201,20,17,49,5,3,3,11,Loyal Users
56540,275,6,11,3,1,1,5,Casual Users
56622,1424,21,102,1,3,4,8,Casual Users
56636,143,6,33,4,1,3,8,Promising
56668,4,30,83,5,4,4,13,Champions
56793,19,85,222,5,5,5,15,Champions
57339,2680,8,12,1,2,1,4,Lost
57508,1084,6,9,2,1,1,4,Lost
57561,1420,5,10,1,1,1,3,Lost
58007,215,26,48,3,4,3,10,Loyal Users
58095,12,40,116,5,4,4,13,Champions
59000,1087,24,48,2,4,3,9,At Risk
59139,397,17,49,3,3,3,9,Loyal Users
59215,2803,33,248,1,4,5,10,At Risk
59347,5,13,87,5,3,4,12,Loyal Users
59393,812,16,49,2,3,3,8,Casual Users
59607,506,16,30,2,3,2,7,Casual Users
59669,11,51,163,5,5,5,15,Champions
59713,9,122,513,5,5,5,15,Champions
59856,117,31,75,4,4,4,12,Champions
59898,242,8,31,3,2,2,7,Casual Users
60409,112,34,57,4,4,3,11,Loyal Users
60563,37,52,163,5,5,5,15,Champions
60571,2713,11,33,1,2,3,6,Lost
60661,440,46,92,3,5,4,12,Loyal Users
60753,29,103,377,5,5,5,15,Champions
60778,2344,17,65,1,3,4,8,Casual Users
61070,405,10,22,3,2,2,7,Casual Users
61211,1367,7,7,1,2,1,4,Lost
61730,2665,6,20,1,1,2,4,Lost
62155,269,54,145,3,5,4,12,Loyal Users
62266,121,68,137,4,5,4,13,Champions
62274,815,5,6,2,1,1,4,Lost
62407,43,26,52,5,4,3,12,Loyal Users
63120,292,5,16,3,1,2,6,Casual Users
63274,503,10,15,2,2,1,5,Lost
63437,417,59,161,3,5,5,13,Loyal Users
63879,16,28,43,5,4,3,12,Loyal Users
63925,221,29,58,3,4,3,10,Loyal Users
64010,907,25,68,2,4,4,10,At Risk
64321,30,9,13,5,2,1,8,Promising
64811,124,5,32,4,1,3,8,Promising
64833,2210,8,10,1,2,1,4,Lost
64887,233,65,342,3,5,5,13,Loyal Users
65230,3142,26,63,1,4,4,9,At Risk
65289,1088,7,9,2,2,1,5,Lost
52629,0,119,640,5,5,5,15,Champions
52779,28,21,116,5,3,4,12,Loyal Users
52997,555,5,7,2,1,1,4,Lost
53041,306,8,10,3,2,1,6,Casual Users
53068,30,5,9,5,1,1,7,Promising
53196,134,9,23,4,2,2,8,Promising
53705,1782,12,23,1,3,2,6,Casual Users
54001,4399,7,17,1,2,2,5,Lost
54140,8,34,129,5,4,4,13,Champions
55204,49,10,15,5,2,1,8,Promising
55229,3850,11,17,1,2,2,5,Lost
55464,1814,16,39,1,3,3,7,Casual Users
55663,10,42,130,5,4,4,13,Champions
56046,148,55,104,4,5,4,13,Champions
56083,423,18,24,3,3,2,8,Loyal Users
56113,1147,7,13,2,2,1,5,Lost
56128,12,8,53,5,2,3,10,Promising
56352,2131,10,12,1,2,1,4,Lost
56501,725,51,68,2,5,4,11,At Risk
56531,1721,8,20,1,2,2,5,Lost
56548,10,39,102,5,4,4,13,Champions
56558,570,9,19,2,2,2,6,Lost
56673,2922,7,18,1,2,2,5,Lost
56911,3047,6,6,1,1,1,3,Lost
57281,141,15,101,4,3,4,11,Loyal Users
57420,117,77,176,4,5,5,14,Champions
57562,136,25,180,4,4,5,13,Champions
57999,967,11,13,2,2,1,5,Lost
58068,28,31,98,5,4,4,13,Champions
58096,161,30,66,4,4,4,12,Champions
58137,538,8,24,2,2,2,6,Lost
58801,168,12,108,3,3,4,10,Loyal Users
58907,3603,6,12,1,1,1,3,Lost
58980,155,74,420,4,5,5,14,Champions
59055,3308,6,22,1,1,2,4,Lost
59060,0,22,32,5,4,3,12,Loyal Users
59210,106,42,149,4,4,5,13,Champions
59519,2523,5,5,1,1,1,3,Lost
59655,72,58,102,4,5,4,13,Champions
59675,1421,9,12,1,2,1,4,Lost
59973,567,17,72,2,3,4,9,Casual Users
60138,1275,8,8,1,2,1,4,Lost
60570,1147,11,14,2,2,1,5,Lost
60610,103,31,143,4,4,4,12,Champions
60717,9,35,110,5,4,4,13,Champions
60820,92,11,39,4,2,3,9,Promising
60890,4538,9,18,1,2,2,5,Lost
61221,463,12,18,3,3,2,8,Loyal Users
61288,3148,5,47,1,1,3,5,Lost
61374,16,30,86,5,4,4,13,Champions
61926,2859,17,47,1,3,3,7,Casual Users
61990,147,17,30,4,3,2,9,Loyal Users
61991,51,22,52,5,4,3,12,Loyal Users
62011,20,29,68,5,4,4,13,Champions
62373,3279,6,6,1,1,1,3,Lost
62569,73,6,9,4,1,1,6,Promising
62652,660,8,8,2,2,1,5,Lost
62709,259,72,518,3,5,5,13,Loyal Users
62936,253,8,24,3,2,2,7,Casual Users
63174,2055,11,13,1,2,1,4,Lost
63277,1989,5,9,1,1,1,3,Lost
63511,261,18,79,3,3,4,10,Loyal Users
63537,1484,8,35,1,2,3,6,Lost
63864,1992,9,14,1,2,1,4,Lost
63883,4664,14,30,1,3,2,6,Casual Users
63890,3,97,221,5,5,5,15,Champions
63906,303,63,115,3,5,4,12,Loyal Users
64032,391,37,196,3,4,5,12,Loyal Users
64097,441,10,14,3,2,1,6,Casual Users
64108,11,7,12,5,2,1,8,Promising
64428,3857,8,21,1,2,2,5,Lost
64710,49,128,781,5,5,5,15,Champions
64942,951,8,21,2,2,2,6,Lost
52905,561,27,60,2,4,3,9,At Risk
53281,80,123,228,4,5,5,14,Champions
53390,263,33,87,3,4,4,11,Loyal Users
53567,2409,6,20,1,1,2,4,Lost
53678,442,25,34,3,4,3,10,Loyal Users
54033,38,22,173,5,4,5,14,Champions
54364,1646,6,11,1,1,1,3,Lost
54399,857,6,11,2,1,1,4,Lost
54444,50,29,190,5,4,5,14,Champions
54582,126,13,95,4,3,4,11,Loyal Users
54631,68,122,517,5,5,5,15,Champions
54725,408,7,10,3,2,1,6,Casual Users
55239,1841,6,14,1,1,1,3,Lost
55273,3,41,62,5,4,3,12,Loyal Users
55301,123,54,396,4,5,5,14,Champions
55414,21,72,318,5,5,5,15,Champions
55578,673,12,23,2,3,2,7,Casual Users
55874,104,18,55,4,3,3,10,Loyal Users
55982,416,21,42,3,3,3,9,Loyal Users
56218,1631,16,25,1,3,2,6,Casual Users
56557,5094,7,30,1,2,2,5,Lost
56934,166,56,106,3,5,4,12,Loyal Users
56995,1437,13,50,1,3,3,7,Casual Users
57106,2517,5,23,1,1,2,4,Lost
57244,29,106,396,5,5,5,15,Champions
58325,722,13,15,2,3,1,6,Casual Users
58355,50,37,50,5,4,3,12,Loyal Users
58362,275,121,304,3,5,5,13,Loyal Users
58372,147,55,335,4,5,5,14,Champions
58391,159,56,116,4,5,4,13,Champions
58480,3470,10,13,1,2,1,4,Lost
58489,100,14,40,4,3,3,10,Loyal Users
58882,15,125,322,5,5,5,15,Champions
58920,1673,6,11,1,1,1,3,Lost
59200,426,11,42,3,2,3,8,Casual Users
59269,123,18,46,4,3,3,10,Loyal Users
59446,848,17,38,2,3,3,8,Casual Users
59705,29,28,88,5,4,4,13,Champions
59718,1425,37,78,1,4,4,9,At Risk
59731,588,14,29,2,3,2,7,Casual Users
60111,290,15,56,3,3,3,9,Loyal Users
60146,13,38,107,5,4,4,13,Champions
60453,145,39,172,4,4,5,13,Champions
61009,150,7,8,4,2,1,7,Promising
61036,87,35,83,4,4,4,12,Champions
61430,427,11,63,3,2,4,9,Casual Users
61555,2482,11,52,1,2,3,6,Lost
61569,573,9,32,2,2,3,7,Lost
61952,1276,8,19,1,2,2,5,Lost
62115,1832,5,6,1,1,1,3,Lost
62138,126,98,383,4,5,5,14,Champions
62141,41,184,710,5,5,5,15,Champions
62508,1047,9,31,2,2,2,6,Lost
62867,4247,5,8,1,1,1,3,Lost
63042,930,6,8,2,1,1,4,Lost
63140,249,5,10,3,1,1,5,Casual Users
63234,833,9,19,2,2,2,6,Lost
63306,1997,15,23,1,3,2,6,Casual Users
63478,11,117,721,5,5,5,15,Champions
64179,264,7,9,3,2,1,6,Casual Users
64217,40,61,134,5,5,4,14,Champions
64261,1230,8,15,2,2,1,5,Lost
64687,1099,10,25,2,2,2,6,Lost
65027,246,11,31,3,2,2,7,Casual Users
65054,683,15,23,2,3,2,7,Casual Users
65389,11,19,45,5,3,3,11,Loyal Users
52382,835,19,38,2,3,3,8,Casual Users
52477,2281,5,22,1,1,2,4,Lost
52536,2999,5,5,1,1,1,3,Lost
52603,691,8,24,2,2,2,6,Lost
52685,2287,6,23,1,1,2,4,Lost
52881,159,9,10,4,2,1,7,Promising
53247,85,9,18,4,2,2,8,Promising
53277,165,25,32,4,4,3,11,Loyal Users
53823,73,88,402,4,5,5,14,Champions
53909,130,9,13,4,2,1,7,Promising
53916,105,19,84,4,3,4,11,Loyal Users
54004,5,17,23,5,3,2,10,Loyal Users
54114,116,80,333,4,5,5,14,Champions
54457,372,14,18,3,3,2,8,Loyal Users
54535,867,45,155,2,4,5,11,At Risk
54583,1381,7,9,1,2,1,4,Lost
54934,707,10,18,2,2,2,6,Lost
55064,823,5,20,2,1,2,5,Lost
55270,722,12,27,2,3,2,7,Casual Users
55393,97,25,70,4,4,4,12,Champions
55419,251,9,14,3,2,1,6,Casual Users
55494,31,20,49,5,3,3,11,Loyal Users
55764,562,6,28,2,1,2,5,Lost
55789,732,8,21,2,2,2,6,Lost
56443,0,36,192,5,4,5,14,Champions
56545,3030,27,168,1,4,5,10,At Risk
57230,1407,49,219,1,5,5,11,At Risk
57424,253,48,60,3,5,3,11,Loyal Users
58110,849,14,18,2,3,2,7,Casual Users
58262,58,36,114,5,4,4,13,Champions
58409,213,20,39,3,3,3,9,Loyal Users
58787,4,40,218,5,4,5,14,Champions
58842,695,6,25,2,1,2,5,Lost
59430,110,50,145,4,5,4,13,Champions
60053,437,20,47,3,3,3,9,Loyal Users
60224,101,58,188,4,5,5,14,Champions
60392,1446,6,6,1,1,1,3,Lost
60416,547,12,93,2,3,4,9,Casual Users
60491,1392,24,36,1,4,3,8,At Risk
60740,51,22,32,5,4,3,12,Loyal Users
60924,23,30,73,5,4,4,13,Champions
60975,55,20,147,5,3,5,13,Loyal Users
61919,143,22,27,4,4,2,10,Loyal Users
62219,1012,8,20,2,2,2,6,Lost
62415,111,54,100,4,5,4,13,Champions
62473,380,34,58,3,4,3,10,Loyal Users
62521,93,29,100,4,4,4,12,Champions
62523,501,6,15,2,1,1,4,Lost
62735,1713,5,49,1,1,3,5,Lost
62770,1121,20,59,2,3,3,8,Casual Users
63196,129,34,174,4,4,5,13,Champions
63273,707,17,37,2,3,3,8,Casual Users
63305,241,20,92,3,3,4,10,Loyal Users
63315,2562,43,231,1,4,5,10,At Risk
64007,65,209,456,5,5,5,15,Champions
64465,861,6,19,2,1,2,5,Lost
64690,57,15,37,5,3,3,11,Loyal Users
64755,909,22,25,2,4,2,8,At Risk
64899,1158,5,27,2,1,2,5,Lost
64913,41,12,74,5,3,4,12,Loyal Users
65134,113,23,101,4,4,4,12,Champions
65211,123,22,44,4,4,3,11,Loyal Users
65249,2808,21,30,1,3,2,6,Casual Users
65338,237,5,11,3,1,1,5,Casual Users
65360,1471,49,147,1,5,5,11,At Risk
52402,129,65,170,4,5,5,14,Champions
52505,527,5,7,2,1,1,4,Lost
52613,58,12,20,5,3,2,10,Loyal Users
52635,230,46,89,3,5,4,12,Loyal Users
52793,235,11,14,3,2,1,6,Casual Users
52831,3860,5,8,1,1,1,3,Lost
53153,31,56,140,5,5,4,14,Champions
53515,517,9,17,2,2,2,6,Lost
53991,65,80,427,5,5,5,15,Champions
54018,611,6,16,2,1,2,5,Lost
54527,337,32,135,3,4,4,11,Loyal Users
54690,547,12,33,2,3,3,8,Casual Users
54875,446,58,208,3,5,5,13,Loyal Users
55060,4844,8,25,1,2,2,5,Lost
55082,123,7,32,4,2,3,9,Promising
55087,450,70,186,3,5,5,13,Loyal Users
55156,255,45,81,3,4,4,11,Loyal Users
55310,413,8,13,3,2,1,6,Casual Users
55658,957,7,14,2,2,1,5,Lost
55854,269,36,63,3,4,4,11,Loyal Users
56106,30,42,170,5,4,5,14,Champions
56137,875,5,21,2,1,2,5,Lost
56362,1637,8,20,1,2,2,5,Lost
56598,465,21,43,3,3,3,9,Loyal Users
56826,2246,10,53,1,2,3,6,Lost
56965,2357,5,8,1,1,1,3,Lost
56967,11,124,554,5,5,5,15,Champions
57318,368,38,131,3,4,4,11,Loyal Users
57678,694,14,30,2,3,2,7,Casual Users
57821,54,7,24,5,2,2,9,Promising
57902,40,51,227,5,5,5,15,Champions
58471,2122,17,79,1,3,4,8,Casual Users
58818,673,23,152,2,4,5,11,At Risk
58836,2422,10,15,1,2,1,4,Lost
58934,126,62,76,4,5,4,13,Champions
59733,518,7,25,2,2,2,6,Lost
59764,475,21,75,2,3,4,9,Casual Users
59796,130,77,200,4,5,5,14,Champions
59979,163,53,116,4,5,4,13,Champions
60125,513,33,154,2,4,5,11,At Risk
60210,9,35,41,5,4,3,12,Loyal Users
60482,57,222,319,5,5,5,15,Champions
60535,8,18,38,5,3,3,11,Loyal Users
60616,593,8,14,2,2,1,5,Lost
60800,158,9,20,4,2,2,8,Promising
60802,58,97,381,5,5,5,15,Champions
60868,695,10,43,2,2,3,7,Lost
60991,102,19,116,4,3,4,11,Loyal Users
61040,71,107,262,4,5,5,14,Champions
61379,2009,12,17,1,3,2,6,Casual Users
61707,845,17,22,2,3,2,7,Casual Users
61736,2132,9,53,1,2,3,6,Lost
61797,2828,5,107,1,1,4,6,Lost
62193,92,135,597,4,5,5,14,Champions
62197,2468,9,11,1,2,1,4,Lost
62772,55,57,188,5,5,5,15,Champions
62775,977,6,12,2,1,1,4,Lost
63159,691,7,34,2,2,3,7,Lost
63209,11,91,360,5,5,5,15,Champions
63243,724,7,15,2,2,1,5,Lost
63490,961,11,20,2,2,2,6,Lost
63956,3538,5,8,1,1,1,3,Lost
64115,181,13,36,3,3,3,9,Loyal Users
64146,1662,6,19,1,1,2,4,Lost
64339,203,42,447,3,4,5,12,Loyal Users
64664,1138,61,113,2,5,4,11,At Risk
52497,2,172,317,5,5,5,15,Champions
52574,141,37,89,4,4,4,12,Champions
52942,124,29,53,4,4,3,11,Loyal Users
53077,1445,7,11,1,2,1,4,Lost
53171,62,115,530,5,5,5,15,Champions
53275,1088,23,91,2,4,4,10,At Risk
53569,134,17,33,4,3,3,10,Loyal Users
53869,99,137,428,4,5,5,14,Champions
54249,31,87,121,5,5,4,14,Champions
54783,97,17,27,4,3,2,9,Loyal Users
54808,406,15,37,3,3,3,9,Loyal Users
54836,114,50,104,4,5,4,13,Champions
55039,458,13,46,3,3,3,9,Loyal Users
55107,14,44,165,5,4,5,14,Champions
55175,86,20,36,4,3,3,10,Loyal Users
55252,0,87,234,5,5,5,15,Champions
55672,201,71,139,3,5,4,12,Loyal Users
55886,2646,16,66,1,3,4,8,Casual Users
56372,3275,11,19,1,2,2,5,Lost
56534,151,40,84,4,4,4,12,Champions
56572,120,5,17,4,1,2,7,Promising
56915,2172,13,52,1,3,3,7,Casual Users
57184,555,12,57,2,3,3,8,Casual Users
57186,819,18,37,2,3,3,8,Casual Users
57193,107,93,566,4,5,5,14,Champions
57889,11,157,525,5,5,5,15,Champions
57908,438,11,55,3,2,3,8,Casual Users
58131,1153,18,27,2,3,2,7,Casual Users
58255,901,12,36,2,3,3,8,Casual Users
58344,528,6,7,2,1,1,4,Lost
59040,16,107,155,5,5,5,15,Champions
59294,5,33,37,5,4,3,12,Loyal Users
59610,492,81,258,2,5,5,12,At Risk
60063,1410,8,11,1,2,1,4,Lost
60192,124,71,631,4,5,5,14,Champions
60266,1138,8,9,2,2,1,5,Lost
60394,2158,5,8,1,1,1,3,Lost
60634,1254,6,9,2,1,1,4,Lost
60776,1015,14,128,2,3,4,9,Casual Users
61219,1170,99,149,2,5,5,12,At Risk
61274,818,16,35,2,3,3,8,Casual Users
61338,655,8,41,2,2,3,7,Lost
61461,172,88,276,3,5,5,13,Loyal Users
61505,257,20,34,3,3,3,9,Loyal Users
61869,139,73,80,4,5,4,13,Champions
62495,233,31,57,3,4,3,10,Loyal Users
62600,3309,121,579,1,5,5,11,At Risk
62802,526,11,51,2,2,3,7,Lost
62831,604,6,10,2,1,1,4,Lost
62853,711,8,11,2,2,1,5,Lost
62924,670,13,16,2,3,2,7,Casual Users
63022,576,29,73,2,4,4,10,At Risk
63314,517,6,10,2,1,1,4,Lost
63806,124,21,44,4,3,3,10,Loyal Users
63874,726,39,186,2,4,5,11,At Risk
63912,27,87,202,5,5,5,15,Champions
63936,8,104,554,5,5,5,15,Champions
64049,4424,16,16,1,3,2,6,Casual Users
64207,232,19,24,3,3,2,8,Loyal Users
64262,3112,6,35,1,1,3,5,Lost
64393,185,20,97,3,3,4,10,Loyal Users
64464,7,56,173,5,5,5,15,Champions
64541,101,38,64,4,4,4,12,Champions
64632,375,49,56,3,5,3,11,Loyal Users
64720,3261,13,18,1,3,2,6,Casual Users
64929,0,83,290,5,5,5,15,Champions
64930,275,48,135,3,5,4,12,Loyal Users
65002,85,42,241,4,4,5,13,Champions
52468,271,10,14,3,2,1,6,Casual Users
52551,144,27,59,4,4,3,11,Loyal Users
52604,434,28,102,3,4,4,11,Loyal Users
52628,13,116,434,5,5,5,15,Champions
52816,1975,10,16,1,2,2,5,Lost
52891,2585,5,11,1,1,1,3,Lost
53210,1817,10,28,1,2,2,5,Lost
53376,1378,10,16,1,2,2,5,Lost
53562,21,153,234,5,5,5,15,Champions
53684,90,14,127,4,3,4,11,Loyal Users
53725,3243,9,81,1,2,4,7,Lost
53829,58,75,305,5,5,5,15,Champions
53985,1627,33,79,1,4,4,9,At Risk
54267,126,51,181,4,5,5,14,Champions
54273,94,123,321,4,5,5,14,Champions
54329,245,17,24,3,3,2,8,Loyal Users
54336,3573,5,8,1,1,1,3,Lost
54377,937,41,94,2,4,4,10,At Risk
54467,2783,13,24,1,3,2,6,Casual Users
55006,1415,7,16,1,2,2,5,Lost
55101,130,79,232,4,5,5,14,Champions
55337,5861,8,16,1,2,2,5,Lost
55739,670,19,43,2,3,3,8,Casual Users
56343,127,8,17,4,2,2,8,Promising
56664,185,17,30,3,3,2,8,Loyal Users
56797,11,42,73,5,4,4,13,Champions
57022,3872,32,157,1,4,5,10,At Risk
57074,569,39,87,2,4,4,10,At Risk
57089,790,11,35,2,2,3,7,Lost
57094,57,42,82,5,4,4,13,Champions
57551,3286,7,46,1,2,3,6,Lost
57646,26,58,153,5,5,5,15,Champions
57647,315,52,79,3,5,4,12,Loyal Users
57743,162,7,10,4,2,1,7,Promising
57954,103,31,44,4,4,3,11,Loyal Users
58009,72,186,351,4,5,5,14,Champions
58227,251,11,20,3,2,2,7,Casual Users
58498,5864,7,7,1,2,1,4,Lost
59681,1333,9,16,1,2,2,5,Lost
59740,2442,5,7,1,1,1,3,Lost
59745,80,79,481,4,5,5,14,Champions
60020,253,16,21,3,3,2,8,Loyal Users
60355,2115,7,8,1,2,1,4,Lost
60447,293,23,61,3,4,3,10,Loyal Users
60518,1701,5,6,1,1,1,3,Lost
60543,251,9,10,3,2,1,6,Casual Users
60550,408,9,19,3,2,2,7,Casual Users
60711,668,8,17,2,2,2,6,Lost
60954,262,15,27,3,3,2,8,Loyal Users
61454,4,73,138,5,5,4,14,Champions
61632,3151,6,12,1,1,1,3,Lost
61909,3586,6,9,1,1,1,3,Lost
61940,132,55,308,4,5,5,14,Champions
62158,0,43,60,5,4,3,12,Loyal Users
62314,173,44,78,3,4,4,11,Loyal Users
62353,131,5,5,4,1,1,6,Promising
62578,10,37,218,5,4,5,14,Champions
63237,102,42,264,4,4,5,13,Champions
63494,264,22,40,3,4,3,10,Loyal Users
63523,3574,6,7,1,1,1,3,Lost
63651,675,6,19,2,1,2,5,Lost
63756,190,10,10,3,2,1,6,Casual Users
63852,137,35,101,4,4,4,12,Champions
64220,92,151,342,4,5,5,14,Champions
64257,1296,12,28,1,3,2,6,Casual Users
64438,426,5,6,3,1,1,5,Casual Users
64730,152,23,102,4,4,4,12,Champions
64783,485,8,19,2,2,2,6,Lost
64909,213,49,94,3,5,4,12,Loyal Users
64995,284,6,20,3,1,2,6,Casual Users
52522,107,30,127,4,4,4,12,Champions
52681,4,65,208,5,5,5,15,Champions
52998,148,91,104,4,5,4,13,Champions
53411,79,42,134,4,4,4,12,Champions
53498,28,29,83,5,4,4,13,Champions
53960,543,36,231,2,4,5,11,At Risk
54659,120,25,46,4,4,3,11,Loyal Users
54711,144,98,312,4,5,5,14,Champions
55090,250,46,100,3,5,4,12,Loyal Users
55116,68,57,103,5,5,4,14,Champions
55836,1237,13,31,2,3,2,7,Casual Users
55846,82,114,219,4,5,5,14,Champions
56180,1696,6,22,1,1,2,4,Lost
56246,95,28,34,4,4,3,11,Loyal Users
56364,698,5,22,2,1,2,5,Lost
56380,131,22,54,4,4,3,11,Loyal Users
56537,66,13,34,5,3,3,11,Loyal Users
56854,379,11,29,3,2,2,7,Casual Users
57005,56,83,508,5,5,5,15,Champions
57070,3676,7,69,1,2,4,7,Lost
57080,175,12,36,3,3,3,9,Loyal Users
57136,1526,6,18,1,1,2,4,Lost
57156,314,28,163,3,4,5,12,Loyal Users
57264,265,18,36,3,3,3,9,Loyal Users
57344,974,8,39,2,2,3,7,Lost
57751,16,17,102,5,3,4,12,Loyal Users
57901,83,130,479,4,5,5,14,Champions
58331,7,11,23,5,2,2,9,Promising
58374,2463,7,13,1,2,1,4,Lost
58680,178,14,97,3,3,4,10,Loyal Users
58822,3804,9,14,1,2,1,4,Lost
58943,84,45,121,4,4,4,12,Champions
59143,467,25,40,3,4,3,10,Loyal Users
59291,0,15,175,5,3,5,13,Loyal Users
59987,2264,6,25,1,1,2,4,Lost
60026,25,6,11,5,1,1,7,Promising
60241,107,63,207,4,5,5,14,Champions
60280,248,5,7,3,1,1,5,Casual Users
60580,41,104,222,5,5,5,15,Champions
61214,1804,5,5,1,1,1,3,Lost
61339,2292,18,20,1,3,2,6,Casual Users
61392,96,12,32,4,3,3,10,Loyal Users
61575,141,12,25,4,3,2,9,Loyal Users
61670,708,6,7,2,1,1,4,Lost
61744,131,14,33,4,3,3,10,Loyal Users
61834,268,5,5,3,1,1,5,Casual Users
62010,289,16,45,3,3,3,9,Loyal Users
62039,3881,5,9,1,1,1,3,Lost
62048,396,8,15,3,2,1,6,Casual Users
62260,117,39,203,4,4,5,13,Champions
62339,2859,6,10,1,1,1,3,Lost
62345,118,42,74,4,4,4,12,Champions
62556,0,126,402,5,5,5,15,Champions
62958,125,10,32,4,2,3,9,Promising
62984,9,98,706,5,5,5,15,Champions
63023,4028,6,17,1,1,2,4,Lost
63105,992,5,8,2,1,1,4,Lost
63186,325,6,10,3,1,1,5,Casual Users
63335,669,7,35,2,2,3,7,Lost
63643,9,40,153,5,4,5,14,Champions
63731,444,34,70,3,4,4,11,Loyal Users
64120,3700,19,87,1,3,4,8,Casual Users
64500,162,9,46,4,2,3,9,Promising
65145,36,125,444,5,5,5,15,Champions
65248,760,11,32,2,2,3,7,Lost
52445,410,20,36,3,3,3,9,Loyal Users
53118,2598,8,20,1,2,2,5,Lost
53248,229,6,6,3,1,1,5,Casual Users
53380,91,29,44,4,4,3,11,Loyal Users
53786,23,29,72,5,4,4,13,Champions
53838,2432,5,9,1,1,1,3,Lost
53997,1421,9,21,1,2,2,5,Lost
54054,1601,18,108,1,3,4,8,Casual Users
54103,286,34,85,3,4,4,11,Loyal Users
54323,431,11,12,3,2,1,6,Casual Users
54344,219,52,183,3,5,5,13,Loyal Users
54493,128,10,24,4,2,2,8,Promising
54558,1847,5,14,1,1,1,3,Lost
54658,54,67,157,5,5,5,15,Champions
54661,512,13,23,2,3,2,7,Casual Users
55380,261,28,49,3,4,3,10,Loyal Users
56157,884,6,12,2,1,1,4,Lost
56255,961,26,70,2,4,4,10,At Risk
56335,0,65,543,5,5,5,15,Champions
56347,185,7,19,3,2,2,7,Casual Users
56356,580,17,58,2,3,3,8,Casual Users
56682,3701,13,19,1,3,2,6,Casual Users
56796,6,77,710,5,5,5,15,Champions
56945,325,111,294,3,5,5,13,Loyal Users
57127,36,27,42,5,4,3,12,Loyal Users
57304,240,86,131,3,5,4,12,Loyal Users
57568,395,21,75,3,3,4,10,Loyal Users
57911,121,22,80,4,4,4,12,Champions
58008,374,45,132,3,4,4,11,Loyal Users
58211,1572,8,29,1,2,2,5,Lost
58247,128,75,172,4,5,5,14,Champions
58385,6,27,101,5,4,4,13,Champions
58529,177,48,83,3,5,4,12,Loyal Users
58689,128,15,29,4,3,2,9,Loyal Users
58999,132,16,56,4,3,3,10,Loyal Users
59250,41,27,44,5,4,3,12,Loyal Users
59334,1602,10,10,1,2,1,4,Lost
59461,3131,23,28,1,4,2,7,At Risk
59867,11,79,789,5,5,5,15,Champions
60400,3980,6,7,1,1,1,3,Lost
60774,520,29,64,2,4,4,10,At Risk
61435,838,41,71,2,4,4,10,At Risk
61462,20,138,666,5,5,5,15,Champions
61773,92,12,58,4,3,3,10,Loyal Users
61962,2831,7,10,1,2,1,4,Lost
62205,243,36,86,3,4,4,11,Loyal Users
62479,107,42,118,4,4,4,12,Champions
62501,16,75,185,5,5,5,15,Champions
62811,472,8,9,2,2,1,5,Lost
62960,1,71,235,5,5,5,15,Champions
63176,422,10,33,3,2,3,8,Casual Users
63180,98,35,168,4,4,5,13,Champions
63739,460,22,94,3,4,4,11,Loyal Users
63834,62,13,28,5,3,2,10,Loyal Users
64175,36,52,179,5,5,5,15,Champions
65010,312,5,14,3,1,1,5,Casual Users
65095,648,13,36,2,3,3,8,Casual Users
65132,159,16,205,4,3,5,12,Loyal Users
52422,3144,6,44,1,1,3,5,Lost
52827,127,20,51,4,3,3,10,Loyal Users
53117,461,49,187,3,5,5,13,Loyal Users
53222,359,35,181,3,4,5,12,Loyal Users
53348,713,8,13,2,2,1,5,Lost
53797,294,20,25,3,3,2,8,Loyal Users
53801,0,23,53,5,4,3,12,Loyal Users
53878,3328,14,24,1,3,2,6,Casual Users
53904,446,14,151,3,3,5,11,Loyal Users
54672,272,29,43,3,4,3,10,Loyal Users
55070,264,8,23,3,2,2,7,Casual Users
55094,12,33,54,5,4,3,12,Loyal Users
55098,168,87,165,3,5,5,13,Loyal Users
55194,31,8,10,5,2,1,8,Promising
55353,271,47,64,3,5,4,12,Loyal Users
55862,463,27,47,3,4,3,10,Loyal Users
55939,120,7,15,4,2,1,7,Promising
55961,690,22,54,2,4,3,9,At Risk
56009,1273,5,9,1,1,1,3,Lost
56025,265,48,158,3,5,5,13,Loyal Users
56112,567,8,11,2,2,1,5,Lost
56156,324,15,41,3,3,3,9,Loyal Users
56247,849,6,8,2,1,1,4,Lost
56292,151,10,33,4,2,3,9,Promising
56334,1,53,109,5,5,4,14,Champions
56543,25,90,242,5,5,5,15,Champions
56860,126,10,42,4,2,3,9,Promising
56908,1003,5,10,2,1,1,4,Lost
57674,10,74,455,5,5,5,15,Champions
57890,698,5,8,2,1,1,4,Lost
58261,882,7,23,2,2,2,6,Lost
58578,4062,5,22,1,1,2,4,Lost
58634,77,8,74,4,2,4,10,Promising
58917,1,20,42,5,3,3,11,Loyal Users
59400,19,32,67,5,4,4,13,Champions
59595,112,12,45,4,3,3,10,Loyal Users
60105,632,21,112,2,3,4,9,Casual Users
60148,99,12,26,4,3,2,9,Loyal Users
60347,681,17,60,2,3,3,8,Casual Users
60937,349,29,95,3,4,4,11,Loyal Users
60995,475,16,19,2,3,2,7,Casual Users
61171,1952,59,243,1,5,5,11,At Risk
61315,415,7,7,3,2,1,6,Casual Users
61335,1150,12,27,2,3,2,7,Casual Users
61418,28,64,294,5,5,5,15,Champions
61474,87,28,79,4,4,4,12,Champions
61582,2491,11,44,1,2,3,6,Lost
61593,119,13,85,4,3,4,11,Loyal Users
62018,32,24,96,5,4,4,13,Champions
62024,23,10,55,5,2,3,10,Promising
62440,48,81,315,5,5,5,15,Champions
62734,694,5,33,2,1,3,6,Lost
62921,3773,5,9,1,1,1,3,Lost
63084,122,71,182,4,5,5,14,Champions
63205,2849,17,52,1,3,3,7,Casual Users
63246,431,11,26,3,2,2,7,Casual Users
63303,571,5,11,2,1,1,4,Lost
63355,14,90,400,5,5,5,15,Champions
63502,2595,7,10,1,2,1,4,Lost
63565,266,65,185,3,5,5,13,Loyal Users
63740,44,33,55,5,4,3,12,Loyal Users
63985,60,61,148,5,5,5,15,Champions
64091,277,62,99,3,5,4,12,Loyal Users
64147,701,15,52,2,3,3,8,Casual Users
64328,144,77,734,4,5,5,14,Champions
64457,2,123,204,5,5,5,15,Champions
64677,1225,6,6,2,1,1,4,Lost
64706,695,37,52,2,4,3,9,At Risk
64856,127,10,16,4,2,2,8,Promising
64943,651,23,35,2,4,3,9,At Risk
65122,3,75,286,5,5,5,15,Champions
65188,140,25,38,4,4,3,11,Loyal Users
65258,193,57,236,3,5,5,13,Loyal Users
65358,12,22,59,5,4,3,12,Loyal Users
52944,3187,12,31,1,3,2,6,Casual Users
53178,3564,10,15,1,2,1,4,Lost
53587,281,7,17,3,2,2,7,Casual Users
53816,137,24,130,4,4,4,12,Champions
54102,334,10,20,3,2,2,7,Casual Users
54105,107,71,210,4,5,5,14,Champions
54119,18,59,132,5,5,4,14,Champions
54154,1457,46,85,1,5,4,10,At Risk
54574,79,148,364,4,5,5,14,Champions
54701,113,55,84,4,5,4,13,Champions
54707,122,40,181,4,4,5,13,Champions
54975,371,6,7,3,1,1,5,Casual Users
55167,377,21,97,3,3,4,10,Loyal Users
55182,322,5,6,3,1,1,5,Casual Users
55299,33,17,48,5,3,3,11,Loyal Users
55705,2546,26,62,1,4,3,8,At Risk
55861,103,37,122,4,4,4,12,Champions
55878,77,48,129,4,5,4,13,Champions
56044,6,51,63,5,5,4,14,Champions
56394,334,14,36,3,3,3,9,Loyal Users
56462,92,66,144,4,5,4,13,Champions
57038,828,19,36,2,3,3,8,Casual Users
57245,36,50,170,5,5,5,15,Champions
57708,29,47,198,5,5,5,15,Champions
58264,264,16,16,3,3,2,8,Loyal Users
58370,588,20,86,2,3,4,9,Casual Users
58412,4,44,123,5,4,4,13,Champions
58413,398,35,65,3,4,4,11,Loyal Users
58464,52,21,49,5,3,3,11,Loyal Users
58520,275,34,90,3,4,4,11,Loyal Users
58586,4,15,25,5,3,2,10,Loyal Users
58686,688,11,28,2,2,2,6,Lost
59031,223,13,31,3,3,2,8,Loyal Users
59076,185,7,9,3,2,1,6,Casual Users
59141,240,5,32,3,1,3,7,Casual Users
59455,125,75,361,4,5,5,14,Champions
59791,235,61,251,3,5,5,13,Loyal Users
59859,832,6,8,2,1,1,4,Lost
59866,3232,6,17,1,1,2,4,Lost
59959,1451,6,18,1,1,2,4,Lost
60019,517,7,26,2,2,2,6,Lost
60163,111,63,268,4,5,5,14,Champions
60353,1280,29,53,1,4,3,8,At Risk
60431,16,48,141,5,5,4,14,Champions
60942,3575,13,33,1,3,3,7,Casual Users
61411,1410,8,15,1,2,1,4,Lost
61448,1114,6,8,2,1,1,4,Lost
61504,462,13,17,3,3,2,8,Loyal Users
61528,44,45,292,5,4,5,14,Champions
61549,929,8,146,2,2,4,8,Lost
61623,48,7,29,5,2,2,9,Promising
61755,834,89,174,2,5,5,12,At Risk
62096,696,8,16,2,2,2,6,Lost
62121,185,12,20,3,3,2,8,Loyal Users
62152,17,23,45,5,4,3,12,Loyal Users
62426,1228,8,32,2,2,3,7,Lost
63050,2281,47,138,1,5,4,10,At Risk
63215,243,7,22,3,2,2,7,Casual Users
63309,14,22,170,5,4,5,14,Champions
63533,3070,5,6,1,1,1,3,Lost
64098,646,62,363,2,5,5,12,At Risk
64231,165,37,157,4,4,5,13,Champions
64296,1440,12,30,1,3,2,6,Casual Users
64633,395,28,84,3,4,4,11,Loyal Users
64658,443,6,26,3,1,2,6,Casual Users
64830,305,16,29,3,3,2,8,Loyal Users
64956,656,16,24,2,3,2,7,Casual Users
53024,60,57,572,5,5,5,15,Champions
53609,1510,5,27,1,1,2,4,Lost
53925,157,13,36,4,3,3,10,Loyal Users
54451,405,22,35,3,4,3,10,Loyal Users
54670,159,5,5,4,1,1,6,Promising
54969,282,19,187,3,3,5,11,Loyal Users
55033,683,6,8,2,1,1,4,Lost
55303,291,5,7,3,1,1,5,Casual Users
55370,585,5,8,2,1,1,4,Lost
55378,851,9,46,2,2,3,7,Lost
55413,710,8,8,2,2,1,5,Lost
55422,38,42,166,5,4,5,14,Champions
55575,839,6,9,2,1,1,4,Lost
55829,250,30,31,3,4,2,9,Loyal Users
56004,1104,8,9,2,2,1,5,Lost
56085,5733,11,11,1,2,1,4,Lost
56233,1837,7,16,1,2,2,5,Lost
57059,1118,5,42,2,1,3,6,Lost
57112,64,45,135,5,4,4,13,Champions
57309,1346,5,7,1,1,1,3,Lost
57573,305,6,10,3,1,1,5,Casual Users
57665,287,27,73,3,4,4,11,Loyal Users
57713,308,82,248,3,5,5,13,Loyal Users
57798,1987,8,14,1,2,1,4,Lost
57803,38,91,261,5,5,5,15,Champions
58036,270,11,27,3,2,2,7,Casual Users
58311,32,40,77,5,4,4,13,Champions
58813,161,15,268,4,3,5,12,Loyal Users
58830,1565,6,19,1,1,2,4,Lost
59185,489,27,116,2,4,4,10,At Risk
59202,150,9,17,4,2,2,8,Promising
59234,29,30,169,5,4,5,14,Champions
59539,147,30,92,4,4,4,12,Champions
59568,379,6,15,3,1,1,5,Casual Users
59757,136,5,22,4,1,2,7,Promising
59769,10,147,275,5,5,5,15,Champions
59893,993,29,111,2,4,4,10,At Risk
60052,250,15,53,3,3,3,9,Loyal Users
60198,584,24,98,2,4,4,10,At Risk
60233,40,43,205,5,4,5,14,Champions
60906,92,28,102,4,4,4,12,Champions
61015,108,65,154,4,5,5,14,Champions
61031,0,58,100,5,5,4,14,Champions
61097,96,136,368,4,5,5,14,Champions
61205,644,18,25,2,3,2,7,Casual Users
61596,8,117,758,5,5,5,15,Champions
61673,4761,7,7,1,2,1,4,Lost
61776,697,6,8,2,1,1,4,Lost
62097,2,165,292,5,5,5,15,Champions
62147,187,32,60,3,4,3,10,Loyal Users
62391,168,13,62,3,3,3,9,Loyal Users
62514,201,11,22,3,2,2,7,Casual Users
62635,42,21,84,5,3,4,12,Loyal Users
62672,1820,9,19,1,2,2,5,Lost
62715,397,10,26,3,2,2,7,Casual Users
62723,512,5,7,2,1,1,4,Lost
62893,11,30,58,5,4,3,12,Loyal Users
62995,114,62,219,4,5,5,14,Champions
63028,127,42,72,4,4,4,12,Champions
63092,130,47,168,4,5,5,14,Champions
63157,2724,8,8,1,2,1,4,Lost
63178,973,18,56,2,3,3,8,Casual Users
63247,605,31,60,2,4,3,9,At Risk
63736,883,30,64,2,4,4,10,At Risk
63737,1320,13,53,1,3,3,7,Casual Users
64063,1355,13,24,1,3,2,6,Casual Users
64199,121,77,209,4,5,5,14,Champions
64419,140,8,15,4,2,1,7,Promising
64463,2006,9,14,1,2,1,4,Lost
64507,0,262,656,5,5,5,15,Champions
64918,978,5,16,2,1,2,5,Lost
64926,19,45,92,5,4,4,13,Champions
64948,53,22,177,5,4,5,14,Champions
65218,1868,9,21,1,2,2,5,Lost
52587,589,13,41,2,3,3,8,Casual Users
52683,219,5,5,3,1,1,5,Casual Users
52708,2308,5,15,1,1,1,3,Lost
52722,32,72,327,5,5,5,15,Champions
52925,168,10,14,3,2,1,6,Casual Users
52971,543,34,115,2,4,4,10,At Risk
53138,688,31,155,2,4,5,11,At Risk
53315,7,8,17,5,2,2,9,Promising
53649,117,116,403,4,5,5,14,Champions
53945,148,24,227,4,4,5,13,Champions
54647,158,11,13,4,2,1,7,Promising
54657,1124,17,43,2,3,3,8,Casual Users
54802,286,26,76,3,4,4,11,Loyal Users
54873,3584,11,18,1,2,2,5,Lost
54948,2457,15,37,1,3,3,7,Casual Users
55159,191,32,91,3,4,4,11,Loyal Users
55365,570,20,57,2,3,3,8,Casual Users
55475,2408,11,32,1,2,3,6,Lost
55816,235,136,159,3,5,5,13,Loyal Users
55825,5446,6,38,1,1,3,5,Lost
56611,130,25,72,4,4,4,12,Champions
56814,45,12,41,5,3,3,11,Loyal Users
57377,1318,33,98,1,4,4,9,At Risk
57755,831,5,9,2,1,1,4,Lost
57992,2666,9,15,1,2,1,4,Lost
58259,423,9,11,3,2,1,6,Casual Users
59092,2587,17,21,1,3,2,6,Casual Users
59110,1407,6,7,1,1,1,3,Lost
59419,1232,7,78,2,2,4,8,Lost
59450,441,9,14,3,2,1,6,Casual Users
59565,1836,9,28,1,2,2,5,Lost
59648,85,86,551,4,5,5,14,Champions
59860,38,43,160,5,4,5,14,Champions
59943,295,9,21,3,2,2,7,Casual Users
60134,31,50,73,5,5,4,14,Champions
60261,433,5,19,3,1,2,6,Casual Users
60344,278,8,30,3,2,2,7,Casual Users
60660,437,27,54,3,4,3,10,Loyal Users
60944,2663,6,13,1,1,1,3,Lost
60946,645,19,62,2,3,3,8,Casual Users
61256,59,179,543,5,5,5,15,Champions
61467,494,7,14,2,2,1,5,Lost
61488,1862,6,19,1,1,2,4,Lost
61735,1053,10,18,2,2,2,6,Lost
61768,3503,21,66,1,3,4,8,Casual Users
61872,45,146,315,5,5,5,15,Champions
62142,1292,6,14,1,1,1,3,Lost
62412,405,5,20,3,1,2,6,Casual Users
62452,1221,6,8,2,1,1,4,Lost
62551,248,20,56,3,3,3,9,Loyal Users
62592,118,32,86,4,4,4,12,Champions
62649,178,97,279,3,5,5,13,Loyal Users
63156,952,13,37,2,3,3,8,Casual Users
63248,177,24,144,3,4,4,11,Loyal Users
63326,32,41,111,5,4,4,13,Champions
63415,884,13,56,2,3,3,8,Casual Users
63723,383,10,12,3,2,1,6,Casual Users
63783,2449,8,33,1,2,3,6,Lost
63853,110,84,312,4,5,5,14,Champions
63933,2543,7,7,1,2,1,4,Lost
64070,635,13,30,2,3,2,7,Casual Users
64364,397,19,36,3,3,3,9,Loyal Users
64654,409,6,17,3,1,2,6,Casual Users
64747,108,57,175,4,5,5,14,Champions
64945,4,145,471,5,5,5,15,Champions
65123,1556,61,95,1,5,4,10,At Risk
65341,67,13,46,5,3,3,11,Loyal Users
52740,1,25,124,5,4,4,13,Champions
52783,383,9,32,3,2,3,8,Casual Users
52908,4404,5,13,1,1,1,3,Lost
53102,90,57,138,4,5,4,13,Champions
53104,118,37,57,4,4,3,11,Loyal Users
53200,1827,6,44,1,1,3,5,Lost
53778,9,70,236,5,5,5,15,Champions
53919,410,12,15,3,3,1,7,Loyal Users
54299,25,67,145,5,5,4,14,Champions
54566,1491,5,16,1,1,2,4,Lost
54740,1303,10,11,1,2,1,4,Lost
54895,507,6,27,2,1,2,5,Lost
55001,1696,6,25,1,1,2,4,Lost
55002,929,12,52,2,3,3,8,Casual Users
55211,151,6,30,4,1,2,7,Promising
55232,1067,11,94,2,2,4,8,Lost
55298,2417,5,12,1,1,1,3,Lost
55713,718,15,167,2,3,5,10,Casual Users
55868,18,67,135,5,5,4,14,Champions
55930,128,52,107,4,5,4,13,Champions
56504,73,118,449,4,5,5,14,Champions
56616,1786,5,9,1,1,1,3,Lost
57010,407,62,92,3,5,4,12,Loyal Users
57338,138,46,164,4,5,5,14,Champions
57709,2204,5,6,1,1,1,3,Lost
58115,428,11,35,3,2,3,8,Casual Users
58315,11,5,68,5,1,4,10,Promising
58418,137,24,47,4,4,3,11,Loyal Users
58439,349,5,25,3,1,2,6,Casual Users
58884,391,11,13,3,2,1,6,Casual Users
58947,49,39,250,5,4,5,14,Champions
59208,245,69,156,3,5,5,13,Loyal Users
59363,14,148,394,5,5,5,15,Champions
59892,2934,7,18,1,2,2,5,Lost
59938,409,16,33,3,3,3,9,Loyal Users
59978,676,10,17,2,2,2,6,Lost
60360,233,7,59,3,2,3,8,Casual Users
60407,1319,7,11,1,2,1,4,Lost
60871,412,12,25,3,3,2,8,Loyal Users
61081,54,51,199,5,5,5,15,Champions
61434,898,16,42,2,3,3,8,Casual Users
61907,0,85,139,5,5,4,14,Champions
62304,216,26,68,3,4,4,11,Loyal Users
62549,266,18,49,3,3,3,9,Loyal Users
62563,121,77,171,4,5,5,14,Champions
62894,110,14,24,4,3,2,9,Loyal Users
62927,3010,5,5,1,1,1,3,Lost
63390,411,6,8,3,1,1,5,Casual Users
63393,829,11,71,2,2,4,8,Lost
63667,920,18,34,2,3,3,8,Casual Users
64030,1480,7,11,1,2,1,4,Lost
64202,259,7,48,3,2,3,8,Casual Users
64252,736,5,9,2,1,1,4,Lost
64938,1882,6,10,1,1,1,3,Lost
64976,266,10,19,3,2,2,7,Casual Users
65342,544,10,67,2,2,4,8,Lost
52921,92,54,102,4,5,4,13,Champions
53319,5,10,26,5,2,2,9,Promising
53652,36,22,31,5,4,2,11,Loyal Users
54090,358,24,52,3,4,3,10,Loyal Users
54121,165,6,34,4,1,3,8,Promising
54217,1676,7,7,1,2,1,4,Lost
54262,26,45,136,5,4,4,13,Champions
54302,3240,7,21,1,2,2,5,Lost
54333,407,6,10,3,1,1,5,Casual Users
54426,2863,5,73,1,1,4,6,Lost
54613,5,73,109,5,5,4,14,Champions
54831,121,122,503,4,5,5,14,Champions
54891,683,38,97,2,4,4,10,At Risk
54962,144,36,51,4,4,3,11,Loyal Users
55139,682,8,94,2,2,4,8,Lost
55245,62,92,670,5,5,5,15,Champions
55448,79,112,252,4,5,5,14,Champions
55542,147,9,51,4,2,3,9,Promising
55674,528,7,53,2,2,3,7,Lost
55751,1,37,85,5,4,4,13,Champions
55889,86,48,86,4,5,4,13,Champions
55979,4231,13,16,1,3,2,6,Casual Users
56205,1001,5,7,2,1,1,4,Lost
56244,677,9,30,2,2,2,6,Lost
56725,1134,10,19,2,2,2,6,Lost
57034,100,137,245,4,5,5,14,Champions
57076,615,25,188,2,4,5,11,At Risk
57144,126,65,427,4,5,5,14,Champions
57145,417,26,83,3,4,4,11,Loyal Users
57399,1586,8,24,1,2,2,5,Lost
57402,823,23,77,2,4,4,10,At Risk
57609,1746,17,33,1,3,3,7,Casual Users
57815,3696,9,16,1,2,2,5,Lost
57935,174,15,22,3,3,2,8,Loyal Users
57995,789,14,28,2,3,2,7,Casual Users
58154,245,28,81,3,4,4,11,Loyal Users
58277,602,18,39,2,3,3,8,Casual Users
58417,3288,11,59,1,2,3,6,Lost
58570,97,16,21,4,3,2,9,Loyal Users
58839,11,109,158,5,5,5,15,Champions
59402,879,10,15,2,2,1,5,Lost
59760,4136,6,7,1,1,1,3,Lost
59991,1989,13,22,1,3,2,6,Casual Users
60103,2433,5,15,1,1,1,3,Lost
60250,804,18,20,2,3,2,7,Casual Users
60604,41,26,179,5,4,5,14,Champions
60770,1,54,237,5,5,5,15,Champions
61017,27,111,427,5,5,5,15,Champions
61679,269,13,34,3,3,3,9,Loyal Users
61783,415,10,37,3,2,3,8,Casual Users
61899,1270,6,8,1,1,1,3,Lost
62056,420,24,31,3,4,2,9,Loyal Users
62294,431,8,21,3,2,2,7,Casual Users
62540,444,43,119,3,4,4,11,Loyal Users
62692,86,23,53,4,4,3,11,Loyal Users
63127,568,5,14,2,1,1,4,Lost
63352,2860,28,49,1,4,3,8,At Risk
63784,933,16,57,2,3,3,8,Casual Users
64009,563,18,51,2,3,3,8,Casual Users
64044,123,37,125,4,4,4,12,Champions
64333,591,9,16,2,2,2,6,Lost
64359,979,23,85,2,4,4,10,At Risk
64728,2048,6,20,1,1,2,4,Lost
65085,111,131,421,4,5,5,14,Champions
52472,1299,6,7,1,1,1,3,Lost
52870,547,17,32,2,3,3,8,Casual Users
53080,150,5,11,4,1,1,6,Promising
53669,157,11,18,4,2,2,8,Promising
53749,62,130,517,5,5,5,15,Champions
53819,362,8,29,3,2,2,7,Casual Users
53828,399,36,95,3,4,4,11,Loyal Users
54096,115,24,52,4,4,3,11,Loyal Users
54284,106,80,208,4,5,5,14,Champions
54621,2810,14,99,1,3,4,8,Casual Users
54681,1733,9,23,1,2,2,5,Lost
54883,81,148,539,4,5,5,14,Champions
55375,153,93,149,4,5,5,14,Champions
55449,1877,18,28,1,3,2,6,Casual Users
55477,79,46,128,4,5,4,13,Champions
55755,115,57,125,4,5,4,13,Champions
55920,683,7,10,2,2,1,5,Lost
55955,3668,38,104,1,4,4,9,At Risk
56066,10,40,249,5,4,5,14,Champions
56434,746,10,27,2,2,2,6,Lost
56527,4738,20,37,1,3,3,7,Casual Users
56919,101,41,187,4,4,5,13,Champions
56927,110,20,77,4,3,4,11,Loyal Users
57296,257,60,182,3,5,5,13,Loyal Users
57331,104,17,27,4,3,2,9,Loyal Users
57799,116,24,91,4,4,4,12,Champions
57867,1001,13,30,2,3,2,7,Casual Users
57887,273,77,85,3,5,4,12,Loyal Users
58012,797,15,93,2,3,4,9,Casual Users
58042,414,28,97,3,4,4,11,Loyal Users
58138,651,8,24,2,2,2,6,Lost
58161,147,31,64,4,4,4,12,Champions
58334,2129,5,29,1,1,2,4,Lost
58594,597,18,33,2,3,3,8,Casual Users
58610,2271,7,9,1,2,1,4,Lost
59172,3558,12,32,1,3,3,7,Casual Users
59293,1747,37,51,1,4,3,8,At Risk
59518,72,25,61,4,4,3,11,Loyal Users
59560,11,70,169,5,5,5,15,Champions
59584,46,19,191,5,3,5,13,Loyal Users
60143,794,15,70,2,3,4,9,Casual Users
60201,144,7,18,4,2,2,8,Promising
60290,263,10,74,3,2,4,9,Casual Users
60291,30,58,95,5,5,4,14,Champions
60396,67,37,147,5,4,5,14,Champions
60497,612,14,24,2,3,2,7,Casual Users
60838,11,150,479,5,5,5,15,Champions
61099,3317,6,9,1,1,1,3,Lost
61191,491,18,70,2,3,4,9,Casual Users
61346,408,32,67,3,4,4,11,Loyal Users
61383,127,22,68,4,4,4,12,Champions
61675,152,6,24,4,1,2,7,Promising
62019,709,9,37,2,2,3,7,Lost
62265,28,28,86,5,4,4,13,Champions
62369,142,6,7,4,1,1,6,Promising
62557,261,7,36,3,2,3,8,Casual Users
62758,1360,5,6,1,1,1,3,Lost
63222,135,10,57,4,2,3,9,Promising
63263,96,75,270,4,5,5,14,Champions
63381,3,11,19,5,2,2,9,Promising
63430,3159,9,24,1,2,2,5,Lost
63527,272,12,40,3,3,3,9,Loyal Users
63856,1,10,13,5,2,1,8,Promising
63962,668,38,42,2,4,3,9,At Risk
64516,98,21,41,4,3,3,10,Loyal Users
64703,151,26,244,4,4,5,13,Champions
64781,64,111,542,5,5,5,15,Champions
64791,65,41,277,5,4,5,14,Champions
65144,104,12,88,4,3,4,11,Loyal Users
52865,706,21,52,2,3,3,8,Casual Users
53086,31,37,90,5,4,4,13,Champions
53119,155,43,79,4,4,4,12,Champions
53139,628,6,11,2,1,1,4,Lost
53366,1,27,36,5,4,3,12,Loyal Users
53391,70,34,80,4,4,4,12,Champions
53574,9,67,253,5,5,5,15,Champions
53617,4548,6,20,1,1,2,4,Lost
53623,354,10,28,3,2,2,7,Casual Users
53910,522,27,137,2,4,4,10,At Risk
53918,3,29,83,5,4,4,13,Champions
53947,1686,17,24,1,3,2,6,Casual Users
54028,1230,14,50,2,3,3,8,Casual Users
54043,39,76,92,5,5,4,14,Champions
54077,143,21,100,4,3,4,11,Loyal Users
54080,3109,11,37,1,2,3,6,Lost
54104,78,7,16,4,2,2,8,Promising
54107,27,109,615,5,5,5,15,Champions
54501,98,20,157,4,3,5,12,Loyal Users
54786,860,14,51,2,3,3,8,Casual Users
55290,2070,7,19,1,2,2,5,Lost
55382,5105,5,36,1,1,3,5,Lost
55766,278,27,32,3,4,3,10,Loyal Users
56116,30,34,165,5,4,5,14,Champions
56951,3017,5,12,1,1,1,3,Lost
57434,693,8,16,2,2,2,6,Lost
57555,2859,6,14,1,1,1,3,Lost
57605,868,9,13,2,2,1,5,Lost
58327,1690,5,6,1,1,1,3,Lost
58341,95,72,255,4,5,5,14,Champions
58360,249,8,34,3,2,3,8,Casual Users
58560,5,21,111,5,3,4,12,Loyal Users
58600,829,10,17,2,2,2,6,Lost
59085,1963,7,30,1,2,2,5,Lost
59377,44,7,8,5,2,1,8,Promising
60075,988,20,37,2,3,3,8,Casual Users
60228,568,14,36,2,3,3,8,Casual Users
60617,44,62,98,5,5,4,14,Champions
60679,59,60,192,5,5,5,15,Champions
60700,421,16,78,3,3,4,10,Loyal Users
60810,95,7,23,4,2,2,8,Promising
61341,2670,6,13,1,1,1,3,Lost
61482,26,49,389,5,5,5,15,Champions
61483,2579,5,8,1,1,1,3,Lost
61597,17,38,81,5,4,4,13,Champions
62140,61,49,207,5,5,5,15,Champions
62690,74,68,291,4,5,5,14,Champions
62710,133,40,105,4,4,4,12,Champions
62851,299,7,9,3,2,1,6,Casual Users
62866,167,12,52,3,3,3,9,Loyal Users
62909,3653,7,16,1,2,2,5,Lost
62971,717,13,46,2,3,3,8,Casual Users
62988,116,7,31,4,2,2,8,Promising
63584,143,33,237,4,4,5,13,Champions
63594,397,113,184,3,5,5,13,Loyal Users
63898,129,62,231,4,5,5,14,Champions
63967,5170,6,15,1,1,1,3,Lost
64005,407,20,77,3,3,4,10,Loyal Users
64103,779,5,26,2,1,2,5,Lost
64705,64,14,41,5,3,3,11,Loyal Users
64738,663,5,56,2,1,3,6,Lost
64872,26,19,82,5,3,4,12,Loyal Users
64991,64,33,83,5,4,4,13,Champions
65024,1997,22,138,1,4,4,9,At Risk
65100,3313,5,5,1,1,1,3,Lost
65287,536,37,54,2,4,3,9,At Risk
52366,261,6,9,3,1,1,5,Casual Users
52548,1698,25,90,1,4,4,9,At Risk
52616,872,18,113,2,3,4,9,Casual Users
52717,3881,6,7,1,1,1,3,Lost
52755,174,32,66,3,4,4,11,Loyal Users
52892,0,99,161,5,5,5,15,Champions
53017,1664,5,14,1,1,1,3,Lost
53058,1552,7,9,1,2,1,4,Lost
53540,239,19,28,3,3,2,8,Loyal Users
53661,409,8,12,3,2,1,6,Casual Users
53681,3556,5,15,1,1,1,3,Lost
54009,975,7,7,2,2,1,5,Lost
54083,2354,16,33,1,3,3,7,Casual Users
54355,453,20,34,3,3,3,9,Loyal Users
54490,14,35,71,5,4,4,13,Champions
54662,2554,12,40,1,3,3,7,Casual Users
54792,73,83,356,4,5,5,14,Champions
54848,3398,9,68,1,2,4,7,Lost
55032,118,48,110,4,5,4,13,Champions
55117,1534,11,18,1,2,2,5,Lost
55821,758,9,13,2,2,1,5,Lost
55973,7,53,96,5,5,4,14,Champions
56097,1046,5,9,2,1,1,4,Lost
56139,200,24,44,3,4,3,10,Loyal Users
56458,133,12,19,4,3,2,9,Loyal Users
56469,160,129,303,4,5,5,14,Champions
56728,1182,7,33,2,2,3,7,Lost
56834,1005,8,18,2,2,2,6,Lost
57122,225,7,24,3,2,2,7,Casual Users
57249,5115,5,7,1,1,1,3,Lost
57381,124,87,138,4,5,4,13,Champions
57450,746,14,100,2,3,4,9,Casual Users
57631,379,5,9,3,1,1,5,Casual Users
57644,272,38,47,3,4,3,10,Loyal Users
57715,941,5,6,2,1,1,4,Lost
58014,2491,5,10,1,1,1,3,Lost
58280,99,16,42,4,3,3,10,Loyal Users
58285,917,6,7,2,1,1,4,Lost
58588,289,11,21,3,2,2,7,Casual Users
58745,2520,10,27,1,2,2,5,Lost
58815,1783,12,17,1,3,2,6,Casual Users
59014,457,9,15,3,2,1,6,Casual Users
59033,1590,14,28,1,3,2,6,Casual Users
59169,131,6,8,4,1,1,6,Promising
59597,2477,12,21,1,3,2,6,Casual Users
59662,133,8,14,4,2,1,7,Promising
59682,984,5,19,2,1,2,5,Lost
59857,32,19,43,5,3,3,11,Loyal Users
60271,304,37,79,3,4,4,11,Loyal Users
60520,511,5,28,2,1,2,5,Lost
60734,453,5,52,3,1,3,7,Casual Users
60795,413,61,327,3,5,5,13,Loyal Users
60990,173,36,93,3,4,4,11,Loyal Users
61172,163,7,16,4,2,2,8,Promising
61525,824,19,35,2,3,3,8,Casual Users
61875,844,9,15,2,2,1,5,Lost
61989,320,7,22,3,2,2,7,Casual Users
62017,19,18,25,5,3,2,10,Loyal Users
62446,37,13,36,5,3,3,11,Loyal Users
62952,549,5,6,2,1,1,4,Lost
62976,289,11,47,3,2,3,8,Casual Users
62994,1698,11,28,1,2,2,5,Lost
63187,85,14,27,4,3,2,9,Loyal Users
63374,3944,6,53,1,1,3,5,Lost
63608,223,6,16,3,1,2,6,Casual Users
63844,294,6,27,3,1,2,6,Casual Users
63865,1276,13,18,1,3,2,6,Casual Users
63996,494,5,10,2,1,1,4,Lost
64282,166,12,40,3,3,3,9,Loyal Users
64402,112,89,164,4,5,5,14,Champions
64444,1531,22,163,1,4,5,10,At Risk
64484,681,23,24,2,4,2,8,At Risk
64527,53,165,500,5,5,5,15,Champions
64824,1415,11,34,1,2,3,6,Lost
64970,87,18,85,4,3,4,11,Loyal Users
65164,165,14,38,4,3,3,10,Loyal Users
65236,243,5,7,3,1,1,5,Casual Users
52499,847,12,31,2,3,2,7,Casual Users
52561,152,117,452,4,5,5,14,Champions
52570,282,51,178,3,5,5,13,Loyal Users
52601,37,119,563,5,5,5,15,Champions
52630,22,129,1040,5,5,5,15,Champions
52688,816,12,22,2,3,2,7,Casual Users
53089,968,12,21,2,3,2,7,Casual Users
53250,37,48,66,5,5,4,14,Champions
53259,200,29,95,3,4,4,11,Loyal Users
53457,921,5,9,2,1,1,4,Lost
53532,204,68,247,3,5,5,13,Loyal Users
53796,14,56,159,5,5,5,15,Champions
54072,227,5,12,3,1,1,5,Casual Users
54198,136,18,63,4,3,4,11,Loyal Users
54289,408,59,162,3,5,5,13,Loyal Users
55463,17,154,525,5,5,5,15,Champions
55887,15,29,187,5,4,5,14,Champions
55893,12,93,356,5,5,5,15,Champions
55964,8,114,278,5,5,5,15,Champions
56192,169,24,246,3,4,5,12,Loyal Users
56196,108,12,109,4,3,4,11,Loyal Users
56422,391,8,18,3,2,2,7,Casual Users
56485,846,5,8,2,1,1,4,Lost
56574,1997,19,157,1,3,5,9,Casual Users
56645,15,16,82,5,3,4,12,Loyal Users
56719,146,23,120,4,4,4,12,Champions
57121,284,33,91,3,4,4,11,Loyal Users
57517,3533,5,6,1,1,1,3,Lost
57567,145,95,317,4,5,5,14,Champions
57657,810,21,91,2,3,4,9,Casual Users
58127,745,14,29,2,3,2,7,Casual Users
58723,1861,5,28,1,1,2,4,Lost
58932,501,45,55,2,4,3,9,At Risk
59423,26,65,130,5,5,4,14,Champions
59877,17,24,36,5,4,3,12,Loyal Users
59926,123,10,21,4,2,2,8,Promising
59958,825,6,6,2,1,1,4,Lost
60223,502,8,25,2,2,2,6,Lost
60349,909,7,14,2,2,1,5,Lost
60714,125,21,47,4,3,3,10,Loyal Users
61139,729,45,250,2,4,5,11,At Risk
61304,273,88,155,3,5,5,13,Loyal Users
61658,39,15,23,5,3,2,10,Loyal Users
61856,49,89,547,5,5,5,15,Champions
62210,2065,12,147,1,3,5,9,Casual Users
62449,643,26,157,2,4,5,11,At Risk
62560,1274,39,92,1,4,4,9,At Risk
62702,1106,5,7,2,1,1,4,Lost
63068,291,7,8,3,2,1,6,Casual Users
63467,4549,7,11,1,2,1,4,Lost
63503,181,23,36,3,4,3,10,Loyal Users
63560,30,7,26,5,2,2,9,Promising
63753,87,6,26,4,1,2,7,Promising
63812,115,78,296,4,5,5,14,Champions
64523,1451,7,12,1,2,1,4,Lost
64568,143,34,212,4,4,5,13,Champions
64671,21,76,228,5,5,5,15,Champions
64773,420,40,126,3,4,4,11,Loyal Users
64782,1849,13,17,1,3,2,6,Casual Users
64806,282,6,16,3,1,2,6,Casual Users
64815,423,7,10,3,2,1,6,Casual Users
64847,458,9,26,3,2,2,7,Casual Users
65171,4097,6,7,1,1,1,3,Lost
52470,5,41,157,5,4,5,14,Champions
52657,1134,11,37,2,2,3,7,Lost
52809,6,7,10,5,2,1,8,Promising
52929,606,6,8,2,1,1,4,Lost
52977,405,27,97,3,4,4,11,Loyal Users
53148,153,30,53,4,4,3,11,Loyal Users
53415,136,180,359,4,5,5,14,Champions
53607,647,5,9,2,1,1,4,Lost
53728,1221,26,33,2,4,3,9,At Risk
53856,735,18,26,2,3,2,7,Casual Users
53978,1841,8,19,1,2,2,5,Lost
54068,1578,8,11,1,2,1,4,Lost
54126,0,9,30,5,2,2,9,Promising
54134,220,9,14,3,2,1,6,Casual Users
54171,130,21,192,4,3,5,12,Loyal Users
54589,830,13,21,2,3,2,7,Casual Users
54861,132,29,128,4,4,4,12,Champions
55262,1533,15,17,1,3,2,6,Casual Users
55532,2449,15,32,1,3,3,7,Casual Users
55823,127,92,252,4,5,5,14,Champions
56495,1636,23,119,1,4,4,9,At Risk
56659,419,12,16,3,3,2,8,Loyal Users
56688,47,20,107,5,3,4,12,Loyal Users
56734,2806,16,74,1,3,4,8,Casual Users
56752,28,101,533,5,5,5,15,Champions
56884,1,47,264,5,5,5,15,Champions
56948,1994,12,19,1,3,2,6,Casual Users
56961,550,8,12,2,2,1,5,Lost
56999,124,59,119,4,5,4,13,Champions
57345,614,45,178,2,4,5,11,At Risk
57845,123,8,28,4,2,2,8,Promising
57847,411,6,10,3,1,1,5,Casual Users
57916,1912,7,11,1,2,1,4,Lost
58162,1007,16,22,2,3,2,7,Casual Users
58506,4106,8,61,1,2,3,6,Lost
58933,256,13,43,3,3,3,9,Loyal Users
58948,1855,35,81,1,4,4,9,At Risk
59089,146,25,41,4,4,3,11,Loyal Users
59906,260,8,13,3,2,1,6,Casual Users
59921,925,20,58,2,3,3,8,Casual Users
60122,728,7,14,2,2,1,5,Lost
60703,3897,5,16,1,1,2,4,Lost
61370,1411,11,113,1,2,4,7,Lost
61429,187,16,40,3,3,3,9,Loyal Users
61668,1091,21,33,2,3,3,8,Casual Users
61795,685,18,41,2,3,3,8,Casual Users
61967,112,22,53,4,4,3,11,Loyal Users
62199,1105,10,43,2,2,3,7,Lost
62318,1670,6,20,1,1,2,4,Lost
62435,129,38,71,4,4,4,12,Champions
62490,1852,22,52,1,4,3,8,At Risk
62607,411,12,17,3,3,2,8,Loyal Users
62801,34,12,38,5,3,3,11,Loyal Users
62869,189,68,164,3,5,5,13,Loyal Users
63077,610,8,9,2,2,1,5,Lost
63143,0,7,9,5,2,1,8,Promising
63165,125,11,39,4,2,3,9,Promising
63281,423,15,24,3,3,2,8,Loyal Users
63468,52,24,38,5,4,3,12,Loyal Users
63672,2884,5,18,1,1,2,4,Lost
63757,235,14,56,3,3,3,9,Loyal Users
64168,18,104,358,5,5,5,15,Champions
64430,48,68,131,5,5,4,14,Champions
64485,2,76,380,5,5,5,15,Champions
64495,20,96,290,5,5,5,15,Champions
64506,104,105,251,4,5,5,14,Champions
64765,5,69,280,5,5,5,15,Champions
52481,8,213,410,5,5,5,15,Champions
52624,294,6,11,3,1,1,5,Casual Users
52644,1241,14,90,2,3,4,9,Casual Users
52771,20,55,154,5,5,5,15,Champions
52862,1168,14,63,2,3,4,9,Casual Users
52932,720,19,54,2,3,3,8,Casual Users
53551,561,12,28,2,3,2,7,Casual Users
53889,31,83,247,5,5,5,15,Champions
54189,443,66,136,3,5,4,12,Loyal Users
54722,724,6,11,2,1,1,4,Lost
54903,100,35,56,4,4,3,11,Loyal Users
55119,8,9,13,5,2,1,8,Promising
55555,4,15,59,5,3,3,11,Loyal Users
55593,2465,19,68,1,3,4,8,Casual Users
56026,3031,7,9,1,2,1,4,Lost
56099,884,6,12,2,1,1,4,Lost
56318,855,11,41,2,2,3,7,Lost
56464,81,40,223,4,4,5,13,Champions
57013,546,19,62,2,3,3,8,Casual Users
57413,845,14,32,2,3,3,8,Casual Users
57591,2147,9,19,1,2,2,5,Lost
57736,23,84,433,5,5,5,15,Champions
57769,3793,6,18,1,1,2,4,Lost
57913,904,6,7,2,1,1,4,Lost
58668,135,11,19,4,2,2,8,Promising
58691,4283,8,15,1,2,1,4,Lost
58890,186,22,269,3,4,5,12,Loyal Users
58899,165,11,95,4,2,4,10,Promising
59034,230,18,39,3,3,3,9,Loyal Users
59037,2782,5,8,1,1,1,3,Lost
59354,250,7,11,3,2,1,6,Casual Users
59513,56,146,413,5,5,5,15,Champions
59732,1571,22,126,1,4,4,9,At Risk
60593,1245,8,11,2,2,1,5,Lost
60662,422,44,89,3,4,4,11,Loyal Users
60670,1253,20,25,2,3,2,7,Casual Users
60686,834,11,20,2,2,2,6,Lost
60719,1110,13,19,2,3,2,7,Casual Users
60914,1134,7,36,2,2,3,7,Lost
61111,1985,8,11,1,2,1,4,Lost
61262,245,23,41,3,4,3,10,Loyal Users
61828,843,6,22,2,1,2,5,Lost
61901,267,15,24,3,3,2,8,Loyal Users
61995,120,64,280,4,5,5,14,Champions
62091,36,201,695,5,5,5,15,Champions
62159,17,89,494,5,5,5,15,Champions
62177,446,12,28,3,3,2,8,Loyal Users
62301,3498,6,15,1,1,1,3,Lost
62532,6,23,26,5,4,2,11,Loyal Users
62663,3295,9,11,1,2,1,4,Lost
62760,1,66,392,5,5,5,15,Champions
63322,1893,10,20,1,2,2,5,Lost
63567,2693,6,6,1,1,1,3,Lost
63857,137,73,128,4,5,4,13,Champions
64073,891,14,27,2,3,2,7,Casual Users
64458,221,6,15,3,1,1,5,Casual Users
64477,2155,27,69,1,4,4,9,At Risk
64825,2538,5,13,1,1,1,3,Lost
65186,126,14,30,4,3,2,9,Loyal Users
65214,101,28,69,4,4,4,12,Champions
52660,175,6,9,3,1,1,5,Casual Users
52695,13,46,174,5,5,5,15,Champions
52975,2,21,152,5,3,5,13,Loyal Users
53106,698,13,54,2,3,3,8,Casual Users
53433,5168,17,28,1,3,2,6,Casual Users
53445,148,47,176,4,5,5,14,Champions
53695,1520,19,21,1,3,2,6,Casual Users
53775,985,34,132,2,4,4,10,At Risk
53929,422,13,76,3,3,4,10,Loyal Users
53938,101,45,90,4,4,4,12,Champions
54036,2852,7,13,1,2,1,4,Lost
54064,134,5,18,4,1,2,7,Promising
54092,1782,13,45,1,3,3,7,Casual Users
54246,426,13,32,3,3,3,9,Loyal Users
54301,822,7,41,2,2,3,7,Lost
54781,59,56,118,5,5,4,14,Champions
55980,247,15,63,3,3,4,10,Loyal Users
56111,3185,5,9,1,1,1,3,Lost
56150,1543,6,8,1,1,1,3,Lost
56162,599,32,267,2,4,5,11,At Risk
56251,849,8,19,2,2,2,6,Lost
56325,803,6,11,2,1,1,4,Lost
56876,1078,10,15,2,2,1,5,Lost
57033,366,25,57,3,4,3,10,Loyal Users
57638,36,8,10,5,2,1,8,Promising
57717,2129,6,44,1,1,3,5,Lost
57862,957,13,17,2,3,2,7,Casual Users
58091,1838,5,8,1,1,1,3,Lost
58248,2123,17,78,1,3,4,8,Casual Users
58496,118,7,14,4,2,1,7,Promising
58522,805,27,55,2,4,3,9,At Risk
58710,107,44,126,4,4,4,12,Champions
58732,1986,5,9,1,1,1,3,Lost
58870,298,24,89,3,4,4,11,Loyal Users
59095,284,11,15,3,2,1,6,Casual Users
59126,14,27,95,5,4,4,13,Champions
59994,147,40,154,4,4,5,13,Champions
60113,1013,6,8,2,1,1,4,Lost
60175,1522,16,16,1,3,2,6,Casual Users
60202,159,8,8,4,2,1,7,Promising
60218,13,78,302,5,5,5,15,Champions
60227,250,51,121,3,5,4,12,Loyal Users
60408,117,68,253,4,5,5,14,Champions
60644,421,6,9,3,1,1,5,Casual Users
60895,249,87,146,3,5,4,12,Loyal Users
61156,4147,6,7,1,1,1,3,Lost
61526,809,9,13,2,2,1,5,Lost
61912,8,113,304,5,5,5,15,Champions
62070,523,12,74,2,3,4,9,Casual Users
62303,1222,41,206,2,4,5,11,At Risk
62468,826,13,200,2,3,5,10,Casual Users
62543,3589,16,29,1,3,2,6,Casual Users
62707,134,27,46,4,4,3,11,Loyal Users
63286,120,45,114,4,4,4,12,Champions
63337,388,59,137,3,5,4,12,Loyal Users
63446,450,10,11,3,2,1,6,Casual Users
63483,10,32,81,5,4,4,13,Champions
63559,815,5,18,2,1,2,5,Lost
63949,439,9,9,3,2,1,6,Casual Users
64679,756,17,30,2,3,2,7,Casual Users
64867,165,41,131,4,4,4,12,Champions
65121,398,19,41,3,3,3,9,Loyal Users
65135,149,9,58,4,2,3,9,Promising
65198,234,77,199,3,5,5,13,Loyal Users
52541,1571,17,45,1,3,3,7,Casual Users
52577,2298,11,18,1,2,2,5,Lost
53009,282,13,30,3,3,2,8,Loyal Users
53311,926,8,9,2,2,1,5,Lost
53557,4743,6,24,1,1,2,4,Lost
53596,321,25,72,3,4,4,11,Loyal Users
53666,147,48,277,4,5,5,14,Champions
53745,1946,7,15,1,2,1,4,Lost
54056,214,50,84,3,5,4,12,Loyal Users
54537,150,30,87,4,4,4,12,Champions
54805,4416,5,5,1,1,1,3,Lost
55051,8,52,166,5,5,5,15,Champions
55063,133,85,278,4,5,5,14,Champions
55066,536,8,129,2,2,4,8,Lost
55192,139,114,394,4,5,5,14,Champions
55282,416,36,49,3,4,3,10,Loyal Users
55312,385,17,99,3,3,4,10,Loyal Users
55364,416,29,66,3,4,4,11,Loyal Users
55368,174,20,28,3,3,2,8,Loyal Users
55775,103,36,87,4,4,4,12,Champions
56212,1590,12,40,1,3,3,7,Casual Users
56478,83,32,292,4,4,5,13,Champions
56835,150,24,47,4,4,3,11,Loyal Users
57014,279,10,38,3,2,3,8,Casual Users
57174,129,10,38,4,2,3,9,Promising
57383,442,13,14,3,3,1,7,Loyal Users
57800,93,21,44,4,3,3,10,Loyal Users
58109,23,79,112,5,5,4,14,Champions
58379,2338,6,6,1,1,1,3,Lost
58510,38,67,372,5,5,5,15,Champions
58547,125,63,147,4,5,5,14,Champions
58777,431,22,31,3,4,2,9,Loyal Users
59065,80,32,60,4,4,3,11,Loyal Users
59232,22,59,349,5,5,5,15,Champions
59800,106,99,358,4,5,5,14,Champions
59965,237,10,15,3,2,1,6,Casual Users
60023,20,26,113,5,4,4,13,Champions
60043,1352,12,77,1,3,4,8,Casual Users
60501,536,26,46,2,4,3,9,At Risk
61147,135,134,540,4,5,5,14,Champions
62012,135,21,173,4,3,5,12,Loyal Users
62464,1997,8,16,1,2,2,5,Lost
62520,2,66,176,5,5,5,15,Champions
62730,1234,7,14,2,2,1,5,Lost
62737,9,79,185,5,5,5,15,Champions
63449,34,35,119,5,4,4,13,Champions
63466,497,38,85,2,4,4,10,At Risk
63704,430,37,97,3,4,4,11,Loyal Users
64119,199,39,49,3,4,3,10,Loyal Users
64486,714,5,5,2,1,1,4,Lost
64577,16,31,128,5,4,4,13,Champions
64675,29,6,8,5,1,1,7,Promising
64988,2017,5,7,1,1,1,3,Lost
65022,4747,5,7,1,1,1,3,Lost
65032,116,19,89,4,3,4,11,Loyal Users
65245,1084,16,46,2,3,3,8,Casual Users
65302,42,30,51,5,4,3,12,Loyal Users
52667,1551,13,20,1,3,2,6,Casual Users
52758,1691,5,9,1,1,1,3,Lost
53040,30,8,9,5,2,1,8,Promising
53243,8,108,403,5,5,5,15,Champions
53427,464,27,46,3,4,3,10,Loyal Users
53459,1273,8,15,1,2,1,4,Lost
53638,579,11,18,2,2,2,6,Lost
53665,416,8,23,3,2,2,7,Casual Users
54228,1104,23,87,2,4,4,10,At Risk
54829,32,31,57,5,4,3,12,Loyal Users
54832,414,32,95,3,4,4,11,Loyal Users
54983,16,5,16,5,1,2,8,Promising
55024,807,28,121,2,4,4,10,At Risk
55596,1001,10,21,2,2,2,6,Lost
55933,131,26,56,4,4,3,11,Loyal Users
56323,673,10,11,2,2,1,5,Lost
56339,127,126,317,4,5,5,14,Champions
56824,1265,12,16,1,3,2,6,Casual Users
57030,104,25,43,4,4,3,11,Loyal Users
57384,57,114,239,5,5,5,15,Champions
57426,2144,9,43,1,2,3,6,Lost
57454,7,7,32,5,2,3,10,Promising
57750,151,14,20,4,3,2,9,Loyal Users
57796,1148,6,39,2,1,3,6,Lost
58478,3812,9,9,1,2,1,4,Lost
58768,325,22,43,3,4,3,10,Loyal Users
59388,275,8,23,3,2,2,7,Casual Users
59598,22,64,71,5,5,4,14,Champions
59725,53,56,130,5,5,4,14,Champions
59809,47,64,96,5,5,4,14,Champions
59826,422,9,19,3,2,2,7,Casual Users
60104,2417,9,9,1,2,1,4,Lost
60109,98,43,122,4,4,4,12,Champions
60541,222,19,118,3,3,4,10,Loyal Users
60638,16,50,77,5,5,4,14,Champions
60707,84,5,8,4,1,1,6,Promising
60743,2462,16,37,1,3,3,7,Casual Users
60930,2851,6,26,1,1,2,4,Lost
61079,32,25,37,5,4,3,12,Loyal Users
61323,284,68,348,3,5,5,13,Loyal Users
61409,1532,6,21,1,1,2,4,Lost
61624,148,7,10,4,2,1,7,Promising
62000,862,7,9,2,2,1,5,Lost
62171,1601,16,42,1,3,3,7,Casual Users
62480,1145,13,13,2,3,1,6,Casual Users
62767,1989,31,91,1,4,4,9,At Risk
63147,8,83,239,5,5,5,15,Champions
63481,108,5,45,4,1,3,8,Promising
63583,143,8,13,4,2,1,7,Promising
63855,13,58,189,5,5,5,15,Champions
64330,144,32,99,4,4,4,12,Champions
64580,12,21,30,5,3,2,10,Loyal Users
64623,55,54,277,5,5,5,15,Champions
64740,6,142,1131,5,5,5,15,Champions
64901,99,83,177,4,5,5,14,Champions
65040,1,54,120,5,5,4,14,Champions
65146,50,13,115,5,3,4,12,Loyal Users
65184,121,159,987,4,5,5,14,Champions
65222,2591,7,10,1,2,1,4,Lost
65429,24,127,188,5,5,5,15,Champions
52393,171,29,46,3,4,3,10,Loyal Users
52642,38,38,200,5,4,5,14,Champions
52926,134,67,266,4,5,5,14,Champions
52974,434,31,85,3,4,4,11,Loyal Users
53230,513,17,37,2,3,3,8,Casual Users
53471,575,15,48,2,3,3,8,Casual Users
53635,137,74,167,4,5,5,14,Champions
54011,289,59,201,3,5,5,13,Loyal Users
54088,847,8,14,2,2,1,5,Lost
54210,4,9,59,5,2,3,10,Promising
54343,696,58,111,2,5,4,11,At Risk
54503,2968,5,5,1,1,1,3,Lost
54634,1966,16,19,1,3,2,6,Casual Users
54902,811,10,11,2,2,1,5,Lost
55096,50,112,556,5,5,5,15,Champions
55394,119,10,14,4,2,1,7,Promising
55396,4,86,383,5,5,5,15,Champions
55534,3,50,157,5,5,5,15,Champions
55745,2488,9,24,1,2,2,5,Lost
55855,125,34,46,4,4,3,11,Loyal Users
56193,92,95,186,4,5,5,14,Champions
56405,109,120,192,4,5,5,14,Champions
56491,1399,26,38,1,4,3,8,At Risk
56675,91,7,17,4,2,2,8,Promising
56704,397,17,68,3,3,4,10,Loyal Users
56746,176,38,67,3,4,4,11,Loyal Users
56791,42,64,182,5,5,5,15,Champions
57254,435,26,61,3,4,3,10,Loyal Users
57489,723,6,19,2,1,2,5,Lost
57503,796,6,15,2,1,1,4,Lost
57552,104,104,178,4,5,5,14,Champions
57577,160,10,192,4,2,5,11,Promising
57679,252,19,24,3,3,2,8,Loyal Users
57737,117,12,23,4,3,2,9,Loyal Users
57966,1982,6,6,1,1,1,3,Lost
58050,5973,5,48,1,1,3,5,Lost
58143,2969,5,8,1,1,1,3,Lost
58333,851,9,19,2,2,2,6,Lost
58609,318,6,7,3,1,1,5,Casual Users
58988,541,86,254,2,5,5,12,At Risk
58997,151,57,100,4,5,4,13,Champions
59047,116,30,69,4,4,4,12,Champions
59325,863,16,48,2,3,3,8,Casual Users
60035,421,6,22,3,1,2,6,Casual Users
60424,606,12,21,2,3,2,7,Casual Users
60510,109,23,130,4,4,4,12,Champions
60546,168,26,61,3,4,3,10,Loyal Users
60759,2015,10,29,1,2,2,5,Lost
60811,576,15,46,2,3,3,8,Casual Users
61134,345,17,43,3,3,3,9,Loyal Users
61349,796,6,22,2,1,2,5,Lost
62131,281,38,365,3,4,5,12,Loyal Users
62618,52,125,623,5,5,5,15,Champions
62854,396,12,39,3,3,3,9,Loyal Users
63053,1303,10,42,1,2,3,6,Lost
63491,421,7,42,3,2,3,8,Casual Users
63554,52,53,92,5,5,4,14,Champions
63677,2076,5,7,1,1,1,3,Lost
63887,10,65,598,5,5,5,15,Champions
64023,32,134,337,5,5,5,15,Champions
64167,224,13,94,3,3,4,10,Loyal Users
64298,3,51,116,5,5,4,14,Champions
64348,89,70,685,4,5,5,14,Champions
64418,1,148,284,5,5,5,15,Champions
64752,2,7,25,5,2,2,9,Promising
65130,15,15,164,5,3,5,13,Loyal Users
65292,2424,29,42,1,4,3,8,At Risk
65357,264,65,94,3,5,4,12,Loyal Users
52741,90,70,321,4,5,5,14,Champions
53033,647,18,29,2,3,2,7,Casual Users
53246,4093,6,21,1,1,2,4,Lost
53738,2593,10,16,1,2,2,5,Lost
54135,702,6,17,2,1,2,5,Lost
54180,1332,8,13,1,2,1,4,Lost
54632,101,35,83,4,4,4,12,Champions
54636,18,44,67,5,4,4,13,Champions
54793,382,9,9,3,2,1,6,Casual Users
55140,546,8,24,2,2,2,6,Lost
55173,144,44,114,4,4,4,12,Champions
55373,367,42,92,3,4,4,11,Loyal Users
55777,243,23,171,3,4,5,12,Loyal Users
55880,233,18,43,3,3,3,9,Loyal Users
56060,96,66,259,4,5,5,14,Champions
56166,97,44,207,4,4,5,13,Champions
56181,2299,10,10,1,2,1,4,Lost
57162,569,17,20,2,3,2,7,Casual Users
57313,550,11,13,2,2,1,5,Lost
57524,1750,8,20,1,2,2,5,Lost
57977,4389,5,12,1,1,1,3,Lost
58199,244,8,15,3,2,1,6,Casual Users
58554,542,16,66,2,3,4,9,Casual Users
58592,854,31,85,2,4,4,10,At Risk
58994,3853,6,11,1,1,1,3,Lost
59007,174,26,60,3,4,3,10,Loyal Users
59634,106,26,36,4,4,3,11,Loyal Users
59847,121,8,15,4,2,1,7,Promising
59851,793,6,11,2,1,1,4,Lost
59993,241,51,115,3,5,4,12,Loyal Users
60328,0,120,295,5,5,5,15,Champions
60340,11,27,62,5,4,3,12,Loyal Users
60378,262,8,12,3,2,1,6,Casual Users
60547,108,7,26,4,2,2,8,Promising
60729,456,23,40,3,4,3,10,Loyal Users
61100,1278,6,62,1,1,3,5,Lost
61166,4080,8,10,1,2,1,4,Lost
61173,505,16,21,2,3,2,7,Casual Users
61389,66,7,12,5,2,1,8,Promising
61630,587,13,22,2,3,2,7,Casual Users
61649,103,26,186,4,4,5,13,Champions
62145,17,122,547,5,5,5,15,Champions
62161,108,25,62,4,4,3,11,Loyal Users
62335,1861,5,18,1,1,2,4,Lost
62568,20,12,14,5,3,1,9,Loyal Users
62945,186,9,22,3,2,2,7,Casual Users
63141,840,32,47,2,4,3,9,At Risk
63162,1616,9,14,1,2,1,4,Lost
63513,240,8,22,3,2,2,7,Casual Users
63663,2304,6,21,1,1,2,4,Lost
63759,4,75,423,5,5,5,15,Champions
63792,1126,11,22,2,2,2,6,Lost
64515,709,11,59,2,2,3,7,Lost
64569,12,32,132,5,4,4,13,Champions
64816,858,8,11,2,2,1,5,Lost
64984,98,54,394,4,5,5,14,Champions
65150,3851,6,9,1,1,1,3,Lost
65172,1,115,584,5,5,5,15,Champions
65421,265,25,46,3,4,3,10,Loyal Users
65422,27,121,516,5,5,5,15,Champions
52371,1,38,334,5,4,5,14,Champions
52518,398,108,215,3,5,5,13,Loyal Users
52733,80,146,605,4,5,5,14,Champions
52856,754,37,52,2,4,3,9,At Risk
53279,413,6,13,3,1,1,5,Casual Users
53599,440,6,29,3,1,2,6,Casual Users
53663,4724,6,9,1,1,1,3,Lost
53693,5271,27,29,1,4,2,7,At Risk
54122,4574,8,32,1,2,3,6,Lost
54382,718,8,11,2,2,1,5,Lost
54515,601,27,101,2,4,4,10,At Risk
55048,1094,5,34,2,1,3,6,Lost
55153,1581,20,58,1,3,3,7,Casual Users
55782,0,43,235,5,4,5,14,Champions
55817,79,33,99,4,4,4,12,Champions
55909,1536,11,17,1,2,2,5,Lost
56100,1218,57,412,2,5,5,12,At Risk
56117,292,5,13,3,1,1,5,Casual Users
56261,6,108,530,5,5,5,15,Champions
56284,293,11,13,3,2,1,6,Casual Users
56367,95,35,81,4,4,4,12,Champions
56695,70,23,25,4,4,2,10,Loyal Users
56714,1116,17,21,2,3,2,7,Casual Users
57167,40,58,96,5,5,4,14,Champions
57430,944,14,55,2,3,3,8,Casual Users
57585,2,73,183,5,5,5,15,Champions
58401,688,10,22,2,2,2,6,Lost
58521,134,53,150,4,5,5,14,Champions
58604,279,25,62,3,4,3,10,Loyal Users
58666,840,15,25,2,3,2,7,Casual Users
58814,1299,7,35,1,2,3,6,Lost
59339,1613,8,11,1,2,1,4,Lost
59508,1977,19,104,1,3,4,8,Casual Users
59923,64,14,25,5,3,2,10,Loyal Users
60157,278,7,20,3,2,2,7,Casual Users
60322,151,62,428,4,5,5,14,Champions
60664,428,12,22,3,3,2,8,Loyal Users
60716,72,62,292,4,5,5,14,Champions
60858,7,121,420,5,5,5,15,Champions
61068,3812,5,26,1,1,2,4,Lost
61590,79,72,233,4,5,5,14,Champions
61873,130,28,44,4,4,3,11,Loyal Users
61882,111,30,98,4,4,4,12,Champions
62160,504,72,133,2,5,4,11,At Risk
62474,851,8,25,2,2,2,6,Lost
62987,1290,10,21,1,2,2,5,Lost
63325,2421,12,40,1,3,3,7,Casual Users
63332,995,20,33,2,3,3,8,Casual Users
63529,568,13,70,2,3,4,9,Casual Users
63796,407,56,134,3,5,4,12,Loyal Users
64285,13,20,26,5,3,2,10,Loyal Users
64304,7,33,337,5,4,5,14,Champions
64498,3,12,29,5,3,2,10,Loyal Users
64939,273,7,12,3,2,1,6,Casual Users
65355,848,12,24,2,3,2,7,Casual Users
65373,398,7,8,3,2,1,6,Casual Users
65436,654,41,129,2,4,4,10,At Risk
65440,145,11,12,4,2,1,7,Promising
65501,2,56,288,5,5,5,15,Champions
65549,4549,13,48,1,3,3,7,Casual Users
65599,12,69,184,5,5,5,15,Champions
65818,1582,7,20,1,2,2,5,Lost
65876,1395,9,28,1,2,2,5,Lost
66125,99,16,22,4,3,2,9,Loyal Users
66521,72,52,156,4,5,5,14,Champions
66727,1370,11,20,1,2,2,5,Lost
67166,113,37,71,4,4,4,12,Champions
67733,421,6,9,3,1,1,5,Casual Users
67881,577,18,18,2,3,2,7,Casual Users
68046,29,191,262,5,5,5,15,Champions
68197,298,5,29,3,1,2,6,Casual Users
68295,123,34,87,4,4,4,12,Champions
68380,386,16,64,3,3,4,10,Loyal Users
68694,864,19,80,2,3,4,9,Casual Users
69092,3,24,70,5,4,4,13,Champions
69207,137,30,108,4,4,4,12,Champions
69210,209,12,91,3,3,4,10,Loyal Users
69236,175,10,70,3,2,4,9,Casual Users
69349,75,114,196,4,5,5,14,Champions
69572,1290,7,8,1,2,1,4,Lost
69867,106,35,99,4,4,4,12,Champions
70051,61,14,32,5,3,3,11,Loyal Users
70240,1841,11,15,1,2,1,4,Lost
70407,1367,9,17,1,2,2,5,Lost
70624,242,35,207,3,4,5,12,Loyal Users
70646,680,68,415,2,5,5,12,At Risk
70735,57,49,299,5,5,5,15,Champions
70741,81,111,305,4,5,5,14,Champions
70815,1108,15,106,2,3,4,9,Casual Users
70865,59,33,155,5,4,5,14,Champions
71027,61,18,54,5,3,3,11,Loyal Users
71157,260,63,126,3,5,4,12,Loyal Users
71230,3724,12,22,1,3,2,6,Casual Users
71345,1382,10,18,1,2,2,5,Lost
71370,585,20,54,2,3,3,8,Casual Users
71546,809,70,124,2,5,4,11,At Risk
71632,3221,7,12,1,2,1,4,Lost
71930,144,37,177,4,4,5,13,Champions
72095,5144,6,36,1,1,3,5,Lost
72188,33,180,241,5,5,5,15,Champions
72289,37,113,654,5,5,5,15,Champions
72522,146,10,23,4,2,2,8,Promising
72576,126,90,129,4,5,4,13,Champions
73387,874,7,20,2,2,2,6,Lost
73465,75,13,28,4,3,2,9,Loyal Users
73771,1472,6,8,1,1,1,3,Lost
73840,6,16,41,5,3,3,11,Loyal Users
73891,88,79,322,4,5,5,14,Champions
73989,102,35,166,4,4,5,13,Champions
74090,3693,6,11,1,1,1,3,Lost
74226,116,23,81,4,4,4,12,Champions
74346,116,63,168,4,5,5,14,Champions
74404,303,8,8,3,2,1,6,Casual Users
74568,2,112,172,5,5,5,15,Champions
74656,1391,8,30,1,2,2,5,Lost
74792,59,81,383,5,5,5,15,Champions
74955,389,25,94,3,4,4,11,Loyal Users
75227,413,13,16,3,3,2,8,Loyal Users
75624,831,31,112,2,4,4,10,At Risk
75740,74,8,8,4,2,1,7,Promising
75795,432,9,17,3,2,2,7,Casual Users
76219,1098,9,12,2,2,1,5,Lost
76282,37,38,49,5,4,3,12,Loyal Users
76326,114,13,204,4,3,5,12,Loyal Users
76540,140,27,44,4,4,3,11,Loyal Users
76614,16,28,288,5,4,5,14,Champions
76745,1177,5,21,2,1,2,5,Lost
76824,101,16,20,4,3,2,9,Loyal Users
77435,95,115,404,4,5,5,14,Champions
77717,4,132,582,5,5,5,15,Champions
77806,4690,6,7,1,1,1,3,Lost
77895,846,7,15,2,2,1,5,Lost
78058,9,78,125,5,5,4,14,Champions
78076,876,9,15,2,2,1,5,Lost
78147,796,33,91,2,4,4,10,At Risk
78180,26,37,72,5,4,4,13,Champions
78232,205,20,27,3,3,2,8,Loyal Users
66269,1485,11,60,1,2,3,6,Lost
66341,1566,168,346,1,5,5,11,At Risk
66831,29,29,79,5,4,4,13,Champions
67137,28,154,333,5,5,5,15,Champions
67659,413,13,21,3,3,2,8,Loyal Users
67698,3353,8,11,1,2,1,4,Lost
67955,7,29,86,5,4,4,13,Champions
67985,15,17,132,5,3,4,12,Loyal Users
68473,1860,5,82,1,1,4,6,Lost
68684,24,102,386,5,5,5,15,Champions
68979,55,105,239,5,5,5,15,Champions
69055,1273,28,52,1,4,3,8,At Risk
69231,320,54,212,3,5,5,13,Loyal Users
69588,2919,12,21,1,3,2,6,Casual Users
70382,15,16,102,5,3,4,12,Loyal Users
70527,1761,7,34,1,2,3,6,Lost
70531,295,8,8,3,2,1,6,Casual Users
70544,20,57,78,5,5,4,14,Champions
71104,126,30,54,4,4,3,11,Loyal Users
71169,154,30,57,4,4,3,11,Loyal Users
71215,159,33,126,4,4,4,12,Champions
71247,2711,5,6,1,1,1,3,Lost
71260,290,7,9,3,2,1,6,Casual Users
71607,258,12,13,3,3,1,7,Loyal Users
71736,2102,43,67,1,4,4,9,At Risk
71801,3705,18,61,1,3,3,7,Casual Users
71953,276,41,118,3,4,4,11,Loyal Users
72084,1451,8,55,1,2,3,6,Lost
72160,205,50,291,3,5,5,13,Loyal Users
72356,0,72,281,5,5,5,15,Champions
72607,1416,9,19,1,2,2,5,Lost
72689,1535,8,25,1,2,2,5,Lost
73116,448,128,249,3,5,5,13,Loyal Users
73502,352,5,6,3,1,1,5,Casual Users
73641,626,8,11,2,2,1,5,Lost
73927,548,7,10,2,2,1,5,Lost
74328,1119,22,81,2,4,4,10,At Risk
74456,747,9,15,2,2,1,5,Lost
74460,1630,14,46,1,3,3,7,Casual Users
74469,359,11,39,3,2,3,8,Casual Users
74690,49,105,285,5,5,5,15,Champions
74950,458,10,40,3,2,3,8,Casual Users
75079,1836,6,8,1,1,1,3,Lost
75095,2391,7,16,1,2,2,5,Lost
75191,18,10,34,5,2,3,10,Promising
75460,730,5,10,2,1,1,4,Lost
75512,259,5,16,3,1,2,6,Casual Users
75748,677,10,26,2,2,2,6,Lost
75847,1840,5,31,1,1,2,4,Lost
76073,1716,7,8,1,2,1,4,Lost
76134,421,28,218,3,4,5,12,Loyal Users
76180,60,20,27,5,3,2,10,Loyal Users
76246,2120,6,41,1,1,3,5,Lost
76472,2122,7,10,1,2,1,4,Lost
76665,520,7,14,2,2,1,5,Lost
76943,43,9,18,5,2,2,9,Promising
77777,124,7,31,4,2,2,8,Promising
66113,9,6,6,5,1,1,7,Promising
66229,225,13,26,3,3,2,8,Loyal Users
66233,93,102,166,4,5,5,14,Champions
66489,58,96,263,5,5,5,15,Champions
66523,1504,5,9,1,1,1,3,Lost
66546,11,136,545,5,5,5,15,Champions
66554,0,20,61,5,3,3,11,Loyal Users
66833,728,22,167,2,4,5,11,At Risk
67064,269,21,28,3,3,2,8,Loyal Users
67281,3121,6,65,1,1,4,6,Lost
67330,850,7,31,2,2,2,6,Lost
67450,2955,10,11,1,2,1,4,Lost
67587,269,19,55,3,3,3,9,Loyal Users
67609,688,9,22,2,2,2,6,Lost
67854,1276,7,30,1,2,2,5,Lost
67935,1557,14,47,1,3,3,7,Casual Users
68187,2692,8,27,1,2,2,5,Lost
68335,1,100,552,5,5,5,15,Champions
68418,313,28,213,3,4,5,12,Loyal Users
68626,414,52,219,3,5,5,13,Loyal Users
68674,721,24,33,2,4,3,9,At Risk
68756,20,104,190,5,5,5,15,Champions
68758,101,6,27,4,1,2,7,Promising
68918,592,11,43,2,2,3,7,Lost
69033,424,54,65,3,5,4,12,Loyal Users
69290,54,42,209,5,4,5,14,Champions
69659,2004,5,21,1,1,2,4,Lost
70075,278,58,137,3,5,4,12,Loyal Users
70792,408,24,112,3,4,4,11,Loyal Users
71264,319,19,170,3,3,5,11,Loyal Users
71448,0,37,139,5,4,4,13,Champions
71880,94,64,194,4,5,5,14,Champions
71925,608,22,49,2,4,3,9,At Risk
71988,440,10,27,3,2,2,7,Casual Users
72311,213,6,17,3,1,2,6,Casual Users
72315,414,37,113,3,4,4,11,Loyal Users
73077,396,11,12,3,2,1,6,Casual Users
73294,1271,9,11,1,2,1,4,Lost
73434,2438,46,82,1,5,4,10,At Risk
73523,1212,13,64,2,3,4,9,Casual Users
73706,2134,63,194,1,5,5,11,At Risk
73758,122,10,35,4,2,3,9,Promising
74416,2852,12,21,1,3,2,6,Casual Users
74825,88,128,488,4,5,5,14,Champions
74963,1843,6,10,1,1,1,3,Lost
75164,2,119,525,5,5,5,15,Champions
75286,5892,9,12,1,2,1,4,Lost
75368,409,22,94,3,4,4,11,Loyal Users
75488,4541,6,31,1,1,2,4,Lost
75578,4665,12,44,1,3,3,7,Casual Users
75897,1288,12,14,1,3,1,5,Casual Users
76020,103,7,11,4,2,1,7,Promising
76268,694,19,33,2,3,3,8,Casual Users
76304,852,9,21,2,2,2,6,Lost
76471,21,13,19,5,3,2,10,Loyal Users
76598,459,10,28,3,2,2,7,Casual Users
77192,58,73,294,5,5,5,15,Champions
77444,40,89,246,5,5,5,15,Champions
78021,30,17,50,5,3,3,11,Loyal Users
78102,797,6,9,2,1,1,4,Lost
78184,109,59,204,4,5,5,14,Champions
65637,2522,7,7,1,2,1,4,Lost
65648,118,89,336,4,5,5,14,Champions
65755,9,17,39,5,3,3,11,Loyal Users
65912,81,48,146,4,5,4,13,Champions
66120,39,54,139,5,5,4,14,Champions
66351,578,6,16,2,1,2,5,Lost
66472,28,53,70,5,5,4,14,Champions
66534,482,35,82,2,4,4,10,At Risk
66823,261,88,398,3,5,5,13,Loyal Users
67413,2117,18,32,1,3,3,7,Casual Users
67479,17,10,12,5,2,1,8,Promising
67717,1868,7,8,1,2,1,4,Lost
67817,66,57,251,5,5,5,15,Champions
67895,1265,21,32,1,3,3,7,Casual Users
67919,409,22,185,3,4,5,12,Loyal Users
68065,3057,6,52,1,1,3,5,Lost
68643,669,17,23,2,3,2,7,Casual Users
68747,194,24,49,3,4,3,10,Loyal Users
68874,144,5,10,4,1,1,6,Promising
68995,271,6,21,3,1,2,6,Casual Users
69020,2522,8,16,1,2,2,5,Lost
69199,186,23,89,3,4,4,11,Loyal Users
69533,52,43,73,5,4,4,13,Champions
69569,988,6,12,2,1,1,4,Lost
70067,112,58,361,4,5,5,14,Champions
70094,2285,7,7,1,2,1,4,Lost
70377,633,6,7,2,1,1,4,Lost
71107,927,20,38,2,3,3,8,Casual Users
71165,287,29,69,3,4,4,11,Loyal Users
71497,828,20,97,2,3,4,9,Casual Users
71589,38,32,313,5,4,5,14,Champions
71639,5565,6,8,1,1,1,3,Lost
72159,104,16,20,4,3,2,9,Loyal Users
72445,2564,5,12,1,1,1,3,Lost
72779,167,33,85,3,4,4,11,Loyal Users
72923,1840,8,16,1,2,2,5,Lost
73016,90,18,30,4,3,2,9,Loyal Users
73139,138,24,106,4,4,4,12,Champions
73151,706,9,13,2,2,1,5,Lost
73285,401,10,50,3,2,3,8,Casual Users
73330,299,11,81,3,2,4,9,Casual Users
73346,2390,7,17,1,2,2,5,Lost
73530,102,9,34,4,2,3,9,Promising
73577,17,74,148,5,5,5,15,Champions
73756,472,28,58,2,4,3,9,At Risk
73794,19,9,34,5,2,3,10,Promising
73899,273,16,44,3,3,3,9,Loyal Users
75000,422,6,7,3,1,1,5,Casual Users
75004,787,22,92,2,4,4,10,At Risk
75645,430,7,12,3,2,1,6,Casual Users
76137,800,9,25,2,2,2,6,Lost
76363,1137,5,10,2,1,1,4,Lost
76469,136,12,14,4,3,1,8,Loyal Users
76917,40,8,10,5,2,1,8,Promising
76960,735,6,27,2,1,2,5,Lost
77874,34,135,376,5,5,5,15,Champions
78163,544,23,40,2,4,3,9,At Risk
65492,4648,5,22,1,1,2,4,Lost
65740,2269,6,10,1,1,1,3,Lost
65812,613,29,121,2,4,4,10,At Risk
66018,1318,41,79,1,4,4,9,At Risk
66408,3754,5,8,1,1,1,3,Lost
66518,13,47,113,5,5,4,14,Champions
66539,333,30,54,3,4,3,10,Loyal Users
66641,1527,7,13,1,2,1,4,Lost
66863,170,12,24,3,3,2,8,Loyal Users
66879,1221,11,40,2,2,3,7,Lost
66972,658,34,88,2,4,4,10,At Risk
66981,163,76,100,4,5,4,13,Champions
67004,440,15,33,3,3,3,9,Loyal Users
67096,188,51,195,3,5,5,13,Loyal Users
67187,124,23,37,4,4,3,11,Loyal Users
67213,255,15,65,3,3,4,10,Loyal Users
67502,2629,5,10,1,1,1,3,Lost
67789,2270,5,6,1,1,1,3,Lost
67808,70,94,305,4,5,5,14,Champions
67862,531,35,172,2,4,5,11,At Risk
67993,37,13,110,5,3,4,12,Loyal Users
68139,373,11,16,3,2,2,7,Casual Users
68262,393,84,181,3,5,5,13,Loyal Users
68619,852,13,43,2,3,3,8,Casual Users
68777,2094,7,40,1,2,3,6,Lost
69486,321,9,9,3,2,1,6,Casual Users
69687,651,10,13,2,2,1,5,Lost
69882,13,150,640,5,5,5,15,Champions
69953,3345,93,225,1,5,5,11,At Risk
69987,2930,6,45,1,1,3,5,Lost
70175,1561,7,8,1,2,1,4,Lost
70649,1536,6,51,1,1,3,5,Lost
70805,110,7,69,4,2,4,10,Promising
70890,574,13,105,2,3,4,9,Casual Users
71193,4842,10,32,1,2,3,6,Lost
71234,1977,10,10,1,2,1,4,Lost
71320,4052,5,5,1,1,1,3,Lost
71356,354,15,31,3,3,2,8,Loyal Users
71667,34,14,102,5,3,4,12,Loyal Users
72122,128,10,21,4,2,2,8,Promising
72594,569,23,36,2,4,3,9,At Risk
72649,5,15,32,5,3,3,11,Loyal Users
72651,79,9,34,4,2,3,9,Promising
72879,1615,10,19,1,2,2,5,Lost
73392,112,7,23,4,2,2,8,Promising
73424,411,100,291,3,5,5,13,Loyal Users
73662,0,13,15,5,3,1,9,Loyal Users
73690,2110,25,94,1,4,4,9,At Risk
74002,430,6,10,3,1,1,5,Casual Users
74032,167,11,20,3,2,2,7,Casual Users
74640,28,83,410,5,5,5,15,Champions
74726,27,98,269,5,5,5,15,Champions
74928,832,13,83,2,3,4,9,Casual Users
74993,3261,5,16,1,1,2,4,Lost
75080,65,65,308,5,5,5,15,Champions
75868,948,12,34,2,3,3,8,Casual Users
75928,46,5,19,5,1,2,8,Promising
76142,3,26,79,5,4,4,13,Champions
76883,1442,8,15,1,2,1,4,Lost
77052,76,59,131,4,5,4,13,Champions
77254,90,102,165,4,5,5,14,Champions
77304,149,30,174,4,4,5,13,Champions
77363,852,5,45,2,1,3,6,Lost
77447,3188,45,56,1,4,3,8,At Risk
77511,1,129,160,5,5,5,15,Champions
77688,992,35,144,2,4,4,10,At Risk
78145,1970,6,19,1,1,2,4,Lost
65664,298,64,84,3,5,4,12,Loyal Users
65774,148,5,10,4,1,1,6,Promising
65785,541,6,11,2,1,1,4,Lost
65911,584,9,36,2,2,3,7,Lost
66073,307,9,15,3,2,1,6,Casual Users
66115,121,57,435,4,5,5,14,Champions
66182,116,40,133,4,4,4,12,Champions
66385,856,12,32,2,3,3,8,Casual Users
66530,1739,8,31,1,2,2,5,Lost
66804,16,37,72,5,4,4,13,Champions
66857,1116,5,33,2,1,3,6,Lost
66904,272,20,125,3,3,4,10,Loyal Users
66952,13,13,94,5,3,4,12,Loyal Users
66988,3,71,273,5,5,5,15,Champions
67165,3013,5,6,1,1,1,3,Lost
67298,1715,16,78,1,3,4,8,Casual Users
67540,933,10,26,2,2,2,6,Lost
67737,213,38,296,3,4,5,12,Loyal Users
67852,153,15,45,4,3,3,10,Loyal Users
68011,46,21,28,5,3,2,10,Loyal Users
68105,78,45,132,4,4,4,12,Champions
68185,28,46,97,5,5,4,14,Champions
69153,332,30,51,3,4,3,10,Loyal Users
69220,13,65,108,5,5,4,14,Champions
69557,1016,9,10,2,2,1,5,Lost
69712,81,27,44,4,4,3,11,Loyal Users
70018,3545,20,69,1,3,4,8,Casual Users
70024,568,38,130,2,4,4,10,At Risk
70132,1560,10,21,1,2,2,5,Lost
70629,211,8,12,3,2,1,6,Casual Users
70652,117,42,162,4,4,5,13,Champions
71188,4448,5,13,1,1,1,3,Lost
71286,1187,7,19,2,2,2,6,Lost
71387,1246,7,38,2,2,3,7,Lost
71389,425,8,14,3,2,1,6,Casual Users
71391,55,26,59,5,4,3,12,Loyal Users
71396,30,71,370,5,5,5,15,Champions
71901,78,56,135,4,5,4,13,Champions
72301,538,9,14,2,2,1,5,Lost
72309,167,24,41,3,4,3,10,Loyal Users
72321,437,11,17,3,2,2,7,Casual Users
72340,119,84,645,4,5,5,14,Champions
72588,7,187,384,5,5,5,15,Champions
72609,2620,12,25,1,3,2,6,Casual Users
72844,1557,17,62,1,3,3,7,Casual Users
73213,1416,5,9,1,1,1,3,Lost
74305,1414,8,28,1,2,2,5,Lost
74376,977,8,23,2,2,2,6,Lost
74530,12,8,9,5,2,1,8,Promising
74881,391,12,47,3,3,3,9,Loyal Users
75085,143,10,12,4,2,1,7,Promising
75165,5318,8,12,1,2,1,4,Lost
75328,1596,7,11,1,2,1,4,Lost
75587,165,6,9,4,1,1,6,Promising
75668,839,15,29,2,3,2,7,Casual Users
75838,370,13,90,3,3,4,10,Loyal Users
76026,1736,6,10,1,1,1,3,Lost
76256,1812,57,142,1,5,4,10,At Risk
76500,208,5,16,3,1,2,6,Casual Users
76547,241,8,9,3,2,1,6,Casual Users
76712,3454,8,25,1,2,2,5,Lost
76716,644,7,21,2,2,2,6,Lost
76836,733,14,23,2,3,2,7,Casual Users
76859,206,168,245,3,5,5,13,Loyal Users
77395,1466,5,14,1,1,1,3,Lost
77608,18,36,72,5,4,4,13,Champions
77897,272,29,100,3,4,4,11,Loyal Users
78008,829,8,48,2,2,3,7,Lost
78033,19,7,65,5,2,4,11,Promising
78066,18,47,80,5,5,4,14,Champions
65485,1,30,57,5,4,3,12,Loyal Users
65779,88,44,87,4,4,4,12,Champions
66112,738,5,8,2,1,1,4,Lost
66329,822,7,21,2,2,2,6,Lost
66378,4127,6,15,1,1,1,3,Lost
66636,41,162,226,5,5,5,15,Champions
66724,440,9,13,3,2,1,6,Casual Users
66759,1375,6,8,1,1,1,3,Lost
66860,0,35,118,5,4,4,13,Champions
66903,174,14,15,3,3,1,7,Loyal Users
67119,10,50,71,5,5,4,14,Champions
67244,4,65,143,5,5,4,14,Champions
67338,190,37,39,3,4,3,10,Loyal Users
67740,19,8,22,5,2,2,9,Promising
67912,2,134,190,5,5,5,15,Champions
68002,3156,5,7,1,1,1,3,Lost
68097,119,68,318,4,5,5,14,Champions
68163,19,79,269,5,5,5,15,Champions
68255,1680,7,9,1,2,1,4,Lost
68563,8,13,93,5,3,4,12,Loyal Users
68914,2083,5,38,1,1,3,5,Lost
69119,144,69,546,4,5,5,14,Champions
69206,300,6,16,3,1,2,6,Casual Users
69381,913,7,33,2,2,3,7,Lost
69474,34,70,183,5,5,5,15,Champions
69623,3739,5,8,1,1,1,3,Lost
69744,159,5,10,4,1,1,6,Promising
69748,246,84,294,3,5,5,13,Loyal Users
69812,279,17,31,3,3,2,8,Loyal Users
69964,684,10,36,2,2,3,7,Lost
70265,12,37,156,5,4,5,14,Champions
70268,2662,5,28,1,1,2,4,Lost
70295,219,8,24,3,2,2,7,Casual Users
70842,67,44,114,5,4,4,13,Champions
71065,2420,9,27,1,2,2,5,Lost
71154,74,16,36,4,3,3,10,Loyal Users
71195,85,17,63,4,3,4,11,Loyal Users
71199,2944,13,64,1,3,4,8,Casual Users
71314,406,25,44,3,4,3,10,Loyal Users
71615,111,13,40,4,3,3,10,Loyal Users
71856,55,8,12,5,2,1,8,Promising
71906,35,52,84,5,5,4,14,Champions
72184,79,9,26,4,2,2,8,Promising
72209,23,11,15,5,2,1,8,Promising
72397,460,22,109,3,4,4,11,Loyal Users
72625,3284,8,11,1,2,1,4,Lost
73001,689,8,26,2,2,2,6,Lost
73019,113,56,232,4,5,5,14,Champions
73084,2081,10,75,1,2,4,7,Lost
73215,180,38,56,3,4,3,10,Loyal Users
73312,1780,7,35,1,2,3,6,Lost
73590,37,81,394,5,5,5,15,Champions
73821,1574,22,94,1,4,4,9,At Risk
74042,12,43,46,5,4,3,12,Loyal Users
74075,665,11,22,2,2,2,6,Lost
74093,584,31,88,2,4,4,10,At Risk
74439,1076,7,8,2,2,1,5,Lost
75066,5764,8,54,1,2,3,6,Lost
75378,137,9,13,4,2,1,7,Promising
75384,21,38,154,5,4,5,14,Champions
75425,394,12,16,3,3,2,8,Loyal Users
75474,480,7,27,2,2,2,6,Lost
75841,3,100,369,5,5,5,15,Champions
75878,3702,5,9,1,1,1,3,Lost
75903,125,55,292,4,5,5,14,Champions
76085,751,25,56,2,4,3,9,At Risk
76183,509,6,6,2,1,1,4,Lost
76560,411,65,460,3,5,5,13,Loyal Users
76863,1874,8,11,1,2,1,4,Lost
77404,124,27,155,4,4,5,13,Champions
77630,23,26,99,5,4,4,13,Champions
77644,1861,5,9,1,1,1,3,Lost
77707,811,5,12,2,1,1,4,Lost
77896,98,5,23,4,1,2,7,Promising
65734,316,8,17,3,2,2,7,Casual Users
65792,265,16,25,3,3,2,8,Loyal Users
66090,13,75,302,5,5,5,15,Champions
66171,161,70,260,4,5,5,14,Champions
66370,595,58,296,2,5,5,12,At Risk
66461,285,7,9,3,2,1,6,Casual Users
66991,126,113,375,4,5,5,14,Champions
67163,132,8,26,4,2,2,8,Promising
67348,561,12,33,2,3,3,8,Casual Users
67458,349,17,20,3,3,2,8,Loyal Users
67534,97,38,74,4,4,4,12,Champions
67638,129,42,176,4,4,5,13,Champions
67728,123,29,36,4,4,3,11,Loyal Users
67999,33,6,16,5,1,2,8,Promising
68039,1499,9,26,1,2,2,5,Lost
68229,2653,67,118,1,5,4,10,At Risk
68330,550,15,15,2,3,1,6,Casual Users
68539,2242,5,21,1,1,2,4,Lost
68552,181,13,18,3,3,2,8,Loyal Users
69393,1877,23,51,1,4,3,8,At Risk
69406,1088,13,51,2,3,3,8,Casual Users
69877,414,36,60,3,4,3,10,Loyal Users
69935,267,46,139,3,5,4,12,Loyal Users
70022,56,64,509,5,5,5,15,Champions
70535,785,11,36,2,2,3,7,Lost
70560,314,8,8,3,2,1,6,Casual Users
70689,19,40,138,5,4,4,13,Champions
70899,1429,40,238,1,4,5,10,At Risk
71044,78,99,295,4,5,5,14,Champions
71159,22,96,593,5,5,5,15,Champions
71380,6,248,360,5,5,5,15,Champions
71461,1036,23,73,2,4,4,10,At Risk
71539,3582,12,27,1,3,2,6,Casual Users
71760,304,14,19,3,3,2,8,Loyal Users
71770,111,7,8,4,2,1,7,Promising
71807,13,106,185,5,5,5,15,Champions
72105,375,6,24,3,1,2,6,Casual Users
72141,377,19,26,3,3,2,8,Loyal Users
72212,2,51,175,5,5,5,15,Champions
72419,217,5,8,3,1,1,5,Casual Users
72626,248,5,9,3,1,1,5,Casual Users
73067,257,27,80,3,4,4,11,Loyal Users
73103,5429,5,16,1,1,2,4,Lost
73232,334,12,22,3,3,2,8,Loyal Users
74011,257,78,202,3,5,5,13,Loyal Users
74120,655,37,91,2,4,4,10,At Risk
74135,1013,33,101,2,4,4,10,At Risk
74179,10,9,37,5,2,3,10,Promising
74349,95,24,41,4,4,3,11,Loyal Users
74396,449,11,14,3,2,1,6,Casual Users
74522,12,81,748,5,5,5,15,Champions
74885,20,88,698,5,5,5,15,Champions
75043,1304,37,191,1,4,5,10,At Risk
75054,84,36,47,4,4,3,11,Loyal Users
75056,1,47,165,5,5,5,15,Champions
75158,484,8,17,2,2,2,6,Lost
75289,55,50,270,5,5,5,15,Champions
75380,196,26,78,3,4,4,11,Loyal Users
75414,229,9,18,3,2,2,7,Casual Users
75571,3020,7,9,1,2,1,4,Lost
75612,1291,9,24,1,2,2,5,Lost
75729,430,10,20,3,2,2,7,Casual Users
75875,825,27,124,2,4,4,10,At Risk
76012,417,6,10,3,1,1,5,Casual Users
76224,422,10,13,3,2,1,6,Casual Users
76323,173,7,15,3,2,1,6,Casual Users
76474,1074,19,101,2,3,4,9,Casual Users
77004,284,13,61,3,3,3,9,Loyal Users
77371,80,62,307,4,5,5,14,Champions
77431,270,60,176,3,5,5,13,Loyal Users
77721,102,60,137,4,5,4,13,Champions
77845,1431,5,6,1,1,1,3,Lost
78085,67,21,33,5,3,3,11,Loyal Users
65464,9,94,149,5,5,5,15,Champions
65808,503,29,191,2,4,5,11,At Risk
66374,3561,6,18,1,1,2,4,Lost
66448,21,100,206,5,5,5,15,Champions
66529,269,10,10,3,2,1,6,Casual Users
66612,4,63,192,5,5,5,15,Champions
67222,839,13,34,2,3,3,8,Casual Users
67288,101,35,97,4,4,4,12,Champions
67455,6,86,129,5,5,4,14,Champions
67517,280,9,23,3,2,2,7,Casual Users
67798,991,20,70,2,3,4,9,Casual Users
67867,6,6,25,5,1,2,8,Promising
67897,146,14,78,4,3,4,11,Loyal Users
68167,382,23,84,3,4,4,11,Loyal Users
68587,592,29,37,2,4,3,9,At Risk
68634,79,51,131,4,5,4,13,Champions
68827,6,58,126,5,5,4,14,Champions
69058,2767,12,13,1,3,1,5,Casual Users
69080,4002,20,38,1,3,3,7,Casual Users
69176,2797,8,12,1,2,1,4,Lost
69363,261,97,409,3,5,5,13,Loyal Users
69423,21,113,517,5,5,5,15,Champions
69428,2846,9,33,1,2,3,6,Lost
69657,6,141,387,5,5,5,15,Champions
70050,4220,8,23,1,2,2,5,Lost
70147,115,13,25,4,3,2,9,Loyal Users
70908,501,15,34,2,3,3,8,Casual Users
71131,189,5,10,3,1,1,5,Casual Users
71191,86,5,7,4,1,1,6,Promising
71570,1284,5,8,1,1,1,3,Lost
71674,278,26,31,3,4,2,9,Loyal Users
71786,297,5,30,3,1,2,6,Casual Users
72067,245,11,28,3,2,2,7,Casual Users
72116,92,95,345,4,5,5,14,Champions
72291,67,8,9,5,2,1,8,Promising
72512,2228,5,11,1,1,1,3,Lost
72618,5,39,164,5,4,5,14,Champions
72628,6,53,246,5,5,5,15,Champions
73018,2,69,273,5,5,5,15,Champions
73171,143,5,9,4,1,1,6,Promising
73674,461,5,8,3,1,1,5,Casual Users
74789,306,123,498,3,5,5,13,Loyal Users
74874,123,56,71,4,5,4,13,Champions
74944,3113,9,25,1,2,2,5,Lost
75246,15,83,181,5,5,5,15,Champions
75464,432,16,39,3,3,3,9,Loyal Users
75550,1281,81,352,1,5,5,11,At Risk
75714,3527,8,17,1,2,2,5,Lost
75827,2972,7,8,1,2,1,4,Lost
76036,2252,17,31,1,3,2,6,Casual Users
76090,1004,7,24,2,2,2,6,Lost
76168,164,19,37,4,3,3,10,Loyal Users
76191,4436,6,16,1,1,2,4,Lost
76454,149,174,343,4,5,5,14,Champions
76807,723,10,18,2,2,2,6,Lost
76843,278,9,31,3,2,2,7,Casual Users
77041,15,28,40,5,4,3,12,Loyal Users
77166,12,55,84,5,5,4,14,Champions
77424,5,53,137,5,5,4,14,Champions
77536,468,9,14,3,2,1,6,Casual Users
77784,1938,5,15,1,1,1,3,Lost
77785,69,38,110,5,4,4,13,Champions
77856,2074,12,17,1,3,2,6,Casual Users
77867,1123,11,38,2,2,3,7,Lost
78216,2559,11,31,1,2,2,5,Lost
66059,3498,7,31,1,2,2,5,Lost
66249,878,14,22,2,3,2,7,Casual Users
66293,46,29,62,5,4,3,12,Loyal Users
66296,270,33,131,3,4,4,11,Loyal Users
66319,437,25,74,3,4,4,11,Loyal Users
66356,119,53,127,4,5,4,13,Champions
66455,1972,12,23,1,3,2,6,Casual Users
67184,275,69,181,3,5,5,13,Loyal Users
67345,959,7,27,2,2,2,6,Lost
67718,2147,5,11,1,1,1,3,Lost
67761,4,40,180,5,4,5,14,Champions
68086,12,21,113,5,3,4,12,Loyal Users
68184,965,27,47,2,4,3,9,At Risk
68260,1745,17,25,1,3,2,6,Casual Users
68355,154,31,48,4,4,3,11,Loyal Users
68523,2954,26,41,1,4,3,8,At Risk
68809,1,32,127,5,4,4,13,Champions
69032,424,28,50,3,4,3,10,Loyal Users
69195,121,74,224,4,5,5,14,Champions
69635,13,31,146,5,4,4,13,Champions
70347,357,20,54,3,3,3,9,Loyal Users
70403,278,13,88,3,3,4,10,Loyal Users
70774,4304,68,209,1,5,5,11,At Risk
70784,226,7,7,3,2,1,6,Casual Users
71249,133,6,17,4,1,2,7,Promising
71443,119,88,205,4,5,5,14,Champions
71763,1601,17,31,1,3,2,6,Casual Users
71910,345,7,11,3,2,1,6,Casual Users
71998,615,5,16,2,1,2,5,Lost
72286,276,39,207,3,4,5,12,Loyal Users
72351,3312,36,80,1,4,4,9,At Risk
72489,531,42,243,2,4,5,11,At Risk
72650,816,13,21,2,3,2,7,Casual Users
72674,901,5,9,2,1,1,4,Lost
72916,2388,20,229,1,3,5,9,Casual Users
73017,2045,5,15,1,1,1,3,Lost
73024,396,8,15,3,2,1,6,Casual Users
73203,790,44,50,2,4,3,9,At Risk
73742,101,21,124,4,3,4,11,Loyal Users
74151,1457,9,20,1,2,2,5,Lost
74273,835,8,20,2,2,2,6,Lost
74455,663,10,21,2,2,2,6,Lost
74498,104,96,435,4,5,5,14,Champions
74527,851,9,26,2,2,2,6,Lost
74947,231,10,12,3,2,1,6,Casual Users
75006,1711,7,48,1,2,3,6,Lost
75112,108,15,44,4,3,3,10,Loyal Users
75115,126,153,481,4,5,5,14,Champions
75279,139,40,85,4,4,4,12,Champions
75394,1279,8,8,1,2,1,4,Lost
75527,64,14,18,5,3,2,10,Loyal Users
75762,3406,14,52,1,3,3,7,Casual Users
75790,26,40,171,5,4,5,14,Champions
76214,788,13,28,2,3,2,7,Casual Users
76311,574,42,105,2,4,4,10,At Risk
76747,285,25,66,3,4,4,11,Loyal Users
76915,1077,11,45,2,2,3,7,Lost
76955,245,37,59,3,4,3,10,Loyal Users
77056,121,25,102,4,4,4,12,Champions
77103,71,22,101,4,4,4,12,Champions
77172,52,123,820,5,5,5,15,Champions
77350,42,55,187,5,5,5,15,Champions
77539,1719,12,24,1,3,2,6,Casual Users
78220,1628,6,54,1,1,3,5,Lost
65499,26,9,17,5,2,2,9,Promising
65529,693,17,27,2,3,2,7,Casual Users
65596,1290,19,44,1,3,3,7,Casual Users
66008,847,5,13,2,1,1,4,Lost
66260,29,37,90,5,4,4,13,Champions
66306,754,8,55,2,2,3,7,Lost
66429,270,5,28,3,1,2,6,Casual Users
66585,401,47,80,3,5,4,12,Loyal Users
66586,2948,35,176,1,4,5,10,At Risk
66816,4529,11,21,1,2,2,5,Lost
67584,34,86,189,5,5,5,15,Champions
67611,189,44,111,3,4,4,11,Loyal Users
67779,2606,14,22,1,3,2,6,Casual Users
68169,3989,8,37,1,2,3,6,Lost
68311,132,18,30,4,3,2,9,Loyal Users
68336,14,99,275,5,5,5,15,Champions
68410,730,28,166,2,4,5,11,At Risk
68735,306,6,9,3,1,1,5,Casual Users
68921,4,98,285,5,5,5,15,Champions
69221,134,83,137,4,5,4,13,Champions
69248,334,5,6,3,1,1,5,Casual Users
69348,164,8,85,4,2,4,10,Promising
69565,581,9,22,2,2,2,6,Lost
69760,189,61,352,3,5,5,13,Loyal Users
69764,1849,9,24,1,2,2,5,Lost
69801,29,27,54,5,4,3,12,Loyal Users
69996,291,9,28,3,2,2,7,Casual Users
70030,139,68,253,4,5,5,14,Champions
70101,3,35,61,5,4,3,12,Loyal Users
70118,11,8,72,5,2,4,11,Promising
70455,412,6,10,3,1,1,5,Casual Users
70467,0,29,90,5,4,4,13,Champions
70721,83,33,192,4,4,5,13,Champions
70921,727,16,22,2,3,2,7,Casual Users
71305,132,62,491,4,5,5,14,Champions
71777,755,35,59,2,4,3,9,At Risk
72297,13,12,50,5,3,3,11,Loyal Users
72950,1557,6,6,1,1,1,3,Lost
73026,509,9,26,2,2,2,6,Lost
73070,938,11,42,2,2,3,7,Lost
73162,2005,6,8,1,1,1,3,Lost
73454,6,5,6,5,1,1,7,Promising
73631,458,8,25,3,2,2,7,Casual Users
74148,2866,7,7,1,2,1,4,Lost
74212,145,11,39,4,2,3,9,Promising
74474,4708,6,11,1,1,1,3,Lost
74586,19,77,499,5,5,5,15,Champions
74793,316,28,59,3,4,3,10,Loyal Users
75035,2762,7,56,1,2,3,6,Lost
75152,2251,9,27,1,2,2,5,Lost
75219,420,10,22,3,2,2,7,Casual Users
75656,855,11,33,2,2,3,7,Lost
75674,84,12,102,4,3,4,11,Loyal Users
76047,633,11,24,2,2,2,6,Lost
76076,749,21,51,2,3,3,8,Casual Users
76260,23,46,114,5,5,4,14,Champions
76338,963,19,34,2,3,3,8,Casual Users
76374,45,12,16,5,3,2,10,Loyal Users
76620,16,81,330,5,5,5,15,Champions
76642,229,76,332,3,5,5,13,Loyal Users
76802,8,81,136,5,5,4,14,Champions
77242,344,46,203,3,5,5,13,Loyal Users
77595,106,38,88,4,4,4,12,Champions
77755,257,21,109,3,3,4,10,Loyal Users
65513,161,32,54,4,4,3,11,Loyal Users
65527,24,95,117,5,5,4,14,Champions
65897,1099,10,26,2,2,2,6,Lost
66098,444,29,239,3,4,5,12,Loyal Users
66159,573,7,39,2,2,3,7,Lost
66678,1704,7,14,1,2,1,4,Lost
66687,2,67,300,5,5,5,15,Champions
66959,440,8,12,3,2,1,6,Casual Users
67078,110,82,716,4,5,5,14,Champions
67149,195,32,63,3,4,4,11,Loyal Users
67355,933,6,10,2,1,1,4,Lost
67658,307,15,138,3,3,4,10,Loyal Users
67719,20,138,213,5,5,5,15,Champions
67910,398,5,9,3,1,1,5,Casual Users
68077,698,14,18,2,3,2,7,Casual Users
68538,2240,6,36,1,1,3,5,Lost
68724,240,6,11,3,1,1,5,Casual Users
68811,30,75,487,5,5,5,15,Champions
68929,711,22,131,2,4,4,10,At Risk
68961,71,8,11,4,2,1,7,Promising
69559,102,43,101,4,4,4,12,Champions
69750,509,11,18,2,2,2,6,Lost
70653,271,5,8,3,1,1,5,Casual Users
70804,37,129,849,5,5,5,15,Champions
70887,155,9,16,4,2,2,8,Promising
70970,439,7,16,3,2,2,7,Casual Users
71440,3482,5,15,1,1,1,3,Lost
71564,422,7,22,3,2,2,7,Casual Users
71648,250,38,54,3,4,3,10,Loyal Users
71948,268,56,90,3,5,4,12,Loyal Users
72162,1255,12,24,2,3,2,7,Casual Users
72852,179,19,130,3,3,4,10,Loyal Users
73032,125,119,519,4,5,5,14,Champions
73621,326,83,102,3,5,4,12,Loyal Users
73752,945,5,34,2,1,3,6,Lost
73768,663,6,29,2,1,2,5,Lost
73832,14,27,29,5,4,2,11,Loyal Users
73849,408,25,112,3,4,4,11,Loyal Users
73910,2416,9,10,1,2,1,4,Lost
73918,443,34,80,3,4,4,11,Loyal Users
73931,219,16,26,3,3,2,8,Loyal Users
74001,262,12,37,3,3,3,9,Loyal Users
74012,23,13,22,5,3,2,10,Loyal Users
74027,1621,19,118,1,3,4,8,Casual Users
74448,120,57,83,4,5,4,13,Champions
74544,94,43,124,4,4,4,12,Champions
74698,375,9,15,3,2,1,6,Casual Users
74760,424,8,40,3,2,3,8,Casual Users
74835,544,26,53,2,4,3,9,At Risk
74878,128,37,51,4,4,3,11,Loyal Users
74992,3501,6,13,1,1,1,3,Lost
75051,424,21,39,3,3,3,9,Loyal Users
75097,14,45,182,5,4,5,14,Champions
75126,304,12,38,3,3,3,9,Loyal Users
75383,3,143,274,5,5,5,15,Champions
75623,2152,5,24,1,1,2,4,Lost
75661,124,59,384,4,5,5,14,Champions
75676,136,21,46,4,3,3,10,Loyal Users
76284,2723,7,10,1,2,1,4,Lost
76297,1,34,51,5,4,3,12,Loyal Users
76308,95,38,131,4,4,4,12,Champions
76599,30,31,71,5,4,4,13,Champions
76659,0,80,208,5,5,5,15,Champions
76816,128,15,48,4,3,3,10,Loyal Users
77045,454,30,88,3,4,4,11,Loyal Users
77240,128,73,228,4,5,5,14,Champions
77355,113,11,41,4,2,3,9,Promising
77855,517,32,214,2,4,5,11,At Risk
77988,8,47,85,5,5,4,14,Champions
78233,33,93,464,5,5,5,15,Champions
78242,2995,11,25,1,2,2,5,Lost
65443,143,34,51,4,4,3,11,Loyal Users
66202,237,36,133,3,4,4,11,Loyal Users
66275,164,76,370,4,5,5,14,Champions
66357,3133,11,21,1,2,2,5,Lost
66393,1627,8,33,1,2,3,6,Lost
66483,125,41,116,4,4,4,12,Champions
66783,52,16,52,5,3,3,11,Loyal Users
67012,59,7,14,5,2,1,8,Promising
67115,7,42,194,5,4,5,14,Champions
67148,52,67,204,5,5,5,15,Champions
67236,147,31,41,4,4,3,11,Loyal Users
67580,19,48,197,5,5,5,15,Champions
67683,186,27,49,3,4,3,10,Loyal Users
67950,149,63,96,4,5,4,13,Champions
68168,786,7,55,2,2,3,7,Lost
68284,127,7,12,4,2,1,7,Promising
68688,58,183,428,5,5,5,15,Champions
69135,887,5,5,2,1,1,4,Lost
69160,15,23,83,5,4,4,13,Champions
69280,189,8,8,3,2,1,6,Casual Users
69579,1969,6,16,1,1,2,4,Lost
69761,456,8,13,3,2,1,6,Casual Users
69928,393,5,52,3,1,3,7,Casual Users
69982,3095,5,6,1,1,1,3,Lost
70298,12,60,142,5,5,4,14,Champions
70453,1738,27,53,1,4,3,8,At Risk
70489,73,51,151,4,5,5,14,Champions
70819,20,63,282,5,5,5,15,Champions
70929,30,11,11,5,2,1,8,Promising
71066,41,39,59,5,4,3,12,Loyal Users
71185,2506,5,12,1,1,1,3,Lost
71309,2946,7,16,1,2,2,5,Lost
71360,7,10,27,5,2,2,9,Promising
71829,397,43,104,3,4,4,11,Loyal Users
71864,1342,12,70,1,3,4,8,Casual Users
72182,593,11,56,2,2,3,7,Lost
72211,43,17,139,5,3,4,12,Loyal Users
72277,379,5,36,3,1,3,7,Casual Users
72891,3,61,88,5,5,4,14,Champions
73189,1662,14,69,1,3,4,8,Casual Users
73874,92,91,213,4,5,5,14,Champions
73932,4259,5,7,1,1,1,3,Lost
74083,3700,5,16,1,1,2,4,Lost
74574,212,6,21,3,1,2,6,Casual Users
75222,143,11,25,4,2,2,8,Promising
75696,416,28,77,3,4,4,11,Loyal Users
75867,492,5,6,2,1,1,4,Lost
75919,1835,7,29,1,2,2,5,Lost
75971,139,6,15,4,1,1,6,Promising
76022,123,6,7,4,1,1,6,Promising
76126,625,15,17,2,3,2,7,Casual Users
76210,1996,5,16,1,1,2,4,Lost
76271,71,17,70,4,3,4,11,Loyal Users
76328,425,20,71,3,3,4,10,Loyal Users
76425,662,22,72,2,4,4,10,At Risk
76845,299,11,27,3,2,2,7,Casual Users
76991,5661,6,15,1,1,1,3,Lost
77043,4,19,49,5,3,3,11,Loyal Users
77077,1989,12,54,1,3,3,7,Casual Users
77110,61,38,101,5,4,4,13,Champions
77183,8,215,396,5,5,5,15,Champions
77189,1659,5,12,1,1,1,3,Lost
77433,457,34,61,3,4,3,10,Loyal Users
77892,749,11,17,2,2,2,6,Lost
65475,45,78,476,5,5,5,15,Champions
65680,21,9,17,5,2,2,9,Promising
65850,947,5,17,2,1,2,5,Lost
66011,265,10,13,3,2,1,6,Casual Users
66029,425,8,24,3,2,2,7,Casual Users
66905,526,12,63,2,3,4,9,Casual Users
67588,579,5,5,2,1,1,4,Lost
67769,154,31,58,4,4,3,11,Loyal Users
68058,429,9,14,3,2,1,6,Casual Users
68415,279,14,51,3,3,3,9,Loyal Users
69219,15,69,417,5,5,5,15,Champions
69890,5,21,120,5,3,4,12,Loyal Users
70127,2,52,180,5,5,5,15,Champions
70518,34,69,149,5,5,5,15,Champions
70637,117,34,42,4,4,3,11,Loyal Users
70810,1986,8,15,1,2,1,4,Lost
71382,271,19,151,3,3,5,11,Loyal Users
71559,662,6,9,2,1,1,4,Lost
72119,1582,11,30,1,2,2,5,Lost
72436,605,6,8,2,1,1,4,Lost
72643,30,49,125,5,5,4,14,Champions
72774,838,18,56,2,3,3,8,Casual Users
73168,261,58,124,3,5,4,12,Loyal Users
73287,2574,5,20,1,1,2,4,Lost
73302,436,10,18,3,2,2,7,Casual Users
73694,16,17,30,5,3,2,10,Loyal Users
73741,1416,43,171,1,4,5,10,At Risk
73906,24,38,230,5,4,5,14,Champions
74143,30,59,131,5,5,4,14,Champions
74200,311,34,178,3,4,5,12,Loyal Users
74372,462,6,12,3,1,1,5,Casual Users
74401,434,15,21,3,3,2,8,Loyal Users
74559,3,30,36,5,4,3,12,Loyal Users
74841,735,5,12,2,1,1,4,Lost
74872,234,11,18,3,2,2,7,Casual Users
74997,483,18,50,2,3,3,8,Casual Users
75053,135,16,81,4,3,4,11,Loyal Users
75237,829,14,16,2,3,2,7,Casual Users
75257,1985,12,12,1,3,1,5,Casual Users
75387,538,26,105,2,4,4,10,At Risk
75593,157,13,49,4,3,3,10,Loyal Users
75597,104,68,387,4,5,5,14,Champions
75632,72,13,29,4,3,2,9,Loyal Users
75649,2782,7,13,1,2,1,4,Lost
75664,3285,8,27,1,2,2,5,Lost
75785,149,5,10,4,1,1,6,Promising
75890,319,12,134,3,3,4,10,Loyal Users
76051,10,46,345,5,5,5,15,Champions
76177,69,22,53,5,4,3,12,Loyal Users
76360,275,22,78,3,4,4,11,Loyal Users
76805,2941,6,7,1,1,1,3,Lost
76880,6015,7,7,1,2,1,4,Lost
77197,75,24,136,4,4,4,12,Champions
77259,48,31,50,5,4,3,12,Loyal Users
77457,107,70,302,4,5,5,14,Champions
77631,16,97,195,5,5,5,15,Champions
77710,6,169,851,5,5,5,15,Champions
65679,901,7,12,2,2,1,5,Lost
65729,428,31,70,3,4,4,11,Loyal Users
65749,65,41,130,5,4,4,13,Champions
65966,3122,9,19,1,2,2,5,Lost
66139,32,38,55,5,4,3,12,Loyal Users
66200,423,7,9,3,2,1,6,Casual Users
66693,75,7,30,4,2,2,8,Promising
66796,104,75,325,4,5,5,14,Champions
67257,66,27,103,5,4,4,13,Champions
67270,3936,5,19,1,1,2,4,Lost
67488,57,106,214,5,5,5,15,Champions
67805,5890,5,21,1,1,2,4,Lost
68256,282,85,269,3,5,5,13,Loyal Users
68528,287,37,88,3,4,4,11,Loyal Users
68658,13,132,661,5,5,5,15,Champions
68803,426,23,31,3,4,2,9,Loyal Users
68923,406,5,6,3,1,1,5,Casual Users
69241,88,48,198,4,5,5,14,Champions
69697,792,6,9,2,1,1,4,Lost
69722,1274,6,14,1,1,1,3,Lost
69762,171,49,180,3,5,5,13,Loyal Users
70209,103,44,76,4,4,4,12,Champions
70221,121,69,286,4,5,5,14,Champions
70843,291,31,69,3,4,4,11,Loyal Users
70949,4,19,72,5,3,4,12,Loyal Users
71307,27,58,164,5,5,5,15,Champions
71609,13,45,74,5,4,4,13,Champions
71874,1877,6,7,1,1,1,3,Lost
71886,78,42,134,4,4,4,12,Champions
72308,4365,8,47,1,2,3,6,Lost
72473,5625,6,20,1,1,2,4,Lost
72714,505,6,36,2,1,3,6,Lost
73031,1854,10,29,1,2,2,5,Lost
73127,46,48,136,5,5,4,14,Champions
73315,262,42,42,3,4,3,10,Loyal Users
73675,117,143,264,4,5,5,14,Champions
73981,224,30,98,3,4,4,11,Loyal Users
74021,265,10,10,3,2,1,6,Casual Users
74028,44,55,113,5,5,4,14,Champions
74191,439,12,24,3,3,2,8,Loyal Users
74225,135,47,106,4,5,4,13,Champions
74385,43,20,32,5,3,3,11,Loyal Users
74454,16,23,51,5,4,3,12,Loyal Users
74719,758,5,25,2,1,2,5,Lost
74752,59,23,37,5,4,3,12,Loyal Users
75452,190,76,368,3,5,5,13,Loyal Users
75607,1307,23,24,1,4,2,7,At Risk
75728,1771,5,12,1,1,1,3,Lost
75929,98,12,34,4,3,3,10,Loyal Users
76362,142,68,136,4,5,4,13,Champions
76565,1278,6,7,1,1,1,3,Lost
76907,0,11,12,5,2,1,8,Promising
77211,90,78,299,4,5,5,14,Champions
77940,406,28,61,3,4,3,10,Loyal Users
78032,419,7,7,3,2,1,6,Casual Users
78054,117,112,350,4,5,5,14,Champions
78168,453,87,372,3,5,5,13,Loyal Users
65822,509,6,13,2,1,1,4,Lost
66179,1974,40,210,1,4,5,10,At Risk
66224,1272,5,10,1,1,1,3,Lost
66225,1836,7,7,1,2,1,4,Lost
66465,135,19,75,4,3,4,11,Loyal Users
66488,6,15,25,5,3,2,10,Loyal Users
66798,531,20,39,2,3,3,8,Casual Users
66880,771,6,13,2,1,1,4,Lost
66932,19,57,231,5,5,5,15,Champions
67085,117,14,16,4,3,2,9,Loyal Users
67108,100,8,21,4,2,2,8,Promising
67221,101,25,65,4,4,4,12,Champions
67536,2347,6,13,1,1,1,3,Lost
67608,825,35,96,2,4,4,10,At Risk
67933,289,9,44,3,2,3,8,Casual Users
68511,740,5,5,2,1,1,4,Lost
68968,2934,26,49,1,4,3,8,At Risk
69146,989,7,29,2,2,2,6,Lost
69242,155,8,40,4,2,3,9,Promising
69273,275,6,13,3,1,1,5,Casual Users
69392,12,90,320,5,5,5,15,Champions
69959,640,12,25,2,3,2,7,Casual Users
70264,72,49,103,4,5,4,13,Champions
70415,270,39,78,3,4,4,11,Loyal Users
70499,2687,8,10,1,2,1,4,Lost
70663,2750,5,41,1,1,3,5,Lost
70956,1349,16,19,1,3,2,6,Casual Users
71014,366,53,133,3,5,4,12,Loyal Users
71031,2344,13,33,1,3,3,7,Casual Users
71078,7,67,177,5,5,5,15,Champions
71080,1261,38,120,1,4,4,9,At Risk
71569,42,38,143,5,4,4,13,Champions
72381,117,44,54,4,4,3,11,Loyal Users
72934,134,9,41,4,2,3,9,Promising
73090,2405,22,49,1,4,3,8,At Risk
73110,111,14,51,4,3,3,10,Loyal Users
73839,3,134,537,5,5,5,15,Champions
73987,86,100,166,4,5,5,14,Champions
74107,11,75,245,5,5,5,15,Champions
74190,77,7,31,4,2,2,8,Promising
74244,1028,5,9,2,1,1,4,Lost
74512,271,14,24,3,3,2,8,Loyal Users
74579,9,69,135,5,5,4,14,Champions
75008,579,5,12,2,1,1,4,Lost
75009,105,18,71,4,3,4,11,Loyal Users
75089,542,10,24,2,2,2,6,Lost
75172,2000,5,31,1,1,2,4,Lost
75393,838,6,22,2,1,2,5,Lost
75688,310,5,22,3,1,2,6,Casual Users
75702,0,42,79,5,4,4,13,Champions
75761,992,14,35,2,3,3,8,Casual Users
76144,137,10,66,4,2,4,10,Promising
76421,78,27,56,4,4,3,11,Loyal Users
76571,4014,7,40,1,2,3,6,Lost
76588,3633,14,22,1,3,2,6,Casual Users
76647,65,35,115,5,4,4,13,Champions
76672,1046,6,23,2,1,2,5,Lost
76951,551,7,18,2,2,2,6,Lost
76952,53,85,269,5,5,5,15,Champions
77065,528,5,5,2,1,1,4,Lost
78125,813,10,14,2,2,1,5,Lost
65984,4132,16,55,1,3,3,7,Casual Users
66009,110,5,15,4,1,1,6,Promising
66415,528,5,6,2,1,1,4,Lost
66610,23,40,154,5,4,5,14,Champions
67114,2267,14,17,1,3,2,6,Casual Users
67200,157,40,58,4,4,3,11,Loyal Users
67335,58,56,82,5,5,4,14,Champions
67731,286,31,143,3,4,4,11,Loyal Users
68232,134,8,109,4,2,4,10,Promising
68305,1127,6,20,2,1,2,5,Lost
68449,4125,5,25,1,1,2,4,Lost
68502,721,6,8,2,1,1,4,Lost
68604,0,130,509,5,5,5,15,Champions
68638,158,30,107,4,4,4,12,Champions
68859,2703,5,8,1,1,1,3,Lost
68890,1758,9,13,1,2,1,4,Lost
68980,119,55,140,4,5,4,13,Champions
69550,101,68,142,4,5,4,13,Champions
69609,114,105,550,4,5,5,14,Champions
69788,1758,22,22,1,4,2,7,At Risk
70063,2149,10,12,1,2,1,4,Lost
70120,90,8,16,4,2,2,8,Promising
70235,710,16,40,2,3,3,8,Casual Users
70319,1347,13,42,1,3,3,7,Casual Users
70353,40,75,315,5,5,5,15,Champions
70835,1601,9,11,1,2,1,4,Lost
70948,18,122,379,5,5,5,15,Champions
71035,85,5,33,4,1,3,8,Promising
71338,91,57,110,4,5,4,13,Champions
71445,292,30,53,3,4,3,10,Loyal Users
71714,187,116,188,3,5,5,13,Loyal Users
71860,66,55,532,5,5,5,15,Champions
71909,622,5,32,2,1,3,6,Lost
72065,2588,11,30,1,2,2,5,Lost
72092,113,39,88,4,4,4,12,Champions
72228,292,59,109,3,5,4,12,Loyal Users
72352,413,15,21,3,3,2,8,Loyal Users
72684,10,47,147,5,5,5,15,Champions
73193,282,5,19,3,1,2,6,Casual Users
73262,292,67,101,3,5,4,12,Loyal Users
73353,297,9,15,3,2,1,6,Casual Users
73623,103,68,159,4,5,5,14,Champions
73766,273,31,58,3,4,3,10,Loyal Users
73974,582,20,26,2,3,2,7,Casual Users
73998,1546,16,23,1,3,2,6,Casual Users
74132,1700,12,32,1,3,3,7,Casual Users
74610,446,40,234,3,4,5,12,Loyal Users
75121,1232,9,9,2,2,1,5,Lost
75240,3714,6,21,1,1,2,4,Lost
75258,113,67,182,4,5,5,14,Champions
75275,857,5,20,2,1,2,5,Lost
75519,1474,15,80,1,3,4,8,Casual Users
75712,127,20,21,4,3,2,9,Loyal Users
75995,31,97,465,5,5,5,15,Champions
76568,3015,30,54,1,4,3,8,At Risk
76723,146,38,73,4,4,4,12,Champions
76950,1904,6,6,1,1,1,3,Lost
77014,439,9,32,3,2,3,8,Casual Users
77247,15,51,123,5,5,4,14,Champions
78178,461,18,28,3,3,2,8,Loyal Users
65538,5689,5,17,1,1,2,4,Lost
65552,2522,12,32,1,3,3,7,Casual Users
65567,159,10,28,4,2,2,8,Promising
65916,3884,15,19,1,3,2,6,Casual Users
66173,132,13,28,4,3,2,9,Loyal Users
66244,12,171,246,5,5,5,15,Champions
66398,308,98,218,3,5,5,13,Loyal Users
66473,413,11,24,3,2,2,7,Casual Users
66475,1083,36,80,2,4,4,10,At Risk
66629,153,40,56,4,4,3,11,Loyal Users
66799,112,26,153,4,4,5,13,Champions
66937,5720,8,8,1,2,1,4,Lost
66973,635,11,13,2,2,1,5,Lost
67414,3,26,45,5,4,3,12,Loyal Users
67568,0,24,55,5,4,3,12,Loyal Users
67579,2038,5,7,1,1,1,3,Lost
67793,540,13,33,2,3,3,8,Casual Users
68281,389,9,16,3,2,2,7,Casual Users
68602,3698,5,5,1,1,1,3,Lost
68998,31,77,187,5,5,5,15,Champions
69052,114,17,47,4,3,3,10,Loyal Users
69099,7,53,155,5,5,5,15,Champions
69191,12,85,128,5,5,4,14,Champions
69612,311,108,336,3,5,5,13,Loyal Users
69721,508,5,5,2,1,1,4,Lost
70259,1610,5,5,1,1,1,3,Lost
70296,36,38,120,5,4,4,13,Champions
70583,179,7,11,3,2,1,6,Casual Users
71086,738,9,34,2,2,3,7,Lost
71646,229,82,255,3,5,5,13,Loyal Users
71973,429,11,36,3,2,3,8,Casual Users
72063,95,64,133,4,5,4,13,Champions
72747,183,69,219,3,5,5,13,Loyal Users
73208,119,8,17,4,2,2,8,Promising
73601,613,5,7,2,1,1,4,Lost
73796,951,13,51,2,3,3,8,Casual Users
74123,110,62,110,4,5,4,13,Champions
74130,7,8,14,5,2,1,8,Promising
74188,16,108,493,5,5,5,15,Champions
74340,3159,6,12,1,1,1,3,Lost
74806,270,27,153,3,4,5,12,Loyal Users
74900,4449,8,10,1,2,1,4,Lost
75422,93,66,184,4,5,5,14,Champions
75525,51,33,263,5,4,5,14,Champions
75895,3,9,11,5,2,1,8,Promising
76016,1333,11,60,1,2,3,6,Lost
76153,42,110,227,5,5,5,15,Champions
76173,526,5,9,2,1,1,4,Lost
76539,1297,10,22,1,2,2,5,Lost
76741,182,20,50,3,3,3,9,Loyal Users
76975,447,28,150,3,4,5,12,Loyal Users
77122,224,29,63,3,4,4,11,Loyal Users
77219,1262,19,46,1,3,3,7,Casual Users
77226,76,30,109,4,4,4,12,Champions
77400,593,24,122,2,4,4,10,At Risk
77456,43,78,198,5,5,5,15,Champions
77723,422,17,113,3,3,4,10,Loyal Users
77877,1563,6,17,1,1,2,4,Lost
78135,1109,29,62,2,4,3,9,At Risk
78259,121,103,775,4,5,5,14,Champions
65576,787,27,53,2,4,3,9,At Risk
65836,285,14,18,3,3,2,8,Loyal Users
66007,160,10,47,4,2,3,9,Promising
66048,1843,5,6,1,1,1,3,Lost
66183,2500,9,12,1,2,1,4,Lost
66213,641,11,27,2,2,2,6,Lost
66308,3286,11,35,1,2,3,6,Lost
66492,40,67,92,5,5,4,14,Champions
66595,1261,9,16,1,2,2,5,Lost
66604,288,22,48,3,4,3,10,Loyal Users
66761,1287,26,49,1,4,3,8,At Risk
66866,2218,12,23,1,3,2,6,Casual Users
66955,1855,13,24,1,3,2,6,Casual Users
67128,4,59,568,5,5,5,15,Champions
67226,237,6,25,3,1,2,6,Casual Users
67403,265,19,52,3,3,3,9,Loyal Users
67456,170,83,225,3,5,5,13,Loyal Users
67671,143,17,60,4,3,3,10,Loyal Users
67757,264,9,19,3,2,2,7,Casual Users
68529,307,10,16,3,2,2,7,Casual Users
68561,251,11,67,3,2,4,9,Casual Users
68582,1820,5,28,1,1,2,4,Lost
68614,184,12,31,3,3,2,8,Loyal Users
68807,3572,9,26,1,2,2,5,Lost
68860,12,141,306,5,5,5,15,Champions
69408,2441,6,18,1,1,2,4,Lost
69857,12,20,38,5,3,3,11,Loyal Users
70058,23,18,64,5,3,4,12,Loyal Users
70164,84,31,136,4,4,4,12,Champions
70391,433,7,9,3,2,1,6,Casual Users
70410,549,19,36,2,3,3,8,Casual Users
70773,1373,33,107,1,4,4,9,At Risk
70775,811,7,17,2,2,2,6,Lost
70902,103,69,292,4,5,5,14,Champions
71274,399,37,82,3,4,4,11,Loyal Users
71322,159,11,65,4,2,4,10,Promising
71834,4,8,11,5,2,1,8,Promising
72081,231,28,97,3,4,4,11,Loyal Users
72126,24,11,40,5,2,3,10,Promising
72227,12,21,86,5,3,4,12,Loyal Users
72483,440,32,63,3,4,4,11,Loyal Users
72986,363,17,200,3,3,5,11,Loyal Users
73021,3088,5,14,1,1,1,3,Lost
73143,811,8,21,2,2,2,6,Lost
73182,553,15,45,2,3,3,8,Casual Users
73217,405,17,35,3,3,3,9,Loyal Users
73498,65,26,206,5,4,5,14,Champions
73524,1844,5,11,1,1,1,3,Lost
73591,129,5,21,4,1,2,7,Promising
73889,1306,5,21,1,1,2,4,Lost
73941,1529,9,11,1,2,1,4,Lost
74626,1419,7,11,1,2,1,4,Lost
74756,259,52,88,3,5,4,12,Loyal Users
74907,64,6,8,5,1,1,7,Promising
75069,116,20,40,4,3,3,10,Loyal Users
75107,241,23,66,3,4,4,11,Loyal Users
75201,41,80,125,5,5,4,14,Champions
75421,281,88,236,3,5,5,13,Loyal Users
75784,1243,5,17,2,1,2,5,Lost
75805,118,8,52,4,2,3,9,Promising
76032,385,22,37,3,4,3,10,Loyal Users
76155,1682,10,19,1,2,2,5,Lost
77282,92,132,177,4,5,5,14,Champions
77510,38,114,572,5,5,5,15,Champions
77545,870,24,44,2,4,3,9,At Risk
77583,4307,5,5,1,1,1,3,Lost
77844,284,13,23,3,3,2,8,Loyal Users
65456,231,97,198,3,5,5,13,Loyal Users
66192,4510,6,28,1,1,2,4,Lost
66569,4,29,42,5,4,3,12,Loyal Users
66843,2311,6,25,1,1,2,4,Lost
66878,4876,12,21,1,3,2,6,Casual Users
67183,496,16,53,2,3,3,8,Casual Users
67264,22,56,134,5,5,4,14,Champions
67585,78,6,8,4,1,1,6,Promising
67655,101,11,29,4,2,2,8,Promising
67946,949,20,32,2,3,3,8,Casual Users
68131,4214,12,17,1,3,2,6,Casual Users
68188,331,35,53,3,4,3,10,Loyal Users
68384,39,81,131,5,5,4,14,Champions
69128,3138,10,10,1,2,1,4,Lost
69269,124,42,89,4,4,4,12,Champions
69293,66,17,81,5,3,4,12,Loyal Users
69431,281,156,294,3,5,5,13,Loyal Users
69548,13,65,191,5,5,5,15,Champions
69688,1563,18,26,1,3,2,6,Casual Users
69866,567,7,46,2,2,3,7,Lost
69997,76,7,46,4,2,3,9,Promising
70116,165,20,63,4,3,4,11,Loyal Users
70140,425,11,43,3,2,3,8,Casual Users
70145,447,11,79,3,2,4,9,Casual Users
70364,75,73,256,4,5,5,14,Champions
70542,3007,6,8,1,1,1,3,Lost
71636,30,52,285,5,5,5,15,Champions
71657,553,22,53,2,4,3,9,At Risk
71671,106,120,492,4,5,5,14,Champions
72110,19,12,28,5,3,2,10,Loyal Users
72206,2272,14,23,1,3,2,6,Casual Users
72238,1155,40,186,2,4,5,11,At Risk
72808,680,20,53,2,3,3,8,Casual Users
73275,438,51,125,3,5,4,12,Loyal Users
73286,1398,6,37,1,1,3,5,Lost
73350,1463,5,7,1,1,1,3,Lost
73828,1,40,106,5,4,4,13,Champions
73860,101,55,126,4,5,4,13,Champions
73886,2051,7,10,1,2,1,4,Lost
74195,4,21,39,5,3,3,11,Loyal Users
74418,55,12,63,5,3,4,12,Loyal Users
74558,85,48,203,4,5,5,14,Champions
74581,1003,10,42,2,2,3,7,Lost
74780,1822,5,8,1,1,1,3,Lost
74957,43,106,337,5,5,5,15,Champions
75040,192,5,9,3,1,1,5,Casual Users
75175,263,31,48,3,4,3,10,Loyal Users
75187,120,34,63,4,4,4,12,Champions
75311,275,5,15,3,1,1,5,Casual Users
75879,288,42,105,3,4,4,11,Loyal Users
75880,3865,27,53,1,4,3,8,At Risk
77098,104,72,120,4,5,4,13,Champions
77426,12,66,117,5,5,4,14,Champions
77858,1461,24,47,1,4,3,8,At Risk
77960,5,75,334,5,5,5,15,Champions
77983,962,12,35,2,3,3,8,Casual Users
78219,2149,5,23,1,1,2,4,Lost
65612,2868,5,17,1,1,2,4,Lost
65830,710,17,48,2,3,3,8,Casual Users
66185,862,18,46,2,3,3,8,Casual Users
66397,106,18,53,4,3,3,10,Loyal Users
66478,8,30,61,5,4,3,12,Loyal Users
66531,272,13,17,3,3,2,8,Loyal Users
66989,583,19,43,2,3,3,8,Casual Users
67464,1669,6,12,1,1,1,3,Lost
68110,96,25,62,4,4,3,11,Loyal Users
68142,272,25,92,3,4,4,11,Loyal Users
68252,370,10,16,3,2,2,7,Casual Users
68651,31,18,23,5,3,2,10,Loyal Users
68696,0,23,73,5,4,4,13,Champions
68876,1430,7,15,1,2,1,4,Lost
69364,124,30,50,4,4,3,11,Loyal Users
69942,122,7,8,4,2,1,7,Promising
69975,6,8,8,5,2,1,8,Promising
70031,86,78,111,4,5,4,13,Champions
70160,3567,6,16,1,1,2,4,Lost
70193,124,12,24,4,3,2,9,Loyal Users
70243,240,40,226,3,4,5,12,Loyal Users
70448,150,14,39,4,3,3,10,Loyal Users
70702,107,6,14,4,1,1,6,Promising
70848,37,223,381,5,5,5,15,Champions
70889,1499,10,12,1,2,1,4,Lost
71113,298,12,19,3,3,2,8,Loyal Users
71148,143,12,21,4,3,2,9,Loyal Users
71690,5703,6,16,1,1,2,4,Lost
71707,33,12,39,5,3,3,11,Loyal Users
71822,140,37,110,4,4,4,12,Champions
72207,289,43,156,3,4,5,12,Loyal Users
72468,696,12,21,2,3,2,7,Casual Users
72928,4,61,163,5,5,5,15,Champions
72940,5,20,65,5,3,4,12,Loyal Users
72990,121,11,24,4,2,2,8,Promising
73005,119,41,147,4,4,5,13,Champions
73007,12,6,7,5,1,1,7,Promising
73268,218,24,112,3,4,4,11,Loyal Users
73578,1972,14,16,1,3,2,6,Casual Users
73751,253,11,47,3,2,3,8,Casual Users
73773,3968,7,19,1,2,2,5,Lost
73784,445,5,5,3,1,1,5,Casual Users
73807,647,45,61,2,4,3,9,At Risk
74155,275,39,115,3,4,4,11,Loyal Users
74296,6,112,597,5,5,5,15,Champions
74405,1127,12,16,2,3,2,7,Casual Users
74407,639,10,42,2,2,3,7,Lost
74423,125,49,72,4,5,4,13,Champions
74546,3,90,231,5,5,5,15,Champions
75407,2524,5,8,1,1,1,3,Lost
75725,112,34,70,4,4,4,12,Champions
76713,23,47,104,5,5,4,14,Champions
76874,891,24,49,2,4,3,9,At Risk
77665,854,7,24,2,2,2,6,Lost
78100,102,38,123,4,4,4,12,Champions
78190,3694,12,32,1,3,3,7,Casual Users
65530,211,45,106,3,4,4,11,Loyal Users
65712,453,9,15,3,2,1,6,Casual Users
65744,778,6,7,2,1,1,4,Lost
65800,250,25,54,3,4,3,10,Loyal Users
66392,743,14,50,2,3,3,8,Casual Users
66583,1688,12,67,1,3,4,8,Casual Users
66680,133,13,26,4,3,2,9,Loyal Users
66692,1151,6,38,2,1,3,6,Lost
66712,4,77,334,5,5,5,15,Champions
67088,440,38,232,3,4,5,12,Loyal Users
67133,9,48,158,5,5,5,15,Champions
67158,150,25,81,4,4,4,12,Champions
67384,227,86,269,3,5,5,13,Loyal Users
67726,88,124,314,4,5,5,14,Champions
68343,174,125,166,3,5,5,13,Loyal Users
68613,315,5,13,3,1,1,5,Casual Users
68718,798,9,22,2,2,2,6,Lost
68748,720,5,29,2,1,2,5,Lost
68812,1,49,118,5,5,4,14,Champions
68908,231,7,11,3,2,1,6,Casual Users
69010,2021,35,113,1,4,4,9,At Risk
69131,128,80,434,4,5,5,14,Champions
69328,1737,9,12,1,2,1,4,Lost
69386,1653,55,97,1,5,4,10,At Risk
69754,450,76,172,3,5,5,13,Loyal Users
69768,21,7,11,5,2,1,8,Promising
69815,218,27,99,3,4,4,11,Loyal Users
69825,80,182,721,4,5,5,14,Champions
69838,266,5,8,3,1,1,5,Casual Users
70006,139,105,338,4,5,5,14,Champions
70378,146,10,14,4,2,1,7,Promising
70443,429,10,50,3,2,3,8,Casual Users
70928,135,26,75,4,4,4,12,Champions
70997,927,20,27,2,3,2,7,Casual Users
71451,3480,9,22,1,2,2,5,Lost
71492,186,15,17,3,3,2,8,Loyal Users
71693,5740,5,6,1,1,1,3,Lost
72210,63,8,12,5,2,1,8,Promising
72237,7,79,295,5,5,5,15,Champions
72361,694,5,12,2,1,1,4,Lost
72376,965,7,41,2,2,3,7,Lost
72641,684,13,15,2,3,1,6,Casual Users
72904,35,42,67,5,4,4,13,Champions
73359,468,14,19,3,3,2,8,Loyal Users
73427,400,10,23,3,2,2,7,Casual Users
74301,134,8,14,4,2,1,7,Promising
74329,936,17,46,2,3,3,8,Casual Users
74347,791,12,13,2,3,1,6,Casual Users
74708,90,52,281,4,5,5,14,Champions
74713,1449,8,30,1,2,2,5,Lost
74986,477,26,99,2,4,4,10,At Risk
75055,126,47,96,4,5,4,13,Champions
75419,135,37,116,4,4,4,12,Champions
75420,412,15,57,3,3,3,9,Loyal Users
75504,5886,7,31,1,2,2,5,Lost
76241,653,21,41,2,3,3,8,Casual Users
76384,287,5,8,3,1,1,5,Casual Users
76406,2265,5,10,1,1,1,3,Lost
76616,85,6,45,4,1,3,8,Promising
76706,13,12,40,5,3,3,11,Loyal Users
76846,12,7,18,5,2,2,9,Promising
76941,3911,6,6,1,1,1,3,Lost
77270,1169,26,67,2,4,4,10,At Risk
77281,15,72,389,5,5,5,15,Champions
77302,897,10,105,2,2,4,8,Lost
77448,140,15,33,4,3,3,10,Loyal Users
77541,17,7,22,5,2,2,9,Promising
77677,1799,5,11,1,1,1,3,Lost
65594,1719,25,74,1,4,4,9,At Risk
65666,12,41,65,5,4,4,13,Champions
65765,2078,8,9,1,2,1,4,Lost
65855,5,37,107,5,4,4,13,Champions
66454,28,21,103,5,3,4,12,Loyal Users
66541,6,76,106,5,5,4,14,Champions
67161,11,19,42,5,3,3,11,Loyal Users
67299,729,18,18,2,3,2,7,Casual Users
67497,390,22,34,3,4,3,10,Loyal Users
68195,13,36,95,5,4,4,13,Champions
68240,306,13,20,3,3,2,8,Loyal Users
68273,431,15,148,3,3,5,11,Loyal Users
68438,2693,5,17,1,1,2,4,Lost
68740,785,29,73,2,4,4,10,At Risk
69095,176,6,7,3,1,1,5,Casual Users
69173,39,95,143,5,5,4,14,Champions
69403,272,45,165,3,4,5,12,Loyal Users
69466,223,12,42,3,3,3,9,Loyal Users
69695,1099,5,5,2,1,1,4,Lost
70520,977,11,29,2,2,2,6,Lost
70610,188,72,425,3,5,5,13,Loyal Users
70651,583,5,22,2,1,2,5,Lost
70798,162,6,26,4,1,2,7,Promising
70814,415,38,115,3,4,4,11,Loyal Users
71055,242,30,51,3,4,3,10,Loyal Users
71675,2564,5,15,1,1,1,3,Lost
71789,1649,5,28,1,1,2,4,Lost
72171,1535,11,11,1,2,1,4,Lost
72240,155,26,99,4,4,4,12,Champions
72296,34,222,587,5,5,5,15,Champions
72491,311,39,63,3,4,4,11,Loyal Users
72551,43,18,126,5,3,4,12,Loyal Users
72587,623,5,12,2,1,1,4,Lost
72613,580,5,16,2,1,2,5,Lost
73112,4476,7,35,1,2,3,6,Lost
73120,4214,6,6,1,1,1,3,Lost
73258,25,46,82,5,5,4,14,Champions
73450,158,42,269,4,4,5,13,Champions
73518,11,114,309,5,5,5,15,Champions
73800,956,20,97,2,3,4,9,Casual Users
73980,4407,9,12,1,2,1,4,Lost
74338,108,5,7,4,1,1,6,Promising
74529,19,115,319,5,5,5,15,Champions
74541,49,127,725,5,5,5,15,Champions
74612,618,19,55,2,3,3,8,Casual Users
75016,16,52,241,5,5,5,15,Champions
75092,1031,9,30,2,2,2,6,Lost
75381,164,19,121,4,3,4,11,Loyal Users
75637,293,18,30,3,3,2,8,Loyal Users
75673,311,18,26,3,3,2,8,Loyal Users
75763,90,36,112,4,4,4,12,Champions
75804,345,7,68,3,2,4,9,Casual Users
75815,137,23,35,4,4,3,11,Loyal Users
75843,1983,8,24,1,2,2,5,Lost
75869,2590,7,25,1,2,2,5,Lost
76136,1231,5,7,2,1,1,4,Lost
76225,485,17,33,2,3,3,8,Casual Users
76372,1744,14,21,1,3,2,6,Casual Users
76415,2457,21,29,1,3,2,6,Casual Users
76719,2449,6,19,1,1,2,4,Lost
76804,1525,9,50,1,2,3,6,Lost
76979,575,85,249,2,5,5,12,At Risk
77289,1894,10,24,1,2,2,5,Lost
78110,42,14,28,5,3,2,10,Loyal Users
65651,6,36,66,5,4,4,13,Champions
65742,121,16,43,4,3,3,10,Loyal Users
66050,574,5,30,2,1,2,5,Lost
66055,228,81,205,3,5,5,13,Loyal Users
66160,1501,5,16,1,1,2,4,Lost
66395,222,38,133,3,4,4,11,Loyal Users
66670,422,9,17,3,2,2,7,Casual Users
66698,112,21,28,4,3,2,9,Loyal Users
66974,3238,7,33,1,2,3,6,Lost
67421,663,6,9,2,1,1,4,Lost
67883,1363,13,49,1,3,3,7,Casual Users
67894,1291,15,31,1,3,2,6,Casual Users
68083,129,6,8,4,1,1,6,Promising
68379,128,7,18,4,2,2,8,Promising
68574,98,18,91,4,3,4,11,Loyal Users
68588,1274,25,52,1,4,3,8,At Risk
68885,273,14,42,3,3,3,9,Loyal Users
69007,2536,12,52,1,3,3,7,Casual Users
69223,34,26,106,5,4,4,13,Champions
69496,1429,11,24,1,2,2,5,Lost
69634,77,56,134,4,5,4,13,Champions
69683,283,12,30,3,3,2,8,Loyal Users
70180,5561,7,10,1,2,1,4,Lost
70338,160,15,25,4,3,2,9,Loyal Users
70379,82,60,250,4,5,5,14,Champions
70397,1431,7,26,1,2,2,5,Lost
70628,735,9,25,2,2,2,6,Lost
70737,30,10,21,5,2,2,9,Promising
70934,245,38,146,3,4,4,11,Loyal Users
71506,122,12,29,4,3,2,9,Loyal Users
71623,151,10,29,4,2,2,8,Promising
71861,620,16,73,2,3,4,9,Casual Users
72256,64,105,506,5,5,5,15,Champions
72373,14,43,94,5,4,4,13,Champions
72549,358,17,73,3,3,4,10,Loyal Users
72639,26,122,498,5,5,5,15,Champions
72865,308,28,76,3,4,4,11,Loyal Users
73080,129,74,162,4,5,5,14,Champions
73269,29,102,516,5,5,5,15,Champions
73334,60,20,60,5,3,3,11,Loyal Users
73598,380,7,44,3,2,3,8,Casual Users
73701,8,99,149,5,5,5,15,Champions
73814,2099,9,47,1,2,3,6,Lost
73868,447,8,14,3,2,1,6,Casual Users
74552,2549,12,30,1,3,2,6,Casual Users
74629,3418,69,108,1,5,4,10,At Risk
74642,14,89,251,5,5,5,15,Champions
74672,1305,13,35,1,3,3,7,Casual Users
74804,123,13,97,4,3,4,11,Loyal Users
74809,104,55,268,4,5,5,14,Champions
74892,1280,5,6,1,1,1,3,Lost
75052,218,17,27,3,3,2,8,Loyal Users
75176,379,14,58,3,3,3,9,Loyal Users
75591,5920,6,11,1,1,1,3,Lost
76127,928,14,18,2,3,2,7,Casual Users
76154,246,119,411,3,5,5,13,Loyal Users
76158,1253,5,17,2,1,2,5,Lost
76163,86,66,641,4,5,5,14,Champions
76250,250,15,45,3,3,3,9,Loyal Users
76838,51,7,17,5,2,2,9,Promising
76923,424,53,311,3,5,5,13,Loyal Users
76954,5,12,73,5,3,4,12,Loyal Users
77452,824,43,186,2,4,5,11,At Risk
77616,2,59,201,5,5,5,15,Champions
77618,705,7,57,2,2,3,7,Lost
77636,3855,8,14,1,2,1,4,Lost
77666,0,138,810,5,5,5,15,Champions
77830,8,199,518,5,5,5,15,Champions
65622,4394,5,9,1,1,1,3,Lost
65758,478,54,118,2,5,4,11,At Risk
66504,119,161,432,4,5,5,14,Champions
66628,5438,6,9,1,1,1,3,Lost
66700,3555,17,57,1,3,3,7,Casual Users
67859,82,75,169,4,5,5,14,Champions
67938,91,17,42,4,3,3,10,Loyal Users
68177,96,13,60,4,3,3,10,Loyal Users
68316,2298,5,6,1,1,1,3,Lost
68714,8,30,74,5,4,4,13,Champions
68994,14,76,244,5,5,5,15,Champions
69638,24,53,112,5,5,4,14,Champions
69641,988,7,9,2,2,1,5,Lost
69705,109,8,45,4,2,3,9,Promising
69791,35,48,339,5,5,5,15,Champions
69806,2675,39,99,1,4,4,9,At Risk
69859,3,62,113,5,5,4,14,Champions
69876,13,43,123,5,4,4,13,Champions
69909,109,25,46,4,4,3,11,Loyal Users
69988,2099,6,33,1,1,3,5,Lost
70019,111,58,231,4,5,5,14,Champions
70354,122,30,150,4,4,5,13,Champions
70945,72,75,114,4,5,4,13,Champions
70962,1274,9,10,1,2,1,4,Lost
71201,12,115,190,5,5,5,15,Champions
71205,949,10,24,2,2,2,6,Lost
71400,1143,7,13,2,2,1,5,Lost
71410,1,5,23,5,1,2,8,Promising
71666,432,11,48,3,2,3,8,Casual Users
71681,5289,5,5,1,1,1,3,Lost
72012,583,6,14,2,1,1,4,Lost
72853,251,44,139,3,4,4,11,Loyal Users
72908,699,7,20,2,2,2,6,Lost
73097,867,18,44,2,3,3,8,Casual Users
73338,115,40,106,4,4,4,12,Champions
73435,86,116,426,4,5,5,14,Champions
73647,2,57,120,5,5,4,14,Champions
73750,1764,5,7,1,1,1,3,Lost
74262,1010,12,18,2,3,2,7,Casual Users
74450,125,14,86,4,3,4,11,Loyal Users
74515,1559,5,22,1,1,2,4,Lost
74585,119,45,245,4,4,5,13,Champions
74631,5011,5,5,1,1,1,3,Lost
75236,1158,5,13,2,1,1,4,Lost
75242,2741,7,11,1,2,1,4,Lost
75533,7,12,16,5,3,2,10,Loyal Users
75584,4767,9,14,1,2,1,4,Lost
75585,155,7,33,4,2,3,9,Promising
76145,230,31,72,3,4,4,11,Loyal Users
76344,165,6,10,4,1,1,6,Promising
76437,100,17,32,4,3,3,10,Loyal Users
76464,334,39,96,3,4,4,11,Loyal Users
76786,165,47,148,4,5,5,14,Champions
77106,108,87,262,4,5,5,14,Champions
77198,136,30,140,4,4,4,12,Champions
77214,107,179,262,4,5,5,14,Champions
77253,4882,5,73,1,1,4,6,Lost
77260,1280,7,23,1,2,2,5,Lost
77469,1,147,543,5,5,5,15,Champions
77534,575,10,17,2,2,2,6,Lost
77563,405,5,8,3,1,1,5,Casual Users
78011,36,54,224,5,5,5,15,Champions
65902,120,27,84,4,4,4,12,Champions
65910,1691,10,16,1,2,2,5,Lost
65971,91,18,78,4,3,4,11,Loyal Users
66129,1290,5,12,1,1,1,3,Lost
66216,82,52,164,4,5,5,14,Champions
66401,4665,11,20,1,2,2,5,Lost
66509,540,13,27,2,3,2,7,Casual Users
67046,424,7,7,3,2,1,6,Casual Users
67103,119,42,67,4,4,4,12,Champions
67571,16,37,163,5,4,5,14,Champions
67693,86,51,107,4,5,4,13,Champions
67727,2029,18,41,1,3,3,7,Casual Users
67738,34,67,178,5,5,5,15,Champions
68061,64,98,432,5,5,5,15,Champions
68074,127,21,29,4,3,2,9,Loyal Users
68408,124,50,196,4,5,5,14,Champions
68817,20,52,112,5,5,4,14,Champions
68996,37,34,95,5,4,4,13,Champions
69167,527,39,75,2,4,4,10,At Risk
69661,1507,10,27,1,2,2,5,Lost
69845,405,29,47,3,4,3,10,Loyal Users
70053,302,12,44,3,3,3,9,Loyal Users
70095,1280,27,159,1,4,5,10,At Risk
70128,3063,12,18,1,3,2,6,Casual Users
70229,26,49,101,5,5,4,14,Champions
70470,1312,24,35,1,4,3,8,At Risk
70673,2,9,10,5,2,1,8,Promising
70991,870,11,12,2,2,1,5,Lost
71089,102,15,26,4,3,2,9,Loyal Users
71302,221,8,18,3,2,2,7,Casual Users
71361,76,54,90,4,5,4,13,Champions
71368,392,36,53,3,4,3,10,Loyal Users
71627,215,17,38,3,3,3,9,Loyal Users
72003,61,45,126,5,4,4,13,Champions
72088,1516,5,65,1,1,4,6,Lost
72503,365,18,34,3,3,3,9,Loyal Users
72574,162,44,51,4,4,3,11,Loyal Users
72903,4552,11,31,1,2,2,5,Lost
73487,338,32,66,3,4,4,11,Loyal Users
73551,2713,10,44,1,2,3,6,Lost
74321,3742,7,7,1,2,1,4,Lost
74483,837,19,99,2,3,4,9,Casual Users
74767,42,38,176,5,4,5,14,Champions
75012,76,31,122,4,4,4,12,Champions
75508,0,28,47,5,4,3,12,Loyal Users
75548,4283,5,6,1,1,1,3,Lost
75600,4,97,448,5,5,5,15,Champions
76302,90,21,63,4,3,4,11,Loyal Users
76339,12,48,134,5,5,4,14,Champions
76553,61,66,163,5,5,5,15,Champions
76764,423,10,38,3,2,3,8,Casual Users
76779,877,9,10,2,2,1,5,Lost
76814,117,52,115,4,5,4,13,Champions
76832,154,14,24,4,3,2,9,Loyal Users
76977,161,97,284,4,5,5,14,Champions
77109,0,35,56,5,4,3,12,Loyal Users
77329,559,5,6,2,1,1,4,Lost
77358,38,15,94,5,3,4,12,Loyal Users
77388,737,6,12,2,1,1,4,Lost
77562,188,47,67,3,5,4,12,Loyal Users
77786,127,6,84,4,1,4,9,Promising
77846,1826,5,6,1,1,1,3,Lost
78097,5001,13,23,1,3,2,6,Casual Users
78271,348,15,26,3,3,2,8,Loyal Users
65520,937,7,7,2,2,1,5,Lost
65644,103,50,272,4,5,5,14,Champions
65689,1705,7,8,1,2,1,4,Lost
65763,530,12,23,2,3,2,7,Casual Users
66075,1377,10,12,1,2,1,4,Lost
66344,72,59,82,4,5,4,13,Champions
66513,449,11,25,3,2,2,7,Casual Users
66625,419,82,244,3,5,5,13,Loyal Users
66939,4,112,462,5,5,5,15,Champions
66987,92,55,301,4,5,5,14,Champions
67139,838,13,41,2,3,3,8,Casual Users
67194,670,13,22,2,3,2,7,Casual Users
67318,2790,49,234,1,5,5,11,At Risk
67422,142,26,232,4,4,5,13,Champions
67889,51,118,151,5,5,5,15,Champions
67915,671,28,173,2,4,5,11,At Risk
68006,856,6,8,2,1,1,4,Lost
68261,116,23,70,4,4,4,12,Champions
68325,364,6,6,3,1,1,5,Casual Users
68456,90,85,139,4,5,4,13,Champions
68477,246,17,48,3,3,3,9,Loyal Users
68750,1139,11,22,2,2,2,6,Lost
68970,2962,6,7,1,1,1,3,Lost
69257,19,61,165,5,5,5,15,Champions
69530,1682,5,12,1,1,1,3,Lost
69610,6,61,312,5,5,5,15,Champions
69827,2124,5,18,1,1,2,4,Lost
70183,1128,7,7,2,2,1,5,Lost
70519,166,12,34,3,3,3,9,Loyal Users
70786,280,20,101,3,3,4,10,Loyal Users
71222,941,13,26,2,3,2,7,Casual Users
71363,115,9,22,4,2,2,8,Promising
71438,2594,5,6,1,1,1,3,Lost
71689,4307,5,11,1,1,1,3,Lost
72213,65,53,275,5,5,5,15,Champions
72353,4249,5,5,1,1,1,3,Lost
72753,365,14,24,3,3,2,8,Loyal Users
72823,161,18,36,4,3,3,10,Loyal Users
73192,294,36,70,3,4,4,11,Loyal Users
73243,12,6,27,5,1,2,8,Promising
73423,162,21,172,4,3,5,12,Loyal Users
73496,6,9,206,5,2,5,12,Promising
73692,672,27,66,2,4,4,10,At Risk
73963,323,15,61,3,3,3,9,Loyal Users
73991,2086,6,27,1,1,2,4,Lost
74022,1075,9,11,2,2,1,5,Lost
74635,438,45,79,3,4,4,11,Loyal Users
74749,4652,9,21,1,2,2,5,Lost
74920,53,75,400,5,5,5,15,Champions
75002,79,34,92,4,4,4,12,Champions
75339,19,20,55,5,3,3,11,Loyal Users
75365,1849,13,14,1,3,1,5,Casual Users
76088,120,92,156,4,5,5,14,Champions
76330,284,33,69,3,4,4,11,Loyal Users
76733,2682,6,6,1,1,1,3,Lost
76892,0,29,160,5,4,5,14,Champions
77059,1868,31,346,1,4,5,10,At Risk
77378,1629,5,6,1,1,1,3,Lost
77576,688,87,158,2,5,5,12,At Risk
77614,139,37,271,4,4,5,13,Champions
78166,3428,13,31,1,3,2,6,Casual Users
78204,91,15,87,4,3,4,11,Loyal Users
65541,2708,7,7,1,2,1,4,Lost
65724,1423,7,20,1,2,2,5,Lost
65794,1419,13,19,1,3,2,6,Casual Users
66252,713,9,9,2,2,1,5,Lost
66498,138,10,25,4,2,2,8,Promising
66511,29,101,151,5,5,5,15,Champions
66788,144,9,35,4,2,3,9,Promising
66846,4964,7,33,1,2,3,6,Lost
66902,3233,26,143,1,4,4,9,At Risk
67147,3431,27,191,1,4,5,10,At Risk
67235,989,6,7,2,1,1,4,Lost
67395,158,18,28,4,3,2,9,Loyal Users
67426,37,87,269,5,5,5,15,Champions
67453,108,73,295,4,5,5,14,Champions
67814,140,40,152,4,4,5,13,Champions
67869,419,5,5,3,1,1,5,Casual Users
67975,2676,13,56,1,3,3,7,Casual Users
68009,484,7,14,2,2,1,5,Lost
68153,101,12,31,4,3,2,9,Loyal Users
68194,736,13,91,2,3,4,9,Casual Users
68226,640,6,21,2,1,2,5,Lost
68290,571,8,17,2,2,2,6,Lost
68359,1855,5,14,1,1,1,3,Lost
68372,35,22,110,5,4,4,13,Champions
68537,126,19,66,4,3,4,11,Loyal Users
68710,2391,6,7,1,1,1,3,Lost
69391,94,61,434,4,5,5,14,Champions
69526,85,35,176,4,4,5,13,Champions
70304,1301,14,89,1,3,4,8,Casual Users
70336,67,10,16,5,2,2,9,Promising
70341,145,15,82,4,3,4,11,Loyal Users
70623,483,29,50,2,4,3,9,At Risk
71102,867,22,64,2,4,4,10,At Risk
71373,19,15,30,5,3,2,10,Loyal Users
71509,3627,9,9,1,2,1,4,Lost
72087,305,20,42,3,3,3,9,Loyal Users
72106,130,37,56,4,4,3,11,Loyal Users
73238,1535,8,15,1,2,1,4,Lost
73519,435,6,22,3,1,2,6,Casual Users
73603,58,21,35,5,3,3,11,Loyal Users
73635,44,15,27,5,3,2,10,Loyal Users
73714,2914,8,10,1,2,1,4,Lost
74138,1161,12,20,2,3,2,7,Casual Users
74786,115,54,188,4,5,5,14,Champions
74959,236,29,103,3,4,4,11,Loyal Users
75314,138,82,201,4,5,5,14,Champions
75357,1335,6,34,1,1,3,5,Lost
75458,411,11,39,3,2,3,8,Casual Users
75644,4,115,620,5,5,5,15,Champions
75864,275,26,67,3,4,4,11,Loyal Users
76099,9,33,98,5,4,4,13,Champions
76341,13,10,37,5,2,3,10,Promising
76656,593,15,175,2,3,5,10,Casual Users
76815,1066,7,21,2,2,2,6,Lost
76861,523,23,89,2,4,4,10,At Risk
76901,566,39,47,2,4,3,9,At Risk
77072,1012,28,94,2,4,4,10,At Risk
77087,124,10,33,4,2,3,9,Promising
77294,797,13,41,2,3,3,8,Casual Users
77458,1555,22,134,1,4,4,9,At Risk
77460,1769,9,10,1,2,1,4,Lost
77499,30,92,196,5,5,5,15,Champions
77776,1181,10,61,2,2,3,7,Lost
78051,129,7,11,4,2,1,7,Promising
65466,693,5,29,2,1,2,5,Lost
66052,90,21,42,4,3,3,10,Loyal Users
66364,596,21,110,2,3,4,9,Casual Users
66388,0,22,37,5,4,3,12,Loyal Users
66576,122,30,88,4,4,4,12,Champions
66623,1164,24,31,2,4,2,8,At Risk
66940,141,56,156,4,5,5,14,Champions
67151,27,7,8,5,2,1,8,Promising
67349,126,45,140,4,4,4,12,Champions
67499,3658,7,22,1,2,2,5,Lost
67507,837,6,7,2,1,1,4,Lost
67711,864,7,19,2,2,2,6,Lost
67930,8,28,127,5,4,4,13,Champions
68099,289,23,63,3,4,4,11,Loyal Users
68159,124,95,401,4,5,5,14,Champions
68436,29,72,386,5,5,5,15,Champions
68513,0,5,15,5,1,1,7,Promising
68518,428,19,34,3,3,3,9,Loyal Users
68553,234,15,65,3,3,4,10,Loyal Users
68948,2718,7,28,1,2,2,5,Lost
69499,1174,5,10,2,1,1,4,Lost
69818,90,12,31,4,3,2,9,Loyal Users
69841,524,143,644,2,5,5,12,At Risk
69940,2010,6,26,1,1,2,4,Lost
70020,13,68,264,5,5,5,15,Champions
70021,94,8,73,4,2,4,10,Promising
70279,3003,10,14,1,2,1,4,Lost
70301,374,7,22,3,2,2,7,Casual Users
70320,36,60,395,5,5,5,15,Champions
70421,51,52,92,5,5,4,14,Champions
70549,1005,35,124,2,4,4,10,At Risk
70746,6,10,17,5,2,2,9,Promising
70919,122,42,57,4,4,3,11,Loyal Users
70966,277,7,12,3,2,1,6,Casual Users
71156,698,13,40,2,3,3,8,Casual Users
71306,123,119,194,4,5,5,14,Champions
71725,26,9,34,5,2,3,10,Promising
72091,421,90,207,3,5,5,13,Loyal Users
72378,114,16,64,4,3,4,11,Loyal Users
72401,473,30,55,2,4,3,9,At Risk
72530,3,10,15,5,2,1,8,Promising
73164,3956,11,21,1,2,2,5,Lost
73224,20,52,287,5,5,5,15,Champions
73554,334,28,34,3,4,3,10,Loyal Users
73609,4,54,91,5,5,4,14,Champions
73733,62,59,301,5,5,5,15,Champions
73866,163,26,52,4,4,3,11,Loyal Users
74970,83,65,219,4,5,5,14,Champions
74991,2011,6,41,1,1,3,5,Lost
75159,9,10,21,5,2,2,9,Promising
75391,971,19,34,2,3,3,8,Casual Users
75486,144,77,325,4,5,5,14,Champions
75769,6,9,36,5,2,3,10,Promising
76679,113,45,258,4,4,5,13,Champions
76976,50,36,51,5,4,3,12,Loyal Users
77095,305,44,194,3,4,5,12,Loyal Users
77397,58,47,149,5,5,5,15,Champions
77655,87,9,9,4,2,1,7,Promising
65461,3761,5,5,1,1,1,3,Lost
65781,695,52,137,2,5,4,11,At Risk
66188,3745,9,9,1,2,1,4,Lost
66285,71,31,102,4,4,4,12,Champions
66704,133,33,77,4,4,4,12,Champions
67189,977,14,28,2,3,2,7,Casual Users
67379,23,90,263,5,5,5,15,Champions
67443,1515,13,90,1,3,4,8,Casual Users
67959,1395,16,89,1,3,4,8,Casual Users
68031,64,94,173,5,5,5,15,Champions
68043,74,91,358,4,5,5,14,Champions
68351,142,10,30,4,2,2,8,Promising
68362,1544,6,20,1,1,2,4,Lost
68401,867,13,64,2,3,4,9,Casual Users
68406,55,73,729,5,5,5,15,Champions
68409,65,49,91,5,5,4,14,Champions
68656,79,16,57,4,3,3,10,Loyal Users
68746,103,35,89,4,4,4,12,Champions
68886,2536,8,13,1,2,1,4,Lost
68900,186,14,30,3,3,2,8,Loyal Users
68974,2817,12,22,1,3,2,6,Casual Users
68988,30,15,42,5,3,3,11,Loyal Users
69311,2255,6,12,1,1,1,3,Lost
69546,22,102,233,5,5,5,15,Champions
69556,1291,7,8,1,2,1,4,Lost
69701,70,7,50,4,2,3,9,Promising
69999,108,11,53,4,2,3,9,Promising
70260,921,43,119,2,4,4,10,At Risk
70439,12,13,19,5,3,2,10,Loyal Users
70482,89,14,21,4,3,2,9,Loyal Users
70492,3,105,307,5,5,5,15,Champions
70552,45,114,341,5,5,5,15,Champions
70734,3416,76,174,1,5,5,11,At Risk
70755,413,15,73,3,3,4,10,Loyal Users
71601,823,11,89,2,2,4,8,Lost
71882,383,26,70,3,4,4,11,Loyal Users
72062,70,25,51,4,4,3,11,Loyal Users
72097,12,33,63,5,4,4,13,Champions
72108,2086,6,11,1,1,1,3,Lost
72183,303,9,11,3,2,1,6,Casual Users
72922,3849,5,19,1,1,2,4,Lost
72939,125,45,132,4,4,4,12,Champions
73029,130,5,22,4,1,2,7,Promising
73113,2713,7,21,1,2,2,5,Lost
73403,29,60,161,5,5,5,15,Champions
73633,12,23,38,5,4,3,12,Loyal Users
73637,1,39,124,5,4,4,13,Champions
73778,278,10,15,3,2,1,6,Casual Users
74072,34,163,410,5,5,5,15,Champions
74417,1682,7,13,1,2,1,4,Lost
74827,3042,8,16,1,2,2,5,Lost
74903,84,71,223,4,5,5,14,Champions
74945,747,10,38,2,2,3,7,Lost
75077,310,30,104,3,4,4,11,Loyal Users
75180,2809,10,34,1,2,3,6,Lost
75256,5,64,243,5,5,5,15,Champions
75462,61,31,158,5,4,5,14,Champions
75754,51,14,17,5,3,2,10,Loyal Users
76921,1,32,73,5,4,4,13,Champions
76942,4058,12,29,1,3,2,6,Casual Users
77128,187,45,89,3,4,4,11,Loyal Users
77207,33,56,111,5,5,4,14,Champions
77569,235,16,33,3,3,3,9,Loyal Users
77794,1048,39,130,2,4,4,10,At Risk
78255,13,18,20,5,3,2,10,Loyal Users
65688,918,14,17,2,3,2,7,Casual Users
66040,384,14,87,3,3,4,10,Loyal Users
66177,104,44,55,4,4,3,11,Loyal Users
66255,278,25,63,3,4,4,11,Loyal Users
66427,3,72,159,5,5,5,15,Champions
66979,4,64,257,5,5,5,15,Champions
67008,34,5,21,5,1,2,8,Promising
67095,79,42,250,4,4,5,13,Champions
67261,251,53,96,3,5,4,12,Loyal Users
67800,25,6,16,5,1,2,8,Promising
68210,121,144,775,4,5,5,14,Champions
68270,690,25,59,2,4,3,9,At Risk
68597,562,11,13,2,2,1,5,Lost
68760,13,22,74,5,4,4,13,Champions
69009,92,146,500,4,5,5,14,Champions
69166,12,99,320,5,5,5,15,Champions
69344,4381,6,26,1,1,2,4,Lost
69390,219,28,82,3,4,4,11,Loyal Users
69900,954,6,20,2,1,2,5,Lost
69912,175,38,64,3,4,4,11,Loyal Users
70225,1505,7,41,1,2,3,6,Lost
70438,101,18,35,4,3,3,10,Loyal Users
70669,627,33,57,2,4,3,9,At Risk
70671,417,26,43,3,4,3,10,Loyal Users
70730,81,32,163,4,4,5,13,Champions
70769,5,11,33,5,2,3,10,Promising
70853,2082,6,18,1,1,2,4,Lost
71453,267,38,133,3,4,4,11,Loyal Users
71484,220,78,246,3,5,5,13,Loyal Users
71494,312,26,52,3,4,3,10,Loyal Users
71677,1338,14,32,1,3,3,7,Casual Users
71771,1092,11,22,2,2,2,6,Lost
71924,130,7,17,4,2,2,8,Promising
72118,146,36,60,4,4,3,11,Loyal Users
73367,34,108,154,5,5,5,15,Champions
73462,9,59,574,5,5,5,15,Champions
73510,133,21,44,4,3,3,10,Loyal Users
73602,196,18,44,3,3,3,9,Loyal Users
74147,1006,15,31,2,3,2,7,Casual Users
74208,165,10,20,4,2,2,8,Promising
74419,121,85,373,4,5,5,14,Champions
74593,38,70,185,5,5,5,15,Champions
74670,2128,10,10,1,2,1,4,Lost
74819,166,69,153,3,5,5,13,Loyal Users
75071,1216,7,9,2,2,1,5,Lost
75766,628,13,127,2,3,4,9,Casual Users
75989,334,6,17,3,1,2,6,Casual Users
76108,146,76,282,4,5,5,14,Champions
76217,406,9,28,3,2,2,7,Casual Users
76261,244,8,17,3,2,2,7,Casual Users
76945,428,44,63,3,4,4,11,Loyal Users
77005,2778,27,80,1,4,4,9,At Risk
77215,1324,6,16,1,1,2,4,Lost
77333,1581,10,10,1,2,1,4,Lost
77633,232,30,81,3,4,4,11,Loyal Users
77652,407,18,60,3,3,3,9,Loyal Users
77654,91,38,60,4,4,3,11,Loyal Users
77754,178,10,34,3,2,3,8,Casual Users
77758,1,5,8,5,1,1,7,Promising
77810,1589,5,12,1,1,1,3,Lost
78012,1368,29,47,1,4,3,8,At Risk
78118,0,38,153,5,4,5,14,Champions
65589,615,36,41,2,4,3,9,At Risk
65735,383,18,88,3,3,4,10,Loyal Users
65795,529,17,34,2,3,3,8,Casual Users
65809,27,37,223,5,4,5,14,Champions
66428,1934,8,16,1,2,2,5,Lost
66914,3697,5,19,1,1,2,4,Lost
67325,7,130,341,5,5,5,15,Champions
67337,1704,6,7,1,1,1,3,Lost
67599,82,131,299,4,5,5,14,Champions
67636,702,12,16,2,3,2,7,Casual Users
68112,210,21,44,3,3,3,9,Loyal Users
68483,208,19,69,3,3,4,10,Loyal Users
68687,32,48,80,5,5,4,14,Champions
68958,415,31,114,3,4,4,11,Loyal Users
69419,130,40,114,4,4,4,12,Champions
70062,65,127,721,5,5,5,15,Champions
70169,997,13,20,2,3,2,7,Casual Users
70178,1786,13,24,1,3,2,6,Casual Users
70207,3649,14,32,1,3,3,7,Casual Users
70254,109,52,241,4,5,5,14,Champions
70332,415,10,16,3,2,2,7,Casual Users
70389,1631,6,6,1,1,1,3,Lost
70536,301,11,20,3,2,2,7,Casual Users
70896,1352,9,33,1,2,3,6,Lost
70953,20,10,13,5,2,1,8,Promising
71216,130,19,44,4,3,3,10,Loyal Users
71521,571,30,77,2,4,4,10,At Risk
71562,669,28,84,2,4,4,10,At Risk
71586,1410,5,65,1,1,4,6,Lost
71862,1269,12,15,1,3,1,5,Casual Users
71893,111,144,321,4,5,5,14,Champions
72101,151,12,16,4,3,2,9,Loyal Users
72134,283,7,12,3,2,1,6,Casual Users
72274,6,20,34,5,3,3,11,Loyal Users
72320,154,6,17,4,1,2,7,Promising
72760,8,88,141,5,5,4,14,Champions
72875,419,54,137,3,5,4,12,Loyal Users
72943,699,6,9,2,1,1,4,Lost
72966,774,50,193,2,5,5,12,At Risk
73186,1512,20,37,1,3,3,7,Casual Users
73222,253,13,15,3,3,1,7,Loyal Users
73253,1672,9,24,1,2,2,5,Lost
73255,2910,5,10,1,1,1,3,Lost
73382,693,28,140,2,4,4,10,At Risk
73562,121,10,10,4,2,1,7,Promising
74367,702,40,308,2,4,5,11,At Risk
74437,688,13,93,2,3,4,9,Casual Users
74692,12,76,272,5,5,5,15,Champions
74711,993,10,31,2,2,2,6,Lost
75295,22,5,7,5,1,1,7,Promising
75532,6,65,253,5,5,5,15,Champions
75577,140,51,133,4,5,4,13,Champions
76030,1294,24,51,1,4,3,8,At Risk
76197,133,15,32,4,3,3,10,Loyal Users
76465,307,44,239,3,4,5,12,Loyal Users
76710,3236,9,13,1,2,1,4,Lost
76736,112,21,39,4,3,3,10,Loyal Users
76795,5,44,95,5,4,4,13,Champions
76820,311,57,188,3,5,5,13,Loyal Users
77068,1954,8,9,1,2,1,4,Lost
77157,1703,13,23,1,3,2,6,Casual Users
77239,17,241,602,5,5,5,15,Champions
77560,1516,6,29,1,1,2,4,Lost
77597,246,25,229,3,4,5,12,Loyal Users
77612,1517,11,20,1,2,2,5,Lost
77924,0,25,60,5,4,3,12,Loyal Users
78030,1976,7,11,1,2,1,4,Lost
65526,1002,21,33,2,3,3,8,Casual Users
65601,2849,5,24,1,1,2,4,Lost
65769,1536,26,75,1,4,4,9,At Risk
65866,850,26,108,2,4,4,10,At Risk
65951,389,14,55,3,3,3,9,Loyal Users
65982,80,8,8,4,2,1,7,Promising
66145,2248,84,387,1,5,5,11,At Risk
66420,1005,5,16,2,1,2,5,Lost
66560,2,120,738,5,5,5,15,Champions
66673,141,12,69,4,3,4,11,Loyal Users
66881,210,11,19,3,2,2,7,Casual Users
67433,915,19,47,2,3,3,8,Casual Users
67970,435,7,9,3,2,1,6,Casual Users
68022,1721,5,8,1,1,1,3,Lost
68145,233,11,25,3,2,2,7,Casual Users
68813,32,116,651,5,5,5,15,Champions
68875,4995,6,31,1,1,2,4,Lost
69026,269,24,54,3,4,3,10,Loyal Users
69066,28,8,26,5,2,2,9,Promising
69203,3448,6,16,1,1,2,4,Lost
69674,425,5,13,3,1,1,5,Casual Users
69853,118,7,12,4,2,1,7,Promising
70047,40,9,10,5,2,1,8,Promising
70469,768,68,149,2,5,5,12,At Risk
70650,546,11,15,2,2,1,5,Lost
70679,134,22,39,4,4,3,11,Loyal Users
70845,306,31,51,3,4,3,10,Loyal Users
70947,273,35,49,3,4,3,10,Loyal Users
70977,3443,9,17,1,2,2,5,Lost
71158,353,12,16,3,3,2,8,Loyal Users
71351,868,15,67,2,3,4,9,Casual Users
71429,1130,5,11,2,1,1,4,Lost
71753,413,21,92,3,3,4,10,Loyal Users
71908,893,5,38,2,1,3,6,Lost
72070,7,76,209,5,5,5,15,Champions
72360,157,7,9,4,2,1,7,Promising
72827,245,16,20,3,3,2,8,Loyal Users
72877,1206,103,438,2,5,5,12,At Risk
72947,5,67,231,5,5,5,15,Champions
73357,447,5,7,3,1,1,5,Casual Users
73965,367,37,121,3,4,4,11,Loyal Users
74153,0,82,189,5,5,5,15,Champions
74203,704,5,5,2,1,1,4,Lost
74279,5,12,23,5,3,2,10,Loyal Users
74353,30,10,13,5,2,1,8,Promising
74547,539,13,16,2,3,2,7,Casual Users
74555,410,5,28,3,1,2,6,Casual Users
74646,1143,10,20,2,2,2,6,Lost
74855,2871,10,13,1,2,1,4,Lost
74876,1276,5,20,1,1,2,4,Lost
75017,102,7,15,4,2,1,7,Promising
75060,38,83,545,5,5,5,15,Champions
75063,1163,14,19,2,3,2,7,Casual Users
75145,71,34,55,4,4,3,11,Loyal Users
75326,37,70,140,5,5,4,14,Champions
75599,1094,13,29,2,3,2,7,Casual Users
76150,2482,6,13,1,1,1,3,Lost
76251,3698,8,18,1,2,2,5,Lost
76436,1129,9,21,2,2,2,6,Lost
76681,102,39,61,4,4,3,11,Loyal Users
76740,57,20,153,5,3,5,13,Loyal Users
76794,720,31,89,2,4,4,10,At Risk
76930,422,8,30,3,2,2,7,Casual Users
77678,118,33,149,4,4,5,13,Champions
77731,2416,23,72,1,4,4,9,At Risk
77765,182,54,63,3,5,4,12,Loyal Users
78212,134,13,95,4,3,4,11,Loyal Users
65670,126,38,126,4,4,4,12,Champions
65708,137,80,276,4,5,5,14,Champions
66164,38,35,47,5,4,3,12,Loyal Users
66968,708,21,30,2,3,2,7,Casual Users
67023,100,76,164,4,5,5,14,Champions
67191,81,42,108,4,4,4,12,Champions
67452,1013,10,26,2,2,2,6,Lost
67968,7,100,563,5,5,5,15,Champions
68071,3248,10,21,1,2,2,5,Lost
68176,1580,12,19,1,3,2,6,Casual Users
68219,105,16,23,4,3,2,9,Loyal Users
68271,547,15,21,2,3,2,7,Casual Users
68363,332,18,108,3,3,4,10,Loyal Users
68383,274,54,126,3,5,4,12,Loyal Users
68707,159,8,10,4,2,1,7,Promising
69063,699,16,59,2,3,3,8,Casual Users
69109,1101,6,6,2,1,1,4,Lost
69265,4,92,238,5,5,5,15,Champions
69821,5,17,50,5,3,3,11,Loyal Users
70191,102,37,317,4,4,5,13,Champions
70250,154,35,140,4,4,4,12,Champions
70360,104,59,452,4,5,5,14,Champions
70430,4321,7,34,1,2,3,6,Lost
70485,670,16,26,2,3,2,7,Casual Users
70634,1255,20,37,2,3,3,8,Casual Users
70987,3,55,85,5,5,4,14,Champions
71042,108,158,269,4,5,5,14,Champions
71253,0,14,33,5,3,3,11,Loyal Users
71304,79,21,62,4,3,3,10,Loyal Users
71875,2175,11,12,1,2,1,4,Lost
72396,277,61,195,3,5,5,13,Loyal Users
72423,89,10,15,4,2,1,7,Promising
72457,2618,15,20,1,3,2,6,Casual Users
72521,266,5,5,3,1,1,5,Casual Users
72730,1070,12,24,2,3,2,7,Casual Users
72746,30,162,415,5,5,5,15,Champions
72915,5528,5,12,1,1,1,3,Lost
73082,479,10,12,2,2,1,5,Lost
73207,1309,12,18,1,3,2,6,Casual Users
73748,1877,11,21,1,2,2,5,Lost
74172,919,5,39,2,1,3,6,Lost
74540,463,5,8,3,1,1,5,Casual Users
74618,13,16,75,5,3,4,12,Loyal Users
75029,152,13,37,4,3,3,10,Loyal Users
75491,5594,6,8,1,1,1,3,Lost
75530,408,21,138,3,3,4,10,Loyal Users
75576,101,21,28,4,3,2,9,Loyal Users
75707,921,9,36,2,2,3,7,Lost
76097,1742,6,25,1,1,2,4,Lost
76131,794,48,342,2,5,5,12,At Risk
76138,889,5,5,2,1,1,4,Lost
76279,2055,8,9,1,2,1,4,Lost
76591,140,42,91,4,4,4,12,Champions
76639,162,5,6,4,1,1,6,Promising
76727,432,9,18,3,2,2,7,Casual Users
77038,128,34,88,4,4,4,12,Champions
77271,1715,8,17,1,2,2,5,Lost
77277,134,6,8,4,1,1,6,Promising
77453,27,38,104,5,4,4,13,Champions
77553,516,18,34,2,3,3,8,Casual Users
77579,1842,15,40,1,3,3,7,Casual Users
77763,703,11,30,2,2,2,6,Lost
78047,267,18,52,3,3,3,9,Loyal Users
65467,132,6,38,4,1,3,8,Promising
65471,73,73,338,4,5,5,14,Champions
65575,290,13,29,3,3,2,8,Loyal Users
65705,796,20,91,2,3,4,9,Casual Users
65743,691,57,142,2,5,4,11,At Risk
65950,3513,5,6,1,1,1,3,Lost
66140,105,8,44,4,2,3,9,Promising
66267,891,16,29,2,3,2,7,Casual Users
66328,108,75,134,4,5,4,13,Champions
66354,57,10,127,5,2,4,11,Promising
66501,85,7,15,4,2,1,7,Promising
66538,108,38,107,4,4,4,12,Champions
66695,1276,8,9,1,2,1,4,Lost
67612,285,16,26,3,3,2,8,Loyal Users
67615,695,8,10,2,2,1,5,Lost
67721,14,65,109,5,5,4,14,Champions
67939,23,76,149,5,5,5,15,Champions
68129,168,108,147,3,5,5,13,Loyal Users
68508,165,35,58,4,4,3,11,Loyal Users
69072,886,5,9,2,1,1,4,Lost
69270,409,19,35,3,3,3,9,Loyal Users
69343,825,5,11,2,1,1,4,Lost
69367,14,71,133,5,5,4,14,Champions
69918,1111,8,50,2,2,3,7,Lost
70074,27,57,373,5,5,5,15,Champions
70222,611,13,52,2,3,3,8,Casual Users
70369,1719,8,8,1,2,1,4,Lost
70498,31,21,81,5,3,4,12,Loyal Users
70582,153,8,16,4,2,2,8,Promising
70666,410,41,82,3,4,4,11,Loyal Users
70703,138,103,251,4,5,5,14,Champions
70812,538,9,15,2,2,1,5,Lost
71446,123,31,148,4,4,5,13,Champions
71495,4,50,339,5,5,5,15,Champions
71954,3557,7,7,1,2,1,4,Lost
72045,412,16,41,3,3,3,9,Loyal Users
72143,3600,38,51,1,4,3,8,At Risk
72258,22,70,399,5,5,5,15,Champions
72325,3585,5,10,1,1,1,3,Lost
72462,674,5,12,2,1,1,4,Lost
72737,261,9,34,3,2,3,8,Casual Users
72783,104,10,21,4,2,2,8,Promising
72888,577,10,35,2,2,3,7,Lost
73490,142,54,129,4,5,4,13,Champions
73582,657,8,9,2,2,1,5,Lost
73663,1307,7,10,1,2,1,4,Lost
73926,128,93,111,4,5,4,13,Champions
74010,188,12,49,3,3,3,9,Loyal Users
74149,533,15,20,2,3,2,7,Casual Users
74735,1271,10,16,1,2,2,5,Lost
74875,248,15,128,3,3,4,10,Loyal Users
74934,474,17,116,2,3,4,9,Casual Users
75032,1411,13,49,1,3,3,7,Casual Users
75153,1676,5,7,1,1,1,3,Lost
75189,97,33,199,4,4,5,13,Champions
75396,140,42,97,4,4,4,12,Champions
75560,1563,6,8,1,1,1,3,Lost
75692,4,106,241,5,5,5,15,Champions
75991,167,7,29,3,2,2,7,Casual Users
75998,26,48,239,5,5,5,15,Champions
76091,3828,6,15,1,1,1,3,Lost
76446,1655,14,45,1,3,3,7,Casual Users
76638,2,36,160,5,4,5,14,Champions
77389,2564,6,10,1,1,1,3,Lost
77490,135,13,69,4,3,4,11,Loyal Users
77675,1714,14,27,1,3,2,6,Casual Users
77970,674,12,19,2,3,2,7,Casual Users
65760,94,21,86,4,3,4,11,Loyal Users
65840,157,8,25,4,2,2,8,Promising
67586,133,36,74,4,4,4,12,Champions
67945,3,113,318,5,5,5,15,Champions
68021,270,31,121,3,4,4,11,Loyal Users
68106,2405,11,34,1,2,3,6,Lost
68815,547,35,76,2,4,4,10,At Risk
68962,464,52,104,3,5,4,12,Loyal Users
69538,710,17,65,2,3,4,9,Casual Users
69737,151,35,102,4,4,4,12,Champions
69817,177,45,236,3,4,5,12,Loyal Users
69856,1994,10,24,1,2,2,5,Lost
69985,1175,20,73,2,3,4,9,Casual Users
70204,364,7,7,3,2,1,6,Casual Users
70736,77,25,87,4,4,4,12,Champions
70757,50,39,60,5,4,3,12,Loyal Users
70808,30,18,127,5,3,4,12,Loyal Users
70878,1023,10,53,2,2,3,7,Lost
70880,8,19,100,5,3,4,12,Loyal Users
71038,127,33,67,4,4,4,12,Champions
71346,103,62,140,4,5,4,13,Champions
71422,303,42,65,3,4,4,11,Loyal Users
71762,162,12,30,4,3,2,9,Loyal Users
71764,717,8,13,2,2,1,5,Lost
71898,1819,7,12,1,2,1,4,Lost
72049,707,11,39,2,2,3,7,Lost
72066,1807,9,28,1,2,2,5,Lost
72176,84,24,35,4,4,3,11,Loyal Users
72427,349,16,28,3,3,2,8,Loyal Users
72583,262,5,8,3,1,1,5,Casual Users
72635,413,38,89,3,4,4,11,Loyal Users
73295,123,16,114,4,3,4,11,Loyal Users
73592,2,38,133,5,4,4,13,Champions
73921,0,120,617,5,5,5,15,Champions
74333,288,34,75,3,4,4,11,Loyal Users
74389,232,41,177,3,4,5,12,Loyal Users
74619,1730,7,14,1,2,1,4,Lost
74678,19,32,124,5,4,4,13,Champions
74962,2317,36,61,1,4,3,8,At Risk
75206,74,104,225,4,5,5,14,Champions
75596,45,88,332,5,5,5,15,Champions
75750,82,6,31,4,1,2,7,Promising
75911,274,15,19,3,3,2,8,Loyal Users
76394,100,18,98,4,3,4,11,Loyal Users
76433,288,17,61,3,3,3,9,Loyal Users
77472,154,42,73,4,4,4,12,Champions
77477,21,28,157,5,4,5,14,Champions
77567,107,6,10,4,1,1,6,Promising
77761,122,8,63,4,2,4,10,Promising
77930,102,22,26,4,4,2,10,Loyal Users
77996,18,5,8,5,1,1,7,Promising
78210,63,26,122,5,4,4,13,Champions
78222,146,115,433,4,5,5,14,Champions
65441,3228,6,6,1,1,1,3,Lost
65633,704,8,61,2,2,3,7,Lost
65780,826,11,23,2,2,2,6,Lost
65961,2482,6,14,1,1,1,3,Lost
66186,2056,11,57,1,2,3,6,Lost
66410,654,12,22,2,3,2,7,Casual Users
66485,368,18,112,3,3,4,10,Loyal Users
66917,63,159,551,5,5,5,15,Champions
66951,23,20,90,5,3,4,12,Loyal Users
67285,2665,9,12,1,2,1,4,Lost
67374,1137,9,14,2,2,1,5,Lost
67819,847,57,185,2,5,5,12,At Risk
68308,103,16,120,4,3,4,11,Loyal Users
68313,1699,6,8,1,1,1,3,Lost
68426,232,20,74,3,3,4,10,Loyal Users
68576,2672,6,35,1,1,3,5,Lost
68581,2001,5,32,1,1,3,5,Lost
68620,365,9,68,3,2,4,9,Casual Users
68928,2296,17,28,1,3,2,6,Casual Users
68955,160,8,13,4,2,1,7,Promising
68991,41,57,133,5,5,4,14,Champions
69036,5659,5,5,1,1,1,3,Lost
69094,216,36,359,3,4,5,12,Loyal Users
69139,613,5,6,2,1,1,4,Lost
69511,109,44,172,4,4,5,13,Champions
69793,123,22,58,4,4,3,11,Loyal Users
69795,646,9,28,2,2,2,6,Lost
69819,833,7,36,2,2,3,7,Lost
70080,2880,10,24,1,2,2,5,Lost
70144,4297,5,6,1,1,1,3,Lost
70234,154,11,13,4,2,1,7,Promising
70445,64,14,24,5,3,2,10,Loyal Users
71164,1559,15,25,1,3,2,6,Casual Users
71503,175,14,19,3,3,2,8,Loyal Users
72414,1389,29,55,1,4,3,8,At Risk
72537,163,24,35,4,4,3,11,Loyal Users
72849,279,14,50,3,3,3,9,Loyal Users
73047,1869,7,43,1,2,3,6,Lost
73176,64,54,219,5,5,5,15,Champions
73211,229,23,26,3,4,2,9,Loyal Users
73389,119,125,599,4,5,5,14,Champions
73494,88,234,624,4,5,5,14,Champions
73538,877,34,40,2,4,3,9,At Risk
73826,128,20,30,4,3,2,9,Loyal Users
73959,40,27,154,5,4,5,14,Champions
74397,43,51,231,5,5,5,15,Champions
74420,709,13,16,2,3,2,7,Casual Users
74577,2116,9,12,1,2,1,4,Lost
74623,3229,60,114,1,5,4,10,At Risk
74797,6,16,26,5,3,2,10,Loyal Users
74816,419,17,105,3,3,4,10,Loyal Users
74895,1472,14,66,1,3,4,8,Casual Users
75208,159,8,13,4,2,1,7,Promising
75882,581,18,25,2,3,2,7,Casual Users
75975,947,29,54,2,4,3,9,At Risk
76045,796,21,50,2,3,3,8,Casual Users
76104,428,7,31,3,2,2,7,Casual Users
76641,105,8,9,4,2,1,7,Promising
76667,32,64,518,5,5,5,15,Champions
76926,165,18,58,4,3,3,10,Loyal Users
76963,1515,6,11,1,1,1,3,Lost
77557,719,16,55,2,3,3,8,Casual Users
77643,5246,14,30,1,3,2,6,Casual Users
77664,4121,9,13,1,2,1,4,Lost
77882,446,23,66,3,4,4,11,Loyal Users
77901,146,11,18,4,2,2,8,Promising
65748,25,46,76,5,5,4,14,Champions
65884,242,5,14,3,1,1,5,Casual Users
65937,2110,10,70,1,2,4,7,Lost
66237,1,43,83,5,4,4,13,Champions
66893,302,11,33,3,2,3,8,Casual Users
66927,3140,9,14,1,2,1,4,Lost
66954,814,22,51,2,4,3,9,At Risk
66966,21,16,20,5,3,2,10,Loyal Users
67000,422,83,131,3,5,4,12,Loyal Users
67014,514,16,66,2,3,4,9,Casual Users
67396,2407,5,5,1,1,1,3,Lost
67407,161,5,24,4,1,2,7,Promising
67435,257,7,8,3,2,1,6,Casual Users
68225,436,27,95,3,4,4,11,Loyal Users
68765,741,17,40,2,3,3,8,Casual Users
69044,219,11,30,3,2,2,7,Casual Users
69132,133,41,128,4,4,4,12,Champions
69824,15,48,634,5,5,5,15,Champions
69992,95,14,86,4,3,4,11,Loyal Users
70567,300,14,59,3,3,3,9,Loyal Users
70589,173,27,71,3,4,4,11,Loyal Users
71315,5351,11,15,1,2,1,4,Lost
71738,94,7,15,4,2,1,7,Promising
72538,10,23,105,5,4,4,13,Champions
72648,2116,10,19,1,2,2,5,Lost
73280,97,11,59,4,2,3,9,Promising
73451,1343,11,20,1,2,2,5,Lost
73711,573,13,40,2,3,3,8,Casual Users
73713,25,36,84,5,4,4,13,Champions
73781,574,9,17,2,2,2,6,Lost
73943,2505,8,37,1,2,3,6,Lost
74707,3121,8,16,1,2,2,5,Lost
74736,319,78,375,3,5,5,13,Loyal Users
74882,5294,7,10,1,2,1,4,Lost
74998,579,12,27,2,3,2,7,Casual Users
75316,146,12,81,4,3,4,11,Loyal Users
75499,384,49,126,3,5,4,12,Loyal Users
75752,19,135,439,5,5,5,15,Champions
76005,546,5,33,2,1,3,6,Lost
76361,699,35,76,2,4,4,10,At Risk
76487,233,11,47,3,2,3,8,Casual Users
76492,645,16,66,2,3,4,9,Casual Users
76524,163,26,92,4,4,4,12,Champions
76813,415,5,14,3,1,1,5,Casual Users
77396,489,9,19,2,2,2,6,Lost
77673,29,108,327,5,5,5,15,Champions
78062,104,75,340,4,5,5,14,Champions
78254,143,28,51,4,4,3,11,Loyal Users
65681,25,46,84,5,5,4,14,Champions
65684,104,77,120,4,5,4,13,Champions
66419,591,9,10,2,2,1,5,Lost
66431,7,163,403,5,5,5,15,Champions
66575,462,10,17,3,2,2,7,Casual Users
66577,268,30,160,3,4,5,12,Loyal Users
67079,259,59,101,3,5,4,12,Loyal Users
67141,3556,6,15,1,1,1,3,Lost
67367,6,28,59,5,4,3,12,Loyal Users
67394,3449,12,53,1,3,3,7,Casual Users
67773,2935,9,27,1,2,2,5,Lost
68029,94,107,246,4,5,5,14,Champions
68048,245,25,88,3,4,4,11,Loyal Users
68479,73,31,149,4,4,5,13,Champions
68751,4746,8,8,1,2,1,4,Lost
68897,118,98,217,4,5,5,14,Champions
69243,3311,7,35,1,2,3,6,Lost
69321,1105,8,22,2,2,2,6,Lost
69332,1591,14,29,1,3,2,6,Casual Users
69843,238,40,89,3,4,4,11,Loyal Users
69949,30,16,35,5,3,3,11,Loyal Users
70055,950,10,45,2,2,3,7,Lost
70230,104,22,90,4,4,4,12,Champions
71011,19,140,247,5,5,5,15,Champions
71023,401,10,40,3,2,3,8,Casual Users
71227,90,77,218,4,5,5,14,Champions
71293,196,39,126,3,4,4,11,Loyal Users
71415,428,34,112,3,4,4,11,Loyal Users
71661,72,42,203,4,4,5,13,Champions
71904,256,7,17,3,2,2,7,Casual Users
72001,670,9,52,2,2,3,7,Lost
72040,626,11,31,2,2,2,6,Lost
72307,2624,24,55,1,4,3,8,At Risk
72403,3295,12,13,1,3,1,5,Casual Users
72557,411,59,238,3,5,5,13,Loyal Users
72634,1,64,198,5,5,5,15,Champions
72665,664,10,60,2,2,3,7,Lost
72818,1,26,105,5,4,4,13,Champions
73057,380,39,264,3,4,5,12,Loyal Users
73073,1373,8,73,1,2,4,7,Lost
74160,1231,15,29,2,3,2,7,Casual Users
74201,2515,10,46,1,2,3,6,Lost
74508,2118,6,18,1,1,2,4,Lost
74674,252,14,33,3,3,3,9,Loyal Users
74766,2674,17,28,1,3,2,6,Casual Users
75432,1809,8,8,1,2,1,4,Lost
75496,121,86,325,4,5,5,14,Champions
75601,7,52,174,5,5,5,15,Champions
76392,134,9,11,4,2,1,7,Promising
76409,273,75,286,3,5,5,13,Loyal Users
76503,1259,27,34,1,4,3,8,At Risk
76749,7,6,6,5,1,1,7,Promising
76770,695,26,58,2,4,3,9,At Risk
76787,0,109,537,5,5,5,15,Champions
76789,160,29,41,4,4,3,11,Loyal Users
76817,103,84,504,4,5,5,14,Champions
76866,255,19,124,3,3,4,10,Loyal Users
77330,851,7,44,2,2,3,7,Lost
77815,9,51,94,5,5,4,14,Champions
77963,1145,5,5,2,1,1,4,Lost
65555,3,100,252,5,5,5,15,Champions
65615,314,99,260,3,5,5,13,Loyal Users
65783,1397,10,17,1,2,2,5,Lost
65943,91,24,158,4,4,5,13,Champions
66230,0,125,271,5,5,5,15,Champions
66301,1457,7,12,1,2,1,4,Lost
66350,267,88,186,3,5,5,13,Loyal Users
67276,635,15,22,2,3,2,7,Casual Users
67406,694,5,21,2,1,2,5,Lost
67657,695,5,5,2,1,1,4,Lost
67742,28,16,39,5,3,3,11,Loyal Users
68081,251,88,828,3,5,5,13,Loyal Users
68349,2405,8,25,1,2,2,5,Lost
68670,9,19,24,5,3,2,10,Loyal Users
69093,1547,12,18,1,3,2,6,Casual Users
69351,13,29,55,5,4,3,12,Loyal Users
69405,136,5,6,4,1,1,6,Promising
69407,2,31,57,5,4,3,12,Loyal Users
69966,20,50,79,5,5,4,14,Champions
70233,1047,106,167,2,5,5,12,At Risk
70558,189,7,38,3,2,3,8,Casual Users
70872,23,86,335,5,5,5,15,Champions
71168,5726,27,221,1,4,5,10,At Risk
71641,114,32,88,4,4,4,12,Champions
71658,2314,7,31,1,2,2,5,Lost
71774,533,5,9,2,1,1,4,Lost
71844,594,7,13,2,2,1,5,Lost
71907,2677,8,14,1,2,1,4,Lost
71914,298,34,91,3,4,4,11,Loyal Users
72432,3125,12,18,1,3,2,6,Casual Users
72539,244,9,14,3,2,1,6,Casual Users
72619,1019,5,14,2,1,1,4,Lost
72858,1554,11,25,1,2,2,5,Lost
73065,116,27,55,4,4,3,11,Loyal Users
73263,44,12,137,5,3,4,12,Loyal Users
73310,126,12,18,4,3,2,9,Loyal Users
73848,2432,6,45,1,1,3,5,Lost
74040,113,40,147,4,4,5,13,Champions
74100,700,10,29,2,2,2,6,Lost
74105,564,45,190,2,4,5,11,At Risk
74344,281,8,31,3,2,2,7,Casual Users
74695,145,27,84,4,4,4,12,Champions
74706,357,27,126,3,4,4,11,Loyal Users
74879,2558,5,9,1,1,1,3,Lost
75018,303,13,142,3,3,4,10,Loyal Users
75281,546,18,30,2,3,2,7,Casual Users
75377,833,9,10,2,2,1,5,Lost
75479,260,29,49,3,4,3,10,Loyal Users
75719,986,11,76,2,2,4,8,Lost
75854,1106,19,36,2,3,3,8,Casual Users
75885,432,9,63,3,2,4,9,Casual Users
76050,3,125,257,5,5,5,15,Champions
76239,6,78,310,5,5,5,15,Champions
76275,478,62,169,2,5,5,12,At Risk
76412,93,19,60,4,3,3,10,Loyal Users
76527,1272,9,37,1,2,3,6,Lost
76575,226,127,224,3,5,5,13,Loyal Users
76589,2403,28,129,1,4,4,9,At Risk
76609,1560,8,10,1,2,1,4,Lost
76922,772,34,81,2,4,4,10,At Risk
76997,419,11,24,3,2,2,7,Casual Users
77339,314,13,40,3,3,3,9,Loyal Users
78024,329,13,25,3,3,2,8,Loyal Users
65449,4,184,449,5,5,5,15,Champions
65608,84,18,27,4,3,2,9,Loyal Users
65649,900,32,77,2,4,4,10,At Risk
65998,1289,5,26,1,1,2,4,Lost
66017,31,73,96,5,5,4,14,Champions
66084,408,12,18,3,3,2,8,Loyal Users
66102,125,13,33,4,3,3,10,Loyal Users
66161,149,11,60,4,2,3,9,Promising
66548,2601,8,21,1,2,2,5,Lost
66818,25,8,16,5,2,2,9,Promising
66832,449,5,11,3,1,1,5,Casual Users
67031,0,52,159,5,5,5,15,Champions
67624,424,12,33,3,3,3,9,Loyal Users
67650,20,27,94,5,4,4,13,Champions
67898,56,13,52,5,3,3,11,Loyal Users
68207,2574,7,20,1,2,2,5,Lost
68364,669,6,16,2,1,2,5,Lost
69046,125,22,69,4,4,4,12,Champions
69726,570,33,43,2,4,3,9,At Risk
69836,570,10,12,2,2,1,5,Lost
69925,279,19,43,3,3,3,9,Loyal Users
70219,91,7,24,4,2,2,8,Promising
70562,414,24,173,3,4,5,12,Loyal Users
70829,212,62,139,3,5,4,12,Loyal Users
70864,165,9,14,4,2,1,7,Promising
70891,587,5,9,2,1,1,4,Lost
71295,143,14,149,4,3,5,12,Loyal Users
71472,171,39,140,3,4,4,11,Loyal Users
71473,3103,9,79,1,2,4,7,Lost
71931,100,88,193,4,5,5,14,Champions
71937,4780,10,44,1,2,3,6,Lost
71962,654,5,7,2,1,1,4,Lost
72090,344,28,89,3,4,4,11,Loyal Users
72671,452,5,14,3,1,1,5,Casual Users
72984,112,25,80,4,4,4,12,Champions
73568,87,8,11,4,2,1,7,Promising
73629,158,28,163,4,4,5,13,Champions
73719,5273,5,6,1,1,1,3,Lost
73816,319,27,55,3,4,3,10,Loyal Users
73877,9,115,210,5,5,5,15,Champions
74280,367,52,273,3,5,5,13,Loyal Users
74331,171,71,158,3,5,5,13,Loyal Users
74685,896,27,82,2,4,4,10,At Risk
74697,8,231,813,5,5,5,15,Champions
75044,142,53,63,4,5,4,13,Champions
75213,132,40,444,4,4,5,13,Champions
75216,1798,7,10,1,2,1,4,Lost
75480,165,11,17,4,2,2,8,Promising
75492,410,9,11,3,2,1,6,Casual Users
75546,567,20,70,2,3,4,9,Casual Users
75605,1080,9,37,2,2,3,7,Lost
76473,49,54,104,5,5,4,14,Champions
76611,133,18,65,4,3,4,11,Loyal Users
76668,1004,40,172,2,4,5,11,At Risk
76920,132,10,46,4,2,3,9,Promising
77364,131,30,76,4,4,4,12,Champions
77910,146,6,9,4,1,1,6,Promising
78130,0,32,84,5,4,4,13,Champions
78164,835,31,34,2,4,3,9,At Risk
65510,4433,6,30,1,1,2,4,Lost
65628,23,84,178,5,5,5,15,Champions
66014,38,17,119,5,3,4,12,Loyal Users
66064,1103,5,10,2,1,1,4,Lost
66273,951,20,95,2,3,4,9,Casual Users
66923,336,75,221,3,5,5,13,Loyal Users
66992,134,46,256,4,5,5,14,Champions
67424,36,82,408,5,5,5,15,Champions
68238,1366,7,23,1,2,2,5,Lost
68635,3274,8,15,1,2,1,4,Lost
69011,287,22,76,3,4,4,11,Loyal Users
69312,3966,6,11,1,1,1,3,Lost
69676,147,9,24,4,2,2,8,Promising
69865,610,34,348,2,4,5,11,At Risk
70839,1274,13,31,1,3,2,6,Casual Users
71543,411,48,74,3,5,4,12,Loyal Users
71574,634,20,33,2,3,3,8,Casual Users
71640,990,9,13,2,2,1,5,Lost
71653,253,7,32,3,2,3,8,Casual Users
71947,1403,7,9,1,2,1,4,Lost
72343,312,6,20,3,1,2,6,Casual Users
72718,53,8,15,5,2,1,8,Promising
73122,391,93,250,3,5,5,13,Loyal Users
73126,5,51,205,5,5,5,15,Champions
73214,738,9,25,2,2,2,6,Lost
73363,119,123,480,4,5,5,14,Champions
73559,2315,5,10,1,1,1,3,Lost
74071,566,7,7,2,2,1,5,Lost
74213,616,19,39,2,3,3,8,Casual Users
74269,396,13,19,3,3,2,8,Loyal Users
74675,0,8,22,5,2,2,9,Promising
74716,255,5,25,3,1,2,6,Casual Users
75337,5338,9,16,1,2,2,5,Lost
75345,285,21,37,3,3,3,9,Loyal Users
75743,372,30,38,3,4,3,10,Loyal Users
75755,416,14,58,3,3,3,9,Loyal Users
75817,1587,16,49,1,3,3,7,Casual Users
76035,1163,8,12,2,2,1,5,Lost
76188,1042,8,25,2,2,2,6,Lost
76255,970,19,124,2,3,4,9,Casual Users
76285,687,5,7,2,1,1,4,Lost
76405,171,9,18,3,2,2,7,Casual Users
76517,232,19,136,3,3,4,10,Loyal Users
76673,483,14,19,2,3,2,7,Casual Users
76738,27,14,66,5,3,4,12,Loyal Users
76868,129,6,27,4,1,2,7,Promising
77191,2780,5,36,1,1,3,5,Lost
77245,126,9,143,4,2,4,10,Promising
77438,12,86,153,5,5,5,15,Champions
77952,1380,7,11,1,2,1,4,Lost
78052,4624,7,11,1,2,1,4,Lost
65696,74,77,166,4,5,5,14,Champions
65908,414,6,6,3,1,1,5,Casual Users
66147,552,13,24,2,3,2,7,Casual Users
66543,4,13,42,5,3,3,11,Loyal Users
66703,561,13,42,2,3,3,8,Casual Users
66887,83,162,341,4,5,5,14,Champions
67019,119,15,39,4,3,3,10,Loyal Users
68001,77,8,64,4,2,4,10,Promising
68152,521,9,21,2,2,2,6,Lost
68258,177,28,64,3,4,4,11,Loyal Users
68304,412,50,176,3,5,5,13,Loyal Users
68376,86,14,26,4,3,2,9,Loyal Users
68510,7,33,133,5,4,4,13,Champions
69012,545,17,139,2,3,4,9,Casual Users
69152,159,24,60,4,4,3,11,Loyal Users
69593,41,60,81,5,5,4,14,Champions
69655,169,5,27,3,1,2,6,Casual Users
70173,1589,7,12,1,2,1,4,Lost
70291,239,9,17,3,2,2,7,Casual Users
70297,1407,5,58,1,1,3,5,Lost
70541,24,6,9,5,1,1,7,Promising
70571,4011,6,26,1,1,2,4,Lost
70724,28,77,400,5,5,5,15,Champions
70976,587,10,13,2,2,1,5,Lost
71167,8,28,125,5,4,4,13,Champions
71310,3309,5,12,1,1,1,3,Lost
71377,242,21,31,3,3,2,8,Loyal Users
71578,36,38,254,5,4,5,14,Champions
71660,1130,6,6,2,1,1,4,Lost
71745,2016,5,5,1,1,1,3,Lost
71994,4525,8,29,1,2,2,5,Lost
72283,236,12,33,3,3,3,9,Loyal Users
72459,2346,6,6,1,1,1,3,Lost
72611,995,7,7,2,2,1,5,Lost
72687,2968,11,14,1,2,1,4,Lost
72792,5590,12,22,1,3,2,6,Casual Users
73083,826,5,13,2,1,1,4,Lost
73111,860,48,189,2,5,5,12,At Risk
73426,146,24,148,4,4,5,13,Champions
73962,31,93,252,5,5,5,15,Champions
74017,245,23,28,3,4,2,9,Loyal Users
74026,394,12,23,3,3,2,8,Loyal Users
74486,426,30,90,3,4,4,11,Loyal Users
74509,57,30,50,5,4,3,12,Loyal Users
74651,426,31,54,3,4,3,10,Loyal Users
75446,820,16,25,2,3,2,7,Casual Users
75783,30,16,115,5,3,4,12,Loyal Users
75791,691,11,17,2,2,2,6,Lost
75816,246,6,7,3,1,1,5,Casual Users
75849,687,5,5,2,1,1,4,Lost
75899,57,54,116,5,5,4,14,Champions
76448,13,6,9,5,1,1,7,Promising
77351,265,7,7,3,2,1,6,Casual Users
77425,796,6,30,2,1,2,5,Lost
77821,134,38,66,4,4,4,12,Champions
78197,1,57,195,5,5,5,15,Champions
65638,780,7,8,2,2,1,5,Lost
65993,1839,9,25,1,2,2,5,Lost
66234,822,11,29,2,2,2,6,Lost
66480,24,34,68,5,4,4,13,Champions
67055,1858,12,28,1,3,2,6,Casual Users
67082,143,39,65,4,4,4,12,Champions
67203,3303,6,20,1,1,2,4,Lost
67254,261,45,159,3,4,5,12,Loyal Users
67316,105,87,135,4,5,4,13,Champions
67481,10,6,19,5,1,2,8,Promising
67776,8,22,30,5,4,2,11,Loyal Users
67850,234,76,348,3,5,5,13,Loyal Users
68082,333,42,133,3,4,4,11,Loyal Users
68196,3166,6,10,1,1,1,3,Lost
68940,695,17,105,2,3,4,9,Casual Users
68963,2467,10,14,1,2,1,4,Lost
69249,30,30,63,5,4,4,13,Champions
69342,5,41,110,5,4,4,13,Champions
69607,1356,9,9,1,2,1,4,Lost
69995,2904,7,35,1,2,3,6,Lost
70289,102,97,384,4,5,5,14,Champions
70337,254,9,61,3,2,3,8,Casual Users
71231,2588,8,12,1,2,1,4,Lost
71323,3555,6,33,1,1,3,5,Lost
71403,256,66,151,3,5,5,13,Loyal Users
71806,783,7,10,2,2,1,5,Lost
72196,0,154,376,5,5,5,15,Champions
72553,105,80,236,4,5,5,14,Champions
72597,442,45,105,3,4,4,11,Loyal Users
72796,2281,49,212,1,5,5,11,At Risk
73025,276,16,25,3,3,2,8,Loyal Users
73140,3,14,22,5,3,2,10,Loyal Users
73563,2415,8,11,1,2,1,4,Lost
73743,406,7,22,3,2,2,7,Casual Users
73901,1,33,161,5,4,5,14,Champions
73928,7,10,61,5,2,3,10,Promising
74234,1,5,13,5,1,1,7,Promising
74332,5,32,251,5,4,5,14,Champions
74394,709,13,36,2,3,3,8,Casual Users
74453,491,11,39,2,2,3,7,Lost
74504,508,68,150,2,5,5,12,At Risk
75197,34,12,15,5,3,1,9,Loyal Users
75276,3599,14,20,1,3,2,6,Casual Users
75297,992,12,27,2,3,2,7,Casual Users
75461,5260,10,39,1,2,3,6,Lost
75641,454,7,18,3,2,2,7,Casual Users
75693,4704,7,26,1,2,2,5,Lost
75807,621,29,59,2,4,3,9,At Risk
75831,76,72,158,4,5,5,14,Champions
75834,552,7,10,2,2,1,5,Lost
75920,3609,5,7,1,1,1,3,Lost
75982,111,13,82,4,3,4,11,Loyal Users
76195,1599,6,7,1,1,1,3,Lost
76646,719,5,14,2,1,1,4,Lost
77549,1410,5,13,1,1,1,3,Lost
65559,1995,11,38,1,2,3,6,Lost
66030,353,5,45,3,1,3,7,Casual Users
66479,264,20,38,3,3,3,9,Loyal Users
66507,272,49,122,3,5,4,12,Loyal Users
66671,135,28,181,4,4,5,13,Champions
66874,252,13,55,3,3,3,9,Loyal Users
66994,41,17,34,5,3,3,11,Loyal Users
67020,3,35,116,5,4,4,13,Champions
67058,2367,5,29,1,1,2,4,Lost
67080,70,14,36,4,3,3,10,Loyal Users
68136,36,34,138,5,4,4,13,Champions
68279,996,14,85,2,3,4,9,Casual Users
68692,173,87,252,3,5,5,13,Loyal Users
68731,123,67,108,4,5,4,13,Champions
68829,753,15,56,2,3,3,8,Casual Users
68835,1018,6,15,2,1,1,4,Lost
68899,1481,180,591,1,5,5,11,At Risk
68992,112,34,67,4,4,4,12,Champions
69003,78,19,31,4,3,2,9,Loyal Users
69378,1844,15,26,1,3,2,6,Casual Users
69440,123,63,238,4,5,5,14,Champions
69566,515,6,6,2,1,1,4,Lost
69608,54,29,46,5,4,3,12,Loyal Users
69921,3403,29,61,1,4,3,8,At Risk
70241,135,48,133,4,5,4,13,Champions
70578,599,14,97,2,3,4,9,Casual Users
70621,200,38,133,3,4,4,11,Loyal Users
70768,780,36,162,2,4,5,11,At Risk
71366,1528,35,86,1,4,4,9,At Risk
71873,5,42,94,5,4,4,13,Champions
71884,4402,8,10,1,2,1,4,Lost
72117,1172,39,62,2,4,3,9,At Risk
72137,405,66,104,3,5,4,12,Loyal Users
72156,5178,5,10,1,1,1,3,Lost
72384,294,9,19,3,2,2,7,Casual Users
72446,2228,5,12,1,1,1,3,Lost
72653,1324,6,27,1,1,2,4,Lost
72840,19,60,155,5,5,5,15,Champions
72913,223,176,772,3,5,5,13,Loyal Users
73749,632,10,34,2,2,3,7,Lost
74170,850,6,17,2,1,2,5,Lost
74174,3717,17,17,1,3,2,6,Casual Users
74184,139,6,38,4,1,3,8,Promising
74272,1015,16,27,2,3,2,7,Casual Users
74511,2,90,179,5,5,5,15,Champions
74733,878,8,12,2,2,1,5,Lost
74843,60,53,161,5,5,5,15,Champions
74863,1972,5,12,1,1,1,3,Lost
75132,101,14,106,4,3,4,11,Loyal Users
75918,1822,5,8,1,1,1,3,Lost
76023,1279,6,14,1,1,1,3,Lost
76084,4427,7,27,1,2,2,5,Lost
76476,803,14,46,2,3,3,8,Casual Users
76507,2300,5,5,1,1,1,3,Lost
76660,440,34,108,3,4,4,11,Loyal Users
77820,4955,6,19,1,1,2,4,Lost
77987,85,93,411,4,5,5,14,Champions
78007,24,39,63,5,4,4,13,Champions
65444,129,34,92,4,4,4,12,Champions
65483,4304,8,13,1,2,1,4,Lost
65691,549,6,19,2,1,2,5,Lost
65890,86,39,94,4,4,4,12,Champions
66043,25,33,71,5,4,4,13,Champions
66109,7,135,746,5,5,5,15,Champions
66438,1733,5,12,1,1,1,3,Lost
66525,4617,10,20,1,2,2,5,Lost
66888,115,53,217,4,5,5,14,Champions
66936,105,84,1079,4,5,5,14,Champions
67024,409,67,294,3,5,5,13,Loyal Users
67047,127,62,75,4,5,4,13,Champions
67145,100,43,134,4,4,4,12,Champions
67526,76,49,215,4,5,5,14,Champions
67669,3513,7,32,1,2,3,6,Lost
67811,104,102,490,4,5,5,14,Champions
68141,68,97,454,5,5,5,15,Champions
68190,1489,8,10,1,2,1,4,Lost
68245,118,14,23,4,3,2,9,Loyal Users
68453,324,58,78,3,5,4,12,Loyal Users
68930,947,5,9,2,1,1,4,Lost
69289,2142,9,12,1,2,1,4,Lost
69555,44,42,171,5,4,5,14,Champions
69698,3164,6,11,1,1,1,3,Lost
69956,275,10,50,3,2,3,8,Casual Users
70000,616,10,42,2,2,3,7,Lost
70306,426,103,313,3,5,5,13,Loyal Users
70551,24,102,527,5,5,5,15,Champions
70760,1422,14,23,1,3,2,6,Casual Users
70937,1614,9,14,1,2,1,4,Lost
71956,3238,5,5,1,1,1,3,Lost
72222,393,12,17,3,3,2,8,Loyal Users
72269,15,43,55,5,4,3,12,Loyal Users
72338,134,19,24,4,3,2,9,Loyal Users
72742,230,8,9,3,2,1,6,Casual Users
72791,17,54,120,5,5,4,14,Champions
72825,962,11,16,2,2,2,6,Lost
72948,1053,16,25,2,3,2,7,Casual Users
73210,371,15,38,3,3,3,9,Loyal Users
73395,65,14,20,5,3,2,10,Loyal Users
73479,0,42,152,5,4,5,14,Champions
73531,307,13,24,3,3,2,8,Loyal Users
73544,107,10,25,4,2,2,8,Promising
73822,449,53,376,3,5,5,13,Loyal Users
74351,16,149,440,5,5,5,15,Champions
74357,65,37,244,5,4,5,14,Champions
74524,994,49,97,2,5,4,11,At Risk
74539,1349,5,5,1,1,1,3,Lost
74765,9,151,624,5,5,5,15,Champions
74777,121,6,13,4,1,1,6,Promising
75140,408,7,11,3,2,1,6,Casual Users
75957,653,22,117,2,4,4,10,At Risk
76130,8,24,38,5,4,3,12,Loyal Users
76267,243,34,135,3,4,4,11,Loyal Users
76358,120,24,38,4,4,3,11,Loyal Users
76396,377,11,77,3,2,4,9,Casual Users
76572,134,8,19,4,2,2,8,Promising
76972,391,19,95,3,3,4,10,Loyal Users
77009,344,16,45,3,3,3,9,Loyal Users
77139,1657,7,8,1,2,1,4,Lost
77161,286,16,27,3,3,2,8,Loyal Users
77405,3704,24,88,1,4,4,9,At Risk
77440,3491,11,21,1,2,2,5,Lost
77506,2544,5,12,1,1,1,3,Lost
77691,57,59,122,5,5,4,14,Champions
77738,209,31,98,3,4,4,11,Loyal Users
77905,4706,6,17,1,1,2,4,Lost
78063,84,9,12,4,2,1,7,Promising
78081,13,15,72,5,3,4,12,Loyal Users
78252,123,7,20,4,2,2,8,Promising
65817,13,79,212,5,5,5,15,Champions
66117,402,6,20,3,1,2,6,Casual Users
66417,122,10,45,4,2,3,9,Promising
66493,60,236,558,5,5,5,15,Champions
67319,263,49,119,3,5,4,12,Loyal Users
67356,740,13,21,2,3,2,7,Casual Users
67535,78,27,48,4,4,3,11,Loyal Users
67987,858,14,30,2,3,2,7,Casual Users
68149,5,8,22,5,2,2,9,Promising
68165,1269,25,66,1,4,4,9,At Risk
68200,34,28,32,5,4,3,12,Loyal Users
68208,1541,19,81,1,3,4,8,Casual Users
68404,260,17,34,3,3,3,9,Loyal Users
68637,16,72,482,5,5,5,15,Champions
68691,568,35,51,2,4,3,9,At Risk
68726,413,15,22,3,3,2,8,Loyal Users
69322,10,53,244,5,5,5,15,Champions
69448,2079,8,13,1,2,1,4,Lost
69531,13,111,242,5,5,5,15,Champions
69624,463,11,13,3,2,1,6,Casual Users
70148,929,7,11,2,2,1,5,Lost
70496,31,138,428,5,5,5,15,Champions
70559,27,15,18,5,3,2,10,Loyal Users
70831,38,31,48,5,4,3,12,Loyal Users
70979,208,51,171,3,5,5,13,Loyal Users
71092,374,26,69,3,4,4,11,Loyal Users
71108,37,85,180,5,5,5,15,Champions
71335,1621,6,115,1,1,4,6,Lost
71676,108,73,392,4,5,5,14,Champions
71796,96,40,117,4,4,4,12,Champions
71991,70,9,14,4,2,1,7,Promising
72573,384,9,40,3,2,3,8,Casual Users
72589,990,24,48,2,4,3,9,At Risk
72944,82,38,134,4,4,4,12,Champions
73273,51,52,137,5,5,4,14,Champions
73418,1399,10,26,1,2,2,5,Lost
73608,1633,10,59,1,2,3,6,Lost
73767,12,85,595,5,5,5,15,Champions
73785,805,6,14,2,1,1,4,Lost
73812,4255,5,14,1,1,1,3,Lost
74228,3813,10,13,1,2,1,4,Lost
74334,5,66,112,5,5,4,14,Champions
74371,625,13,19,2,3,2,7,Casual Users
74648,956,11,42,2,2,3,7,Lost
74745,2775,8,13,1,2,1,4,Lost
74936,1553,9,10,1,2,1,4,Lost
74968,3626,5,24,1,1,2,4,Lost
75110,152,51,132,4,5,4,13,Champions
76331,406,12,44,3,3,3,9,Loyal Users
76610,3562,46,286,1,5,5,11,At Risk
76819,603,25,72,2,4,4,10,At Risk
77053,740,12,70,2,3,4,9,Casual Users
77112,368,6,6,3,1,1,5,Casual Users
77558,17,56,280,5,5,5,15,Champions
77609,137,46,210,4,5,5,14,Champions
77611,689,17,36,2,3,3,8,Casual Users
77997,4978,6,10,1,1,1,3,Lost
78017,211,7,9,3,2,1,6,Casual Users
78029,46,106,206,5,5,5,15,Champions
78238,244,16,25,3,3,2,8,Loyal Users
66019,17,100,271,5,5,5,15,Champions
66677,583,38,108,2,4,4,10,At Risk
66690,218,13,24,3,3,2,8,Loyal Users
66856,265,7,31,3,2,2,7,Casual Users
66965,674,40,98,2,4,4,10,At Risk
67381,1570,14,24,1,3,2,6,Casual Users
67480,297,14,28,3,3,2,8,Loyal Users
67547,33,150,246,5,5,5,15,Champions
67598,1523,22,59,1,4,3,8,At Risk
67613,540,7,8,2,2,1,5,Lost
67809,419,14,57,3,3,3,9,Loyal Users
67967,2262,14,23,1,3,2,6,Casual Users
68244,118,74,420,4,5,5,14,Champions
68298,1716,6,13,1,1,1,3,Lost
68337,2478,5,17,1,1,2,4,Lost
68464,102,6,13,4,1,1,6,Promising
68742,24,34,47,5,4,3,12,Loyal Users
68810,35,38,85,5,4,4,13,Champions
69030,0,26,35,5,4,3,12,Loyal Users
69286,434,11,109,3,2,4,9,Casual Users
69308,227,9,49,3,2,3,8,Casual Users
69560,131,15,102,4,3,4,11,Loyal Users
70137,3083,6,13,1,1,1,3,Lost
70647,424,21,78,3,3,4,10,Loyal Users
71237,99,16,60,4,3,3,10,Loyal Users
71583,3409,7,88,1,2,4,7,Lost
71694,5696,6,36,1,1,3,5,Lost
71790,141,29,120,4,4,4,12,Champions
71935,2,69,190,5,5,5,15,Champions
71961,98,11,28,4,2,2,8,Promising
72047,567,7,9,2,2,1,5,Lost
72064,54,58,153,5,5,5,15,Champions
72130,2023,26,90,1,4,4,9,At Risk
72157,104,176,674,4,5,5,14,Champions
72180,426,39,86,3,4,4,11,Loyal Users
72304,134,24,52,4,4,3,11,Loyal Users
72332,275,21,45,3,3,3,9,Loyal Users
73154,96,15,32,4,3,3,10,Loyal Users
73160,156,22,29,4,4,2,10,Loyal Users
73198,2,134,278,5,5,5,15,Champions
73354,3830,7,11,1,2,1,4,Lost
73611,3581,5,6,1,1,1,3,Lost
73770,131,11,41,4,2,3,9,Promising
74395,1422,7,12,1,2,1,4,Lost
74599,1509,5,14,1,1,1,3,Lost
74668,121,14,28,4,3,2,9,Loyal Users
74866,12,37,65,5,4,4,13,Champions
74941,592,7,59,2,2,3,7,Lost
75021,1864,11,12,1,2,1,4,Lost
75141,328,30,133,3,4,4,11,Loyal Users
75358,1646,6,15,1,1,1,3,Lost
75397,1107,6,9,2,1,1,4,Lost
75832,144,14,21,4,3,2,9,Loyal Users
75892,2471,5,6,1,1,1,3,Lost
76009,504,11,41,2,2,3,7,Lost
76118,3699,7,38,1,2,3,6,Lost
76298,265,12,27,3,3,2,8,Loyal Users
76884,1890,32,72,1,4,4,9,At Risk
77123,1,37,139,5,4,4,13,Champions
77220,550,6,19,2,1,2,5,Lost
77280,131,58,152,4,5,5,14,Champions
77316,1,20,27,5,3,2,10,Loyal Users
77427,1748,5,11,1,1,1,3,Lost
77459,149,10,23,4,2,2,8,Promising
78048,116,24,137,4,4,4,12,Champions
65972,1079,12,21,2,3,2,7,Casual Users
66184,2652,8,74,1,2,4,7,Lost
66404,580,20,33,2,3,3,8,Casual Users
66457,1989,6,15,1,1,1,3,Lost
66540,421,5,6,3,1,1,5,Casual Users
67101,106,137,260,4,5,5,14,Champions
67308,310,35,120,3,4,4,11,Loyal Users
67358,52,36,98,5,4,4,13,Champions
67512,959,12,20,2,3,2,7,Casual Users
67570,1257,8,22,2,2,2,6,Lost
67596,2,18,22,5,3,2,10,Loyal Users
67626,33,38,123,5,4,4,13,Champions
67958,222,25,43,3,4,3,10,Loyal Users
68391,695,28,47,2,4,3,9,At Risk
68402,1978,9,49,1,2,3,6,Lost
68965,164,20,50,4,3,3,10,Loyal Users
68977,69,53,642,5,5,5,15,Champions
69113,147,8,12,4,2,1,7,Promising
70157,315,14,58,3,3,3,9,Loyal Users
70315,4762,19,84,1,3,4,8,Casual Users
70390,221,70,271,3,5,5,13,Loyal Users
70418,150,15,54,4,3,3,10,Loyal Users
70464,655,17,53,2,3,3,8,Casual Users
70488,963,11,42,2,2,3,7,Lost
70990,155,68,128,4,5,4,13,Champions
71125,357,10,31,3,2,2,7,Casual Users
71563,407,23,37,3,4,3,10,Loyal Users
71656,524,14,43,2,3,3,8,Casual Users
71691,289,9,27,3,2,2,7,Casual Users
71872,1561,32,63,1,4,4,9,At Risk
72037,741,5,5,2,1,1,4,Lost
72239,2164,9,24,1,2,2,5,Lost
72437,14,5,9,5,1,1,7,Promising
73081,71,50,349,4,5,5,14,Champions
73209,79,19,63,4,3,4,11,Loyal Users
73279,851,8,47,2,2,3,7,Lost
73484,1419,9,25,1,2,2,5,Lost
73806,2269,6,11,1,1,1,3,Lost
73890,142,11,30,4,2,2,8,Promising
74288,834,9,25,2,2,2,6,Lost
74447,545,32,84,2,4,4,10,At Risk
74532,543,19,49,2,3,3,8,Casual Users
74607,287,17,72,3,3,4,10,Loyal Users
74937,1008,14,60,2,3,3,8,Casual Users
75139,412,13,29,3,3,2,8,Loyal Users
75148,36,25,97,5,4,4,13,Champions
75351,8,17,40,5,3,3,11,Loyal Users
75806,293,21,28,3,3,2,8,Loyal Users
76548,3315,8,14,1,2,1,4,Lost
76841,173,31,90,3,4,4,11,Loyal Users
76958,4,62,177,5,5,5,15,Champions
77136,2,11,22,5,2,2,9,Promising
77181,267,44,107,3,4,4,11,Loyal Users
77365,3055,5,7,1,1,1,3,Lost
77554,111,55,97,4,5,4,13,Champions
78151,79,132,227,4,5,5,14,Champions
78213,17,45,73,5,4,4,13,Champions
78279,867,6,17,2,1,2,5,Lost
65516,107,10,53,4,2,3,9,Promising
65913,777,30,44,2,4,3,9,At Risk
66258,447,5,47,3,1,3,7,Casual Users
66476,409,5,40,3,1,3,7,Casual Users
66536,495,5,9,2,1,1,4,Lost
66588,1635,12,65,1,3,4,8,Casual Users
66701,72,44,128,4,4,4,12,Champions
66732,168,23,84,3,4,4,11,Loyal Users
66762,12,25,146,5,4,4,13,Champions
66795,73,37,179,4,4,5,13,Champions
66894,350,34,55,3,4,3,10,Loyal Users
66982,19,7,13,5,2,1,8,Promising
67017,98,32,104,4,4,4,12,Champions
67177,1566,13,113,1,3,4,8,Casual Users
67386,27,33,42,5,4,3,12,Loyal Users
67758,107,76,299,4,5,5,14,Champions
68134,814,6,10,2,1,1,4,Lost
68248,1879,15,22,1,3,2,6,Casual Users
68421,138,33,56,4,4,3,11,Loyal Users
68559,57,10,23,5,2,2,9,Promising
68662,48,30,70,5,4,4,13,Champions
69245,1278,14,46,1,3,3,7,Casual Users
69477,128,23,104,4,4,4,12,Champions
69585,415,98,332,3,5,5,13,Loyal Users
69627,20,113,421,5,5,5,15,Champions
69694,225,19,24,3,3,2,8,Loyal Users
69756,113,16,67,4,3,4,11,Loyal Users
69919,969,6,9,2,1,1,4,Lost
70179,1980,7,8,1,2,1,4,Lost
70386,141,31,71,4,4,4,12,Champions
70436,3607,11,20,1,2,2,5,Lost
70586,834,22,163,2,4,5,11,At Risk
70691,196,12,12,3,3,1,7,Loyal Users
70763,699,13,21,2,3,2,7,Casual Users
70771,708,27,77,2,4,4,10,At Risk
70820,724,10,26,2,2,2,6,Lost
70933,5759,10,10,1,2,1,4,Lost
71019,169,83,255,3,5,5,13,Loyal Users
71043,128,12,13,4,3,1,8,Loyal Users
71172,8,129,363,5,5,5,15,Champions
71339,145,38,79,4,4,4,12,Champions
71487,845,9,19,2,2,2,6,Lost
71617,217,20,154,3,3,5,11,Loyal Users
71938,246,18,59,3,3,3,9,Loyal Users
72234,293,30,63,3,4,4,11,Loyal Users
72581,124,61,76,4,5,4,13,Champions
72591,115,21,80,4,3,4,11,Loyal Users
72596,128,30,55,4,4,3,11,Loyal Users
72868,224,50,174,3,5,5,13,Loyal Users
73056,31,109,148,5,5,5,15,Champions
73177,3329,5,5,1,1,1,3,Lost
73188,666,9,27,2,2,2,6,Lost
73246,1,38,128,5,4,4,13,Champions
73300,252,16,49,3,3,3,9,Loyal Users
73327,101,117,161,4,5,5,14,Champions
73398,19,32,99,5,4,4,13,Champions
73576,709,10,11,2,2,1,5,Lost
73809,13,33,107,5,4,4,13,Champions
74216,358,13,37,3,3,3,9,Loyal Users
74436,417,11,19,3,2,2,7,Casual Users
74696,285,26,102,3,4,4,11,Loyal Users
74956,805,12,49,2,3,3,8,Casual Users
75034,947,16,38,2,3,3,8,Casual Users
75074,2025,5,7,1,1,1,3,Lost
75424,126,13,70,4,3,4,11,Loyal Users
75493,1457,10,35,1,2,3,6,Lost
75510,283,19,30,3,3,2,8,Loyal Users
75803,388,17,29,3,3,2,8,Loyal Users
75908,1011,7,23,2,2,2,6,Lost
75967,53,117,360,5,5,5,15,Champions
75981,246,6,9,3,1,1,5,Casual Users
76264,167,59,124,3,5,4,12,Loyal Users
76342,655,14,42,2,3,3,8,Casual Users
76343,545,26,42,2,4,3,9,At Risk
76562,5447,5,10,1,1,1,3,Lost
76578,440,14,20,3,3,2,8,Loyal Users
76750,127,16,27,4,3,2,9,Loyal Users
76912,30,134,337,5,5,5,15,Champions
77348,394,22,102,3,4,4,11,Loyal Users
77746,228,61,168,3,5,5,13,Loyal Users
77748,422,55,205,3,5,5,13,Loyal Users
77751,1117,23,37,2,4,3,9,At Risk
77795,428,43,381,3,4,5,12,Loyal Users
78010,240,81,249,3,5,5,13,Loyal Users
78226,1990,5,11,1,1,1,3,Lost
65828,286,9,15,3,2,1,6,Casual Users
65926,2071,15,37,1,3,3,7,Casual Users
66001,0,56,88,5,5,4,14,Champions
66436,777,16,38,2,3,3,8,Casual Users
66474,3087,19,28,1,3,2,6,Casual Users
66487,2631,7,35,1,2,3,6,Lost
66571,0,6,14,5,1,1,7,Promising
66620,5,120,381,5,5,5,15,Champions
66803,1168,9,51,2,2,3,7,Lost
67009,20,8,16,5,2,2,9,Promising
67252,103,81,213,4,5,5,14,Champions
67508,119,11,76,4,2,4,10,Promising
67627,3343,5,5,1,1,1,3,Lost
67835,1380,11,21,1,2,2,5,Lost
67849,136,17,141,4,3,4,11,Loyal Users
67882,1111,18,58,2,3,3,8,Casual Users
67886,31,82,405,5,5,5,15,Champions
67903,1281,9,111,1,2,4,7,Lost
68472,15,5,9,5,1,1,7,Promising
68504,468,14,20,3,3,2,8,Loyal Users
68686,14,9,22,5,2,2,9,Promising
68943,1554,5,9,1,1,1,3,Lost
69519,5376,5,12,1,1,1,3,Lost
69728,140,26,110,4,4,4,12,Champions
70038,5,169,397,5,5,5,15,Champions
70110,1518,11,54,1,2,3,6,Lost
70316,181,90,157,3,5,5,13,Loyal Users
70333,3465,6,6,1,1,1,3,Lost
70399,2114,6,22,1,1,2,4,Lost
70458,25,63,156,5,5,5,15,Champions
70506,1842,14,23,1,3,2,6,Casual Users
70612,313,52,105,3,5,4,12,Loyal Users
70639,11,61,120,5,5,4,14,Champions
70961,146,10,22,4,2,2,8,Promising
70969,1697,5,5,1,1,1,3,Lost
71145,2043,7,10,1,2,1,4,Lost
71285,1423,10,22,1,2,2,5,Lost
71476,157,48,84,4,5,4,13,Champions
71840,181,11,21,3,2,2,7,Casual Users
71845,270,8,30,3,2,2,7,Casual Users
72181,79,31,94,4,4,4,12,Champions
72372,1000,21,44,2,3,3,8,Casual Users
72495,286,7,18,3,2,2,7,Casual Users
72517,826,16,39,2,3,3,8,Casual Users
72560,367,11,24,3,2,2,7,Casual Users
72919,242,7,16,3,2,2,7,Casual Users
73196,149,27,132,4,4,4,12,Champions
73401,16,79,314,5,5,5,15,Champions
73499,4992,11,52,1,2,3,6,Lost
73658,151,35,204,4,4,5,13,Champions
73672,90,16,38,4,3,3,10,Loyal Users
73718,719,11,40,2,2,3,7,Lost
73737,327,27,44,3,4,3,10,Loyal Users
74117,2537,9,21,1,2,2,5,Lost
74128,688,6,14,2,1,1,4,Lost
74341,268,7,7,3,2,1,6,Casual Users
74382,876,23,126,2,4,4,10,At Risk
74421,542,8,13,2,2,1,5,Lost
74444,104,51,115,4,5,4,13,Champions
74575,171,33,130,3,4,4,11,Loyal Users
74774,2949,5,5,1,1,1,3,Lost
75447,13,38,92,5,4,4,13,Champions
75874,2914,5,6,1,1,1,3,Lost
75990,103,7,13,4,2,1,7,Promising
76559,52,19,51,5,3,3,11,Loyal Users
77359,2,39,75,5,4,4,13,Champions
77980,28,20,45,5,3,3,11,Loyal Users
78117,4284,14,35,1,3,3,7,Casual Users
65435,85,5,44,4,1,3,8,Promising
65617,1674,10,10,1,2,1,4,Lost
65677,23,11,86,5,2,4,11,Promising
65948,393,7,11,3,2,1,6,Casual Users
65987,423,7,33,3,2,3,8,Casual Users
66070,11,25,56,5,4,3,12,Loyal Users
66235,544,16,36,2,3,3,8,Casual Users
66934,1383,5,7,1,1,1,3,Lost
67045,48,6,15,5,1,1,7,Promising
67201,721,8,16,2,2,2,6,Lost
67229,207,19,36,3,3,3,9,Loyal Users
67303,838,18,28,2,3,2,7,Casual Users
67601,15,19,43,5,3,3,11,Loyal Users
67714,95,19,30,4,3,2,9,Loyal Users
67745,853,7,9,2,2,1,5,Lost
67872,143,72,182,4,5,5,14,Champions
67971,489,8,12,2,2,1,5,Lost
68531,4862,8,10,1,2,1,4,Lost
68562,688,6,45,2,1,3,6,Lost
68570,968,8,29,2,2,2,6,Lost
68580,2014,5,8,1,1,1,3,Lost
69027,509,32,157,2,4,5,11,At Risk
69202,141,28,66,4,4,4,12,Champions
69542,4,9,10,5,2,1,8,Promising
70711,58,86,969,5,5,5,15,Champions
70756,23,40,328,5,4,5,14,Champions
70849,1089,8,14,2,2,1,5,Lost
71229,407,32,63,3,4,4,11,Loyal Users
71479,34,97,399,5,5,5,15,Champions
71588,327,6,19,3,1,2,6,Casual Users
71621,71,8,13,4,2,1,7,Promising
71673,776,13,75,2,3,4,9,Casual Users
71698,292,13,25,3,3,2,8,Loyal Users
71723,530,30,59,2,4,3,9,At Risk
72215,850,5,50,2,1,3,6,Lost
72285,55,62,218,5,5,5,15,Champions
72333,2987,14,14,1,3,1,5,Casual Users
72365,699,12,27,2,3,2,7,Casual Users
72400,719,5,6,2,1,1,4,Lost
72640,37,40,206,5,4,5,14,Champions
72776,4149,5,5,1,1,1,3,Lost
72918,408,10,10,3,2,1,6,Casual Users
73104,920,15,30,2,3,2,7,Casual Users
73463,4511,9,14,1,2,1,4,Lost
73825,287,6,10,3,1,1,5,Casual Users
74014,4394,6,8,1,1,1,3,Lost
74060,1057,16,56,2,3,3,8,Casual Users
74142,330,12,14,3,3,1,7,Loyal Users
74494,246,15,35,3,3,3,9,Loyal Users
74620,1371,16,29,1,3,2,6,Casual Users
74808,203,35,51,3,4,3,10,Loyal Users
74919,809,6,10,2,1,1,4,Lost
74964,798,5,5,2,1,1,4,Lost
74973,92,10,22,4,2,2,8,Promising
75214,23,86,197,5,5,5,15,Champions
75443,74,12,13,4,3,1,8,Loyal Users
75472,20,72,223,5,5,5,15,Champions
75481,195,11,105,3,2,4,9,Casual Users
75559,1989,7,7,1,2,1,4,Lost
75923,3135,11,14,1,2,1,4,Lost
76018,391,49,220,3,5,5,13,Loyal Users
76186,8,144,315,5,5,5,15,Champions
76233,742,5,19,2,1,2,5,Lost
76317,398,16,31,3,3,2,8,Loyal Users
76389,128,85,362,4,5,5,14,Champions
76528,54,8,12,5,2,1,8,Promising
76806,1787,21,52,1,3,3,7,Casual Users
76848,626,65,226,2,5,5,12,At Risk
77070,3417,7,20,1,2,2,5,Lost
77121,1427,6,19,1,1,2,4,Lost
77244,156,35,141,4,4,4,12,Champions
77495,1305,7,66,1,2,4,7,Lost
77734,1123,32,125,2,4,4,10,At Risk
65447,13,60,301,5,5,5,15,Champions
65674,329,8,11,3,2,1,6,Casual Users
65802,15,160,521,5,5,5,15,Champions
65803,1857,10,45,1,2,3,6,Lost
65997,1731,10,21,1,2,2,5,Lost
66223,6,53,73,5,5,4,14,Champions
66660,4137,6,6,1,1,1,3,Lost
67029,132,25,33,4,4,3,11,Loyal Users
67150,303,7,14,3,2,1,6,Casual Users
67969,10,142,428,5,5,5,15,Champions
67989,120,83,283,4,5,5,14,Champions
68357,2,64,125,5,5,4,14,Champions
68375,420,6,14,3,1,1,5,Casual Users
68546,99,21,67,4,3,4,11,Loyal Users
68736,31,62,247,5,5,5,15,Champions
68749,174,33,55,3,4,3,10,Loyal Users
68797,35,106,323,5,5,5,15,Champions
68800,92,11,86,4,2,4,10,Promising
69121,0,62,180,5,5,5,15,Champions
69633,119,10,29,4,2,2,8,Promising
69699,45,11,15,5,2,1,8,Promising
69807,983,14,46,2,3,3,8,Casual Users
69983,1046,7,7,2,2,1,5,Lost
70133,30,7,54,5,2,3,10,Promising
70494,143,7,7,4,2,1,7,Promising
70616,137,77,282,4,5,5,14,Champions
70620,684,22,141,2,4,4,10,At Risk
70772,1148,24,60,2,4,3,9,At Risk
70794,289,5,50,3,1,3,7,Casual Users
70931,94,163,408,4,5,5,14,Champions
71827,422,8,8,3,2,1,6,Casual Users
72292,11,125,532,5,5,5,15,Champions
72382,140,6,13,4,1,1,6,Promising
72528,698,37,97,2,4,4,10,At Risk
72603,530,6,22,2,1,2,5,Lost
72772,0,68,107,5,5,4,14,Champions
72886,25,24,123,5,4,4,13,Champions
73206,4,50,326,5,5,5,15,Champions
73537,1080,7,17,2,2,2,6,Lost
73795,244,39,66,3,4,4,11,Loyal Users
73914,180,10,20,3,2,2,7,Casual Users
74088,1550,16,78,1,3,4,8,Casual Users
74292,398,16,50,3,3,3,9,Loyal Users
74449,268,11,14,3,2,1,6,Casual Users
74718,1174,11,21,2,2,2,6,Lost
74817,1288,10,20,1,2,2,5,Lost
76165,13,57,160,5,5,5,15,Champions
76218,49,86,292,5,5,5,15,Champions
76295,3399,5,17,1,1,2,4,Lost
76424,275,94,158,3,5,5,13,Loyal Users
76569,67,115,459,5,5,5,15,Champions
77096,106,6,8,4,1,1,6,Promising
77690,126,50,86,4,5,4,13,Champions
65481,292,7,19,3,2,2,7,Casual Users
65605,123,35,99,4,4,4,12,Champions
65720,4050,7,9,1,2,1,4,Lost
66309,755,22,67,2,4,4,10,At Risk
66380,3155,7,7,1,2,1,4,Lost
66413,15,48,256,5,5,5,15,Champions
66790,408,6,26,3,1,2,6,Casual Users
66877,4581,5,6,1,1,1,3,Lost
67344,428,24,38,3,4,3,10,Loyal Users
67546,789,17,28,2,3,2,7,Casual Users
67564,111,82,287,4,5,5,14,Champions
67662,278,13,26,3,3,2,8,Loyal Users
68199,90,8,47,4,2,3,9,Promising
68257,1378,13,34,1,3,3,7,Casual Users
68661,5910,6,7,1,1,1,3,Lost
68888,858,11,28,2,2,2,6,Lost
68926,133,27,76,4,4,4,12,Champions
69017,57,75,214,5,5,5,15,Champions
69690,1506,10,14,1,2,1,4,Lost
70123,508,9,25,2,2,2,6,Lost
70217,102,47,234,4,5,5,14,Champions
70595,48,97,128,5,5,4,14,Champions
70596,1,59,96,5,5,4,14,Champions
70682,1286,139,526,1,5,5,11,At Risk
71058,928,27,49,2,4,3,9,At Risk
71398,151,49,82,4,5,4,13,Champions
71537,143,47,183,4,5,5,14,Champions
71549,4227,7,23,1,2,2,5,Lost
71553,49,24,50,5,4,3,12,Loyal Users
71720,68,103,622,5,5,5,15,Champions
71999,155,21,69,4,3,4,11,Loyal Users
72600,214,13,107,3,3,4,10,Loyal Users
72817,3,110,323,5,5,5,15,Champions
72953,370,11,39,3,2,3,8,Casual Users
73062,2458,21,51,1,3,3,7,Casual Users
73380,3631,8,11,1,2,1,4,Lost
73468,1137,9,14,2,2,1,5,Lost
73565,2565,8,13,1,2,1,4,Lost
73716,20,39,212,5,4,5,14,Champions
73887,657,7,10,2,2,1,5,Lost
74018,2404,5,10,1,1,1,3,Lost
74076,259,54,196,3,5,5,13,Loyal Users
74257,56,21,23,5,3,2,10,Loyal Users
74276,5210,6,10,1,1,1,3,Lost
74566,58,85,380,5,5,5,15,Champions
75037,3672,139,219,1,5,5,11,At Risk
75556,4,93,312,5,5,5,15,Champions
75873,853,18,38,2,3,3,8,Casual Users
76306,13,22,49,5,4,3,12,Loyal Users
76576,20,12,24,5,3,2,10,Loyal Users
76627,282,17,27,3,3,2,8,Loyal Users
76784,2,44,97,5,4,4,13,Champions
77178,213,24,71,3,4,4,11,Loyal Users
77394,543,5,18,2,1,2,5,Lost
77566,125,68,139,4,5,4,13,Champions
78034,484,6,15,2,1,1,4,Lost
78036,73,57,159,4,5,5,14,Champions
66318,87,107,830,4,5,5,14,Champions
66490,180,24,118,3,4,4,11,Loyal Users
66730,15,146,222,5,5,5,15,Champions
66867,2012,28,33,1,4,3,8,At Risk
67109,130,44,111,4,4,4,12,Champions
67192,87,28,107,4,4,4,12,Champions
67249,2118,8,13,1,2,1,4,Lost
67391,416,8,15,3,2,1,6,Casual Users
67644,120,21,74,4,3,4,11,Loyal Users
67836,402,10,13,3,2,1,6,Casual Users
68554,114,8,9,4,2,1,7,Promising
68564,1087,32,116,2,4,4,10,At Risk
69031,553,7,35,2,2,3,7,Lost
69334,479,10,13,2,2,1,5,Lost
69534,3295,5,10,1,1,1,3,Lost
69875,2,22,57,5,4,3,12,Loyal Users
69923,77,6,25,4,1,2,7,Promising
70185,3141,5,20,1,1,2,4,Lost
70564,284,55,109,3,5,4,12,Loyal Users
70626,431,14,17,3,3,2,8,Loyal Users
70869,226,32,113,3,4,4,11,Loyal Users
71174,96,36,150,4,4,5,13,Champions
71337,294,10,28,3,2,2,7,Casual Users
71475,134,5,7,4,1,1,6,Promising
71761,94,40,342,4,4,5,13,Champions
71849,1077,13,18,2,3,2,7,Casual Users
72465,335,21,78,3,3,4,10,Loyal Users
72715,1802,5,37,1,1,3,5,Lost
73181,106,16,23,4,3,2,9,Loyal Users
73240,309,27,44,3,4,3,10,Loyal Users
73670,725,11,17,2,2,2,6,Lost
73679,156,10,13,4,2,1,7,Promising
73902,286,14,37,3,3,3,9,Loyal Users
74194,3135,8,10,1,2,1,4,Lost
74773,8,19,38,5,3,3,11,Loyal Users
75088,127,13,33,4,3,3,10,Loyal Users
75163,14,64,301,5,5,5,15,Champions
75182,1995,12,26,1,3,2,6,Casual Users
75332,4794,11,12,1,2,1,4,Lost
75392,1727,7,9,1,2,1,4,Lost
75485,860,44,82,2,4,4,10,At Risk
75609,1247,12,58,2,3,3,8,Casual Users
75786,4627,6,51,1,1,3,5,Lost
75980,2068,22,33,1,4,3,8,At Risk
76238,3323,7,11,1,2,1,4,Lost
76287,2562,6,9,1,1,1,3,Lost
76337,117,18,56,4,3,3,10,Loyal Users
76556,504,18,37,2,3,3,8,Casual Users
76643,263,45,65,3,4,4,11,Loyal Users
76872,20,57,113,5,5,4,14,Champions
76881,4146,6,6,1,1,1,3,Lost
76985,735,6,18,2,1,2,5,Lost
77552,325,17,72,3,3,4,10,Loyal Users
77656,135,28,39,4,4,3,11,Loyal Users
77658,127,23,62,4,4,3,11,Loyal Users
77680,1428,26,77,1,4,4,9,At Risk
77692,729,19,94,2,3,4,9,Casual Users
78189,108,35,72,4,4,4,12,Champions
65534,283,31,88,3,4,4,11,Loyal Users
65959,37,14,25,5,3,2,10,Loyal Users
66162,2733,14,63,1,3,4,8,Casual Users
66626,5100,5,19,1,1,2,4,Lost
67011,537,20,41,2,3,3,8,Casual Users
67509,3400,6,36,1,1,3,5,Lost
67543,239,6,6,3,1,1,5,Casual Users
67589,209,87,151,3,5,5,13,Loyal Users
67679,640,6,10,2,1,1,4,Lost
67766,10,96,582,5,5,5,15,Champions
67893,2139,5,9,1,1,1,3,Lost
67907,2258,10,52,1,2,3,6,Lost
68070,124,13,65,4,3,4,11,Loyal Users
68093,1347,23,52,1,4,3,8,At Risk
68287,3673,18,45,1,3,3,7,Casual Users
68339,3778,6,6,1,1,1,3,Lost
68861,32,15,20,5,3,2,10,Loyal Users
69460,14,80,123,5,5,4,14,Champions
69671,112,9,36,4,2,3,9,Promising
69684,108,20,65,4,3,4,11,Loyal Users
69747,405,17,46,3,3,3,9,Loyal Users
70014,158,21,55,4,3,3,10,Loyal Users
70092,710,33,65,2,4,4,10,At Risk
70404,594,14,37,2,3,3,8,Casual Users
70537,454,24,93,3,4,4,11,Loyal Users
71614,114,11,21,4,2,2,8,Promising
71644,366,8,33,3,2,3,8,Casual Users
71800,21,31,148,5,4,5,14,Champions
71810,592,25,49,2,4,3,9,At Risk
72281,0,96,208,5,5,5,15,Champions
72929,306,80,304,3,5,5,13,Loyal Users
72933,408,13,29,3,3,2,8,Loyal Users
73051,2871,10,11,1,2,1,4,Lost
73847,138,88,112,4,5,4,13,Champions
73961,33,13,65,5,3,4,12,Loyal Users
74063,76,29,112,4,4,4,12,Champions
74249,4673,5,9,1,1,1,3,Lost
74304,25,33,56,5,4,3,12,Loyal Users
74538,1173,6,30,2,1,2,5,Lost
74717,1299,7,15,1,2,1,4,Lost
74960,281,6,13,3,1,1,5,Casual Users
75142,53,22,72,5,4,4,13,Champions
75252,846,7,10,2,2,1,5,Lost
75501,163,6,11,4,1,1,6,Promising
75517,78,45,124,4,4,4,12,Champions
75753,115,13,37,4,3,3,10,Loyal Users
75798,125,72,90,4,5,4,13,Champions
76082,2552,6,33,1,1,3,5,Lost
76103,178,74,267,3,5,5,13,Loyal Users
76181,1712,6,7,1,1,1,3,Lost
76398,409,18,28,3,3,2,8,Loyal Users
76900,0,18,54,5,3,3,11,Loyal Users
76904,130,19,44,4,3,3,10,Loyal Users
77288,568,10,47,2,2,3,7,Lost
77589,141,64,77,4,5,4,13,Champions
78020,3714,5,24,1,1,2,4,Lost
78049,51,75,250,5,5,5,15,Champions
78152,4014,9,20,1,2,2,5,Lost
65700,342,28,84,3,4,4,11,Loyal Users
65721,470,7,13,3,2,1,6,Casual Users
65731,0,114,383,5,5,5,15,Champions
65953,1392,5,22,1,1,2,4,Lost
66209,128,14,34,4,3,3,10,Loyal Users
66664,63,100,235,5,5,5,15,Champions
66839,416,10,19,3,2,2,7,Casual Users
66933,65,95,390,5,5,5,15,Champions
67038,116,14,39,4,3,3,10,Loyal Users
67317,452,5,8,3,1,1,5,Casual Users
67408,3185,7,28,1,2,2,5,Lost
67557,3698,11,20,1,2,2,5,Lost
67573,118,16,50,4,3,3,10,Loyal Users
67660,96,91,408,4,5,5,14,Champions
67756,401,87,456,3,5,5,13,Loyal Users
67785,20,39,448,5,4,5,14,Champions
67885,843,31,65,2,4,4,10,At Risk
67914,44,11,47,5,2,3,10,Promising
69376,188,32,164,3,4,5,12,Loyal Users
69629,164,14,32,4,3,3,10,Loyal Users
69792,5,54,317,5,5,5,15,Champions
69913,3577,15,37,1,3,3,7,Casual Users
70102,99,73,247,4,5,5,14,Champions
70214,1373,5,10,1,1,1,3,Lost
70231,18,31,297,5,4,5,14,Champions
70237,408,5,16,3,1,2,6,Casual Users
70324,1275,14,97,1,3,4,8,Casual Users
70398,128,15,181,4,3,5,12,Loyal Users
70408,59,34,98,5,4,4,13,Champions
70501,282,50,55,3,5,3,11,Loyal Users
70885,18,86,206,5,5,5,15,Champions
70986,0,91,251,5,5,5,15,Champions
71015,2238,5,9,1,1,1,3,Lost
71117,965,11,15,2,2,1,5,Lost
71432,1540,7,10,1,2,1,4,Lost
71437,1342,20,42,1,3,3,7,Casual Users
71488,4248,7,13,1,2,1,4,Lost
71649,409,5,8,3,1,1,5,Casual Users
71997,3000,29,50,1,4,3,8,At Risk
72200,166,21,26,3,3,2,8,Loyal Users
72417,1564,6,12,1,1,1,3,Lost
72492,37,32,57,5,4,3,12,Loyal Users
72524,975,64,220,2,5,5,12,At Risk
72721,95,21,33,4,3,3,10,Loyal Users
73583,139,7,14,4,2,1,7,Promising
73811,1235,9,16,2,2,2,6,Lost
74175,4685,6,12,1,1,1,3,Lost
74400,132,45,90,4,4,4,12,Champions
74582,18,73,230,5,5,5,15,Champions
74633,834,7,16,2,2,2,6,Lost
74763,320,19,23,3,3,2,8,Loyal Users
74776,30,9,19,5,2,2,9,Promising
74958,14,26,135,5,4,4,13,Champions
75036,258,25,52,3,4,3,10,Loyal Users
75401,1557,5,26,1,1,2,4,Lost
75537,695,10,13,2,2,1,5,Lost
75802,17,78,198,5,5,5,15,Champions
75970,1004,8,20,2,2,2,6,Lost
76265,1817,20,80,1,3,4,8,Casual Users
76301,373,47,389,3,5,5,13,Loyal Users
76359,25,90,168,5,5,5,15,Champions
76821,293,61,95,3,5,4,12,Loyal Users
77092,4625,9,18,1,2,2,5,Lost
77250,80,128,261,4,5,5,14,Champions
77492,294,69,177,3,5,5,13,Loyal Users
77572,1959,12,24,1,3,2,6,Casual Users
77822,3774,7,10,1,2,1,4,Lost
77841,586,8,9,2,2,1,5,Lost
77861,546,9,36,2,2,3,7,Lost
78084,42,52,103,5,5,4,14,Champions
78229,986,71,525,2,5,5,12,At Risk
78262,1870,10,21,1,2,2,5,Lost
65511,10,36,90,5,4,4,13,Champions
65521,2829,5,13,1,1,1,3,Lost
65565,5554,5,6,1,1,1,3,Lost
65995,38,69,541,5,5,5,15,Champions
66061,1388,12,21,1,3,2,6,Casual Users
66107,302,7,7,3,2,1,6,Casual Users
66196,1966,12,23,1,3,2,6,Casual Users
66688,466,11,51,3,2,3,8,Casual Users
66835,118,67,317,4,5,5,14,Champions
66895,3,9,75,5,2,4,11,Promising
67003,74,185,237,4,5,5,14,Champions
67533,83,20,42,4,3,3,10,Loyal Users
67565,593,5,6,2,1,1,4,Lost
67674,27,7,8,5,2,1,8,Promising
68062,3119,14,26,1,3,2,6,Casual Users
68080,414,28,69,3,4,4,11,Loyal Users
68356,58,79,422,5,5,5,15,Champions
68488,232,7,59,3,2,3,8,Casual Users
68590,143,7,22,4,2,2,8,Promising
68699,4426,8,8,1,2,1,4,Lost
69050,276,24,58,3,4,3,10,Loyal Users
69059,156,8,54,4,2,3,9,Promising
69096,64,38,213,5,4,5,14,Champions
69102,5142,6,11,1,1,1,3,Lost
69133,1294,6,17,1,1,2,4,Lost
70034,1743,76,272,1,5,5,11,At Risk
70503,300,13,18,3,3,2,8,Loyal Users
70635,133,6,22,4,1,2,7,Promising
70827,2649,11,13,1,2,1,4,Lost
71341,82,146,203,4,5,5,14,Champions
71783,179,60,143,3,5,4,12,Loyal Users
72146,3,71,235,5,5,5,15,Champions
72204,213,118,216,3,5,5,13,Loyal Users
72371,3299,7,39,1,2,3,6,Lost
72425,2407,6,12,1,1,1,3,Lost
72608,22,148,389,5,5,5,15,Champions
72636,286,12,37,3,3,3,9,Loyal Users
72672,619,9,21,2,2,2,6,Lost
72770,130,68,185,4,5,5,14,Champions
72816,132,9,16,4,2,2,8,Promising
72838,254,23,30,3,4,2,9,Loyal Users
73271,10,43,103,5,4,4,13,Champions
73553,3,5,5,5,1,1,7,Promising
73597,1449,12,15,1,3,1,5,Casual Users
73779,438,63,300,3,5,5,13,Loyal Users
74531,17,33,72,5,4,4,13,Champions
74627,1273,6,25,1,1,2,4,Lost
74658,1107,7,9,2,2,1,5,Lost
74661,5266,10,10,1,2,1,4,Lost
74686,0,62,86,5,5,4,14,Champions
75007,23,59,87,5,5,4,14,Champions
75155,116,56,194,4,5,5,14,Champions
75215,139,62,182,4,5,5,14,Champions
75865,652,11,25,2,2,2,6,Lost
76087,1566,33,64,1,4,4,9,At Risk
76132,4,17,45,5,3,3,11,Loyal Users
76226,53,179,438,5,5,5,15,Champions
76452,94,6,7,4,1,1,6,Promising
76903,3623,6,12,1,1,1,3,Lost
76988,387,20,79,3,3,4,10,Loyal Users
77026,1159,5,8,2,1,1,4,Lost
77607,13,87,390,5,5,5,15,Champions
77837,295,7,14,3,2,1,6,Casual Users
78056,91,11,19,4,2,2,8,Promising
66038,71,34,70,4,4,4,12,Champions
66295,23,45,275,5,4,5,14,Champions
66310,1626,9,28,1,2,2,5,Lost
66708,442,17,32,3,3,3,9,Loyal Users
66731,3363,9,23,1,2,2,5,Lost
67214,90,50,365,4,5,5,14,Champions
67411,21,24,31,5,4,2,11,Loyal Users
67703,90,14,66,4,3,4,11,Loyal Users
67786,1092,7,9,2,2,1,5,Lost
67949,1384,10,23,1,2,2,5,Lost
68012,150,104,312,4,5,5,14,Champions
68458,211,10,12,3,2,1,6,Casual Users
68665,0,74,391,5,5,5,15,Champions
68787,119,5,23,4,1,2,7,Promising
68907,19,68,328,5,5,5,15,Champions
68910,3223,7,23,1,2,2,5,Lost
68964,319,17,32,3,3,3,9,Loyal Users
69180,10,16,27,5,3,2,10,Loyal Users
69246,53,122,307,5,5,5,15,Champions
69375,2288,9,14,1,2,1,4,Lost
69528,2474,6,13,1,1,1,3,Lost
69968,74,69,383,4,5,5,14,Champions
70126,2868,6,10,1,1,1,3,Lost
70172,68,87,156,5,5,5,15,Champions
70318,7,36,75,5,4,4,13,Champions
70447,913,8,19,2,2,2,6,Lost
70512,388,8,8,3,2,1,6,Casual Users
70897,5,149,472,5,5,5,15,Champions
70900,16,23,57,5,4,3,12,Loyal Users
71063,411,9,22,3,2,2,7,Casual Users
71970,1393,11,38,1,2,3,6,Lost
71993,826,8,14,2,2,1,5,Lost
73137,59,18,26,5,3,2,10,Loyal Users
73225,359,62,289,3,5,5,13,Loyal Users
73328,722,70,143,2,5,4,11,At Risk
73441,31,128,469,5,5,5,15,Champions
73483,1937,17,45,1,3,3,7,Casual Users
73643,377,6,11,3,1,1,5,Casual Users
73777,470,66,144,3,5,4,12,Loyal Users
74078,96,46,119,4,5,4,13,Champions
74094,421,8,17,3,2,2,7,Casual Users
74390,130,6,9,4,1,1,6,Promising
74408,393,9,23,3,2,2,7,Casual Users
74443,2264,9,23,1,2,2,5,Lost
74466,232,25,39,3,4,3,10,Loyal Users
74567,1116,7,14,2,2,1,5,Lost
74812,54,172,682,5,5,5,15,Champions
74901,1970,43,43,1,4,3,8,At Risk
75160,5147,26,149,1,4,5,10,At Risk
75196,2668,28,44,1,4,3,8,At Risk
75727,91,25,116,4,4,4,12,Champions
75994,264,23,40,3,4,3,10,Loyal Users
76080,408,18,35,3,3,3,9,Loyal Users
76117,682,7,85,2,2,4,8,Lost
76174,61,154,1067,5,5,5,15,Champions
76453,838,7,11,2,2,1,5,Lost
76782,189,25,62,3,4,3,10,Loyal Users
76785,2153,12,17,1,3,2,6,Casual Users
77074,1878,10,16,1,2,2,5,Lost
77184,179,25,39,3,4,3,10,Loyal Users
77308,235,52,539,3,5,5,13,Loyal Users
77414,98,64,88,4,5,4,13,Champions
77416,88,77,316,4,5,5,14,Champions
77429,2816,5,7,1,1,1,3,Lost
77468,1,135,676,5,5,5,15,Champions
77481,12,92,481,5,5,5,15,Champions
77527,233,7,11,3,2,1,6,Casual Users
77687,4108,10,10,1,2,1,4,Lost
77791,746,21,93,2,3,4,9,Casual Users
77857,168,13,18,3,3,2,8,Loyal Users
78154,94,65,105,4,5,4,13,Champions
78199,11,99,227,5,5,5,15,Champions
65772,56,12,72,5,3,4,12,Loyal Users
65801,395,12,32,3,3,3,9,Loyal Users
66066,505,7,10,2,2,1,5,Lost
66110,654,12,14,2,3,1,6,Casual Users
66215,149,14,15,4,3,1,8,Loyal Users
66265,1869,8,16,1,2,2,5,Lost
66402,82,31,82,4,4,4,12,Champions
66458,52,78,341,5,5,5,15,Champions
66567,52,126,177,5,5,5,15,Champions
66855,1689,29,52,1,4,3,8,At Risk
66930,9,17,63,5,3,4,12,Loyal Users
67168,978,14,45,2,3,3,8,Casual Users
67289,139,69,109,4,5,4,13,Champions
67362,228,25,36,3,4,3,10,Loyal Users
67637,3255,5,8,1,1,1,3,Lost
67874,367,10,13,3,2,1,6,Casual Users
67913,15,77,147,5,5,5,15,Champions
68186,73,48,176,4,5,5,14,Champions
68628,133,83,150,4,5,5,14,Champions
68650,2226,5,17,1,1,2,4,Lost
68881,2493,5,5,1,1,1,3,Lost
69154,2,53,145,5,5,4,14,Champions
69453,399,5,12,3,1,1,5,Casual Users
69979,1149,21,43,2,3,3,8,Casual Users
70093,1009,19,42,2,3,3,8,Casual Users
70474,1121,5,11,2,1,1,4,Lost
70676,683,21,113,2,3,4,9,Casual Users
70780,407,24,94,3,4,4,11,Loyal Users
71913,72,12,42,4,3,3,10,Loyal Users
72314,7,100,416,5,5,5,15,Champions
73145,24,57,109,5,5,4,14,Champions
73248,356,8,21,3,2,2,7,Casual Users
73375,334,16,49,3,3,3,9,Loyal Users
73505,934,10,21,2,2,2,6,Lost
73507,259,26,199,3,4,5,12,Loyal Users
73765,318,7,54,3,2,3,8,Casual Users
73940,5420,8,11,1,2,1,4,Lost
73970,107,34,89,4,4,4,12,Champions
74054,188,53,191,3,5,5,13,Loyal Users
74488,4866,8,30,1,2,2,5,Lost
74823,128,31,61,4,4,3,11,Loyal Users
74943,4,115,223,5,5,5,15,Champions
75010,74,32,78,4,4,4,12,Champions
75025,1155,13,19,2,3,2,7,Casual Users
75181,5027,8,12,1,2,1,4,Lost
75839,125,22,84,4,4,4,12,Champions
75955,270,5,8,3,1,1,5,Casual Users
76120,2689,25,34,1,4,3,8,At Risk
76670,133,39,111,4,4,4,12,Champions
76791,4466,6,17,1,1,2,4,Lost
77327,655,5,33,2,1,3,6,Lost
78004,5,29,109,5,4,4,13,Champions
78112,120,75,143,4,5,4,13,Champions
65462,5,28,62,5,4,3,12,Loyal Users
65493,266,38,62,3,4,3,10,Loyal Users
65591,453,18,42,3,3,3,9,Loyal Users
65624,109,13,20,4,3,2,9,Loyal Users
65703,134,19,87,4,3,4,11,Loyal Users
65747,93,5,7,4,1,1,6,Promising
66072,1233,10,13,2,2,1,5,Lost
66453,164,10,34,4,2,3,9,Promising
66945,3759,5,5,1,1,1,3,Lost
67275,390,9,32,3,2,3,8,Casual Users
67493,123,40,68,4,4,4,12,Champions
67528,277,15,30,3,3,2,8,Loyal Users
67735,413,12,40,3,3,3,9,Loyal Users
67812,61,107,301,5,5,5,15,Champions
68004,254,74,341,3,5,5,13,Loyal Users
68036,1696,12,17,1,3,2,6,Casual Users
68285,2429,5,33,1,1,3,5,Lost
68395,47,59,233,5,5,5,15,Champions
68551,48,30,218,5,4,5,14,Champions
68671,167,16,104,3,3,4,10,Loyal Users
68788,186,6,22,3,1,2,6,Casual Users
68841,128,17,33,4,3,3,10,Loyal Users
69850,21,139,406,5,5,5,15,Champions
70139,422,20,95,3,3,4,10,Loyal Users
70151,57,62,187,5,5,5,15,Champions
70251,146,5,6,4,1,1,6,Promising
70591,705,7,13,2,2,1,5,Lost
70728,3227,5,5,1,1,1,3,Lost
71135,396,13,23,3,3,2,8,Loyal Users
71386,391,18,21,3,3,2,8,Loyal Users
71447,1483,15,42,1,3,3,7,Casual Users
71464,64,63,408,5,5,5,15,Champions
71557,2430,5,6,1,1,1,3,Lost
71561,773,6,23,2,1,2,5,Lost
71598,273,29,137,3,4,4,11,Loyal Users
72043,957,6,16,2,1,2,5,Lost
72313,2232,17,33,1,3,3,7,Casual Users
72565,25,47,274,5,5,5,15,Champions
72616,404,14,108,3,3,4,10,Loyal Users
72806,122,81,221,4,5,5,14,Champions
72812,827,24,58,2,4,3,9,At Risk
72909,1007,30,58,2,4,3,9,At Risk
72997,42,46,109,5,5,4,14,Champions
73288,39,7,20,5,2,2,9,Promising
73292,1944,6,8,1,1,1,3,Lost
73444,413,14,20,3,3,2,8,Loyal Users
73599,315,58,231,3,5,5,13,Loyal Users
73755,3284,6,36,1,1,3,5,Lost
74024,22,47,89,5,5,4,14,Champions
74133,2990,6,11,1,1,1,3,Lost
74339,2860,8,30,1,2,2,5,Lost
74434,45,8,86,5,2,4,11,Promising
74520,3250,5,12,1,1,1,3,Lost
74636,20,7,23,5,2,2,9,Promising
75065,113,109,412,4,5,5,14,Champions
75686,1713,7,10,1,2,1,4,Lost
75840,3,28,40,5,4,3,12,Loyal Users
76008,3,46,188,5,5,5,15,Champions
76161,266,15,94,3,3,4,10,Loyal Users
76231,653,27,78,2,4,4,10,At Risk
76585,135,50,86,4,5,4,13,Champions
76661,75,51,227,4,5,5,14,Champions
76774,6,5,11,5,1,1,7,Promising
77258,3168,8,14,1,2,1,4,Lost
77575,389,23,27,3,4,2,9,Loyal Users
77768,2,26,65,5,4,4,13,Champions
77942,184,8,15,3,2,1,6,Casual Users
78126,438,27,38,3,4,3,10,Loyal Users
78136,5875,14,54,1,3,3,7,Casual Users
65450,776,8,82,2,2,4,8,Lost
65623,5575,6,14,1,1,1,3,Lost
65969,119,35,72,4,4,4,12,Champions
66071,21,9,26,5,2,2,9,Promising
66170,144,11,36,4,2,3,9,Promising
66172,425,15,96,3,3,4,10,Loyal Users
66325,1568,6,8,1,1,1,3,Lost
66450,75,49,151,4,5,5,14,Champions
67705,3393,6,14,1,1,1,3,Lost
67804,438,12,21,3,3,2,8,Loyal Users
68182,80,85,175,4,5,5,14,Champions
68326,96,82,397,4,5,5,14,Champions
68542,522,7,10,2,2,1,5,Lost
68560,2849,7,10,1,2,1,4,Lost
69120,5473,10,10,1,2,1,4,Lost
69144,39,43,167,5,4,5,14,Champions
69230,246,19,47,3,3,3,9,Loyal Users
69259,2710,15,17,1,3,2,6,Casual Users
69320,20,107,300,5,5,5,15,Champions
69647,1098,38,100,2,4,4,10,At Risk
69804,127,9,71,4,2,4,10,Promising
70134,434,22,110,3,4,4,11,Loyal Users
70236,154,7,23,4,2,2,8,Promising
70412,349,21,35,3,3,3,9,Loyal Users
70557,1878,7,15,1,2,1,4,Lost
70577,3246,5,5,1,1,1,3,Lost
70622,44,47,70,5,5,4,14,Champions
70946,863,7,7,2,2,1,5,Lost
71163,419,101,325,3,5,5,13,Loyal Users
71748,92,32,67,4,4,4,12,Champions
72305,1725,39,94,1,4,4,9,At Risk
72335,22,105,369,5,5,5,15,Champions
72412,455,51,122,3,5,4,12,Loyal Users
73522,1486,6,11,1,1,1,3,Lost
73700,2663,31,89,1,4,4,9,At Risk
73712,137,24,46,4,4,3,11,Loyal Users
73834,2749,16,47,1,3,3,7,Casual Users
73978,2418,13,27,1,3,2,6,Casual Users
73984,444,8,68,3,2,4,9,Casual Users
74106,547,18,31,2,3,2,7,Casual Users
74136,57,8,30,5,2,2,9,Promising
74146,3739,5,13,1,1,1,3,Lost
74315,1008,31,109,2,4,4,10,At Risk
74649,167,39,69,3,4,4,11,Loyal Users
74818,15,24,84,5,4,4,13,Champions
74846,696,12,52,2,3,3,8,Casual Users
75072,11,77,174,5,5,5,15,Champions
75143,263,127,196,3,5,5,13,Loyal Users
75154,138,16,86,4,3,4,11,Loyal Users
75497,4866,6,35,1,1,3,5,Lost
75544,402,25,62,3,4,3,10,Loyal Users
75936,75,62,389,4,5,5,14,Champions
76048,112,38,79,4,4,4,12,Champions
76079,117,34,75,4,4,4,12,Champions
76185,356,35,90,3,4,4,11,Loyal Users
76333,63,139,276,5,5,5,15,Champions
76663,269,45,110,3,4,4,11,Loyal Users
76822,409,13,24,3,3,2,8,Loyal Users
76875,195,26,161,3,4,5,12,Loyal Users
77003,0,11,19,5,2,2,9,Promising
77275,7,147,505,5,5,5,15,Champions
77476,140,48,138,4,5,4,13,Champions
77606,928,49,173,2,5,5,12,At Risk
77697,2,45,168,5,4,5,14,Champions
78205,121,58,151,4,5,5,14,Champions
65614,2974,6,9,1,1,1,3,Lost
65757,456,26,45,3,4,3,10,Loyal Users
65805,241,10,14,3,2,1,6,Casual Users
66097,2440,7,16,1,2,2,5,Lost
66114,1403,28,41,1,4,3,8,At Risk
66133,2944,5,6,1,1,1,3,Lost
66189,2969,6,32,1,1,3,5,Lost
66206,1347,30,129,1,4,4,9,At Risk
66299,64,22,98,5,4,4,13,Champions
66394,113,38,164,4,4,5,13,Champions
66581,302,13,26,3,3,2,8,Loyal Users
66969,226,117,305,3,5,5,13,Loyal Users
67260,118,11,21,4,2,2,8,Promising
67405,159,40,71,4,4,4,12,Champions
67529,0,68,270,5,5,5,15,Champions
68390,24,61,373,5,5,5,15,Champions
68441,456,6,13,3,1,1,5,Casual Users
68474,52,18,123,5,3,4,12,Loyal Users
68832,83,73,363,4,5,5,14,Champions
69285,136,13,23,4,3,2,9,Loyal Users
69417,161,26,126,4,4,4,12,Champions
69424,2622,7,40,1,2,3,6,Lost
69805,446,26,201,3,4,5,12,Loyal Users
69906,1144,8,15,2,2,1,5,Lost
69947,1099,5,8,2,1,1,4,Lost
70072,1996,6,20,1,1,2,4,Lost
70238,29,23,38,5,4,3,12,Loyal Users
70789,137,63,251,4,5,5,14,Champions
70821,12,39,91,5,4,4,13,Champions
70967,268,25,34,3,4,3,10,Loyal Users
70978,1141,5,32,2,1,3,6,Lost
70995,422,6,9,3,1,1,5,Casual Users
71067,1115,5,17,2,1,2,5,Lost
71228,4569,5,7,1,1,1,3,Lost
71515,420,10,15,3,2,1,6,Casual Users
71517,121,10,11,4,2,1,7,Promising
71545,14,13,39,5,3,3,11,Loyal Users
71686,1168,9,29,2,2,2,6,Lost
71814,141,176,215,4,5,5,14,Champions
71980,677,6,23,2,1,2,5,Lost
72260,850,9,22,2,2,2,6,Lost
72496,80,57,147,4,5,5,14,Champions
72513,24,38,270,5,4,5,14,Champions
72743,92,43,167,4,4,5,13,Champions
72773,67,112,454,5,5,5,15,Champions
72864,192,38,153,3,4,5,12,Loyal Users
73393,1415,8,11,1,2,1,4,Lost
73929,66,74,160,5,5,5,15,Champions
74103,791,5,33,2,1,3,6,Lost
74751,28,83,299,5,5,5,15,Champions
74861,979,5,17,2,1,2,5,Lost
75562,2540,5,25,1,1,2,4,Lost
75588,3525,8,31,1,2,2,5,Lost
75814,113,36,104,4,4,4,12,Champions
75917,247,19,43,3,3,3,9,Loyal Users
76140,1,150,628,5,5,5,15,Champions
76146,38,61,342,5,5,5,15,Champions
76193,248,10,19,3,2,2,7,Casual Users
76348,95,115,759,4,5,5,14,Champions
76683,846,20,21,2,3,2,7,Casual Users
77217,1431,8,13,1,2,1,4,Lost
77324,5,49,63,5,5,4,14,Champions
77485,61,172,921,5,5,5,15,Champions
77724,967,12,29,2,3,2,7,Casual Users
77819,145,21,28,4,3,2,9,Loyal Users
77849,442,25,61,3,4,3,10,Loyal Users
65554,283,25,36,3,4,3,10,Loyal Users
65852,119,23,151,4,4,5,13,Champions
65870,3997,6,9,1,1,1,3,Lost
65990,1509,12,88,1,3,4,8,Casual Users
65994,4079,5,7,1,1,1,3,Lost
66168,38,28,76,5,4,4,13,Champions
66602,130,40,93,4,4,4,12,Champions
67067,411,7,15,3,2,1,6,Casual Users
67130,243,10,23,3,2,2,7,Casual Users
67709,169,32,123,3,4,4,11,Loyal Users
67825,1,21,128,5,3,4,12,Loyal Users
67827,2121,9,42,1,2,3,6,Lost
67925,127,17,40,4,3,3,10,Loyal Users
67948,753,11,38,2,2,3,7,Lost
68041,419,15,27,3,3,2,8,Loyal Users
68598,3218,5,48,1,1,3,5,Lost
69082,713,7,15,2,2,1,5,Lost
69292,837,12,42,2,3,3,8,Casual Users
69356,90,14,17,4,3,2,9,Loyal Users
69553,33,20,106,5,3,4,12,Loyal Users
69651,31,170,351,5,5,5,15,Champions
69810,3197,14,55,1,3,3,7,Casual Users
69858,437,32,88,3,4,4,11,Loyal Users
70196,92,12,36,4,3,3,10,Loyal Users
70245,146,41,174,4,4,5,13,Champions
70416,1110,25,127,2,4,4,10,At Risk
70572,5475,8,29,1,2,2,5,Lost
70709,177,18,205,3,3,5,11,Loyal Users
70748,224,120,264,3,5,5,13,Loyal Users
70800,3123,6,7,1,1,1,3,Lost
70874,3365,9,38,1,2,3,6,Lost
70876,15,23,80,5,4,4,13,Champions
71372,828,8,15,2,2,1,5,Lost
71502,2,123,328,5,5,5,15,Champions
71511,136,24,68,4,4,4,12,Champions
71811,4828,10,10,1,2,1,4,Lost
71815,152,45,133,4,4,4,12,Champions
72368,2,49,69,5,5,4,14,Champions
72575,248,12,38,3,3,3,9,Loyal Users
72898,215,34,144,3,4,4,11,Loyal Users
72982,944,22,84,2,4,4,10,At Risk
73400,170,47,111,3,5,4,12,Loyal Users
73622,158,15,31,4,3,2,9,Loyal Users
73649,93,75,111,4,5,4,13,Champions
73688,314,48,266,3,5,5,13,Loyal Users
73876,91,42,128,4,4,4,12,Champions
74036,32,118,433,5,5,5,15,Champions
74161,3,149,271,5,5,5,15,Champions
74192,461,5,13,3,1,1,5,Casual Users
74659,119,6,10,4,1,1,6,Promising
74712,716,8,11,2,2,1,5,Lost
74983,18,39,101,5,4,4,13,Champions
75954,101,29,299,4,4,5,13,Champions
76444,1103,7,8,2,2,1,5,Lost
77042,1197,15,88,2,3,4,9,Casual Users
77238,107,43,181,4,4,5,13,Champions
77279,2605,12,28,1,3,2,6,Casual Users
77392,1017,25,99,2,4,4,10,At Risk
77759,1590,9,33,1,2,3,6,Lost
78005,101,27,102,4,4,4,12,Champions
78028,3,37,101,5,4,4,13,Champions
65524,128,5,16,4,1,2,7,Promising
65548,4279,8,14,1,2,1,4,Lost
66083,817,11,24,2,2,2,6,Lost
66598,149,26,46,4,4,3,11,Loyal Users
66675,136,70,124,4,5,4,13,Champions
66767,115,24,40,4,4,3,11,Loyal Users
67153,101,103,137,4,5,4,13,Champions
67561,1206,5,5,2,1,1,4,Lost
67815,34,45,142,5,4,4,13,Champions
68595,123,79,153,4,5,5,14,Champions
69111,1510,11,41,1,2,3,6,Lost
69685,1692,36,73,1,4,4,9,At Risk
70032,120,18,27,4,3,2,9,Loyal Users
70087,2172,5,5,1,1,1,3,Lost
70253,2580,10,10,1,2,1,4,Lost
70317,4973,6,14,1,1,1,3,Lost
70345,197,64,143,3,5,4,12,Loyal Users
70762,695,15,23,2,3,2,7,Casual Users
70910,444,9,39,3,2,3,8,Casual Users
71430,163,33,56,4,4,3,11,Loyal Users
71702,4838,5,9,1,1,1,3,Lost
71842,2545,13,17,1,3,2,6,Casual Users
72015,3152,5,90,1,1,4,6,Lost
72079,591,19,49,2,3,3,8,Casual Users
72083,1753,35,90,1,4,4,9,At Risk
72242,20,111,823,5,5,5,15,Champions
72409,531,38,177,2,4,5,11,At Risk
72420,844,32,81,2,4,4,10,At Risk
72696,836,6,8,2,1,1,4,Lost
72708,85,29,65,4,4,4,12,Champions
72870,85,105,217,4,5,5,14,Champions
72976,414,15,57,3,3,3,9,Loyal Users
73142,1435,5,10,1,1,1,3,Lost
73165,142,16,85,4,3,4,11,Loyal Users
73316,2119,5,16,1,1,2,4,Lost
73366,422,19,69,3,3,4,10,Loyal Users
73475,370,29,130,3,4,4,11,Loyal Users
73836,975,8,17,2,2,2,6,Lost
74005,517,13,48,2,3,3,8,Casual Users
74164,2452,5,8,1,1,1,3,Lost
74326,48,138,491,5,5,5,15,Champions
74478,108,19,55,4,3,3,10,Loyal Users
74513,292,42,155,3,4,5,12,Loyal Users
74594,583,55,75,2,5,4,11,At Risk
74737,253,52,169,3,5,5,13,Loyal Users
74759,35,8,10,5,2,1,8,Promising
74987,416,36,94,3,4,4,11,Loyal Users
75033,248,10,20,3,2,2,7,Casual Users
75198,134,185,642,4,5,5,14,Champions
75247,448,14,61,3,3,3,9,Loyal Users
75573,158,17,24,4,3,2,9,Loyal Users
75876,33,49,62,5,5,3,13,Loyal Users
75938,4005,13,53,1,3,3,7,Casual Users
76215,155,7,12,4,2,1,7,Promising
76677,170,30,237,3,4,5,12,Loyal Users
76707,3145,6,9,1,1,1,3,Lost
76798,125,21,79,4,3,4,11,Loyal Users
77050,11,16,39,5,3,3,11,Loyal Users
77153,295,13,32,3,3,3,9,Loyal Users
77297,113,167,241,4,5,5,14,Champions
77733,3396,10,19,1,2,2,5,Lost
77933,535,9,76,2,2,4,8,Lost
77934,579,5,13,2,1,1,4,Lost
77936,117,26,53,4,4,3,11,Loyal Users
78231,3,152,348,5,5,5,15,Champions
78246,137,48,173,4,5,5,14,Champions
65474,155,85,143,4,5,4,13,Champions
65606,420,8,49,3,2,3,8,Casual Users
65640,3685,13,32,1,3,3,7,Casual Users
65698,1140,37,66,2,4,4,10,At Risk
65719,1378,9,11,1,2,1,4,Lost
66002,422,18,46,3,3,3,9,Loyal Users
66032,998,7,24,2,2,2,6,Lost
66642,213,43,108,3,4,4,11,Loyal Users
66764,3470,9,11,1,2,1,4,Lost
67037,104,114,306,4,5,5,14,Champions
67052,132,10,33,4,2,3,9,Promising
67262,220,31,102,3,4,4,11,Loyal Users
67418,5480,14,31,1,3,2,6,Casual Users
67832,76,112,399,4,5,5,14,Champions
68223,230,14,60,3,3,3,9,Loyal Users
68276,200,9,20,3,2,2,7,Casual Users
68425,2557,12,51,1,3,3,7,Casual Users
68603,7,33,141,5,4,4,13,Champions
68695,1246,6,33,2,1,3,6,Lost
68806,1630,5,7,1,1,1,3,Lost
68986,12,30,60,5,4,3,12,Loyal Users
69164,581,16,19,2,3,2,7,Casual Users
69305,3304,12,25,1,3,2,6,Casual Users
69447,1691,19,105,1,3,4,8,Casual Users
69648,67,102,337,5,5,5,15,Champions
69932,2326,6,67,1,1,4,6,Lost
70194,55,28,40,5,4,3,12,Loyal Users
70258,257,20,166,3,3,5,11,Loyal Users
70459,687,15,27,2,3,2,7,Casual Users
70607,587,6,9,2,1,1,4,Lost
70999,226,20,120,3,3,4,10,Loyal Users
71037,84,35,62,4,4,3,11,Loyal Users
71184,130,33,87,4,4,4,12,Champions
72631,3709,5,8,1,1,1,3,Lost
73074,1178,9,65,2,2,4,8,Lost
73144,1588,6,6,1,1,1,3,Lost
73204,84,36,135,4,4,4,12,Champions
73218,3594,5,5,1,1,1,3,Lost
74254,1575,7,13,1,2,1,4,Lost
74260,130,48,79,4,5,4,13,Champions
74677,478,5,6,2,1,1,4,Lost
75402,418,9,28,3,2,2,7,Casual Users
75489,2647,6,6,1,1,1,3,Lost
75628,5300,12,20,1,3,2,6,Casual Users
76037,1738,9,32,1,2,3,6,Lost
76043,415,5,8,3,1,1,5,Casual Users
76322,100,42,181,4,4,5,13,Champions
76346,4,26,82,5,4,4,13,Champions
76697,1759,5,17,1,1,2,4,Lost
76887,62,113,775,5,5,5,15,Champions
77135,701,15,55,2,3,3,8,Casual Users
77283,845,43,97,2,4,4,10,At Risk
77370,420,19,49,3,3,3,9,Loyal Users
77406,3673,27,220,1,4,5,10,At Risk
77474,29,113,155,5,5,5,15,Champions
77561,99,7,74,4,2,4,10,Promising
77814,35,113,569,5,5,5,15,Champions
77873,2,124,308,5,5,5,15,Champions
77911,109,19,56,4,3,3,10,Loyal Users
65582,1465,11,40,1,2,3,6,Lost
65613,140,23,85,4,4,4,12,Champions
65652,379,65,347,3,5,5,13,Loyal Users
65739,5961,6,16,1,1,2,4,Lost
66016,75,22,35,4,4,3,11,Loyal Users
66719,282,6,11,3,1,1,5,Casual Users
66749,130,17,85,4,3,4,11,Loyal Users
66999,695,8,16,2,2,2,6,Lost
67430,1702,6,10,1,1,1,3,Lost
67829,133,13,15,4,3,1,8,Loyal Users
68137,402,11,38,3,2,3,8,Casual Users
68291,299,7,49,3,2,3,8,Casual Users
68514,396,6,7,3,1,1,5,Casual Users
68636,2729,107,623,1,5,5,11,At Risk
68878,280,7,38,3,2,3,8,Casual Users
69015,1302,39,65,1,4,4,9,At Risk
69535,101,32,146,4,4,4,12,Champions
69618,2636,5,27,1,1,2,4,Lost
69786,590,5,6,2,1,1,4,Lost
69961,581,6,11,2,1,1,4,Lost
70054,493,28,273,2,4,5,11,At Risk
70171,126,24,47,4,4,3,11,Loyal Users
70513,703,5,15,2,1,1,4,Lost
71034,45,15,51,5,3,3,11,Loyal Users
71181,111,51,167,4,5,5,14,Champions
71271,2120,42,246,1,4,5,10,At Risk
71297,451,6,30,3,1,2,6,Casual Users
71595,1061,18,40,2,3,3,8,Casual Users
71799,112,41,67,4,4,4,12,Champions
72175,1081,14,52,2,3,3,8,Casual Users
72231,145,30,119,4,4,4,12,Champions
72481,1292,38,73,1,4,4,9,At Risk
72499,1875,6,14,1,1,1,3,Lost
72623,4,28,57,5,4,3,12,Loyal Users
72660,1135,6,11,2,1,1,4,Lost
73038,5,181,316,5,5,5,15,Champions
73191,33,111,281,5,5,5,15,Champions
73265,34,120,448,5,5,5,15,Champions
74008,120,7,21,4,2,2,8,Promising
74263,417,8,10,3,2,1,6,Casual Users
74270,76,52,284,4,5,5,14,Champions
74746,103,5,5,4,1,1,6,Promising
75429,1660,9,21,1,2,2,5,Lost
75618,531,20,52,2,3,3,8,Casual Users
75826,1039,28,53,2,4,3,9,At Risk
75906,287,5,8,3,1,1,5,Casual Users
76004,298,12,74,3,3,4,10,Loyal Users
76017,4,28,113,5,4,4,13,Champions
76315,877,18,24,2,3,2,7,Casual Users
76320,96,31,70,4,4,4,12,Champions
76730,24,77,588,5,5,5,15,Champions
76878,2260,11,42,1,2,3,6,Lost
76910,2972,9,17,1,2,2,5,Lost
76993,20,171,301,5,5,5,15,Champions
77446,974,5,7,2,1,1,4,Lost
77486,411,13,30,3,3,2,8,Loyal Users
77500,146,12,61,4,3,3,10,Loyal Users
77648,1150,11,33,2,2,3,7,Lost
77715,1818,10,42,1,2,3,6,Lost
77781,2990,12,12,1,3,1,5,Casual Users
78090,15,9,11,5,2,1,8,Promising
78096,6,19,82,5,3,4,12,Loyal Users
78241,27,42,224,5,4,5,14,Champions
65506,127,19,49,4,3,3,10,Loyal Users
65515,5256,6,6,1,1,1,3,Lost
66321,80,25,39,4,4,3,11,Loyal Users
66545,1369,10,24,1,2,2,5,Lost
66549,836,9,11,2,2,1,5,Lost
66614,560,19,30,2,3,2,7,Casual Users
66684,408,19,38,3,3,3,9,Loyal Users
66765,1680,34,62,1,4,3,8,At Risk
67242,118,31,157,4,4,5,13,Champions
67292,2,181,252,5,5,5,15,Champions
67332,844,9,21,2,2,2,6,Lost
67537,2134,27,94,1,4,4,9,At Risk
67576,313,56,80,3,5,4,12,Loyal Users
67634,63,57,256,5,5,5,15,Champions
68055,9,10,89,5,2,4,11,Promising
68251,526,8,8,2,2,1,5,Lost
68338,103,61,142,4,5,4,13,Champions
68346,44,14,67,5,3,4,12,Loyal Users
68583,213,21,77,3,3,4,10,Loyal Users
68655,382,71,428,3,5,5,13,Loyal Users
68677,42,65,339,5,5,5,15,Champions
68768,100,70,190,4,5,5,14,Champions
69054,3661,9,98,1,2,4,7,Lost
69078,936,11,16,2,2,2,6,Lost
69170,4567,5,28,1,1,2,4,Lost
69175,1286,6,9,1,1,1,3,Lost
69383,22,78,236,5,5,5,15,Champions
69398,227,26,105,3,4,4,11,Loyal Users
69470,149,169,263,4,5,5,14,Champions
69532,1518,11,14,1,2,1,4,Lost
70300,491,15,50,2,3,3,8,Casual Users
70795,1383,6,6,1,1,1,3,Lost
71256,123,11,15,4,2,1,7,Promising
71294,15,109,331,5,5,5,15,Champions
71547,119,34,54,4,4,3,11,Loyal Users
71664,505,42,199,2,4,5,11,At Risk
71740,135,14,59,4,3,3,10,Loyal Users
71918,65,11,102,5,2,4,11,Promising
71920,736,9,15,2,2,1,5,Lost
71936,3182,8,11,1,2,1,4,Lost
71943,2369,12,62,1,3,3,7,Casual Users
71963,41,5,46,5,1,3,9,Promising
72415,9,191,362,5,5,5,15,Champions
72452,280,50,102,3,5,4,12,Loyal Users
73304,502,8,9,2,2,1,5,Lost
73458,110,122,386,4,5,5,14,Champions
73546,635,15,53,2,3,3,8,Casual Users
73808,124,30,62,4,4,3,11,Loyal Users
74015,587,6,6,2,1,1,4,Lost
74165,5029,6,11,1,1,1,3,Lost
74571,39,8,9,5,2,1,8,Promising
75483,2,48,146,5,5,4,14,Champions
75557,727,12,26,2,3,2,7,Casual Users
75677,129,31,138,4,4,4,12,Champions
76566,158,12,63,4,3,4,11,Loyal Users
76580,2269,5,6,1,1,1,3,Lost
76929,3113,19,26,1,3,2,6,Casual Users
77133,1349,6,16,1,1,2,4,Lost
77285,2440,7,9,1,2,1,4,Lost
77367,1445,8,9,1,2,1,4,Lost
77544,237,14,23,3,3,2,8,Loyal Users
77718,3126,6,12,1,1,1,3,Lost
77834,5360,7,7,1,2,1,4,Lost
77842,184,9,21,3,2,2,7,Casual Users
65448,528,8,10,2,2,1,5,Lost
65597,284,7,11,3,2,1,6,Casual Users
65759,583,9,10,2,2,1,5,Lost
65799,528,9,20,2,2,2,6,Lost
65849,3665,6,14,1,1,1,3,Lost
66000,4504,5,5,1,1,1,3,Lost
66099,2504,11,40,1,2,3,6,Lost
66655,19,70,95,5,5,4,14,Champions
67530,1004,14,34,2,3,3,8,Casual Users
67724,1,187,323,5,5,5,15,Champions
67796,543,8,17,2,2,2,6,Lost
68490,3,8,53,5,2,3,10,Promising
68763,110,32,60,4,4,3,11,Loyal Users
68814,907,13,18,2,3,2,7,Casual Users
69444,70,110,273,4,5,5,14,Champions
69574,18,34,50,5,4,3,12,Loyal Users
69709,19,33,56,5,4,3,12,Loyal Users
70201,1118,5,20,2,1,2,5,Lost
70302,4252,11,53,1,2,3,6,Lost
70356,147,9,32,4,2,3,9,Promising
70367,319,8,17,3,2,2,7,Casual Users
70700,71,64,296,4,5,5,14,Champions
70958,177,32,47,3,4,3,10,Loyal Users
70972,15,55,129,5,5,4,14,Champions
71053,69,86,200,5,5,5,15,Champions
71127,655,19,151,2,3,5,10,Casual Users
71133,132,10,12,4,2,1,7,Promising
71331,244,47,87,3,5,4,12,Loyal Users
71375,307,34,168,3,4,5,12,Loyal Users
71741,499,18,67,2,3,4,9,Casual Users
72000,945,21,98,2,3,4,9,Casual Users
72002,132,6,11,4,1,1,6,Promising
72033,291,11,23,3,2,2,7,Casual Users
72759,365,53,258,3,5,5,13,Loyal Users
73356,1807,17,116,1,3,4,8,Casual Users
73399,40,16,75,5,3,4,12,Loyal Users
73587,1464,9,17,1,2,2,5,Lost
73651,40,6,8,5,1,1,7,Promising
73930,121,43,62,4,4,3,11,Loyal Users
74259,68,18,71,5,3,4,12,Loyal Users
75449,425,5,35,3,1,3,7,Casual Users
75572,2270,7,38,1,2,3,6,Lost
75672,965,5,8,2,1,1,4,Lost
75689,3,126,551,5,5,5,15,Champions
75704,1365,10,24,1,2,2,5,Lost
75941,548,7,21,2,2,2,6,Lost
76618,1294,12,17,1,3,2,6,Casual Users
76731,429,13,28,3,3,2,8,Loyal Users
76768,95,9,38,4,2,3,9,Promising
76776,36,55,125,5,5,4,14,Champions
76850,1083,63,185,2,5,5,12,At Risk
76913,4005,8,15,1,2,1,4,Lost
77151,574,8,10,2,2,1,5,Lost
77237,80,52,274,4,5,5,14,Champions
77532,570,7,25,2,2,2,6,Lost
78027,841,6,10,2,1,1,4,Lost
78171,2,93,375,5,5,5,15,Champions
65619,105,8,13,4,2,1,7,Promising
65723,229,28,123,3,4,4,11,Loyal Users
65872,333,42,169,3,4,5,12,Loyal Users
66242,240,9,14,3,2,1,6,Casual Users
66460,275,5,47,3,1,3,7,Casual Users
66736,20,47,93,5,5,4,14,Champions
66812,155,7,12,4,2,1,7,Promising
66970,12,91,127,5,5,4,14,Champions
67036,282,8,51,3,2,3,8,Casual Users
67232,16,31,45,5,4,3,12,Loyal Users
67354,1555,8,16,1,2,2,5,Lost
67446,1146,11,24,2,2,2,6,Lost
68084,258,28,81,3,4,4,11,Loyal Users
68156,5068,5,14,1,1,1,3,Lost
68192,765,103,256,2,5,5,12,At Risk
68198,105,8,66,4,2,4,10,Promising
68675,116,80,130,4,5,4,13,Champions
68743,719,10,54,2,2,3,7,Lost
68745,1123,5,19,2,1,2,5,Lost
68904,29,46,313,5,5,5,15,Champions
68949,857,18,62,2,3,3,8,Casual Users
68973,1569,8,61,1,2,3,6,Lost
69019,116,7,12,4,2,1,7,Promising
69260,2,23,51,5,4,3,12,Loyal Users
69567,149,24,60,4,4,3,11,Loyal Users
69823,5412,8,18,1,2,2,5,Lost
70084,554,10,24,2,2,2,6,Lost
70384,8,28,69,5,4,4,13,Champions
70631,24,70,200,5,5,5,15,Champions
70705,3098,5,21,1,1,2,4,Lost
70712,12,27,49,5,4,3,12,Loyal Users
70783,154,9,26,4,2,2,8,Promising
71025,3682,16,23,1,3,2,6,Casual Users
71147,2283,7,12,1,2,1,4,Lost
71220,0,12,55,5,3,3,11,Loyal Users
72136,9,98,730,5,5,5,15,Champions
72219,33,60,83,5,5,4,14,Champions
72276,27,80,214,5,5,5,15,Champions
72439,43,25,64,5,4,4,13,Champions
72847,1016,9,13,2,2,1,5,Lost
73108,2046,14,30,1,3,2,6,Casual Users
73118,111,7,19,4,2,2,8,Promising
73278,2247,40,40,1,4,3,8,At Risk
73281,416,8,15,3,2,1,6,Casual Users
73446,1268,10,35,1,2,3,6,Lost
73558,117,89,537,4,5,5,14,Champions
73574,80,56,282,4,5,5,14,Champions
73594,8,82,285,5,5,5,15,Champions
73819,163,19,73,4,3,4,11,Loyal Users
73907,102,26,78,4,4,4,12,Champions
73924,26,30,157,5,4,5,14,Champions
74023,416,21,94,3,3,4,10,Loyal Users
74035,1510,8,17,1,2,2,5,Lost
74038,421,7,8,3,2,1,6,Casual Users
74121,93,24,131,4,4,4,12,Champions
74181,34,105,207,5,5,5,15,Champions
74186,275,19,73,3,3,4,10,Loyal Users
74969,42,202,729,5,5,5,15,Champions
75210,523,34,109,2,4,4,10,At Risk
75253,127,40,84,4,4,4,12,Champions
75794,1003,11,22,2,2,2,6,Lost
76139,61,47,107,5,5,4,14,Champions
76490,3092,36,72,1,4,4,9,At Risk
76497,579,8,12,2,2,1,5,Lost
76499,354,13,141,3,3,4,10,Loyal Users
76752,412,6,20,3,1,2,6,Casual Users
76837,85,25,71,4,4,4,12,Champions
77251,566,11,37,2,2,3,7,Lost
77750,1392,7,7,1,2,1,4,Lost
77931,3029,6,25,1,1,2,4,Lost
78014,166,14,28,3,3,2,8,Loyal Users
78124,109,9,20,4,2,2,8,Promising
78261,3547,15,41,1,3,3,7,Casual Users
65446,695,22,48,2,4,3,9,At Risk
65477,152,75,159,4,5,5,14,Champions
65701,1379,5,16,1,1,2,4,Lost
65936,1289,8,10,1,2,1,4,Lost
66033,697,5,14,2,1,1,4,Lost
66154,293,10,57,3,2,3,8,Casual Users
66574,1135,14,19,2,3,2,7,Casual Users
66997,2259,10,19,1,2,2,5,Lost
67063,3279,8,19,1,2,2,5,Lost
67741,405,8,13,3,2,1,6,Casual Users
67929,177,5,6,3,1,1,5,Casual Users
67962,86,60,332,4,5,5,14,Champions
68164,14,17,28,5,3,2,10,Loyal Users
68249,673,7,9,2,2,1,5,Lost
68393,111,37,63,4,4,4,12,Champions
68444,357,15,37,3,3,3,9,Loyal Users
68482,264,52,248,3,5,5,13,Loyal Users
68759,707,5,20,2,1,2,5,Lost
68783,381,10,20,3,2,2,7,Casual Users
68989,539,17,137,2,3,4,9,Casual Users
69225,135,5,8,4,1,1,6,Promising
69446,4613,8,31,1,2,2,5,Lost
70212,25,90,259,5,5,5,15,Champions
70555,187,49,79,3,5,4,12,Loyal Users
70714,430,7,9,3,2,1,6,Casual Users
71146,114,104,281,4,5,5,14,Champions
71458,1026,6,50,2,1,3,6,Lost
72089,3793,6,6,1,1,1,3,Lost
72138,2689,14,60,1,3,3,7,Casual Users
72268,2270,8,33,1,2,3,6,Lost
72621,117,103,385,4,5,5,14,Champions
72669,356,10,13,3,2,1,6,Casual Users
72983,2104,5,14,1,1,1,3,Lost
73121,163,22,30,4,4,2,10,Loyal Users
73241,72,14,45,4,3,3,10,Loyal Users
73627,1121,13,46,2,3,3,8,Casual Users
73857,472,34,90,2,4,4,10,At Risk
73937,15,46,73,5,5,4,14,Champions
73957,84,25,68,4,4,4,12,Champions
74062,144,5,37,4,1,3,8,Promising
74187,1820,23,63,1,4,4,9,At Risk
74608,11,33,78,5,4,4,13,Champions
74688,719,24,57,2,4,3,9,At Risk
74720,79,5,20,4,1,2,7,Promising
74802,292,25,80,3,4,4,11,Loyal Users
74977,72,58,161,4,5,5,14,Champions
74980,824,14,19,2,3,2,7,Casual Users
75390,47,34,71,5,4,4,13,Champions
75433,3458,5,8,1,1,1,3,Lost
75494,795,10,38,2,2,3,7,Lost
75551,152,72,181,4,5,5,14,Champions
75659,1708,6,12,1,1,1,3,Lost
75717,1,118,671,5,5,5,15,Champions
76113,3,28,119,5,4,4,13,Champions
76184,10,114,319,5,5,5,15,Champions
76463,863,6,11,2,1,1,4,Lost
76744,399,14,32,3,3,3,9,Loyal Users
77071,407,20,34,3,3,3,9,Loyal Users
77160,188,61,170,3,5,5,13,Loyal Users
77248,16,55,339,5,5,5,15,Champions
77402,55,112,324,5,5,5,15,Champions
77439,2,36,127,5,4,4,13,Champions
77487,121,21,41,4,3,3,10,Loyal Users
77546,837,12,47,2,3,3,8,Casual Users
77843,1154,9,16,2,2,2,6,Lost
77922,25,21,170,5,3,5,13,Loyal Users
78001,1039,14,33,2,3,3,8,Casual Users
78082,113,54,102,4,5,4,13,Champions
65553,43,44,93,5,4,4,13,Champions
65697,4798,8,16,1,2,2,5,Lost
65796,394,43,93,3,4,4,11,Loyal Users
65940,247,7,18,3,2,2,7,Casual Users
66153,2461,7,18,1,2,2,5,Lost
66368,408,26,53,3,4,3,10,Loyal Users
66441,7,5,18,5,1,2,8,Promising
66456,3868,7,21,1,2,2,5,Lost
66723,4716,5,28,1,1,2,4,Lost
67035,2318,7,24,1,2,2,5,Lost
67331,3478,6,15,1,1,1,3,Lost
67686,112,119,192,4,5,5,14,Champions
68278,120,64,103,4,5,4,13,Champions
68501,591,46,186,2,5,5,12,At Risk
68572,1246,14,41,2,3,3,8,Casual Users
68798,268,21,56,3,3,3,9,Loyal Users
68865,26,22,121,5,4,4,13,Champions
69346,324,18,46,3,3,3,9,Loyal Users
69450,2,183,696,5,5,5,15,Champions
69522,788,6,6,2,1,1,4,Lost
69590,282,18,41,3,3,3,9,Loyal Users
69592,5,27,37,5,4,3,12,Loyal Users
69640,17,38,85,5,4,4,13,Champions
69677,103,12,42,4,3,3,10,Loyal Users
69922,12,11,38,5,2,3,10,Promising
70205,90,8,49,4,2,3,9,Promising
70465,512,32,176,2,4,5,11,At Risk
70466,2586,9,42,1,2,3,6,Lost
70515,35,191,624,5,5,5,15,Champions
70575,684,49,213,2,5,5,12,At Risk
71136,701,9,25,2,2,2,6,Lost
71187,79,137,375,4,5,5,14,Champions
71418,1157,24,79,2,4,4,10,At Risk
71485,91,46,110,4,5,4,13,Champions
71577,867,7,16,2,2,2,6,Lost
71751,2723,5,18,1,1,2,4,Lost
71773,6,72,424,5,5,5,15,Champions
71785,654,70,107,2,5,4,11,At Risk
71835,30,32,147,5,4,5,14,Champions
72248,406,116,279,3,5,5,13,Loyal Users
72302,23,49,136,5,5,4,14,Champions
72712,127,38,199,4,4,5,13,Champions
72821,319,6,16,3,1,2,6,Casual Users
72856,528,9,17,2,2,2,6,Lost
72920,8,57,178,5,5,5,15,Champions
73383,131,20,45,4,3,3,10,Loyal Users
73408,801,8,10,2,2,1,5,Lost
73533,10,61,209,5,5,5,15,Champions
74177,3280,87,239,1,5,5,11,At Risk
74207,127,6,6,4,1,1,6,Promising
74210,647,20,77,2,3,4,9,Casual Users
74233,18,173,213,5,5,5,15,Champions
74306,128,32,116,4,4,4,12,Champions
74755,69,6,68,5,1,4,10,Promising
74785,2161,7,23,1,2,2,5,Lost
75423,2408,7,16,1,2,2,5,Lost
75582,9,77,151,5,5,5,15,Champions
75643,424,25,48,3,4,3,10,Loyal Users
75964,1414,10,27,1,2,2,5,Lost
76049,908,6,12,2,1,1,4,Lost
76332,78,23,53,4,4,3,11,Loyal Users
76685,115,33,46,4,4,3,11,Loyal Users
76970,662,15,90,2,3,4,9,Casual Users
76973,2276,9,52,1,2,3,6,Lost
77079,2278,17,38,1,3,3,7,Casual Users
77102,794,10,52,2,2,3,7,Lost
77173,86,160,283,4,5,5,14,Champions
77175,274,34,58,3,4,3,10,Loyal Users
77325,781,12,28,2,3,2,7,Casual Users
77515,500,9,15,2,2,1,5,Lost
77523,87,46,142,4,5,4,13,Champions
77653,39,7,16,5,2,2,9,Promising
77661,2485,8,14,1,2,1,4,Lost
78225,487,5,6,2,1,1,4,Lost
78281,575,55,80,2,5,4,11,At Risk
65727,75,92,228,4,5,5,14,Champions
65859,442,37,97,3,4,4,11,Loyal Users
65889,752,7,14,2,2,1,5,Lost
65952,373,6,9,3,1,1,5,Casual Users
65980,1490,43,186,1,4,5,10,At Risk
66334,271,35,105,3,4,4,11,Loyal Users
66506,433,48,103,3,5,4,12,Loyal Users
66683,292,6,16,3,1,2,6,Casual Users
66836,3460,6,14,1,1,1,3,Lost
67172,4313,10,11,1,2,1,4,Lost
67259,129,24,31,4,4,2,10,Loyal Users
67677,270,17,30,3,3,2,8,Loyal Users
68025,1115,13,51,2,3,3,8,Casual Users
68166,188,7,19,3,2,2,7,Casual Users
68400,621,8,20,2,2,2,6,Lost
68625,2853,13,20,1,3,2,6,Casual Users
68632,1296,8,58,1,2,3,6,Lost
68931,226,10,34,3,2,3,8,Casual Users
69053,4,64,173,5,5,5,15,Champions
69090,0,10,23,5,2,2,9,Promising
69244,1072,12,25,2,3,2,7,Casual Users
69359,135,15,91,4,3,4,11,Loyal Users
69402,707,8,22,2,2,2,6,Lost
69516,15,16,64,5,3,4,12,Loyal Users
69646,145,30,69,4,4,4,12,Champions
69678,60,82,157,5,5,5,15,Champions
69846,1417,8,12,1,2,1,4,Lost
70090,661,29,99,2,4,4,10,At Risk
70108,1946,7,9,1,2,1,4,Lost
70576,572,5,12,2,1,1,4,Lost
70722,487,9,41,2,2,3,7,Lost
70799,1646,13,17,1,3,2,6,Casual Users
71041,123,66,154,4,5,5,14,Champions
71217,50,92,289,5,5,5,15,Champions
71280,813,23,92,2,4,4,10,At Risk
71284,3022,22,85,1,4,4,9,At Risk
71318,908,8,23,2,2,2,6,Lost
71405,4,70,166,5,5,5,15,Champions
71645,85,50,134,4,5,4,13,Champions
72100,791,18,36,2,3,3,8,Casual Users
72139,15,67,181,5,5,5,15,Champions
72298,1125,10,37,2,2,3,7,Lost
72306,3997,5,8,1,1,1,3,Lost
72317,165,18,125,4,3,4,11,Loyal Users
73473,407,81,191,3,5,5,13,Loyal Users
73612,2543,46,165,1,5,5,11,At Risk
73707,1420,5,7,1,1,1,3,Lost
73904,1097,6,24,2,1,2,5,Lost
73969,16,73,394,5,5,5,15,Champions
74154,1042,136,433,2,5,5,12,At Risk
74222,76,17,52,4,3,3,10,Loyal Users
74561,721,17,31,2,3,2,7,Casual Users
74743,410,28,37,3,4,3,10,Loyal Users
74927,264,50,95,3,5,4,12,Loyal Users
75476,142,8,71,4,2,4,10,Promising
75539,2420,8,10,1,2,1,4,Lost
75555,13,122,1015,5,5,5,15,Champions
75778,744,12,98,2,3,4,9,Casual Users
75835,1414,30,53,1,4,3,8,At Risk
76577,4,166,484,5,5,5,15,Champions
76702,2131,6,13,1,1,1,3,Lost
76809,427,19,24,3,3,2,8,Loyal Users
77100,154,56,77,4,5,4,13,Champions
77449,182,5,6,3,1,1,5,Casual Users
77465,118,20,22,4,3,2,9,Loyal Users
77726,39,7,17,5,2,2,9,Promising
65585,424,9,22,3,2,2,7,Casual Users
65929,947,5,18,2,1,2,5,Lost
66227,2583,5,16,1,1,2,4,Lost
66426,158,88,157,4,5,5,14,Champions
66555,50,62,360,5,5,5,15,Champions
66679,191,21,39,3,3,3,9,Loyal Users
66958,255,10,16,3,2,2,7,Casual Users
67066,136,12,29,4,3,2,9,Loyal Users
67116,1180,16,19,2,3,2,7,Casual Users
67425,238,11,28,3,2,2,7,Casual Users
67691,521,8,13,2,2,1,5,Lost
67704,390,6,7,3,1,1,5,Casual Users
67778,96,24,92,4,4,4,12,Champions
68000,1748,7,9,1,2,1,4,Lost
68019,1553,11,18,1,2,2,5,Lost
68212,2237,10,10,1,2,1,4,Lost
68283,1967,5,11,1,1,1,3,Lost
68468,1813,11,25,1,2,2,5,Lost
68469,201,25,134,3,4,4,11,Loyal Users
68545,126,54,222,4,5,5,14,Champions
68615,349,8,16,3,2,2,7,Casual Users
68618,125,57,133,4,5,4,13,Champions
69190,7,26,78,5,4,4,13,Champions
69394,645,18,115,2,3,4,9,Casual Users
69689,2,30,165,5,4,5,14,Champions
69735,36,47,130,5,5,4,14,Champions
69829,2534,7,16,1,2,2,5,Lost
70045,0,72,347,5,5,5,15,Champions
70052,20,108,696,5,5,5,15,Champions
70107,2675,6,11,1,1,1,3,Lost
70159,569,6,6,2,1,1,4,Lost
70429,117,100,334,4,5,5,14,Champions
70432,0,155,274,5,5,5,15,Champions
70597,391,69,119,3,5,4,12,Loyal Users
70654,3728,9,10,1,2,1,4,Lost
70973,143,5,7,4,1,1,6,Promising
71126,24,51,169,5,5,5,15,Champions
71900,94,6,40,4,1,3,8,Promising
72006,59,29,39,5,4,3,12,Loyal Users
72218,78,7,8,4,2,1,7,Promising
72250,757,5,7,2,1,1,4,Lost
72312,1436,9,44,1,2,3,6,Lost
72366,863,20,103,2,3,4,9,Casual Users
72592,155,31,51,4,4,3,11,Loyal Users
72602,5232,8,24,1,2,2,5,Lost
72676,24,17,37,5,3,3,11,Loyal Users
72750,128,89,173,4,5,5,14,Champions
73138,348,5,8,3,1,1,5,Casual Users
73228,3081,25,185,1,4,5,10,At Risk
73520,594,41,93,2,4,4,10,At Risk
74342,85,139,595,4,5,5,14,Champions
74584,2092,6,8,1,1,1,3,Lost
74722,1557,28,76,1,4,4,9,At Risk
75046,359,31,92,3,4,4,11,Loyal Users
75270,481,33,85,2,4,4,10,At Risk
75333,92,98,354,4,5,5,14,Champions
75475,44,41,62,5,4,3,12,Loyal Users
75574,123,75,166,4,5,5,14,Champions
75611,270,46,174,3,5,5,13,Loyal Users
75663,4611,6,6,1,1,1,3,Lost
75956,3874,12,32,1,3,3,7,Casual Users
75996,239,70,124,3,5,4,12,Loyal Users
76074,10,91,457,5,5,5,15,Champions
76357,138,27,127,4,4,4,12,Champions
76635,126,37,277,4,4,5,13,Champions
76640,965,6,8,2,1,1,4,Lost
77168,2828,5,8,1,1,1,3,Lost
77318,604,9,14,2,2,1,5,Lost
77380,863,86,249,2,5,5,12,At Risk
77659,159,73,448,4,5,5,14,Champions
77747,366,10,31,3,2,2,7,Casual Users
77797,1719,10,17,1,2,2,5,Lost
77885,102,95,283,4,5,5,14,Champions
65489,667,12,41,2,3,3,8,Casual Users
65592,1813,5,8,1,1,1,3,Lost
65671,7,40,127,5,4,4,13,Champions
66361,3564,11,16,1,2,2,5,Lost
67039,883,8,18,2,2,2,6,Lost
67320,33,38,110,5,4,4,13,Champions
67842,1377,17,54,1,3,3,7,Casual Users
68018,32,7,10,5,2,1,8,Promising
68050,87,30,130,4,4,4,12,Champions
68413,24,134,864,5,5,5,15,Champions
68452,83,97,495,4,5,5,14,Champions
68722,15,129,325,5,5,5,15,Champions
68891,1561,8,22,1,2,2,5,Lost
69138,4143,6,8,1,1,1,3,Lost
69360,341,27,50,3,4,3,10,Loyal Users
69420,125,37,185,4,4,5,13,Champions
69831,70,9,28,4,2,2,8,Promising
70309,575,8,22,2,2,2,6,Lost
70330,130,11,36,4,2,3,9,Promising
70365,98,62,102,4,5,4,13,Champions
70563,69,91,228,5,5,5,15,Champions
70690,109,39,73,4,4,4,12,Champions
70704,71,47,164,4,5,5,14,Champions
70750,37,24,53,5,4,3,12,Loyal Users
71242,834,38,169,2,4,5,11,At Risk
71846,0,113,194,5,5,5,15,Champions
71863,80,10,48,4,2,3,9,Promising
72173,36,33,112,5,4,4,13,Champions
72214,2548,5,6,1,1,1,3,Lost
72350,854,6,7,2,1,1,4,Lost
72418,379,73,246,3,5,5,13,Loyal Users
72527,86,29,224,4,4,5,13,Champions
73517,714,7,10,2,2,1,5,Lost
73818,393,10,49,3,2,3,8,Casual Users
74003,264,9,22,3,2,2,7,Casual Users
74061,38,10,13,5,2,1,8,Promising
74077,2026,12,13,1,3,1,5,Casual Users
74224,5,29,66,5,4,4,13,Champions
74383,1780,7,7,1,2,1,4,Lost
74399,248,15,28,3,3,2,8,Loyal Users
74516,220,24,110,3,4,4,11,Loyal Users
74606,34,18,21,5,3,2,10,Loyal Users
75005,855,7,19,2,2,2,6,Lost
75406,2346,9,11,1,2,1,4,Lost
75511,1384,41,187,1,4,5,10,At Risk
75569,103,130,325,4,5,5,14,Champions
76176,1023,52,215,2,5,5,12,At Risk
76277,6,83,124,5,5,4,14,Champions
76345,1147,33,79,2,4,4,10,At Risk
76485,33,10,14,5,2,1,8,Promising
76914,1026,36,100,2,4,4,10,At Risk
76916,702,7,50,2,2,3,7,Lost
76938,121,20,27,4,3,2,9,Loyal Users
77047,154,36,100,4,4,4,12,Champions
77526,3380,5,25,1,1,2,4,Lost
77712,431,36,107,3,4,4,11,Loyal Users
77722,379,41,62,3,4,3,10,Loyal Users
65469,4152,5,11,1,1,1,3,Lost
65873,1279,44,149,1,4,5,10,At Risk
66330,266,77,184,3,5,5,13,Loyal Users
66550,1845,6,12,1,1,1,3,Lost
66740,423,13,30,3,3,2,8,Loyal Users
68010,128,26,78,4,4,4,12,Champions
68044,217,15,43,3,3,3,9,Loyal Users
68228,819,18,26,2,3,2,7,Casual Users
68407,1945,16,27,1,3,2,6,Casual Users
68442,2819,5,5,1,1,1,3,Lost
68489,438,45,164,3,4,5,12,Loyal Users
68669,2155,24,63,1,4,4,9,At Risk
68985,222,28,100,3,4,4,11,Loyal Users
69000,162,54,384,4,5,5,14,Champions
69089,752,12,90,2,3,4,9,Casual Users
69116,493,19,35,2,3,3,8,Casual Users
69196,281,32,44,3,4,3,10,Loyal Users
69253,398,21,50,3,3,3,9,Loyal Users
69274,6,16,86,5,3,4,12,Loyal Users
69509,207,93,322,3,5,5,13,Loyal Users
70013,250,9,85,3,2,4,9,Casual Users
70065,380,17,56,3,3,3,9,Loyal Users
70247,30,15,33,5,3,3,11,Loyal Users
70255,15,6,9,5,1,1,7,Promising
70269,136,11,67,4,2,4,10,Promising
70468,2633,7,12,1,2,1,4,Lost
70642,264,14,136,3,3,4,10,Loyal Users
70796,88,28,54,4,4,3,11,Loyal Users
71178,819,6,24,2,1,2,5,Lost
71262,85,12,70,4,3,4,11,Loyal Users
71312,4479,5,5,1,1,1,3,Lost
71324,64,92,383,5,5,5,15,Champions
71505,53,29,51,5,4,3,12,Loyal Users
71544,4432,5,9,1,1,1,3,Lost
71847,375,12,48,3,3,3,9,Loyal Users
72324,272,6,22,3,1,2,6,Casual Users
72804,42,29,54,5,4,3,12,Loyal Users
72880,1703,43,136,1,4,4,9,At Risk
72957,674,12,50,2,3,3,8,Casual Users
73254,1728,9,23,1,2,2,5,Lost
73343,800,9,14,2,2,1,5,Lost
74095,125,21,131,4,3,4,11,Loyal Users
74327,819,19,80,2,3,4,9,Casual Users
74621,246,76,167,3,5,5,13,Loyal Users
75403,3,7,18,5,2,2,9,Promising
75466,13,292,465,5,5,5,15,Champions
75799,1987,5,10,1,1,1,3,Lost
75820,964,10,22,2,2,2,6,Lost
75894,137,51,215,4,5,5,14,Champions
76019,281,7,9,3,2,1,6,Casual Users
76111,3819,14,33,1,3,3,7,Casual Users
76457,305,10,31,3,2,2,7,Casual Users
76766,252,16,43,3,3,3,9,Loyal Users
76839,2951,8,13,1,2,1,4,Lost
76956,1421,7,34,1,2,3,6,Lost
76968,424,24,55,3,4,3,10,Loyal Users
77002,2849,5,9,1,1,1,3,Lost
77023,483,18,24,2,3,2,7,Casual Users
77063,960,17,76,2,3,4,9,Casual Users
77086,175,11,15,3,2,1,6,Casual Users
77432,141,29,54,4,4,3,11,Loyal Users
78094,73,81,281,4,5,5,14,Champions
78103,3700,6,15,1,1,1,3,Lost
78248,82,55,149,4,5,5,14,Champions
65925,230,12,32,3,3,3,9,Loyal Users
66180,139,61,125,4,5,4,13,Champions
66281,133,41,90,4,4,4,12,Champions
66464,5,113,583,5,5,5,15,Champions
66721,2417,8,22,1,2,2,5,Lost
66769,151,21,42,4,3,3,10,Loyal Users
66775,120,111,303,4,5,5,14,Champions
66853,230,62,116,3,5,4,12,Loyal Users
67190,214,24,29,3,4,2,9,Loyal Users
67302,2998,5,25,1,1,2,4,Lost
67314,129,35,263,4,4,5,13,Champions
67363,379,29,74,3,4,4,11,Loyal Users
67390,598,16,24,2,3,2,7,Casual Users
67767,550,10,12,2,2,1,5,Lost
67845,1137,19,32,2,3,3,8,Casual Users
67878,1705,6,9,1,1,1,3,Lost
67918,836,8,12,2,2,1,5,Lost
67941,849,14,51,2,3,3,8,Casual Users
67953,88,34,220,4,4,5,13,Champions
68737,36,35,98,5,4,4,13,Champions
69563,2352,8,11,1,2,1,4,Lost
69802,93,66,368,4,5,5,14,Champions
69897,667,8,60,2,2,3,7,Lost
70565,577,10,95,2,2,4,8,Lost
70657,5425,25,37,1,4,3,8,At Risk
70951,12,46,76,5,5,4,14,Champions
71180,654,8,19,2,2,2,6,Lost
71452,20,35,59,5,4,3,12,Loyal Users
71780,20,193,897,5,5,5,15,Champions
71794,408,31,135,3,4,4,11,Loyal Users
72411,219,94,301,3,5,5,13,Loyal Users
72606,60,21,57,5,3,3,11,Loyal Users
72962,1972,6,12,1,1,1,3,Lost
73391,796,9,28,2,2,2,6,Lost
73504,4283,6,17,1,1,2,4,Lost
73802,5821,13,36,1,3,3,7,Casual Users
74283,282,30,132,3,4,4,11,Loyal Users
74505,134,33,83,4,4,4,12,Champions
74596,126,13,29,4,3,2,9,Loyal Users
75269,692,39,95,2,4,4,10,At Risk
75349,852,8,49,2,2,3,7,Lost
75430,477,36,101,2,4,4,10,At Risk
75441,1554,12,27,1,3,2,6,Casual Users
75756,132,7,34,4,2,3,9,Promising
75907,399,37,66,3,4,4,11,Loyal Users
76027,2485,22,92,1,4,4,9,At Risk
76075,12,35,93,5,4,4,13,Champions
76481,1802,13,39,1,3,3,7,Casual Users
76637,83,53,207,4,5,5,14,Champions
76688,276,53,127,3,5,4,12,Loyal Users
76962,3371,21,68,1,3,4,8,Casual Users
77179,95,43,267,4,4,5,13,Champions
77309,830,9,15,2,2,1,5,Lost
77409,5263,13,17,1,3,2,6,Casual Users
77518,9,29,52,5,4,3,12,Loyal Users
77574,435,8,40,3,2,3,8,Casual Users
77703,5,82,112,5,5,4,14,Champions
77773,6,54,203,5,5,5,15,Champions
77916,1000,7,13,2,2,1,5,Lost
78104,1578,21,27,1,3,2,6,Casual Users
78167,111,108,508,4,5,5,14,Champions
65457,81,58,288,4,5,5,14,Champions
65847,101,30,56,4,4,3,11,Loyal Users
65967,117,15,21,4,3,2,9,Loyal Users
66274,150,64,83,4,5,4,13,Champions
66399,107,35,270,4,4,5,13,Champions
66416,529,15,26,2,3,2,7,Casual Users
66618,2841,7,23,1,2,2,5,Lost
66742,395,32,66,3,4,4,11,Loyal Users
66876,59,101,194,5,5,5,15,Champions
67205,1432,20,39,1,3,3,7,Casual Users
67296,80,12,23,4,3,2,9,Loyal Users
67351,883,32,67,2,4,4,10,At Risk
67429,3859,31,75,1,4,4,9,At Risk
67750,630,15,19,2,3,2,7,Casual Users
68381,136,13,19,4,3,2,9,Loyal Users
68730,256,46,158,3,5,5,13,Loyal Users
68739,545,12,46,2,3,3,8,Casual Users
68791,13,11,18,5,2,2,9,Promising
69047,970,5,20,2,1,2,5,Lost
69525,295,37,70,3,4,4,11,Loyal Users
70372,475,9,55,2,2,3,7,Lost
70422,2,40,129,5,4,4,13,Champions
70502,287,21,34,3,3,3,9,Loyal Users
70856,146,7,29,4,2,2,8,Promising
71455,24,163,456,5,5,5,15,Champions
71523,409,7,17,3,2,2,7,Casual Users
71585,151,5,20,4,1,2,7,Promising
71680,123,7,14,4,2,1,7,Promising
72168,98,10,33,4,2,3,9,Promising
72398,785,13,62,2,3,3,8,Casual Users
72569,111,41,59,4,4,3,11,Loyal Users
72601,307,45,179,3,4,5,12,Loyal Users
73123,11,56,82,5,5,4,14,Champions
73249,82,76,115,4,5,4,13,Champions
73270,221,38,90,3,4,4,11,Loyal Users
73337,381,17,22,3,3,2,8,Loyal Users
74074,29,17,25,5,3,2,10,Loyal Users
74323,299,30,43,3,4,3,10,Loyal Users
74521,721,13,15,2,3,1,6,Casual Users
74597,1385,20,33,1,3,3,7,Casual Users
74638,122,17,26,4,3,2,9,Loyal Users
74667,150,18,24,4,3,2,9,Loyal Users
74723,6,16,17,5,3,2,10,Loyal Users
75057,26,83,213,5,5,5,15,Champions
75170,1717,5,6,1,1,1,3,Lost
75173,1278,14,47,1,3,3,7,Casual Users
75679,374,23,68,3,4,4,11,Loyal Users
75768,1088,12,32,2,3,3,8,Casual Users
76171,157,9,16,4,2,2,8,Promising
76551,851,24,80,2,4,4,10,At Risk
77222,11,60,415,5,5,5,15,Champions
77263,91,11,159,4,2,5,11,Promising
77334,3989,6,18,1,1,2,4,Lost
77570,119,33,92,4,4,4,12,Champions
77593,35,26,47,5,4,3,12,Loyal Users
77641,841,203,613,2,5,5,12,At Risk
77929,1,189,528,5,5,5,15,Champions
65586,379,50,111,3,5,4,12,Loyal Users
65733,593,7,35,2,2,3,7,Lost
65838,1286,16,130,1,3,4,8,Casual Users
65842,1973,7,18,1,2,2,5,Lost
66101,705,12,71,2,3,4,9,Casual Users
66174,347,10,77,3,2,4,9,Casual Users
66228,2877,5,6,1,1,1,3,Lost
66324,1417,15,32,1,3,3,7,Casual Users
66409,667,23,35,2,4,3,9,At Risk
66411,4021,12,21,1,3,2,6,Casual Users
66566,39,164,311,5,5,5,15,Champions
66928,126,13,17,4,3,2,9,Loyal Users
67105,270,18,87,3,3,4,10,Loyal Users
67238,101,58,108,4,5,4,13,Champions
67505,360,35,141,3,4,4,11,Loyal Users
67559,958,17,47,2,3,3,8,Casual Users
67597,129,14,42,4,3,3,10,Loyal Users
67706,90,19,41,4,3,3,10,Loyal Users
68667,186,12,20,3,3,2,8,Loyal Users
68935,2851,8,40,1,2,3,6,Lost
68938,119,74,380,4,5,5,14,Champions
68999,144,13,27,4,3,2,9,Loyal Users
69226,289,65,127,3,5,4,12,Loyal Users
69327,143,33,81,4,4,4,12,Champions
69389,106,5,7,4,1,1,6,Promising
69418,1864,6,9,1,1,1,3,Lost
69870,3947,8,8,1,2,1,4,Lost
70027,133,51,212,4,5,5,14,Champions
70483,335,5,9,3,1,1,5,Casual Users
70837,1388,9,33,1,2,3,6,Lost
71255,240,25,73,3,4,4,11,Loyal Users
71401,74,18,50,4,3,3,10,Loyal Users
71474,859,55,169,2,5,5,12,At Risk
71567,1236,10,21,2,2,2,6,Lost
71823,95,63,359,4,5,5,14,Champions
71950,3625,6,13,1,1,1,3,Lost
72142,5409,5,29,1,1,2,4,Lost
72364,4004,6,17,1,1,2,4,Lost
72532,5508,14,35,1,3,3,7,Casual Users
73034,133,48,98,4,5,4,13,Champions
73100,26,31,111,5,4,4,13,Champions
73373,725,32,224,2,4,5,11,At Risk
73422,429,9,27,3,2,2,7,Casual Users
73731,579,35,132,2,4,4,10,At Risk
74020,5,34,132,5,4,4,13,Champions
74064,984,5,5,2,1,1,4,Lost
74300,977,7,11,2,2,1,5,Lost
74632,55,58,226,5,5,5,15,Champions
74801,965,107,137,2,5,4,11,At Risk
74857,2566,5,6,1,1,1,3,Lost
75301,1144,7,19,2,2,2,6,Lost
75361,7,12,66,5,3,4,12,Loyal Users
75721,175,45,166,3,4,5,12,Loyal Users
75735,7,97,147,5,5,5,15,Champions
75736,5,92,629,5,5,5,15,Champions
75959,381,19,38,3,3,3,9,Loyal Users
76055,701,36,77,2,4,4,10,At Risk
76070,120,6,19,4,1,2,7,Promising
76100,1140,7,13,2,2,1,5,Lost
76827,49,140,312,5,5,5,15,Champions
77030,257,31,65,3,4,4,11,Loyal Users
77205,854,21,51,2,3,3,8,Casual Users
77307,4028,9,13,1,2,1,4,Lost
77592,2236,5,19,1,1,2,4,Lost
77809,20,20,24,5,3,2,10,Loyal Users
77941,493,35,84,2,4,4,10,At Risk
65732,1354,20,33,1,3,3,7,Casual Users
66203,178,34,184,3,4,5,12,Loyal Users
66270,2027,6,7,1,1,1,3,Lost
66650,1525,21,28,1,3,2,6,Casual Users
67504,241,25,52,3,4,3,10,Loyal Users
67524,535,8,20,2,2,2,6,Lost
67664,404,12,19,3,3,2,8,Loyal Users
67755,103,55,70,4,5,4,13,Champions
67856,16,80,324,5,5,5,15,Champions
67960,122,43,63,4,4,4,12,Champions
67965,307,20,34,3,3,3,9,Loyal Users
68215,132,27,124,4,4,4,12,Champions
68289,418,11,28,3,2,2,7,Casual Users
68309,139,43,56,4,4,3,11,Loyal Users
68382,1007,86,146,2,5,4,11,At Risk
68429,2,73,190,5,5,5,15,Champions
68822,14,125,297,5,5,5,15,Champions
68969,3449,6,7,1,1,1,3,Lost
69062,2816,7,9,1,2,1,4,Lost
69149,131,11,37,4,2,3,9,Promising
69370,2962,5,5,1,1,1,3,Lost
69445,147,17,61,4,3,3,10,Loyal Users
69464,2273,6,73,1,1,4,6,Lost
69502,228,113,321,3,5,5,13,Loyal Users
69551,123,37,145,4,4,4,12,Champions
70189,692,16,33,2,3,3,8,Casual Users
70406,5415,5,12,1,1,1,3,Lost
70419,660,5,8,2,1,1,4,Lost
71095,1,178,530,5,5,5,15,Champions
71289,437,14,21,3,3,2,8,Loyal Users
71350,81,118,335,4,5,5,14,Champions
71665,285,51,166,3,5,5,13,Loyal Users
71782,159,8,15,4,2,1,7,Promising
71791,14,34,55,5,4,3,12,Loyal Users
72073,72,15,34,4,3,3,10,Loyal Users
72114,172,5,5,3,1,1,5,Casual Users
72767,895,6,21,2,1,2,5,Lost
73035,430,11,52,3,2,3,8,Casual Users
73050,0,27,44,5,4,3,12,Loyal Users
73076,3816,5,6,1,1,1,3,Lost
74247,478,24,68,2,4,4,10,At Risk
74261,92,120,143,4,5,4,13,Champions
74285,423,23,76,3,4,4,11,Loyal Users
74519,78,76,484,4,5,5,14,Champions
74535,448,11,29,3,2,2,7,Casual Users
74550,36,8,114,5,2,4,11,Promising
75313,2723,18,24,1,3,2,6,Casual Users
75455,117,11,18,4,2,2,8,Promising
75561,28,21,50,5,3,3,11,Loyal Users
75652,43,49,194,5,5,5,15,Champions
75987,140,6,14,4,1,1,6,Promising
76468,1493,10,12,1,2,1,4,Lost
76574,1105,6,13,2,1,1,4,Lost
76729,138,14,91,4,3,4,11,Loyal Users
76763,829,5,16,2,1,2,5,Lost
77398,386,30,39,3,4,3,10,Loyal Users
77540,1888,11,13,1,2,1,4,Lost
77550,1421,16,51,1,3,3,7,Casual Users
77623,274,57,120,3,5,4,12,Loyal Users
78146,694,7,9,2,2,1,5,Lost
65646,137,14,22,4,3,2,9,Loyal Users
65730,399,27,107,3,4,4,11,Loyal Users
66093,208,20,49,3,3,3,9,Loyal Users
66259,623,7,12,2,2,1,5,Lost
66278,80,9,17,4,2,2,8,Promising
66303,208,12,33,3,3,3,9,Loyal Users
66622,124,39,204,4,4,5,13,Champions
67521,92,8,25,4,2,2,8,Promising
67702,4,80,139,5,5,4,14,Champions
68455,13,9,14,5,2,1,8,Promising
68465,1278,8,12,1,2,1,4,Lost
68854,13,12,30,5,3,2,10,Loyal Users
69057,412,38,152,3,4,5,12,Loyal Users
69382,3408,12,30,1,3,2,6,Casual Users
69459,3673,14,44,1,3,3,7,Casual Users
69489,278,17,99,3,3,4,10,Loyal Users
69498,13,47,110,5,5,4,14,Champions
69518,754,6,14,2,1,1,4,Lost
69639,19,41,134,5,4,4,13,Champions
69656,704,27,150,2,4,5,11,At Risk
69662,680,8,15,2,2,1,5,Lost
70370,62,139,235,5,5,5,15,Champions
70477,26,48,133,5,5,4,14,Champions
70548,449,7,14,3,2,1,6,Casual Users
70694,447,13,27,3,3,2,8,Loyal Users
70801,1515,22,28,1,4,2,7,At Risk
71057,1009,9,16,2,2,2,6,Lost
71141,549,23,42,2,4,3,9,At Risk
71355,26,78,368,5,5,5,15,Champions
71868,75,5,14,4,1,1,6,Promising
72264,9,64,293,5,5,5,15,Champions
72316,304,20,117,3,3,4,10,Loyal Users
72731,417,10,18,3,2,2,7,Casual Users
72911,116,75,205,4,5,5,14,Champions
72998,88,105,343,4,5,5,14,Champions
73043,78,41,184,4,4,5,13,Champions
73267,688,10,18,2,2,2,6,Lost
73727,414,21,32,3,3,3,9,Loyal Users
74255,98,88,171,4,5,5,14,Champions
74477,78,41,87,4,4,4,12,Champions
74492,138,52,206,4,5,5,14,Champions
74859,3622,15,35,1,3,3,7,Casual Users
75093,17,9,32,5,2,3,10,Promising
75157,2679,7,28,1,2,2,5,Lost
75261,145,81,142,4,5,4,13,Champions
75540,106,88,181,4,5,5,14,Champions
75657,20,80,142,5,5,4,14,Champions
75760,65,66,215,5,5,5,15,Champions
76038,3522,13,54,1,3,3,7,Casual Users
76204,636,14,56,2,3,3,8,Casual Users
76291,31,67,188,5,5,5,15,Champions
76690,120,52,189,4,5,5,14,Champions
76890,14,7,9,5,2,1,8,Promising
77010,248,24,103,3,4,4,11,Loyal Users
77085,616,28,187,2,4,5,11,At Risk
77201,4,131,734,5,5,5,15,Champions
77752,85,42,135,4,4,4,12,Champions
77757,1397,13,30,1,3,2,6,Casual Users
77813,4767,5,10,1,1,1,3,Lost
77839,298,21,23,3,3,2,8,Loyal Users
77949,15,6,7,5,1,1,7,Promising
78015,20,64,554,5,5,5,15,Champions
78114,827,7,10,2,2,1,5,Lost
65490,85,87,109,4,5,4,13,Champions
65533,270,27,217,3,4,5,12,Loyal Users
65858,79,11,21,4,2,2,8,Promising
65865,5,13,90,5,3,4,12,Loyal Users
65877,6079,7,7,1,2,1,4,Lost
66131,16,24,40,5,4,3,12,Loyal Users
66187,1323,17,25,1,3,2,6,Casual Users
66423,3398,8,17,1,2,2,5,Lost
66640,130,5,23,4,1,2,7,Promising
66756,427,5,9,3,1,1,5,Casual Users
67072,267,41,106,3,4,4,11,Loyal Users
67111,2560,5,8,1,1,1,3,Lost
67255,150,22,50,4,4,3,11,Loyal Users
67469,1951,14,35,1,3,3,7,Casual Users
67990,1292,22,41,1,4,3,8,At Risk
68026,110,48,141,4,5,4,13,Champions
68214,583,17,35,2,3,3,8,Casual Users
68577,2500,6,6,1,1,1,3,Lost
68630,110,123,420,4,5,5,14,Champions
69214,57,209,654,5,5,5,15,Champions
69240,681,16,73,2,3,4,9,Casual Users
69345,3224,8,22,1,2,2,5,Lost
69414,130,28,45,4,4,3,11,Loyal Users
69468,106,36,155,4,4,5,13,Champions
69549,805,53,60,2,5,3,10,At Risk
69652,266,29,121,3,4,4,11,Loyal Users
69751,1526,10,21,1,2,2,5,Lost
69774,48,132,181,5,5,5,15,Champions
69930,1346,25,66,1,4,4,9,At Risk
70066,117,87,386,4,5,5,14,Champions
70521,1414,8,12,1,2,1,4,Lost
71012,295,20,48,3,3,3,9,Loyal Users
71118,280,9,18,3,2,2,7,Casual Users
71173,1299,58,487,1,5,5,11,At Risk
71298,218,8,18,3,2,2,7,Casual Users
71441,1957,7,8,1,2,1,4,Lost
71556,11,42,74,5,4,4,13,Champions
71888,195,35,68,3,4,4,11,Loyal Users
71959,285,17,39,3,3,3,9,Loyal Users
72208,71,17,40,4,3,3,10,Loyal Users
72354,4311,8,9,1,2,1,4,Lost
72701,241,11,25,3,2,2,7,Casual Users
72809,32,120,274,5,5,5,15,Champions
72830,5423,10,23,1,2,2,5,Lost
73170,2508,7,12,1,2,1,4,Lost
74227,138,9,38,4,2,3,9,Promising
74313,165,11,49,4,2,3,9,Promising
74442,5,110,322,5,5,5,15,Champions
74989,282,6,17,3,1,2,6,Casual Users
75078,145,32,69,4,4,4,12,Champions
75084,36,100,154,5,5,5,15,Champions
75134,708,57,190,2,5,5,12,At Risk
75621,93,15,51,4,3,3,10,Loyal Users
75751,90,7,46,4,2,3,9,Promising
76124,3000,6,10,1,1,1,3,Lost
76147,15,88,241,5,5,5,15,Champions
76608,1363,7,13,1,2,1,4,Lost
76742,10,116,207,5,5,5,15,Champions
77319,29,34,129,5,4,4,13,Champions
77514,135,30,137,4,4,4,12,Champions
77619,181,8,37,3,2,3,8,Casual Users
77788,1365,25,39,1,4,3,8,At Risk
65833,961,10,13,2,2,1,5,Lost
66041,855,5,5,2,1,1,4,Lost
66111,3657,7,11,1,2,1,4,Lost
66222,156,9,15,4,2,1,7,Promising
66248,28,16,58,5,3,3,11,Loyal Users
67398,306,27,104,3,4,4,11,Loyal Users
67402,653,29,65,2,4,4,10,At Risk
67460,1109,11,18,2,2,2,6,Lost
67643,17,41,84,5,4,4,13,Champions
68107,491,5,8,2,1,1,4,Lost
68322,10,53,133,5,5,4,14,Champions
68328,168,57,335,3,5,5,13,Loyal Users
68340,2,127,449,5,5,5,15,Champions
68420,79,45,116,4,4,4,12,Champions
68499,240,57,100,3,5,4,12,Loyal Users
68820,839,10,15,2,2,1,5,Lost
68837,1471,11,63,1,2,4,7,Lost
69076,419,17,153,3,3,5,11,Loyal Users
69185,284,11,22,3,2,2,7,Casual Users
69354,543,6,29,2,1,2,5,Lost
69432,1845,5,41,1,1,3,5,Lost
69680,529,5,24,2,1,2,5,Lost
69682,427,48,54,3,5,3,11,Loyal Users
69980,352,11,38,3,2,3,8,Casual Users
70017,5095,7,10,1,2,1,4,Lost
70614,47,59,120,5,5,4,14,Champions
71203,412,7,8,3,2,1,6,Casual Users
71329,112,21,51,4,3,3,10,Loyal Users
71344,239,13,134,3,3,4,10,Loyal Users
71894,41,20,37,5,3,3,11,Loyal Users
71929,2160,5,8,1,1,1,3,Lost
72646,312,20,28,3,3,2,8,Loyal Users
72958,1116,18,200,2,3,5,10,Casual Users
73054,248,24,150,3,4,5,12,Loyal Users
73146,15,97,199,5,5,5,15,Champions
73184,172,25,48,3,4,3,10,Loyal Users
73227,1144,7,8,2,2,1,5,Lost
73495,0,48,92,5,5,4,14,Champions
73527,1090,26,77,2,4,4,10,At Risk
74150,81,55,204,4,5,5,14,Champions
74180,65,59,310,5,5,5,15,Champions
74223,1325,8,9,1,2,1,4,Lost
74309,126,33,143,4,4,4,12,Champions
74358,13,10,46,5,2,3,10,Promising
74729,576,20,58,2,3,3,8,Casual Users
74822,126,9,39,4,2,3,9,Promising
75068,1795,7,11,1,2,1,4,Lost
75238,141,85,364,4,5,5,14,Champions
75833,1492,5,7,1,1,1,3,Lost
75845,737,14,67,2,3,4,9,Casual Users
75898,45,19,50,5,3,3,11,Loyal Users
75912,18,49,70,5,5,4,14,Champions
75948,24,51,85,5,5,4,14,Champions
75984,1649,5,7,1,1,1,3,Lost
76526,1964,7,36,1,2,3,6,Lost
76650,3,28,68,5,4,4,13,Champions
76800,16,13,15,5,3,1,9,Loyal Users
77006,6,58,85,5,5,4,14,Champions
77156,31,12,37,5,3,3,11,Loyal Users
77208,121,71,477,4,5,5,14,Champions
77264,831,6,7,2,1,1,4,Lost
77461,1817,5,21,1,1,2,4,Lost
77926,741,5,20,2,1,2,5,Lost
77944,643,12,21,2,3,2,7,Casual Users
78215,633,47,157,2,5,5,12,At Risk
78244,160,8,15,4,2,1,7,Promising
65960,252,8,26,3,2,2,7,Casual Users
66551,1868,5,33,1,1,3,5,Lost
66807,41,40,123,5,4,4,13,Champions
67328,40,14,19,5,3,2,10,Loyal Users
67365,3,101,193,5,5,5,15,Champions
68027,3,7,14,5,2,1,8,Promising
68629,674,7,18,2,2,2,6,Lost
68898,533,6,48,2,1,3,6,Lost
68993,330,8,12,3,2,1,6,Casual Users
69598,75,41,138,4,4,4,12,Champions
69600,24,203,352,5,5,5,15,Champions
70363,245,9,20,3,2,2,7,Casual Users
70493,73,54,337,4,5,5,14,Champions
70613,130,176,568,4,5,5,14,Champions
70873,290,23,60,3,4,3,10,Loyal Users
71079,2378,25,71,1,4,4,9,At Risk
71166,90,6,8,4,1,1,6,Promising
71558,647,43,280,2,4,5,11,At Risk
71591,793,6,10,2,1,1,4,Lost
71899,116,50,159,4,5,5,14,Champions
72226,2096,10,106,1,2,4,7,Lost
72341,415,76,407,3,5,5,13,Loyal Users
72460,39,99,293,5,5,5,15,Champions
72467,2464,7,13,1,2,1,4,Lost
72507,270,55,152,3,5,5,13,Loyal Users
72677,330,51,155,3,5,5,13,Loyal Users
72738,122,93,218,4,5,5,14,Champions
72862,1957,11,19,1,2,2,5,Lost
72936,1563,14,178,1,3,5,9,Casual Users
73117,5617,8,8,1,2,1,4,Lost
73545,117,64,132,4,5,4,13,Champions
73754,1126,34,88,2,4,4,10,At Risk
73979,1119,18,21,2,3,2,7,Casual Users
75184,393,25,49,3,4,3,10,Loyal Users
75738,331,5,8,3,1,1,5,Casual Users
76116,116,37,76,4,4,4,12,Champions
76205,2991,7,18,1,2,2,5,Lost
76230,163,12,12,4,3,1,8,Loyal Users
76266,1722,18,104,1,3,4,8,Casual Users
77826,145,59,247,4,5,5,14,Champions
77829,289,21,56,3,3,3,9,Loyal Users
77866,674,17,29,2,3,2,7,Casual Users
78174,106,27,118,4,4,4,12,Champions
78267,416,23,39,3,4,3,10,Loyal Users
66124,1092,31,99,2,4,4,10,At Risk
66205,69,125,396,5,5,5,15,Champions
66298,1887,5,5,1,1,1,3,Lost
66391,1670,5,5,1,1,1,3,Lost
66403,0,65,168,5,5,5,15,Champions
66449,1376,6,9,1,1,1,3,Lost
66606,135,7,20,4,2,2,8,Promising
66774,156,10,28,4,2,2,8,Promising
67539,242,14,32,3,3,3,9,Loyal Users
67631,233,23,33,3,4,3,10,Loyal Users
68496,374,30,41,3,4,3,10,Loyal Users
68682,1028,28,108,2,4,4,10,At Risk
68770,119,7,7,4,2,1,7,Promising
68952,840,5,7,2,1,1,4,Lost
69266,1284,12,63,1,3,4,8,Casual Users
69451,527,9,39,2,2,3,7,Lost
69479,16,77,476,5,5,5,15,Champions
69605,119,38,69,4,4,4,12,Champions
69706,726,10,17,2,2,2,6,Lost
69710,5,12,26,5,3,2,10,Loyal Users
69782,2547,6,12,1,1,1,3,Lost
69904,549,17,28,2,3,2,7,Casual Users
69944,36,31,53,5,4,3,12,Loyal Users
70088,5,31,59,5,4,3,12,Loyal Users
70405,11,46,146,5,5,4,14,Champions
70509,616,9,22,2,2,2,6,Lost
70584,50,53,201,5,5,5,15,Champions
70924,306,22,58,3,4,3,10,Loyal Users
71513,94,115,305,4,5,5,14,Champions
71682,1668,12,27,1,3,2,6,Casual Users
71766,112,23,101,4,4,4,12,Champions
71839,1109,22,89,2,4,4,10,At Risk
71887,420,11,50,3,2,3,8,Casual Users
72115,14,11,21,5,2,2,9,Promising
73202,1137,6,7,2,1,1,4,Lost
73236,3102,6,26,1,1,2,4,Lost
73406,38,59,105,5,5,4,14,Champions
73466,24,14,132,5,3,4,12,Loyal Users
73946,429,92,140,3,5,4,12,Loyal Users
74048,181,26,37,3,4,3,10,Loyal Users
74518,504,28,169,2,4,5,11,At Risk
75096,5,58,93,5,5,4,14,Champions
75128,19,39,96,5,4,4,13,Champions
75862,403,21,33,3,3,3,9,Loyal Users
76383,0,58,138,5,5,4,14,Champions
76544,41,92,260,5,5,5,15,Champions
76567,39,8,15,5,2,1,8,Promising
76626,1572,12,18,1,3,2,6,Casual Users
77274,842,5,27,2,1,2,5,Lost
77286,1708,7,16,1,2,2,5,Lost
77578,289,53,94,3,5,4,12,Loyal Users
77918,91,148,475,4,5,5,14,Champions
77992,827,8,43,2,2,3,7,Lost
77994,27,72,284,5,5,5,15,Champions
78044,7,35,76,5,4,4,13,Champions
78142,742,6,13,2,1,1,4,Lost
65561,114,8,51,4,2,3,9,Promising
65583,27,81,252,5,5,5,15,Champions
65616,356,47,120,3,5,4,12,Loyal Users
65815,214,30,136,3,4,4,11,Loyal Users
66047,25,51,95,5,5,4,14,Champions
66718,754,11,22,2,2,2,6,Lost
66780,2108,9,27,1,2,2,5,Lost
66838,4594,9,9,1,2,1,4,Lost
66864,694,18,24,2,3,2,7,Casual Users
66961,853,34,158,2,4,5,11,At Risk
67030,221,9,20,3,2,2,7,Casual Users
67204,3895,6,13,1,1,1,3,Lost
67283,156,7,12,4,2,1,7,Promising
67551,102,118,231,4,5,5,14,Champions
67577,133,12,34,4,3,3,10,Loyal Users
68329,549,5,15,2,1,1,4,Lost
68435,110,28,55,4,4,3,11,Loyal Users
68766,250,51,240,3,5,5,13,Loyal Users
68916,398,9,12,3,2,1,6,Casual Users
69025,96,34,109,4,4,4,12,Champions
69443,148,7,9,4,2,1,7,Promising
69471,98,14,17,4,3,2,9,Loyal Users
69771,145,19,31,4,3,2,9,Loyal Users
70004,822,13,40,2,3,3,8,Casual Users
71233,1012,5,20,2,1,2,5,Lost
71551,582,10,31,2,2,2,6,Lost
71715,471,61,172,2,5,5,12,At Risk
71755,20,12,13,5,3,1,9,Loyal Users
71926,142,72,137,4,5,4,13,Champions
72004,843,8,21,2,2,2,6,Lost
72174,5410,6,16,1,1,2,4,Lost
72199,163,13,25,4,3,2,9,Loyal Users
72486,6,161,302,5,5,5,15,Champions
72598,255,15,26,3,3,2,8,Loyal Users
72803,362,33,108,3,4,4,11,Loyal Users
72925,117,78,262,4,5,5,14,Champions
72972,51,23,60,5,4,3,12,Loyal Users
73261,796,8,53,2,2,3,7,Lost
73333,995,11,24,2,2,2,6,Lost
73456,440,29,106,3,4,4,11,Loyal Users
73472,151,15,35,4,3,3,10,Loyal Users
73512,124,35,181,4,4,5,13,Champions
73885,3,49,172,5,5,5,15,Champions
73892,2990,6,11,1,1,1,3,Lost
73968,6,54,310,5,5,5,15,Champions
74157,418,13,85,3,3,4,10,Loyal Users
74430,287,30,65,3,4,4,11,Loyal Users
74673,269,8,11,3,2,1,6,Casual Users
74761,121,20,50,4,3,3,10,Loyal Users
75020,226,46,90,3,5,4,12,Loyal Users
75030,419,6,16,3,1,2,6,Casual Users
75356,121,31,157,4,4,5,13,Champions
75398,401,25,166,3,4,5,12,Loyal Users
75575,19,26,85,5,4,4,13,Champions
76327,1011,5,11,2,1,1,4,Lost
76423,1838,8,30,1,2,2,5,Lost
76459,450,21,66,3,3,4,10,Loyal Users
77711,3403,6,14,1,1,1,3,Lost
77770,432,7,9,3,2,1,6,Casual Users
77876,118,30,42,4,4,3,11,Loyal Users
77889,131,7,17,4,2,2,8,Promising
78203,74,30,37,4,4,3,11,Loyal Users
66053,421,30,242,3,4,5,12,Loyal Users
66165,523,6,33,2,1,3,6,Lost
66238,0,28,160,5,4,5,14,Champions
66825,85,5,7,4,1,1,6,Promising
67071,0,41,238,5,4,5,14,Champions
67117,828,15,87,2,3,4,9,Casual Users
67181,1770,19,37,1,3,3,7,Casual Users
67368,3096,16,47,1,3,3,7,Casual Users
67462,8,49,95,5,5,4,14,Champions
67484,113,66,181,4,5,5,14,Champions
67520,4527,5,6,1,1,1,3,Lost
67697,292,8,28,3,2,2,7,Casual Users
67834,50,119,592,5,5,5,15,Champions
68181,28,70,375,5,5,5,15,Champions
68286,134,25,124,4,4,4,12,Champions
68319,113,41,172,4,4,5,13,Champions
68347,13,73,237,5,5,5,15,Champions
68494,70,111,235,4,5,5,14,Champions
68507,126,66,189,4,5,5,14,Champions
68547,392,11,18,3,2,2,7,Casual Users
68566,487,42,78,2,4,4,10,At Risk
68639,353,8,30,3,2,2,7,Casual Users
69926,133,73,370,4,5,5,14,Champions
70186,55,58,114,5,5,4,14,Champions
70326,57,228,487,5,5,5,15,Champions
70580,545,14,44,2,3,3,8,Casual Users
70627,928,6,10,2,1,1,4,Lost
70726,958,6,7,2,1,1,4,Lost
70822,132,24,72,4,4,4,12,Champions
71003,1127,36,112,2,4,4,10,At Risk
71049,245,12,27,3,3,2,8,Loyal Users
71384,1798,5,13,1,1,1,3,Lost
71514,707,84,157,2,5,5,12,At Risk
71594,349,10,53,3,2,3,8,Casual Users
71711,104,7,25,4,2,2,8,Promising
71784,24,39,69,5,4,4,13,Champions
71851,692,11,45,2,2,3,7,Lost
71965,213,60,244,3,5,5,13,Loyal Users
72018,354,10,58,3,2,3,8,Casual Users
72068,411,11,14,3,2,1,6,Casual Users
72155,2571,8,16,1,2,2,5,Lost
72428,403,11,19,3,2,2,7,Casual Users
72506,844,13,33,2,3,3,8,Casual Users
72632,390,113,304,3,5,5,13,Loyal Users
72644,50,55,116,5,5,4,14,Champions
72690,1578,9,40,1,2,3,6,Lost
72878,1126,8,26,2,2,2,6,Lost
72932,145,57,160,4,5,5,14,Champions
73256,5553,6,8,1,1,1,3,Lost
73411,429,5,7,3,1,1,5,Casual Users
73638,23,89,283,5,5,5,15,Champions
73942,14,54,145,5,5,4,14,Champions
74403,745,14,80,2,3,4,9,Casual Users
74412,120,54,143,4,5,4,13,Champions
74551,282,81,108,3,5,4,12,Loyal Users
74850,121,17,40,4,3,3,10,Loyal Users
74988,557,13,18,2,3,2,7,Casual Users
75135,82,66,158,4,5,5,14,Champions
75405,700,8,19,2,2,2,6,Lost
75619,606,5,11,2,1,1,4,Lost
75782,176,18,29,3,3,2,8,Loyal Users
75822,119,9,25,4,2,2,8,Promising
76010,207,5,24,3,1,2,6,Casual Users
76039,149,15,32,4,3,3,10,Loyal Users
76232,10,86,244,5,5,5,15,Champions
76237,408,26,148,3,4,5,12,Loyal Users
76390,828,6,10,2,1,1,4,Lost
76623,1253,14,27,2,3,2,7,Casual Users
76624,278,6,15,3,1,1,5,Casual Users
76628,109,42,176,4,4,5,13,Champions
76631,1138,7,7,2,2,1,5,Lost
76873,4070,5,17,1,1,2,4,Lost
77393,30,30,87,5,4,4,13,Champions
77670,3866,9,13,1,2,1,4,Lost
65682,70,84,547,4,5,5,14,Champions
65756,677,18,59,2,3,3,8,Casual Users
65968,2355,8,19,1,2,2,5,Lost
66452,3,100,721,5,5,5,15,Champions
66517,118,15,51,4,3,3,10,Loyal Users
66587,1260,22,49,1,4,3,8,At Risk
66859,124,15,43,4,3,3,10,Loyal Users
67042,844,23,26,2,4,2,8,At Risk
67112,643,12,62,2,3,3,8,Casual Users
67343,104,5,12,4,1,1,6,Promising
67525,101,11,48,4,2,3,9,Promising
67676,2669,10,16,1,2,2,5,Lost
67684,126,44,163,4,4,5,13,Champions
68020,3814,24,82,1,4,4,9,At Risk
68492,178,91,171,3,5,5,13,Loyal Users
68543,30,215,679,5,5,5,15,Champions
68761,186,33,86,3,4,4,11,Loyal Users
68903,141,11,16,4,2,2,8,Promising
69037,453,8,27,3,2,2,7,Casual Users
69213,347,12,35,3,3,3,9,Loyal Users
69400,7,11,41,5,2,3,10,Promising
69729,941,12,56,2,3,3,8,Casual Users
69732,11,66,114,5,5,4,14,Champions
69775,2855,9,9,1,2,1,4,Lost
69826,541,8,36,2,2,3,7,Lost
69861,2722,45,82,1,4,4,9,At Risk
69976,283,13,51,3,3,3,9,Loyal Users
70440,667,5,18,2,1,2,5,Lost
70640,587,9,19,2,2,2,6,Lost
70706,283,37,94,3,4,4,11,Loyal Users
70975,9,113,328,5,5,5,15,Champions
70993,2261,7,8,1,2,1,4,Lost
71072,89,61,161,4,5,5,14,Champions
71496,601,42,270,2,4,5,11,At Risk
71604,55,52,171,5,5,5,15,Champions
71912,34,68,352,5,5,5,15,Champions
71957,182,166,442,3,5,5,13,Loyal Users
72328,626,17,33,2,3,3,8,Casual Users
72358,133,10,37,4,2,3,9,Promising
72395,189,31,88,3,4,4,11,Loyal Users
72931,915,13,56,2,3,3,8,Casual Users
73023,115,35,158,4,4,5,13,Champions
73049,543,6,13,2,1,1,4,Lost
73099,72,37,111,4,4,4,12,Champions
73245,3103,12,29,1,3,2,6,Casual Users
73412,77,74,129,4,5,4,13,Champions
73956,3491,5,96,1,1,4,6,Lost
73971,170,16,109,3,3,4,10,Loyal Users
74240,540,17,17,2,3,2,7,Casual Users
74320,47,73,259,5,5,5,15,Champions
74386,114,17,20,4,3,2,9,Loyal Users
74468,102,87,134,4,5,4,13,Champions
74811,915,51,327,2,5,5,12,At Risk
74932,151,12,19,4,3,2,9,Loyal Users
75299,520,48,66,2,5,4,11,At Risk
75749,4412,7,42,1,2,3,6,Lost
76270,117,6,49,4,1,3,8,Promising
76891,9,8,20,5,2,2,9,Promising
77033,327,20,130,3,3,4,10,Loyal Users
77331,121,30,37,4,4,3,11,Loyal Users
77533,416,9,26,3,2,2,7,Casual Users
77613,2296,6,10,1,1,1,3,Lost
77716,1151,9,25,2,2,2,6,Lost
77783,406,22,34,3,4,3,10,Loyal Users
77793,1434,13,21,1,3,2,6,Casual Users
77796,842,8,12,2,2,1,5,Lost
77887,207,28,78,3,4,4,11,Loyal Users
77956,416,20,65,3,3,4,10,Loyal Users
78129,364,9,16,3,2,2,7,Casual Users
78144,786,13,19,2,3,2,7,Casual Users
78256,1869,39,131,1,4,4,9,At Risk
65557,275,6,8,3,1,1,5,Casual Users
65667,6143,7,7,1,2,1,4,Lost
65946,90,18,36,4,3,3,10,Loyal Users
66004,135,11,13,4,2,1,7,Promising
66442,113,146,279,4,5,5,14,Champions
66495,6,77,225,5,5,5,15,Champions
66743,1269,7,10,1,2,1,4,Lost
67104,115,23,98,4,4,4,12,Champions
67266,4424,18,18,1,3,2,6,Casual Users
67286,1576,13,17,1,3,2,6,Casual Users
67712,772,18,44,2,3,3,8,Casual Users
67831,28,27,135,5,4,4,13,Champions
68312,124,40,85,4,4,4,12,Champions
68358,281,39,158,3,4,5,12,Loyal Users
68654,264,41,151,3,4,5,12,Loyal Users
69325,154,51,99,4,5,4,13,Champions
69492,202,19,48,3,3,3,9,Loyal Users
69552,162,20,112,4,3,4,11,Loyal Users
69797,150,10,212,4,2,5,11,Promising
70177,1989,26,28,1,4,2,7,At Risk
70328,16,85,358,5,5,5,15,Champions
70385,77,11,141,4,2,4,10,Promising
70846,179,77,146,3,5,4,12,Loyal Users
71068,1454,8,37,1,2,3,6,Lost
71278,26,44,216,5,4,5,14,Champions
71279,82,103,388,4,5,5,14,Champions
71357,156,15,24,4,3,2,9,Loyal Users
71471,954,12,27,2,3,2,7,Casual Users
71798,42,12,74,5,3,4,12,Loyal Users
71813,5838,5,8,1,1,1,3,Lost
71826,2379,5,7,1,1,1,3,Lost
72059,252,7,10,3,2,1,6,Casual Users
72563,54,21,27,5,3,2,10,Loyal Users
72571,737,19,84,2,3,4,9,Casual Users
72797,663,5,8,2,1,1,4,Lost
72924,1128,15,51,2,3,3,8,Casual Users
73384,589,28,65,2,4,4,10,At Risk
73529,3010,9,24,1,2,2,5,Lost
73667,570,22,38,2,4,3,9,At Risk
73757,17,71,281,5,5,5,15,Champions
73823,10,67,203,5,5,5,15,Champions
74081,422,38,173,3,4,5,12,Loyal Users
74152,388,9,28,3,2,2,7,Casual Users
74387,4812,7,27,1,2,2,5,Lost
74536,75,43,87,4,4,4,12,Champions
74753,1667,7,14,1,2,1,4,Lost
74803,67,125,346,5,5,5,15,Champions
74877,15,61,230,5,5,5,15,Champions
74935,0,8,32,5,2,3,10,Promising
75235,3040,5,15,1,1,1,3,Lost
75467,835,15,22,2,3,2,7,Casual Users
75687,1589,7,12,1,2,1,4,Lost
75968,35,21,31,5,3,2,10,Loyal Users
76505,415,14,56,3,3,3,9,Loyal Users
76586,27,83,252,5,5,5,15,Champions
76634,63,107,570,5,5,5,15,Champions
76823,152,34,89,4,4,4,12,Champions
76870,81,24,35,4,4,3,11,Loyal Users
76927,33,76,270,5,5,5,15,Champions
77073,366,31,286,3,4,5,12,Loyal Users
77075,8,69,241,5,5,5,15,Champions
77600,29,6,11,5,1,1,7,Promising
77605,2510,34,207,1,4,5,10,At Risk
77685,837,12,32,2,3,3,8,Casual Users
77696,1,38,85,5,4,4,13,Champions
77767,272,22,71,3,4,4,11,Loyal Users
77870,11,130,280,5,5,5,15,Champions
77937,148,12,52,4,3,3,10,Loyal Users
77953,92,75,423,4,5,5,14,Champions
78073,830,52,279,2,5,5,12,At Risk
65434,2111,44,320,1,4,5,10,At Risk
65540,390,50,134,3,5,4,12,Loyal Users
66207,406,53,181,3,5,5,13,Loyal Users
66241,157,27,42,4,4,3,11,Loyal Users
66352,122,104,231,4,5,5,14,Champions
66565,141,157,288,4,5,5,14,Champions
66734,3,172,1081,5,5,5,15,Champions
67284,396,10,29,3,2,2,7,Casual Users
67324,3352,7,7,1,2,1,4,Lost
67563,167,83,139,3,5,4,12,Loyal Users
67736,44,41,118,5,4,4,13,Champions
67936,430,64,204,3,5,5,13,Loyal Users
68016,57,81,170,5,5,5,15,Champions
68059,1826,5,5,1,1,1,3,Lost
68385,466,32,127,3,4,4,11,Loyal Users
68434,102,9,31,4,2,2,8,Promising
68852,3393,54,249,1,5,5,11,At Risk
68917,282,7,33,3,2,3,8,Casual Users
69006,24,31,54,5,4,3,12,Loyal Users
69276,423,16,30,3,3,2,8,Loyal Users
69907,1155,5,14,2,1,1,4,Lost
70678,441,32,134,3,4,4,11,Loyal Users
70680,1302,11,71,1,2,4,7,Lost
70806,102,22,76,4,4,4,12,Champions
70851,1598,8,16,1,2,2,5,Lost
70968,598,7,16,2,2,2,6,Lost
71596,363,20,34,3,3,3,9,Loyal Users
71663,154,12,24,4,3,2,9,Loyal Users
71855,73,196,677,4,5,5,14,Champions
72161,25,165,384,5,5,5,15,Champions
72872,35,15,18,5,3,2,10,Loyal Users
73096,18,11,18,5,2,2,9,Promising
73477,152,29,37,4,4,3,11,Loyal Users
73695,1722,52,79,1,5,4,10,At Risk
73879,111,20,46,4,3,3,10,Loyal Users
73903,117,7,20,4,2,2,8,Promising
74086,306,21,240,3,3,5,11,Loyal Users
74092,113,37,133,4,4,4,12,Champions
74462,108,11,36,4,2,3,9,Promising
74476,216,12,26,3,3,2,8,Loyal Users
74580,2684,16,84,1,3,4,8,Casual Users
74967,457,13,16,3,3,2,8,Loyal Users
75150,123,18,44,4,3,3,10,Loyal Users
75376,126,5,25,4,1,2,7,Promising
75926,4012,6,6,1,1,1,3,Lost
75935,24,40,264,5,4,5,14,Champions
77467,17,70,264,5,5,5,15,Champions
77632,5,135,832,5,5,5,15,Champions
77969,642,6,64,2,1,4,7,Lost
78137,4238,16,82,1,3,4,8,Casual Users
65487,1638,11,26,1,2,2,5,Lost
65813,239,5,6,3,1,1,5,Casual Users
65947,2978,5,9,1,1,1,3,Lost
66135,370,7,31,3,2,2,7,Casual Users
66283,2604,10,29,1,2,2,5,Lost
66553,368,8,10,3,2,1,6,Casual Users
66557,101,131,716,4,5,5,14,Champions
66929,631,55,167,2,5,5,12,At Risk
67280,130,55,358,4,5,5,14,Champions
67290,831,48,153,2,5,5,12,At Risk
67491,1665,25,28,1,4,2,7,At Risk
67553,1313,36,130,1,4,4,9,At Risk
67562,176,9,19,3,2,2,7,Casual Users
67858,54,87,169,5,5,5,15,Champions
67954,311,13,19,3,3,2,8,Loyal Users
68344,3498,8,26,1,2,2,5,Lost
68461,416,35,267,3,4,5,12,Loyal Users
68596,412,10,49,3,2,3,8,Casual Users
68663,146,45,159,4,4,5,13,Champions
69084,443,9,33,3,2,3,8,Casual Users
69115,196,12,14,3,3,1,7,Loyal Users
69189,885,7,52,2,2,3,7,Lost
69675,1691,9,33,1,2,3,6,Lost
69707,112,5,10,4,1,1,6,Promising
69840,371,29,67,3,4,4,11,Loyal Users
70550,141,44,98,4,4,4,12,Champions
70630,1,27,129,5,4,4,13,Champions
70942,125,36,85,4,4,4,12,Champions
71001,3700,11,47,1,2,3,6,Lost
71224,2,15,22,5,3,2,10,Loyal Users
71311,360,38,108,3,4,4,11,Loyal Users
71778,6,6,6,5,1,1,7,Promising
71964,3485,11,13,1,2,1,4,Lost
72055,196,18,42,3,3,3,9,Loyal Users
72404,126,65,113,4,5,4,13,Champions
72700,593,6,22,2,1,2,5,Lost
73006,14,10,52,5,2,3,10,Promising
73060,4649,5,6,1,1,1,3,Lost
73226,6,142,643,5,5,5,15,Champions
73272,1066,12,215,2,3,5,10,Casual Users
73318,60,43,102,5,4,4,13,Champions
73665,33,51,120,5,5,4,14,Champions
73677,732,8,8,2,2,1,5,Lost
74268,3949,7,17,1,2,2,5,Lost
74287,140,52,166,4,5,5,14,Champions
74410,68,25,144,5,4,4,13,Champions
74457,678,26,37,2,4,3,9,At Risk
74727,33,99,214,5,5,5,15,Champions
75067,119,35,89,4,4,4,12,Champions
75317,113,15,20,4,3,2,9,Loyal Users
75553,2602,5,29,1,1,2,4,Lost
75856,147,9,21,4,2,2,8,Promising
75889,35,127,276,5,5,5,15,Champions
75942,135,98,175,4,5,5,14,Champions
75978,109,30,108,4,4,4,12,Champions
76227,2806,5,12,1,1,1,3,Lost
76347,107,53,465,4,5,5,14,Champions
76605,137,32,98,4,4,4,12,Champions
76765,856,60,112,2,5,4,11,At Risk
77022,298,8,9,3,2,1,6,Casual Users
77125,4266,7,7,1,2,1,4,Lost
77266,379,20,31,3,3,2,8,Loyal Users
77382,439,13,27,3,3,2,8,Loyal Users
77410,87,20,53,4,3,3,10,Loyal Users
77720,20,20,33,5,3,3,11,Loyal Users
78116,69,58,193,5,5,5,15,Champions
78224,95,63,144,4,5,4,13,Champions
65544,266,21,101,3,3,4,10,Loyal Users
65551,7,68,314,5,5,5,15,Champions
65728,12,7,31,5,2,2,9,Promising
66253,119,40,236,4,4,5,13,Champions
66851,246,14,28,3,3,2,8,Loyal Users
66858,165,83,310,4,5,5,14,Champions
67015,2,5,9,5,1,1,7,Promising
67090,1888,8,14,1,2,1,4,Lost
67121,856,46,185,2,5,5,12,At Risk
67792,808,44,114,2,4,4,10,At Risk
67816,29,124,352,5,5,5,15,Champions
67974,69,17,23,5,3,2,10,Loyal Users
68014,944,11,43,2,2,3,7,Lost
68216,88,5,6,4,1,1,6,Promising
68274,474,49,171,2,5,5,12,At Risk
68439,95,83,264,4,5,5,14,Champions
68593,2458,5,17,1,1,2,4,Lost
68754,1008,11,86,2,2,4,8,Lost
68772,221,81,543,3,5,5,13,Loyal Users
68799,1008,11,62,2,2,3,7,Lost
68825,852,19,35,2,3,3,8,Casual Users
69437,272,13,57,3,3,3,9,Loyal Users
69512,1374,7,18,1,2,2,5,Lost
69521,568,6,17,2,1,2,5,Lost
70587,431,6,8,3,1,1,5,Casual Users
70633,0,176,513,5,5,5,15,Champions
70754,418,14,28,3,3,2,8,Loyal Users
71130,1152,11,84,2,2,4,8,Lost
71402,216,66,333,3,5,5,13,Loyal Users
71573,1267,10,45,1,2,3,6,Lost
71597,138,35,113,4,4,4,12,Champions
72195,426,9,18,3,2,2,7,Casual Users
72456,151,9,17,4,2,2,8,Promising
72505,401,6,20,3,1,2,6,Casual Users
72622,164,49,461,4,5,5,14,Champions
72657,1839,5,10,1,1,1,3,Lost
73175,23,55,101,5,5,4,14,Champions
73283,420,6,7,3,1,1,5,Casual Users
73671,1407,10,11,1,2,1,4,Lost
73944,83,56,233,4,5,5,14,Champions
73986,1985,5,8,1,1,1,3,Lost
74082,1955,10,139,1,2,4,7,Lost
74277,15,114,306,5,5,5,15,Champions
74721,1254,10,46,2,2,3,7,Lost
75111,108,41,132,4,4,4,12,Champions
75503,949,34,60,2,4,3,9,At Risk
75859,254,12,55,3,3,3,9,Loyal Users
75952,118,21,27,4,3,2,9,Loyal Users
76001,621,7,12,2,2,1,5,Lost
76167,3973,6,13,1,1,1,3,Lost
76253,4090,10,34,1,2,3,6,Lost
76316,402,23,112,3,4,4,11,Loyal Users
76658,1024,8,22,2,2,2,6,Lost
76760,146,24,59,4,4,3,11,Loyal Users
76894,143,42,80,4,4,4,12,Champions
77296,168,39,118,3,4,4,11,Loyal Users
77347,509,8,16,2,2,2,6,Lost
77728,158,87,403,4,5,5,14,Champions
77981,39,102,223,5,5,5,15,Champions
78031,1,14,63,5,3,4,12,Loyal Users
78109,30,103,205,5,5,5,15,Champions
65438,2827,6,16,1,1,2,4,Lost
65673,160,6,22,4,1,2,7,Promising
65695,441,20,59,3,3,3,9,Loyal Users
65762,145,10,36,4,2,3,9,Promising
65928,408,26,145,3,4,4,11,Loyal Users
66103,110,53,116,4,5,4,13,Champions
66217,4428,27,51,1,4,3,8,At Risk
66219,15,174,422,5,5,5,15,Champions
67202,108,6,15,4,1,1,6,Promising
67668,3,150,762,5,5,5,15,Champions
67696,289,5,20,3,1,2,6,Casual Users
68122,97,45,89,4,4,4,12,Champions
68253,3124,9,13,1,2,1,4,Lost
68585,102,47,247,4,5,5,14,Champions
68649,141,44,98,4,4,4,12,Champions
68680,343,5,8,3,1,1,5,Casual Users
68700,3180,11,32,1,2,3,6,Lost
68864,847,21,48,2,3,3,8,Casual Users
69056,429,6,10,3,1,1,5,Casual Users
69617,0,133,179,5,5,5,15,Champions
69691,313,14,51,3,3,3,9,Loyal Users
70009,598,22,28,2,4,2,8,At Risk
70290,411,23,97,3,4,4,11,Loyal Users
70343,46,40,126,5,4,4,13,Champions
70759,461,6,16,3,1,2,6,Casual Users
70936,506,5,11,2,1,1,4,Lost
71214,1087,8,9,2,2,1,5,Lost
71512,271,27,76,3,4,4,11,Loyal Users
72039,2,52,210,5,5,5,15,Champions
72275,2223,5,10,1,1,1,3,Lost
72280,3111,12,69,1,3,4,8,Casual Users
72405,28,147,603,5,5,5,15,Champions
72474,17,75,227,5,5,5,15,Champions
72970,3249,5,6,1,1,1,3,Lost
73180,4,46,131,5,5,4,14,Champions
73301,85,67,152,4,5,5,14,Champions
73709,1149,5,19,2,1,2,5,Lost
74252,864,9,20,2,2,2,6,Lost
74573,432,13,22,3,3,2,8,Loyal Users
74613,501,68,183,2,5,5,12,At Risk
74614,3003,10,10,1,2,1,4,Lost
74873,1123,11,19,2,2,2,6,Lost
74975,684,13,24,2,3,2,7,Casual Users
75031,75,38,99,4,4,4,12,Champions
75058,1414,6,12,1,1,1,3,Lost
75059,108,16,25,4,3,2,9,Loyal Users
75514,159,8,53,4,2,3,9,Promising
75701,858,10,13,2,2,1,5,Lost
75773,280,14,18,3,3,2,8,Loyal Users
75800,2491,6,11,1,1,1,3,Lost
75945,95,9,9,4,2,1,7,Promising
76058,7,55,117,5,5,4,14,Champions
76128,1579,5,11,1,1,1,3,Lost
76498,3292,15,61,1,3,3,7,Casual Users
76512,391,7,9,3,2,1,6,Casual Users
76860,882,6,16,2,1,2,5,Lost
76996,159,10,61,4,2,3,9,Promising
77036,38,13,32,5,3,3,11,Loyal Users
77732,275,20,41,3,3,3,9,Loyal Users
77787,134,14,33,4,3,3,10,Loyal Users
77990,2264,7,7,1,2,1,4,Lost
65484,2297,7,148,1,2,5,8,Lost
65537,2031,5,9,1,1,1,3,Lost
65635,30,95,373,5,5,5,15,Champions
65782,91,12,84,4,3,4,11,Loyal Users
65914,12,13,45,5,3,3,11,Loyal Users
65939,1570,8,43,1,2,3,6,Lost
66178,158,5,10,4,1,1,6,Promising
66243,38,10,24,5,2,2,9,Promising
66271,2076,9,29,1,2,2,5,Lost
66776,294,10,12,3,2,1,6,Casual Users
67007,2014,9,28,1,2,2,5,Lost
67315,3817,7,23,1,2,2,5,Lost
67327,2009,10,28,1,2,2,5,Lost
67623,105,68,198,4,5,5,14,Champions
67791,398,13,22,3,3,2,8,Loyal Users
68277,6,67,129,5,5,4,14,Champions
68280,8,16,99,5,3,4,12,Loyal Users
68412,296,48,89,3,5,4,12,Loyal Users
68448,225,19,53,3,3,3,9,Loyal Users
68703,4,115,459,5,5,5,15,Champions
68771,109,8,9,4,2,1,7,Promising
68867,1997,7,13,1,2,1,4,Lost
69702,22,160,335,5,5,5,15,Champions
69936,2979,6,12,1,1,1,3,Lost
69984,19,7,16,5,2,2,9,Promising
70524,306,27,102,3,4,4,11,Loyal Users
70540,1346,13,30,1,3,2,6,Casual Users
71039,511,9,43,2,2,3,7,Lost
71069,1695,12,17,1,3,2,6,Casual Users
71196,412,29,97,3,4,4,11,Loyal Users
71575,5,10,61,5,2,3,10,Promising
71593,238,8,61,3,2,3,8,Casual Users
71608,50,15,124,5,3,4,12,Loyal Users
71824,1423,17,60,1,3,3,7,Casual Users
72080,11,19,66,5,3,4,12,Loyal Users
72153,969,12,41,2,3,3,8,Casual Users
72430,265,23,53,3,4,3,10,Loyal Users
72501,280,12,34,3,3,3,9,Loyal Users
72749,438,40,114,3,4,4,11,Loyal Users
72945,2305,16,31,1,3,2,6,Casual Users
72973,137,44,57,4,4,3,11,Loyal Users
73336,28,6,9,5,1,1,7,Promising
73378,459,154,779,3,5,5,13,Loyal Users
73425,1267,5,11,1,1,1,3,Lost
73585,85,28,52,4,4,3,11,Loyal Users
74059,262,8,9,3,2,1,6,Casual Users
74534,1013,8,16,2,2,2,6,Lost
74839,52,52,305,5,5,5,15,Champions
75195,865,8,9,2,2,1,5,Lost
75264,1986,5,5,1,1,1,3,Lost
75268,86,46,129,4,5,4,13,Champions
75448,102,64,165,4,5,5,14,Champions
75680,26,9,9,5,2,1,8,Promising
75932,126,16,35,4,3,3,10,Loyal Users
76002,665,9,9,2,2,1,5,Lost
76003,4577,7,12,1,2,1,4,Lost
76067,1012,40,43,2,4,3,9,At Risk
76068,1626,18,145,1,3,4,8,Casual Users
76715,275,9,22,3,2,2,7,Casual Users
76852,99,26,45,4,4,3,11,Loyal Users
76898,2540,14,26,1,3,2,6,Casual Users
77278,997,5,11,2,1,1,4,Lost
77478,1406,7,10,1,2,1,4,Lost
77556,9,6,25,5,1,2,8,Promising
77917,56,14,16,5,3,2,10,Loyal Users
77951,554,66,112,2,5,4,11,At Risk
78131,301,19,25,3,3,2,8,Loyal Users
78153,8,56,69,5,5,4,14,Champions
66570,258,12,35,3,3,3,9,Loyal Users
66669,115,12,21,4,3,2,9,Loyal Users
66908,379,18,40,3,3,3,9,Loyal Users
67122,1261,6,19,1,1,2,4,Lost
67353,592,17,67,2,3,4,9,Casual Users
68371,1576,5,5,1,1,1,3,Lost
68493,591,17,42,2,3,3,8,Casual Users
68506,303,16,19,3,3,2,8,Loyal Users
68526,217,59,198,3,5,5,13,Loyal Users
68527,111,11,31,4,2,2,8,Promising
69122,1,81,355,5,5,5,15,Champions
69140,122,18,25,4,3,2,9,Loyal Users
69228,1708,8,9,1,2,1,4,Lost
69339,896,12,28,2,3,2,7,Casual Users
69421,2774,11,59,1,2,3,6,Lost
69578,822,5,8,2,1,1,4,Lost
69883,594,16,54,2,3,3,8,Casual Users
70161,58,130,313,5,5,5,15,Champions
70504,48,45,100,5,4,4,13,Champions
71121,1722,15,138,1,3,4,8,Casual Users
71236,1428,31,64,1,4,4,9,At Risk
71408,3233,36,115,1,4,4,9,At Risk
71688,2131,14,21,1,3,2,6,Casual Users
71802,112,12,49,4,3,3,10,Loyal Users
72262,6,9,33,5,2,3,10,Promising
72359,823,8,23,2,2,2,6,Lost
72859,2094,53,81,1,5,4,10,At Risk
73370,1009,15,31,2,3,2,7,Casual Users
73506,4010,29,49,1,4,3,8,At Risk
73550,3567,9,37,1,2,3,6,Lost
74256,406,29,92,3,4,4,11,Loyal Users
74788,406,7,25,3,2,2,7,Casual Users
74921,148,14,72,4,3,4,11,Loyal Users
75231,588,16,34,2,3,3,8,Casual Users
75249,2437,6,20,1,1,2,4,Lost
75274,105,44,451,4,4,5,13,Champions
75797,1446,11,16,1,2,2,5,Lost
76044,709,15,38,2,3,3,8,Casual Users
77013,6,36,50,5,4,3,12,Loyal Users
77055,76,78,330,4,5,5,14,Champions
77357,150,9,28,4,2,2,8,Promising
77401,837,6,9,2,1,1,4,Lost
77740,276,26,74,3,4,4,11,Loyal Users
77909,125,10,44,4,2,3,9,Promising
78236,566,54,126,2,5,4,11,At Risk
66013,32,6,35,5,1,3,9,Promising
66505,20,92,151,5,5,5,15,Champions
66522,532,14,22,2,3,2,7,Casual Users
66630,0,48,129,5,5,4,14,Champions
66862,87,66,238,4,5,5,14,Champions
67560,1577,14,18,1,3,2,6,Casual Users
67749,4,48,205,5,5,5,15,Champions
67851,1300,5,12,1,1,1,3,Lost
67900,140,13,52,4,3,3,10,Loyal Users
67952,2098,14,25,1,3,2,6,Casual Users
67963,10,39,59,5,4,3,12,Loyal Users
68147,31,11,71,5,2,4,11,Promising
68246,41,117,290,5,5,5,15,Champions
68565,941,7,44,2,2,3,7,Lost
68676,833,5,8,2,1,1,4,Lost
68780,461,18,45,3,3,3,9,Loyal Users
69141,145,17,34,4,3,3,10,Loyal Users
69209,941,19,84,2,3,4,9,Casual Users
69473,2699,5,63,1,1,4,6,Lost
69854,833,8,20,2,2,2,6,Lost
70015,215,34,188,3,4,5,12,Loyal Users
70082,2747,6,6,1,1,1,3,Lost
70344,4,84,308,5,5,5,15,Champions
70907,3629,6,6,1,1,1,3,Lost
70965,579,72,261,2,5,5,12,At Risk
71103,290,33,83,3,4,4,11,Loyal Users
71467,2,56,173,5,5,5,15,Champions
71481,417,28,84,3,4,4,11,Loyal Users
71776,883,28,39,2,4,3,9,At Risk
71795,131,32,335,4,4,5,13,Champions
72172,11,139,517,5,5,5,15,Champions
72536,137,31,120,4,4,4,12,Champions
72790,12,47,177,5,5,5,15,Champions
73239,2,95,498,5,5,5,15,Champions
73428,1697,6,7,1,1,1,3,Lost
73813,429,12,29,3,3,2,8,Loyal Users
73893,956,15,120,2,3,4,9,Casual Users
74101,184,24,38,3,4,3,10,Loyal Users
74409,254,10,18,3,2,2,7,Casual Users
74791,730,17,56,2,3,3,8,Casual Users
74929,1427,7,7,1,2,1,4,Lost
75026,35,69,114,5,5,4,14,Champions
75087,1053,16,57,2,3,3,8,Casual Users
75091,26,89,641,5,5,5,15,Champions
75226,1533,11,35,1,2,3,6,Lost
75288,231,28,85,3,4,4,11,Loyal Users
75528,739,19,62,2,3,3,8,Casual Users
76129,138,31,44,4,4,3,11,Loyal Users
76404,1394,26,28,1,4,2,7,At Risk
76939,966,14,92,2,3,4,9,Casual Users
77044,5315,11,26,1,2,2,5,Lost
77069,97,33,74,4,4,4,12,Champions
77268,35,94,169,5,5,5,15,Champions
77320,233,20,104,3,3,4,10,Loyal Users
77328,842,33,48,2,4,3,9,At Risk
77412,138,81,265,4,5,5,14,Champions
77848,56,88,203,5,5,5,15,Champions
78115,3249,6,9,1,1,1,3,Lost
65453,1371,8,22,1,2,2,5,Lost
65558,543,27,67,2,4,4,10,At Risk
65577,729,14,79,2,3,4,9,Casual Users
65661,45,19,81,5,3,4,12,Loyal Users
65694,436,6,25,3,1,2,6,Casual Users
65804,1280,5,8,1,1,1,3,Lost
65816,845,84,186,2,5,5,12,At Risk
65864,725,21,42,2,3,3,8,Casual Users
66081,47,21,46,5,3,3,11,Loyal Users
66445,1222,32,42,2,4,3,9,At Risk
66768,861,48,110,2,5,4,11,At Risk
66813,713,6,38,2,1,3,6,Lost
66913,10,73,307,5,5,5,15,Champions
66925,37,48,89,5,5,4,14,Champions
67248,8,77,214,5,5,5,15,Champions
67383,3586,10,26,1,2,2,5,Lost
67581,89,61,169,4,5,5,14,Champions
67582,797,14,34,2,3,3,8,Casual Users
67879,503,10,23,2,2,2,6,Lost
68024,21,58,115,5,5,4,14,Champions
68114,36,61,151,5,5,5,15,Champions
68120,480,25,128,2,4,4,10,At Risk
68175,130,21,52,4,3,3,10,Loyal Users
68733,5,100,367,5,5,5,15,Champions
68870,176,30,75,3,4,4,11,Loyal Users
69427,115,10,19,4,2,2,8,Promising
69589,128,34,110,4,4,4,12,Champions
69604,890,23,56,2,4,3,9,At Risk
69673,87,15,25,4,3,2,9,Loyal Users
69740,1133,6,24,2,1,2,5,Lost
69794,31,5,6,5,1,1,7,Promising
69813,183,96,202,3,5,5,13,Loyal Users
69868,16,50,67,5,5,4,14,Champions
70275,946,56,176,2,5,5,12,At Risk
70371,2376,21,101,1,3,4,8,Casual Users
70396,2519,6,12,1,1,1,3,Lost
70400,3056,5,10,1,1,1,3,Lost
70417,1458,6,9,1,1,1,3,Lost
70884,2227,7,9,1,2,1,4,Lost
71071,1277,20,66,1,3,4,8,Casual Users
71129,126,34,168,4,4,5,13,Champions
71334,257,44,213,3,4,5,12,Loyal Users
71651,73,31,207,4,4,5,13,Champions
72072,1573,6,51,1,1,3,5,Lost
72074,68,57,122,5,5,4,14,Champions
72727,237,118,249,3,5,5,13,Loyal Users
73163,33,19,39,5,3,3,11,Loyal Users
73696,1134,11,16,2,2,2,6,Lost
73955,277,26,88,3,4,4,11,Loyal Users
74438,1842,15,79,1,3,4,8,Casual Users
75038,322,9,16,3,2,2,7,Casual Users
75156,1220,7,7,2,2,1,5,Lost
75211,532,7,16,2,2,2,6,Lost
75282,428,15,40,3,3,3,9,Loyal Users
75309,277,5,16,3,1,2,6,Casual Users
75363,26,97,258,5,5,5,15,Champions
75482,2027,8,24,1,2,2,5,Lost
76391,289,10,40,3,2,3,8,Casual Users
76445,76,48,155,4,5,5,14,Champions
76737,12,77,666,5,5,5,15,Champions
76987,1146,13,40,2,3,3,8,Casual Users
77115,236,98,200,3,5,5,13,Loyal Users
77293,3293,19,21,1,3,2,6,Casual Users
77927,63,12,140,5,3,4,12,Loyal Users
78002,91,41,66,4,4,4,12,Champions
78053,111,49,371,4,5,5,14,Champions
78123,317,34,115,3,4,4,11,Loyal Users
65829,660,18,47,2,3,3,8,Casual Users
65924,4739,59,115,1,5,4,10,At Risk
65954,6115,31,31,1,4,2,7,At Risk
65970,1123,11,13,2,2,1,5,Lost
66169,701,10,19,2,2,2,6,Lost
66194,43,15,44,5,3,3,11,Loyal Users
66300,6,72,178,5,5,5,15,Champions
66462,1137,10,12,2,2,1,5,Lost
66497,278,15,47,3,3,3,9,Loyal Users
66510,139,31,151,4,4,5,13,Champions
67048,50,21,82,5,3,4,12,Loyal Users
67084,28,64,234,5,5,5,15,Champions
67369,130,5,14,4,1,1,6,Promising
67604,37,68,228,5,5,5,15,Champions
67621,19,56,103,5,5,4,14,Champions
67763,682,8,30,2,2,2,6,Lost
67783,101,65,303,4,5,5,14,Champions
68512,421,11,41,3,2,3,8,Casual Users
68701,184,24,37,3,4,3,10,Loyal Users
68857,1429,48,221,1,5,5,11,At Risk
68944,5561,5,9,1,1,1,3,Lost
68960,2442,9,32,1,2,3,6,Lost
69517,845,8,62,2,2,3,7,Lost
69543,360,31,47,3,4,3,10,Loyal Users
69696,1929,5,38,1,1,3,5,Lost
69981,106,35,97,4,4,4,12,Champions
70002,899,5,16,2,1,2,5,Lost
70361,273,45,315,3,4,5,12,Loyal Users
70388,1504,10,28,1,2,2,5,Lost
70855,1589,9,12,1,2,1,4,Lost
71552,1796,9,10,1,2,1,4,Lost
72273,65,15,50,5,3,3,11,Loyal Users
72357,241,58,373,3,5,5,13,Loyal Users
72458,266,95,241,3,5,5,13,Loyal Users
72533,71,50,146,4,5,4,13,Champions
72647,241,6,11,3,1,1,5,Casual Users
72704,689,5,11,2,1,1,4,Lost
72805,451,22,28,3,4,2,9,Loyal Users
72807,19,16,38,5,3,3,11,Loyal Users
73219,529,6,8,2,1,1,4,Lost
73443,435,31,46,3,4,3,10,Loyal Users
73448,1303,126,394,1,5,5,11,At Risk
73476,943,8,12,2,2,1,5,Lost
73485,2,155,342,5,5,5,15,Champions
73624,2023,8,11,1,2,1,4,Lost
73708,1568,5,11,1,1,1,3,Lost
73715,294,5,9,3,1,1,5,Casual Users
73780,2290,10,29,1,2,2,5,Lost
74322,49,41,62,5,4,3,12,Loyal Users
74324,43,43,100,5,4,4,13,Champions
74467,14,138,221,5,5,5,15,Champions
74542,422,9,26,3,2,2,7,Casual Users
74611,562,22,55,2,4,3,9,At Risk
74909,822,39,171,2,4,5,11,At Risk
75171,65,17,39,5,3,3,11,Loyal Users
75456,338,6,36,3,1,3,7,Casual Users
75604,87,19,59,4,3,3,10,Loyal Users
75708,35,75,319,5,5,5,15,Champions
76212,81,12,20,4,3,2,9,Loyal Users
76400,85,11,18,4,2,2,8,Promising
76525,2410,15,30,1,3,2,6,Casual Users
76851,580,10,31,2,2,2,6,Lost
76964,9,64,233,5,5,5,15,Champions
77298,171,31,91,3,4,4,11,Loyal Users
77299,638,40,114,2,4,4,10,At Risk
77375,403,14,23,3,3,2,8,Loyal Users
77377,1124,9,21,2,2,2,6,Lost
77729,67,50,310,5,5,5,15,Champions
78208,2440,13,19,1,3,2,6,Casual Users
78209,1118,5,7,2,1,1,4,Lost
65693,1416,17,52,1,3,3,7,Casual Users
66432,1543,11,47,1,2,3,6,Lost
66439,966,10,18,2,2,2,6,Lost
67043,30,52,263,5,5,5,15,Champions
67098,282,29,43,3,4,3,10,Loyal Users
67237,275,8,13,3,2,1,6,Casual Users
67695,21,72,129,5,5,4,14,Champions
67905,159,7,10,4,2,1,7,Promising
68243,804,10,29,2,2,2,6,Lost
68301,1312,6,42,1,1,3,5,Lost
68495,110,43,71,4,4,4,12,Champions
68883,1143,16,26,2,3,2,7,Casual Users
69147,312,17,35,3,3,3,9,Loyal Users
69411,1529,8,9,1,2,1,4,Lost
69776,3014,13,26,1,3,2,6,Casual Users
69842,3578,6,16,1,1,2,4,Lost
69938,12,86,193,5,5,5,15,Champions
70475,2521,6,17,1,1,2,4,Lost
70598,143,21,34,4,3,3,10,Loyal Users
70989,25,126,376,5,5,5,15,Champions
71101,2649,11,64,1,2,4,7,Lost
71124,568,126,219,2,5,5,12,At Risk
71327,92,29,55,4,4,3,11,Loyal Users
71819,74,11,14,4,2,1,7,Promising
71878,1297,134,186,1,5,5,11,At Risk
72453,116,45,78,4,4,4,12,Champions
72882,2293,13,24,1,3,2,6,Casual Users
73061,2014,8,124,1,2,4,7,Lost
73063,15,64,150,5,5,5,15,Champions
73513,429,7,15,3,2,1,6,Casual Users
73535,1821,11,15,1,2,1,4,Lost
73540,201,59,239,3,5,5,13,Loyal Users
74189,1136,13,21,2,3,2,7,Casual Users
74481,125,36,233,4,4,5,13,Champions
74637,67,79,420,5,5,5,15,Champions
74650,2370,12,14,1,3,1,5,Casual Users
74666,125,72,177,4,5,5,14,Champions
75312,248,22,199,3,4,5,12,Loyal Users
75718,22,18,39,5,3,3,11,Loyal Users
75776,915,7,12,2,2,1,5,Lost
75886,812,9,27,2,2,2,6,Lost
75913,437,28,68,3,4,4,11,Loyal Users
76442,1863,6,18,1,1,2,4,Lost
77232,1034,12,89,2,3,4,9,Casual Users
77360,679,28,67,2,4,4,10,At Risk
77512,0,28,37,5,4,3,12,Loyal Users
77682,388,15,23,3,3,2,8,Loyal Users
77868,927,94,210,2,5,5,12,At Risk
77973,221,59,387,3,5,5,13,Loyal Users
78077,1135,6,7,2,1,1,4,Lost
78265,363,5,22,3,1,2,6,Casual Users
65502,948,7,17,2,2,2,6,Lost
65507,1132,5,5,2,1,1,4,Lost
66034,278,13,36,3,3,3,9,Loyal Users
66062,230,91,268,3,5,5,13,Loyal Users
66315,401,101,230,3,5,5,13,Loyal Users
66371,295,8,11,3,2,1,6,Casual Users
66643,784,21,88,2,3,4,9,Casual Users
66834,409,7,8,3,2,1,6,Casual Users
67176,123,109,312,4,5,5,14,Champions
67377,488,11,81,2,2,4,8,Lost
68113,135,8,11,4,2,1,7,Promising
68299,1,42,90,5,4,4,13,Champions
68851,847,27,60,2,4,3,9,At Risk
68894,17,5,9,5,1,1,7,Promising
68895,2036,24,29,1,4,2,7,At Risk
69021,124,14,42,4,3,3,10,Loyal Users
69315,25,64,167,5,5,5,15,Champions
69331,220,18,29,3,3,2,8,Loyal Users
69720,16,26,139,5,4,4,13,Champions
69752,3333,13,69,1,3,4,8,Casual Users
69833,20,55,212,5,5,5,15,Champions
70011,131,96,153,4,5,5,14,Champions
70141,253,11,31,3,2,2,7,Casual Users
70523,1726,45,264,1,4,5,10,At Risk
70670,1303,7,8,1,2,1,4,Lost
70785,2559,64,123,1,5,4,10,At Risk
71030,4310,20,44,1,3,3,7,Casual Users
71713,277,9,29,3,2,2,7,Casual Users
71727,55,43,49,5,4,3,12,Loyal Users
71890,142,44,82,4,4,4,12,Champions
72135,2441,5,5,1,1,1,3,Lost
72186,552,5,18,2,1,2,5,Lost
72220,109,101,684,4,5,5,14,Champions
72363,254,9,22,3,2,2,7,Casual Users
72564,1426,6,6,1,1,1,3,Lost
72593,610,9,21,2,2,2,6,Lost
72658,440,7,45,3,2,3,8,Casual Users
72754,17,138,234,5,5,5,15,Champions
72780,2,91,462,5,5,5,15,Champions
73869,1075,17,116,2,3,4,9,Casual Users
73895,1858,7,15,1,2,1,4,Lost
73999,150,80,111,4,5,4,13,Champions
74171,272,5,6,3,1,1,5,Casual Users
74182,234,7,12,3,2,1,6,Casual Users
74471,13,54,364,5,5,5,15,Champions
74495,1153,7,45,2,2,3,7,Lost
75360,1000,6,12,2,1,1,4,Lost
75774,9,63,344,5,5,5,15,Champions
75857,409,28,100,3,4,4,11,Loyal Users
76119,2301,78,213,1,5,5,11,At Risk
76440,547,7,14,2,2,1,5,Lost
76486,2126,20,70,1,3,4,8,Casual Users
76808,477,113,162,2,5,5,12,At Risk
77040,3070,21,30,1,3,2,6,Casual Users
77141,265,9,50,3,2,3,8,Casual Users
77705,566,29,121,2,4,4,10,At Risk
77779,1669,5,17,1,1,2,4,Lost
78282,1,111,363,5,5,5,15,Champions
65472,348,10,22,3,2,2,7,Casual Users
65496,225,61,150,3,5,5,13,Loyal Users
66254,246,13,138,3,3,4,10,Loyal Users
66605,27,173,586,5,5,5,15,Champions
66652,269,46,74,3,5,4,12,Loyal Users
66801,2941,6,17,1,1,2,4,Lost
67001,105,130,666,4,5,5,14,Champions
67470,1862,12,18,1,3,2,6,Casual Users
67794,3260,9,13,1,2,1,4,Lost
67932,574,13,25,2,3,2,7,Casual Users
68268,5284,5,8,1,1,1,3,Lost
68403,832,8,42,2,2,3,7,Lost
68679,403,30,83,3,4,4,11,Loyal Users
68838,5693,5,5,1,1,1,3,Lost
68850,591,21,61,2,3,3,8,Casual Users
68919,432,34,123,3,4,4,11,Loyal Users
69330,115,5,19,4,1,2,7,Promising
69452,94,10,20,4,2,2,8,Promising
69501,11,85,292,5,5,5,15,Champions
69513,39,90,428,5,5,5,15,Champions
69644,1380,10,29,1,2,2,5,Lost
69848,1288,40,95,1,4,4,9,At Risk
69894,1,127,297,5,5,5,15,Champions
70176,367,26,189,3,4,5,12,Loyal Users
70200,1926,21,43,1,3,3,7,Casual Users
70294,30,43,102,5,4,4,13,Champions
70478,1733,6,8,1,1,1,3,Lost
70655,113,35,69,4,4,4,12,Champions
70826,6,35,104,5,4,4,13,Champions
71059,837,12,51,2,3,3,8,Casual Users
71417,106,16,94,4,3,4,11,Loyal Users
71520,83,31,78,4,4,4,12,Champions
72014,153,60,267,4,5,5,14,Champions
72036,138,107,210,4,5,5,14,Champions
72177,93,84,348,4,5,5,14,Champions
72295,10,25,37,5,4,3,12,Loyal Users
72713,1123,9,13,2,2,1,5,Lost
73030,2534,6,13,1,1,1,3,Lost
73136,319,12,14,3,3,1,7,Loyal Users
73183,106,54,97,4,5,4,13,Champions
73332,397,18,61,3,3,3,9,Loyal Users
73405,3502,17,63,1,3,4,8,Casual Users
74079,103,6,6,4,1,1,6,Promising
74084,384,14,52,3,3,3,9,Loyal Users
74569,1692,6,29,1,1,2,4,Lost
75267,3470,7,12,1,2,1,4,Lost
75310,289,21,123,3,3,4,10,Loyal Users
75373,575,15,22,2,3,2,7,Casual Users
75457,120,32,85,4,4,4,12,Champions
75670,1056,10,15,2,2,1,5,Lost
75730,3018,18,24,1,3,2,6,Casual Users
75732,1578,12,15,1,3,1,5,Casual Users
75939,162,32,101,4,4,4,12,Champions
76247,5450,5,9,1,1,1,3,Lost
76590,138,71,257,4,5,5,14,Champions
76775,2,28,49,5,4,3,12,Loyal Users
76777,719,10,31,2,2,2,6,Lost
77104,248,16,22,3,3,2,8,Loyal Users
77150,587,55,290,2,5,5,12,At Risk
77818,569,33,63,2,4,4,10,At Risk
78019,27,7,14,5,2,1,8,Promising
65468,73,173,643,4,5,5,14,Champions
65770,676,9,16,2,2,2,6,Lost
65955,407,18,131,3,3,4,10,Loyal Users
65973,184,23,109,3,4,4,11,Loyal Users
66045,25,79,136,5,5,4,14,Champions
66305,1998,15,28,1,3,2,6,Casual Users
66340,28,31,55,5,4,3,12,Loyal Users
66564,139,80,175,4,5,5,14,Champions
66661,254,64,250,3,5,5,13,Loyal Users
66726,1534,6,10,1,1,1,3,Lost
67057,165,22,31,4,4,2,10,Loyal Users
67061,110,48,175,4,5,5,14,Champions
67380,869,11,13,2,2,1,5,Lost
67620,153,26,78,4,4,4,12,Champions
67739,1123,19,28,2,3,2,7,Casual Users
67899,424,7,9,3,2,1,6,Casual Users
67956,569,13,19,2,3,2,7,Casual Users
68126,1390,6,41,1,1,3,5,Lost
68297,1560,12,15,1,3,1,5,Casual Users
68607,850,85,390,2,5,5,12,At Risk
68648,642,6,41,2,1,3,6,Lost
69168,1031,5,6,2,1,1,4,Lost
69179,17,40,69,5,4,4,13,Champions
69184,255,12,75,3,3,4,10,Loyal Users
69362,354,6,21,3,1,2,6,Casual Users
69665,1243,43,181,2,4,5,11,At Risk
69686,291,8,13,3,2,1,6,Casual Users
69758,34,123,956,5,5,5,15,Champions
70083,5741,6,8,1,1,1,3,Lost
70195,1462,24,80,1,4,4,9,At Risk
70331,1960,14,14,1,3,1,5,Casual Users
70426,2988,6,37,1,1,3,5,Lost
70600,21,28,50,5,4,3,12,Loyal Users
71013,845,14,36,2,3,3,8,Casual Users
71245,413,33,187,3,4,5,12,Loyal Users
71459,1587,13,80,1,3,4,8,Casual Users
71757,3,44,279,5,4,5,14,Champions
71797,795,13,31,2,3,2,7,Casual Users
72099,572,31,57,2,4,3,9,At Risk
73322,93,10,78,4,2,4,10,Promising
74033,120,35,85,4,4,4,12,Champions
74047,478,17,23,2,3,2,7,Casual Users
74366,224,22,132,3,4,4,11,Loyal Users
74918,1261,21,56,1,3,3,7,Casual Users
74994,1135,29,48,2,4,3,9,At Risk
75188,7,88,646,5,5,5,15,Champions
75698,137,26,109,4,4,4,12,Champions
75916,18,20,85,5,3,4,12,Loyal Users
76810,129,63,165,4,5,5,14,Champions
76925,229,43,246,3,4,5,12,Loyal Users
77060,139,8,36,4,2,3,9,Promising
77780,1278,6,9,1,1,1,3,Lost
65839,412,6,29,3,1,2,6,Casual Users
65921,297,132,283,3,5,5,13,Loyal Users
65976,0,14,25,5,3,2,10,Loyal Users
66143,5892,7,7,1,2,1,4,Lost
66886,221,25,246,3,4,5,12,Loyal Users
66938,4991,18,25,1,3,2,6,Casual Users
67239,751,11,20,2,2,2,6,Lost
67471,249,57,81,3,5,4,12,Loyal Users
67516,1712,11,19,1,2,2,5,Lost
67600,52,6,14,5,1,1,7,Promising
68241,139,18,148,4,3,5,12,Loyal Users
68698,154,21,86,4,3,4,11,Loyal Users
68882,248,54,270,3,5,5,13,Loyal Users
69070,150,75,170,4,5,5,14,Champions
69074,44,17,47,5,3,3,11,Loyal Users
69105,301,27,52,3,4,3,10,Loyal Users
69171,791,39,83,2,4,4,10,At Risk
69232,3246,8,30,1,2,2,5,Lost
69291,9,111,373,5,5,5,15,Champions
69435,342,11,25,3,2,2,7,Casual Users
69561,189,17,60,3,3,3,9,Loyal Users
69616,183,29,76,3,4,4,11,Loyal Users
69660,465,5,27,3,1,2,6,Casual Users
69869,10,7,9,5,2,1,8,Promising
70129,7,103,144,5,5,4,14,Champions
70312,1136,8,15,2,2,1,5,Lost
70423,3403,6,44,1,1,3,5,Lost
70449,3204,6,11,1,1,1,3,Lost
70526,90,17,35,4,3,3,10,Loyal Users
71010,1294,16,61,1,3,3,7,Casual Users
71383,67,33,74,5,4,4,13,Champions
71655,611,8,15,2,2,1,5,Lost
71825,101,6,12,4,1,1,6,Promising
72121,175,73,132,3,5,4,12,Loyal Users
72568,815,16,191,2,3,5,10,Casual Users
72967,132,66,257,4,5,5,14,Champions
73149,35,77,235,5,5,5,15,Champions
73317,74,5,6,4,1,1,6,Promising
73437,2474,10,24,1,2,2,5,Lost
73569,1528,10,20,1,2,2,5,Lost
73660,1443,8,25,1,2,2,5,Lost
73841,294,49,96,3,5,4,12,Loyal Users
73934,51,167,508,5,5,5,15,Champions
74046,1115,14,66,2,3,4,9,Casual Users
74237,76,172,234,4,5,5,14,Champions
74451,84,129,511,4,5,5,14,Champions
74979,248,7,8,3,2,1,6,Casual Users
75453,242,65,149,3,5,5,13,Loyal Users
75770,645,9,18,2,2,2,6,Lost
75780,231,16,157,3,3,5,11,Loyal Users
75977,338,42,111,3,4,4,11,Loyal Users
76438,4125,5,8,1,1,1,3,Lost
76675,1236,18,66,2,3,4,9,Casual Users
76692,282,33,104,3,4,4,11,Loyal Users
76826,570,13,88,2,3,4,9,Casual Users
76844,914,57,215,2,5,5,12,At Risk
77039,100,110,526,4,5,5,14,Champions
77342,200,32,82,3,4,4,11,Loyal Users
77441,426,22,71,3,4,4,11,Loyal Users
77462,733,9,16,2,2,2,6,Lost
78106,187,46,95,3,5,4,12,Loyal Users
65944,105,6,15,4,1,1,6,Promising
65963,534,28,104,2,4,4,10,At Risk
66383,3506,6,15,1,1,1,3,Lost
66773,706,11,15,2,2,1,5,Lost
66873,267,6,13,3,1,1,5,Casual Users
66946,407,32,66,3,4,4,11,Loyal Users
68127,2,94,259,5,5,5,15,Champions
68374,2,35,91,5,4,4,13,Champions
68422,3,53,293,5,5,5,15,Champions
68640,289,27,105,3,4,4,11,Loyal Users
69264,85,13,58,4,3,3,10,Loyal Users
69272,119,30,104,4,4,4,12,Champions
69306,32,49,114,5,5,4,14,Champions
69358,1717,38,194,1,4,5,10,At Risk
69467,970,9,22,2,2,2,6,Lost
69524,17,5,10,5,1,1,7,Promising
69619,296,6,21,3,1,2,6,Casual Users
70061,706,16,19,2,3,2,7,Casual Users
70213,727,16,24,2,3,2,7,Casual Users
70352,67,94,276,5,5,5,15,Champions
70529,2731,6,6,1,1,1,3,Lost
70534,524,26,63,2,4,4,10,At Risk
70926,5576,20,67,1,3,4,8,Casual Users
70943,80,17,169,4,3,5,12,Loyal Users
71021,477,87,220,2,5,5,12,At Risk
71040,580,33,79,2,4,4,10,At Risk
71183,128,8,24,4,2,2,8,Promising
71232,684,6,6,2,1,1,4,Lost
71369,869,7,8,2,2,1,5,Lost
71477,1,146,951,5,5,5,15,Champions
72028,434,12,113,3,3,4,10,Loyal Users
72082,102,66,214,4,5,5,14,Champions
72284,2125,5,19,1,1,2,4,Lost
72303,253,10,33,3,2,3,8,Casual Users
72362,1111,8,23,2,2,2,6,Lost
72389,6,105,301,5,5,5,15,Champions
72599,413,6,17,3,1,2,6,Casual Users
72633,359,27,42,3,4,3,10,Loyal Users
73115,76,112,206,4,5,5,14,Champions
73200,87,69,149,4,5,5,14,Champions
73467,817,5,5,2,1,1,4,Lost
73668,245,82,259,3,5,5,13,Loyal Users
73699,274,65,325,3,5,5,13,Loyal Users
73838,241,7,13,3,2,1,6,Casual Users
74013,276,10,11,3,2,1,6,Casual Users
74043,863,15,37,2,3,3,8,Casual Users
74267,2,10,15,5,2,1,8,Promising
74302,327,28,100,3,4,4,11,Loyal Users
74325,2636,9,20,1,2,2,5,Lost
74402,4285,10,10,1,2,1,4,Lost
74605,5560,29,45,1,4,3,8,At Risk
74630,800,16,80,2,3,4,9,Casual Users
74951,1097,12,13,2,3,1,6,Casual Users
74978,1109,11,43,2,2,3,7,Lost
75014,93,64,95,4,5,4,13,Champions
75106,511,38,81,2,4,4,10,At Risk
75192,396,8,18,3,2,2,7,Casual Users
75280,3,9,32,5,2,3,10,Promising
75417,76,102,713,4,5,5,14,Champions
75583,110,13,61,4,3,3,10,Loyal Users
75608,208,79,168,3,5,5,13,Loyal Users
75905,1853,7,14,1,2,1,4,Lost
76368,569,12,35,2,3,3,8,Casual Users
76488,3,155,527,5,5,5,15,Champions
76759,424,67,86,3,5,4,12,Loyal Users
77230,958,12,22,2,3,2,7,Casual Users
77455,863,5,12,2,1,1,4,Lost
77501,431,35,73,3,4,4,11,Loyal Users
77580,637,46,71,2,5,4,11,At Risk
77660,620,8,26,2,2,2,6,Lost
77699,1482,8,73,1,2,4,7,Lost
77864,130,26,114,4,4,4,12,Champions
78003,135,23,57,4,4,3,11,Loyal Users
78218,92,82,168,4,5,5,14,Champions
65707,77,6,11,4,1,1,6,Promising
66104,402,10,143,3,2,4,9,Casual Users
66157,3255,5,7,1,1,1,3,Lost
66263,1,111,505,5,5,5,15,Champions
66286,1212,12,24,2,3,2,7,Casual Users
66336,3570,8,64,1,2,4,7,Lost
66592,550,9,25,2,2,2,6,Lost
66681,95,34,58,4,4,3,11,Loyal Users
67487,857,7,36,2,2,3,7,Lost
67496,150,5,25,4,1,2,7,Promising
67511,1001,7,7,2,2,1,5,Lost
67906,3129,10,17,1,2,2,5,Lost
68013,531,10,10,2,2,1,5,Lost
68353,10,14,58,5,3,3,11,Loyal Users
68368,253,20,62,3,3,3,9,Loyal Users
68377,2036,8,47,1,2,3,6,Lost
68505,876,19,59,2,3,3,8,Casual Users
68834,272,9,37,3,2,3,8,Casual Users
68901,156,45,88,4,4,4,12,Champions
68942,663,12,20,2,3,2,7,Casual Users
69472,7,135,632,5,5,5,15,Champions
70645,1039,20,146,2,3,4,9,Casual Users
70668,619,40,70,2,4,4,10,At Risk
70777,1952,11,13,1,2,1,4,Lost
71340,402,6,9,3,1,1,5,Casual Users
71735,417,23,61,3,4,3,10,Loyal Users
71976,671,7,9,2,2,1,5,Lost
72194,965,23,140,2,4,4,10,At Risk
72263,1515,15,45,1,3,3,7,Casual Users
72789,264,40,76,3,4,4,11,Loyal Users
72866,19,41,99,5,4,4,13,Champions
72927,129,15,25,4,3,2,9,Loyal Users
72978,1363,21,108,1,3,4,8,Casual Users
73282,246,10,46,3,2,3,8,Casual Users
73308,845,6,11,2,1,1,4,Lost
73482,2014,10,11,1,2,1,4,Lost
73618,2180,11,39,1,2,3,6,Lost
74025,304,30,192,3,4,5,12,Loyal Users
74068,2115,21,55,1,3,3,7,Casual Users
74319,14,39,98,5,4,4,13,Champions
74381,49,95,327,5,5,5,15,Champions
74680,308,5,11,3,1,1,5,Casual Users
74965,3456,9,15,1,2,1,4,Lost
75177,1780,12,39,1,3,3,7,Casual Users
75277,1424,13,17,1,3,2,6,Casual Users
75364,87,52,119,4,5,4,13,Champions
75635,7,28,171,5,4,5,14,Champions
75666,1011,11,12,2,2,1,5,Lost
75716,241,5,5,3,1,1,5,Casual Users
75809,1,64,153,5,5,5,15,Champions
75940,3184,17,33,1,3,3,7,Casual Users
76041,677,6,36,2,1,3,6,Lost
76375,278,5,10,3,1,1,5,Casual Users
76538,1034,17,54,2,3,3,8,Casual Users
76602,65,50,127,5,5,4,14,Champions
76696,461,5,42,3,1,3,7,Casual Users
76703,19,10,17,5,2,2,9,Promising
76714,243,9,18,3,2,2,7,Casual Users
76735,144,5,9,4,1,1,6,Promising
76781,135,8,44,4,2,3,9,Promising
76879,135,46,80,4,5,4,13,Champions
76986,2270,6,9,1,1,1,3,Lost
77058,1228,32,49,2,4,3,9,At Risk
77108,3,164,738,5,5,5,15,Champions
77152,256,21,85,3,3,4,10,Loyal Users
77343,3029,37,61,1,4,3,8,At Risk
77662,640,22,38,2,4,3,9,At Risk
77805,276,7,13,3,2,1,6,Casual Users
77823,30,5,9,5,1,1,7,Promising
77961,3268,14,15,1,3,1,5,Casual Users
77966,1292,12,16,1,3,2,6,Casual Users
78127,71,9,10,4,2,1,7,Promising
78278,83,120,159,4,5,5,14,Champions
65498,3,39,93,5,4,4,13,Champions
65514,232,6,21,3,1,2,6,Casual Users
65645,8,42,176,5,4,5,14,Champions
65896,65,155,445,5,5,5,15,Champions
66005,688,19,33,2,3,3,8,Casual Users
66015,3,37,109,5,4,4,13,Champions
66020,44,24,34,5,4,3,12,Loyal Users
66056,120,34,71,4,4,4,12,Champions
66362,36,71,293,5,5,5,15,Champions
66715,261,19,117,3,3,4,10,Loyal Users
66996,137,25,166,4,4,5,13,Champions
67097,25,70,140,5,5,4,14,Champions
67272,2263,6,10,1,1,1,3,Lost
67372,405,36,65,3,4,4,11,Loyal Users
67410,545,11,33,2,2,3,7,Lost
67483,137,10,20,4,2,2,8,Promising
67538,1420,6,7,1,1,1,3,Lost
67984,289,19,32,3,3,3,9,Loyal Users
68222,85,60,215,4,5,5,14,Champions
68824,301,53,147,3,5,5,13,Loyal Users
68836,393,22,57,3,4,3,10,Loyal Users
69433,461,38,134,3,4,4,11,Loyal Users
69480,78,66,129,4,5,4,13,Champions
69490,234,5,12,3,1,1,5,Casual Users
69847,3082,5,6,1,1,1,3,Lost
69952,434,11,15,3,2,1,6,Casual Users
70070,949,11,22,2,2,2,6,Lost
70152,21,5,16,5,1,2,8,Promising
70681,836,13,17,2,3,2,7,Casual Users
70707,3527,20,24,1,3,2,6,Casual Users
70732,99,16,52,4,3,3,10,Loyal Users
70858,5,14,101,5,3,4,12,Loyal Users
71085,1850,6,9,1,1,1,3,Lost
71235,155,37,64,4,4,4,12,Champions
71701,240,35,190,3,4,5,12,Loyal Users
72189,1176,9,39,2,2,3,7,Lost
72270,1088,34,145,2,4,4,10,At Risk
72668,27,41,108,5,4,4,13,Champions
72709,102,5,22,4,1,2,7,Promising
72857,90,152,790,4,5,5,14,Champions
72901,254,41,66,3,4,4,11,Loyal Users
73158,1093,10,42,2,2,3,7,Lost
73340,955,7,16,2,2,2,6,Lost
73676,23,67,142,5,5,4,14,Champions
73845,12,38,94,5,4,4,13,Champions
74141,1987,22,108,1,4,4,9,At Risk
74156,5782,5,25,1,1,2,4,Lost
74169,685,26,44,2,4,3,9,At Risk
74221,491,133,165,2,5,5,12,At Risk
74378,151,20,34,4,3,3,10,Loyal Users
74431,28,95,434,5,5,5,15,Champions
74472,118,16,37,4,3,3,10,Loyal Users
74490,48,61,256,5,5,5,15,Champions
74502,2494,10,36,1,2,3,6,Lost
74565,164,66,299,4,5,5,14,Champions
74641,98,7,8,4,2,1,7,Promising
74744,233,70,317,3,5,5,13,Loyal Users
74771,112,14,125,4,3,4,11,Loyal Users
75083,608,14,111,2,3,4,9,Casual Users
75104,116,9,68,4,2,4,10,Promising
75667,1599,9,26,1,2,2,5,Lost
75733,3272,6,49,1,1,3,5,Lost
75792,3,92,194,5,5,5,15,Champions
76194,2142,6,27,1,1,2,4,Lost
76321,437,24,75,3,4,4,11,Loyal Users
76557,701,10,31,2,2,2,6,Lost
76686,1180,5,14,2,1,1,4,Lost
76796,4287,7,43,1,2,3,6,Lost
76803,3,64,123,5,5,4,14,Champions
76935,103,46,113,4,5,4,13,Champions
77051,220,10,23,3,2,2,7,Casual Users
77314,176,40,105,3,4,4,11,Loyal Users
77413,238,23,84,3,4,4,11,Loyal Users
77428,81,72,141,4,5,4,13,Champions
77825,10,6,8,5,1,1,7,Promising
77977,384,12,64,3,3,4,10,Loyal Users
65647,10,75,291,5,5,5,15,Champions
65706,167,11,35,3,2,3,8,Casual Users
65854,7,135,540,5,5,5,15,Champions
66366,101,83,354,4,5,5,14,Champions
66785,61,36,56,5,4,3,12,Loyal Users
67025,153,16,30,4,3,2,9,Loyal Users
67307,3288,39,288,1,4,5,10,At Risk
67357,458,7,19,3,2,2,7,Casual Users
67518,4784,5,6,1,1,1,3,Lost
67614,350,39,170,3,4,5,12,Loyal Users
67688,431,10,11,3,2,1,6,Casual Users
67923,259,15,57,3,3,3,9,Loyal Users
68627,61,33,70,5,4,4,13,Champions
68644,90,52,121,4,5,4,13,Champions
68781,2,31,57,5,4,3,12,Loyal Users
68833,127,14,68,4,3,4,11,Loyal Users
68941,135,19,42,4,3,3,10,Loyal Users
69043,834,15,46,2,3,3,8,Casual Users
69302,109,73,341,4,5,5,14,Champions
69438,328,35,102,3,4,4,11,Loyal Users
69573,1227,17,32,2,3,3,8,Casual Users
69730,112,8,25,4,2,2,8,Promising
69783,350,15,35,3,3,3,9,Loyal Users
69849,2,107,470,5,5,5,15,Champions
70335,1263,6,8,1,1,1,3,Lost
70414,298,9,25,3,2,2,7,Casual Users
70490,227,56,127,3,5,4,12,Loyal Users
70731,456,78,151,3,5,5,13,Loyal Users
70790,414,9,26,3,2,2,7,Casual Users
70915,4735,14,36,1,3,3,7,Casual Users
71024,1377,31,58,1,4,3,8,At Risk
71210,83,21,58,4,3,3,10,Loyal Users
71301,3,15,45,5,3,3,11,Loyal Users
71364,154,44,218,4,4,5,13,Champions
72107,439,77,513,3,5,5,13,Loyal Users
72131,1470,5,18,1,1,2,4,Lost
72267,494,16,31,2,3,2,7,Casual Users
72377,15,31,223,5,4,5,14,Champions
72438,1269,8,18,1,2,2,5,Lost
72454,1296,19,132,1,3,4,8,Casual Users
72455,283,5,10,3,1,1,5,Casual Users
72494,477,6,9,2,1,1,4,Lost
73020,83,9,20,4,2,2,8,Promising
73501,315,7,30,3,2,2,7,Casual Users
73693,1382,5,5,1,1,1,3,Lost
74089,4421,6,6,1,1,1,3,Lost
74139,5539,5,7,1,1,1,3,Lost
74145,3,160,586,5,5,5,15,Champions
74311,7,98,363,5,5,5,15,Champions
74352,549,11,25,2,2,2,6,Lost
74459,1097,8,9,2,2,1,5,Lost
75075,854,11,37,2,2,3,7,Lost
75076,130,82,469,4,5,5,14,Champions
75124,182,41,82,3,4,4,11,Loyal Users
75137,159,18,21,4,3,2,9,Loyal Users
75554,151,5,5,4,1,1,6,Promising
75586,28,71,520,5,5,5,15,Champions
75594,116,45,206,4,4,5,13,Champions
75655,598,5,7,2,1,1,4,Lost
75739,264,5,10,3,1,1,5,Casual Users
75999,114,42,87,4,4,4,12,Champions
76060,21,152,378,5,5,5,15,Champions
76069,4855,6,13,1,1,1,3,Lost
76159,171,13,20,3,3,2,8,Loyal Users
76613,416,6,9,3,1,1,5,Casual Users
76694,1996,19,38,1,3,3,7,Casual Users
77107,2213,8,11,1,2,1,4,Lost
77509,903,19,32,2,3,3,8,Casual Users
77698,41,49,167,5,5,5,15,Champions
78679,1685,11,68,1,2,4,7,Lost
79246,5,50,59,5,5,3,13,Loyal Users
79743,417,17,25,3,3,2,8,Loyal Users
79806,117,81,147,4,5,5,14,Champions
80201,16,36,154,5,4,5,14,Champions
80489,2079,6,8,1,1,1,3,Lost
80763,1796,5,5,1,1,1,3,Lost
80768,478,18,37,2,3,3,8,Casual Users
81436,3615,7,21,1,2,2,5,Lost
81785,75,26,47,4,4,3,11,Loyal Users
82167,1951,9,50,1,2,3,6,Lost
82181,317,30,68,3,4,4,11,Loyal Users
82523,1614,9,19,1,2,2,5,Lost
82877,23,38,54,5,4,3,12,Loyal Users
82960,1723,7,29,1,2,2,5,Lost
83170,428,20,21,3,3,2,8,Loyal Users
83249,107,61,331,4,5,5,14,Champions
83891,22,40,96,5,4,4,13,Champions
83959,5040,32,82,1,4,4,9,At Risk
83992,940,22,39,2,4,3,9,At Risk
84321,933,30,90,2,4,4,10,At Risk
84356,114,21,33,4,3,3,10,Loyal Users
84545,1038,21,114,2,3,4,9,Casual Users
84699,90,62,324,4,5,5,14,Champions
84820,8,94,245,5,5,5,15,Champions
84874,4,14,45,5,3,3,11,Loyal Users
85183,65,26,45,5,4,3,12,Loyal Users
85324,17,100,501,5,5,5,15,Champions
85373,10,63,118,5,5,4,14,Champions
85684,418,11,28,3,2,2,7,Casual Users
85712,2210,6,7,1,1,1,3,Lost
85847,1048,11,40,2,2,3,7,Lost
86447,81,17,52,4,3,3,10,Loyal Users
86483,1820,6,37,1,1,3,5,Lost
86608,107,57,187,4,5,5,14,Champions
87010,115,198,613,4,5,5,14,Champions
87514,9,120,514,5,5,5,15,Champions
87673,104,13,52,4,3,3,10,Loyal Users
87676,307,32,108,3,4,4,11,Loyal Users
87688,11,57,400,5,5,5,15,Champions
87713,97,62,187,4,5,5,14,Champions
87770,6,135,386,5,5,5,15,Champions
88269,1425,5,10,1,1,1,3,Lost
88334,27,98,536,5,5,5,15,Champions
88380,580,6,17,2,1,2,5,Lost
88680,113,34,98,4,4,4,12,Champions
88915,7,44,77,5,4,4,13,Champions
89038,2641,5,33,1,1,3,5,Lost
89058,16,54,190,5,5,5,15,Champions
89709,1957,8,34,1,2,3,6,Lost
89969,11,61,204,5,5,5,15,Champions
90628,252,7,15,3,2,1,6,Casual Users
90765,162,20,207,4,3,5,12,Loyal Users
90842,223,73,129,3,5,4,12,Loyal Users
90962,269,32,49,3,4,3,10,Loyal Users
91054,238,99,219,3,5,5,13,Loyal Users
78502,74,27,83,4,4,4,12,Champions
78510,24,124,787,5,5,5,15,Champions
78516,3707,5,7,1,1,1,3,Lost
78799,0,130,324,5,5,5,15,Champions
79051,25,43,157,5,4,5,14,Champions
79113,1271,5,6,1,1,1,3,Lost
79534,164,26,96,4,4,4,12,Champions
79584,286,21,34,3,3,3,9,Loyal Users
79659,708,11,17,2,2,2,6,Lost
79726,149,32,145,4,4,4,12,Champions
80013,105,23,51,4,4,3,11,Loyal Users
80604,13,8,32,5,2,3,10,Promising
80651,164,61,307,4,5,5,14,Champions
80865,5390,6,17,1,1,2,4,Lost
81206,151,8,27,4,2,2,8,Promising
81385,38,84,420,5,5,5,15,Champions
82684,2,37,155,5,4,5,14,Champions
82915,262,26,55,3,4,3,10,Loyal Users
83476,469,14,33,3,3,3,9,Loyal Users
83491,1730,5,20,1,1,2,4,Lost
83701,86,89,296,4,5,5,14,Champions
83850,985,9,12,2,2,1,5,Lost
83931,1377,61,202,1,5,5,11,At Risk
84029,127,65,352,4,5,5,14,Champions
84588,272,25,29,3,4,2,9,Loyal Users
84796,2219,9,17,1,2,2,5,Lost
84872,4364,5,10,1,1,1,3,Lost
85407,2138,5,5,1,1,1,3,Lost
85508,76,6,28,4,1,2,7,Promising
86129,706,57,341,2,5,5,12,At Risk
86260,3536,6,12,1,1,1,3,Lost
86619,3662,5,18,1,1,2,4,Lost
86827,264,57,352,3,5,5,13,Loyal Users
86866,0,16,37,5,3,3,11,Loyal Users
86929,143,43,113,4,4,4,12,Champions
87065,337,17,61,3,3,3,9,Loyal Users
87185,72,8,12,4,2,1,7,Promising
87405,405,10,46,3,2,3,8,Casual Users
87455,2123,7,29,1,2,2,5,Lost
87551,8,187,291,5,5,5,15,Champions
87836,119,56,135,4,5,4,13,Champions
87986,428,30,102,3,4,4,11,Loyal Users
88182,16,19,33,5,3,3,11,Loyal Users
88305,3983,6,19,1,1,2,4,Lost
88324,1373,7,9,1,2,1,4,Lost
88428,7,5,8,5,1,1,7,Promising
88647,81,13,19,4,3,2,9,Loyal Users
88691,920,37,105,2,4,4,10,At Risk
89102,1167,30,75,2,4,4,10,At Risk
89182,125,12,67,4,3,4,11,Loyal Users
89592,266,20,69,3,3,4,10,Loyal Users
89784,244,14,20,3,3,2,8,Loyal Users
90347,4762,12,12,1,3,1,5,Casual Users
90440,8,72,238,5,5,5,15,Champions
90496,3233,8,42,1,2,3,6,Lost
90537,3003,7,16,1,2,2,5,Lost
78411,65,15,84,5,3,4,12,Loyal Users
79183,1198,11,16,2,2,2,6,Lost
79297,1544,33,120,1,4,4,9,At Risk
79560,1288,15,20,1,3,2,6,Casual Users
79612,460,8,14,3,2,1,6,Casual Users
79677,697,14,27,2,3,2,7,Casual Users
79714,14,21,23,5,3,2,10,Loyal Users
80051,3140,5,18,1,1,2,4,Lost
80360,86,7,47,4,2,3,9,Promising
80416,456,9,34,3,2,3,8,Casual Users
80421,394,21,23,3,3,2,8,Loyal Users
80674,23,18,35,5,3,3,11,Loyal Users
80783,268,56,101,3,5,4,12,Loyal Users
80944,852,5,7,2,1,1,4,Lost
80948,203,12,13,3,3,1,7,Loyal Users
80958,3445,12,22,1,3,2,6,Casual Users
81182,161,20,77,4,3,4,11,Loyal Users
81340,432,46,170,3,5,5,13,Loyal Users
81778,531,8,10,2,2,1,5,Lost
81948,5048,5,5,1,1,1,3,Lost
82411,213,24,218,3,4,5,12,Loyal Users
82419,439,73,353,3,5,5,13,Loyal Users
82427,1650,15,79,1,3,4,8,Casual Users
82719,391,12,55,3,3,3,9,Loyal Users
82785,2123,9,14,1,2,1,4,Lost
82863,115,8,16,4,2,2,8,Promising
82868,35,59,366,5,5,5,15,Champions
83071,421,5,6,3,1,1,5,Casual Users
83091,1313,18,30,1,3,2,6,Casual Users
83159,1111,45,140,2,4,4,10,At Risk
83590,416,14,28,3,3,2,8,Loyal Users
83725,103,35,147,4,4,5,13,Champions
83874,430,14,24,3,3,2,8,Loyal Users
84095,2861,5,7,1,1,1,3,Lost
84100,407,36,96,3,4,4,11,Loyal Users
84146,1369,13,19,1,3,2,6,Casual Users
84529,2702,48,126,1,5,4,10,At Risk
84593,616,8,17,2,2,2,6,Lost
84630,3008,5,7,1,1,1,3,Lost
84805,974,12,41,2,3,3,8,Casual Users
84898,394,39,157,3,4,5,12,Loyal Users
84926,1726,9,13,1,2,1,4,Lost
85070,310,14,25,3,3,2,8,Loyal Users
85607,556,6,10,2,1,1,4,Lost
85644,701,19,70,2,3,4,9,Casual Users
86161,3972,5,8,1,1,1,3,Lost
86179,2603,5,14,1,1,1,3,Lost
86622,145,8,23,4,2,2,8,Promising
86675,399,8,28,3,2,2,7,Casual Users
86738,56,30,152,5,4,5,14,Champions
86900,53,69,295,5,5,5,15,Champions
87084,167,23,48,3,4,3,10,Loyal Users
87491,269,6,21,3,1,2,6,Casual Users
87555,1304,20,44,1,3,3,7,Casual Users
87773,5423,13,34,1,3,3,7,Casual Users
88372,1733,11,30,1,2,2,5,Lost
88490,25,7,46,5,2,3,10,Promising
88535,1386,9,14,1,2,1,4,Lost
89266,785,15,46,2,3,3,8,Casual Users
89575,3908,7,14,1,2,1,4,Lost
89899,135,97,161,4,5,5,14,Champions
90038,36,79,240,5,5,5,15,Champions
90055,946,8,32,2,2,3,7,Lost
90418,468,61,140,3,5,4,12,Loyal Users
90850,5457,10,34,1,2,3,6,Lost
90881,113,12,16,4,3,2,9,Loyal Users
78375,157,44,98,4,4,4,12,Champions
78396,1123,86,237,2,5,5,12,At Risk
78640,560,15,127,2,3,4,9,Casual Users
78800,81,8,25,4,2,2,8,Promising
78991,3,93,437,5,5,5,15,Champions
79120,132,29,41,4,4,3,11,Loyal Users
79282,283,19,64,3,3,4,10,Loyal Users
79364,1499,6,16,1,1,2,4,Lost
79496,29,82,138,5,5,4,14,Champions
80118,2546,5,9,1,1,1,3,Lost
80126,728,24,30,2,4,2,8,At Risk
80503,164,27,74,4,4,4,12,Champions
80596,254,48,195,3,5,5,13,Loyal Users
80797,1,18,30,5,3,2,10,Loyal Users
81009,1860,8,19,1,2,2,5,Lost
81070,62,118,352,5,5,5,15,Champions
81095,719,19,46,2,3,3,8,Casual Users
81502,473,27,48,2,4,3,9,At Risk
81520,137,8,12,4,2,1,7,Promising
81603,2724,9,19,1,2,2,5,Lost
81737,430,18,25,3,3,2,8,Loyal Users
81781,132,118,321,4,5,5,14,Champions
81814,306,8,60,3,2,3,8,Casual Users
82202,161,60,349,4,5,5,14,Champions
82509,430,21,36,3,3,3,9,Loyal Users
83076,0,49,129,5,5,4,14,Champions
84372,30,22,126,5,4,4,13,Champions
84526,2565,13,20,1,3,2,6,Casual Users
84622,424,8,28,3,2,2,7,Casual Users
84656,2298,5,5,1,1,1,3,Lost
84696,3882,22,45,1,4,3,8,At Risk
84753,287,22,73,3,4,4,11,Loyal Users
85354,122,9,10,4,2,1,7,Promising
85576,29,132,446,5,5,5,15,Champions
86288,966,11,33,2,2,3,7,Lost
86303,261,72,385,3,5,5,13,Loyal Users
86971,660,21,50,2,3,3,8,Casual Users
87092,80,21,22,4,3,2,9,Loyal Users
87202,23,40,218,5,4,5,14,Champions
87327,187,36,45,3,4,3,10,Loyal Users
87561,131,7,7,4,2,1,7,Promising
87594,1531,7,15,1,2,1,4,Lost
87631,104,22,85,4,4,4,12,Champions
87644,61,20,126,5,3,4,12,Loyal Users
87924,1396,18,149,1,3,5,9,Casual Users
88178,4735,39,68,1,4,4,9,At Risk
88365,433,14,24,3,3,2,8,Loyal Users
88849,12,231,440,5,5,5,15,Champions
88998,539,10,16,2,2,2,6,Lost
89046,626,11,34,2,2,3,7,Lost
89275,317,46,70,3,5,4,12,Loyal Users
89440,245,218,654,3,5,5,13,Loyal Users
89932,12,26,90,5,4,4,13,Champions
90144,112,28,86,4,4,4,12,Champions
90411,108,10,14,4,2,1,7,Promising
90467,150,42,70,4,4,4,12,Champions
90480,2281,17,42,1,3,3,7,Casual Users
90553,79,204,336,4,5,5,14,Champions
90653,279,5,10,3,1,1,5,Casual Users
90814,739,6,6,2,1,1,4,Lost
90984,80,34,117,4,4,4,12,Champions
90989,2,7,17,5,2,2,9,Promising
91006,754,10,30,2,2,2,6,Lost
78322,1766,6,17,1,1,2,4,Lost
78399,1814,7,15,1,2,1,4,Lost
78595,2246,8,47,1,2,3,6,Lost
78756,3,42,178,5,4,5,14,Champions
79421,10,37,89,5,4,4,13,Champions
79822,531,17,45,2,3,3,8,Casual Users
79837,649,8,27,2,2,2,6,Lost
80192,1297,5,9,1,1,1,3,Lost
80314,777,22,24,2,4,2,8,At Risk
80387,122,70,150,4,5,5,14,Champions
80396,329,40,243,3,4,5,12,Loyal Users
80495,116,8,57,4,2,3,9,Promising
80766,643,6,57,2,1,3,6,Lost
80952,243,6,6,3,1,1,5,Casual Users
81474,231,72,185,3,5,5,13,Loyal Users
81647,564,24,76,2,4,4,10,At Risk
81866,259,7,29,3,2,2,7,Casual Users
81978,87,69,306,4,5,5,14,Champions
82016,5250,6,31,1,1,2,4,Lost
82232,253,5,26,3,1,2,6,Casual Users
82499,1040,71,121,2,5,4,11,At Risk
82611,795,15,47,2,3,3,8,Casual Users
82624,5,115,248,5,5,5,15,Champions
83078,14,21,165,5,3,5,13,Loyal Users
83216,656,32,82,2,4,4,10,At Risk
83397,1087,6,10,2,1,1,4,Lost
83834,4820,5,10,1,1,1,3,Lost
83873,2876,14,56,1,3,3,7,Casual Users
83925,11,139,317,5,5,5,15,Champions
83929,27,19,264,5,3,5,13,Loyal Users
84248,3153,17,39,1,3,3,7,Casual Users
84268,108,28,54,4,4,3,11,Loyal Users
84735,28,54,117,5,5,4,14,Champions
84953,94,8,23,4,2,2,8,Promising
85162,119,61,92,4,5,4,13,Champions
85342,246,31,40,3,4,3,10,Loyal Users
85574,5499,8,28,1,2,2,5,Lost
85672,87,13,144,4,3,4,11,Loyal Users
87285,237,6,15,3,1,1,5,Casual Users
87452,2699,7,22,1,2,2,5,Lost
87518,421,28,44,3,4,3,10,Loyal Users
87785,133,42,98,4,4,4,12,Champions
88101,278,6,13,3,1,1,5,Casual Users
88812,489,26,95,2,4,4,10,At Risk
89163,17,88,250,5,5,5,15,Champions
89417,11,32,59,5,4,3,12,Loyal Users
89580,289,5,6,3,1,1,5,Casual Users
89645,244,13,15,3,3,1,7,Loyal Users
90238,275,97,169,3,5,5,13,Loyal Users
90421,4155,6,9,1,1,1,3,Lost
90422,383,18,104,3,3,4,10,Loyal Users
90514,69,94,505,5,5,5,15,Champions
90656,294,49,472,3,5,5,13,Loyal Users
90743,691,8,10,2,2,1,5,Lost
90834,5023,7,8,1,2,1,4,Lost
90943,104,88,299,4,5,5,14,Champions
91013,3,209,483,5,5,5,15,Champions
78323,387,5,6,3,1,1,5,Casual Users
78699,135,26,75,4,4,4,12,Champions
78921,793,6,37,2,1,3,6,Lost
79034,1641,7,29,1,2,2,5,Lost
79241,489,8,11,2,2,1,5,Lost
79369,2655,6,11,1,1,1,3,Lost
79705,276,15,60,3,3,3,9,Loyal Users
79778,403,7,11,3,2,1,6,Casual Users
79827,1130,11,54,2,2,3,7,Lost
80218,24,38,73,5,4,4,13,Champions
80405,261,24,106,3,4,4,11,Loyal Users
80479,1854,5,17,1,1,2,4,Lost
80521,136,13,27,4,3,2,9,Loyal Users
80567,40,70,520,5,5,5,15,Champions
80569,177,29,69,3,4,4,11,Loyal Users
80599,101,13,46,4,3,3,10,Loyal Users
80751,16,71,190,5,5,5,15,Champions
80872,1120,5,9,2,1,1,4,Lost
81548,269,8,34,3,2,3,8,Casual Users
81615,1508,37,63,1,4,4,9,At Risk
81793,3216,37,166,1,4,5,10,At Risk
82051,255,6,21,3,1,2,6,Casual Users
82196,11,91,294,5,5,5,15,Champions
82219,113,46,99,4,5,4,13,Champions
82259,3833,7,8,1,2,1,4,Lost
82300,3241,5,29,1,1,2,4,Lost
82311,405,29,177,3,4,5,12,Loyal Users
82488,447,9,12,3,2,1,6,Casual Users
82958,1131,7,9,2,2,1,5,Lost
83138,2036,10,34,1,2,3,6,Lost
83457,274,20,24,3,3,2,8,Loyal Users
83600,104,24,51,4,4,3,11,Loyal Users
83792,523,8,69,2,2,4,8,Lost
84071,450,38,92,3,4,4,11,Loyal Users
84112,233,133,320,3,5,5,13,Loyal Users
84198,2922,18,42,1,3,3,7,Casual Users
84399,88,46,83,4,5,4,13,Champions
84951,1238,54,92,2,5,4,11,At Risk
84990,405,6,18,3,1,2,6,Casual Users
85133,652,7,8,2,2,1,5,Lost
85212,170,19,57,3,3,3,9,Loyal Users
85422,987,5,9,2,1,1,4,Lost
85812,265,19,65,3,3,4,10,Loyal Users
86116,36,96,477,5,5,5,15,Champions
86816,1721,13,137,1,3,4,8,Casual Users
86964,78,104,398,4,5,5,14,Champions
87538,1404,19,74,1,3,4,8,Casual Users
87583,3,137,958,5,5,5,15,Champions
87699,260,27,66,3,4,4,11,Loyal Users
87794,1217,9,47,2,2,3,7,Lost
87897,514,20,45,2,3,3,8,Casual Users
87949,290,14,31,3,3,2,8,Loyal Users
88093,2496,10,51,1,2,3,6,Lost
88100,138,7,12,4,2,1,7,Promising
88109,19,36,129,5,4,4,13,Champions
88349,406,8,9,3,2,1,6,Casual Users
88948,1999,10,31,1,2,2,5,Lost
89077,14,5,6,5,1,1,7,Promising
89120,840,15,64,2,3,4,9,Casual Users
89272,2946,5,5,1,1,1,3,Lost
89810,33,64,172,5,5,5,15,Champions
89906,18,29,114,5,4,4,13,Champions
90005,26,62,172,5,5,5,15,Champions
90129,748,23,65,2,4,4,10,At Risk
90306,162,69,374,4,5,5,14,Champions
90449,489,5,6,2,1,1,4,Lost
90725,211,11,31,3,2,2,7,Casual Users
90736,274,10,15,3,2,1,6,Casual Users
90942,133,25,50,4,4,3,11,Loyal Users
90987,36,127,213,5,5,5,15,Champions
78362,444,23,37,3,4,3,10,Loyal Users
78391,2702,5,10,1,1,1,3,Lost
78596,414,8,15,3,2,1,6,Casual Users
78729,694,10,30,2,2,2,6,Lost
78933,58,65,113,5,5,4,14,Champions
78978,4,74,243,5,5,5,15,Champions
79497,127,63,191,4,5,5,14,Champions
79793,145,7,17,4,2,2,8,Promising
79975,474,5,9,2,1,1,4,Lost
80076,89,10,17,4,2,2,8,Promising
80415,11,93,395,5,5,5,15,Champions
80432,69,136,333,5,5,5,15,Champions
80750,417,9,13,3,2,1,6,Casual Users
80909,44,50,58,5,5,3,13,Loyal Users
81186,122,45,127,4,4,4,12,Champions
81294,13,50,103,5,5,4,14,Champions
81346,283,27,118,3,4,4,11,Loyal Users
81363,575,5,8,2,1,1,4,Lost
81526,2243,12,42,1,3,3,7,Casual Users
81939,103,120,436,4,5,5,14,Champions
82372,3580,5,7,1,1,1,3,Lost
82774,39,46,171,5,5,5,15,Champions
82859,57,43,88,5,4,4,13,Champions
83348,66,82,228,5,5,5,15,Champions
83436,64,13,61,5,3,3,11,Loyal Users
83915,526,12,34,2,3,3,8,Casual Users
84007,0,43,167,5,4,5,14,Champions
84237,691,8,13,2,2,1,5,Lost
84310,1838,16,18,1,3,2,6,Casual Users
84415,30,69,502,5,5,5,15,Champions
84618,101,45,121,4,4,4,12,Champions
85062,1068,46,55,2,5,3,10,At Risk
85092,4431,10,15,1,2,1,4,Lost
85589,7,22,40,5,4,3,12,Loyal Users
85622,376,25,122,3,4,4,11,Loyal Users
86107,964,12,27,2,3,2,7,Casual Users
86241,5,56,213,5,5,5,15,Champions
86557,324,25,56,3,4,3,10,Loyal Users
86620,8,82,453,5,5,5,15,Champions
86885,76,30,147,4,4,5,13,Champions
86957,568,18,42,2,3,3,8,Casual Users
87276,92,35,124,4,4,4,12,Champions
87533,90,81,143,4,5,4,13,Champions
88057,737,80,107,2,5,4,11,At Risk
88217,86,30,118,4,4,4,12,Champions
88252,665,17,45,2,3,3,8,Casual Users
88630,161,5,10,4,1,1,6,Promising
88744,999,21,65,2,3,4,9,Casual Users
88770,1683,7,9,1,2,1,4,Lost
88983,6,78,200,5,5,5,15,Champions
89227,414,7,10,3,2,1,6,Casual Users
89680,923,12,17,2,3,2,7,Casual Users
90017,265,18,58,3,3,3,9,Loyal Users
90208,220,23,54,3,4,3,10,Loyal Users
90774,262,29,51,3,4,3,10,Loyal Users
78286,1559,14,23,1,3,2,6,Casual Users
78304,986,9,13,2,2,1,5,Lost
78310,132,100,124,4,5,4,13,Champions
78710,879,12,24,2,3,2,7,Casual Users
78724,375,14,110,3,3,4,10,Loyal Users
78900,1644,16,32,1,3,3,7,Casual Users
78950,23,21,101,5,3,4,12,Loyal Users
79076,86,6,12,4,1,1,6,Promising
79145,135,56,257,4,5,5,14,Champions
79217,130,121,292,4,5,5,14,Champions
79628,2,69,289,5,5,5,15,Champions
79668,112,13,37,4,3,3,10,Loyal Users
79840,299,80,150,3,5,5,13,Loyal Users
79857,50,8,24,5,2,2,9,Promising
80235,179,21,82,3,3,4,10,Loyal Users
80236,26,83,306,5,5,5,15,Champions
80482,977,6,17,2,1,2,5,Lost
81362,117,85,149,4,5,5,14,Champions
81369,4955,11,11,1,2,1,4,Lost
81725,3297,7,17,1,2,2,5,Lost
81965,136,41,101,4,4,4,12,Champions
82050,439,16,29,3,3,2,8,Loyal Users
82159,0,59,255,5,5,5,15,Champions
82208,6,13,126,5,3,4,12,Loyal Users
82224,279,109,249,3,5,5,13,Loyal Users
82492,82,47,153,4,5,5,14,Champions
82580,414,86,171,3,5,5,13,Loyal Users
82603,169,13,57,3,3,3,9,Loyal Users
83116,144,34,51,4,4,3,11,Loyal Users
83167,11,34,72,5,4,4,13,Champions
83201,79,5,12,4,1,1,6,Promising
83375,545,22,44,2,4,3,9,At Risk
83396,155,87,537,4,5,5,14,Champions
83437,2975,8,10,1,2,1,4,Lost
84295,580,30,99,2,4,4,10,At Risk
84351,271,75,294,3,5,5,13,Loyal Users
84536,46,5,19,5,1,2,8,Promising
84589,19,22,73,5,4,4,13,Champions
84737,381,43,166,3,4,5,12,Loyal Users
84816,1822,5,5,1,1,1,3,Lost
84817,283,13,116,3,3,4,10,Loyal Users
85120,44,50,106,5,5,4,14,Champions
85161,114,5,8,4,1,1,6,Promising
85247,31,29,148,5,4,5,14,Champions
85296,3767,6,9,1,1,1,3,Lost
85481,748,7,9,2,2,1,5,Lost
85723,374,5,8,3,1,1,5,Casual Users
85869,87,35,62,4,4,3,11,Loyal Users
85999,89,10,20,4,2,2,8,Promising
86160,378,110,512,3,5,5,13,Loyal Users
86441,2786,11,32,1,2,3,6,Lost
86614,161,38,74,4,4,4,12,Champions
87071,2221,8,26,1,2,2,5,Lost
87104,401,7,14,3,2,1,6,Casual Users
87314,451,11,17,3,2,2,7,Casual Users
87562,152,39,123,4,4,4,12,Champions
87790,130,14,39,4,3,3,10,Loyal Users
87964,448,15,43,3,3,3,9,Loyal Users
87984,1621,24,85,1,4,4,9,At Risk
88345,1373,6,6,1,1,1,3,Lost
88617,251,51,115,3,5,4,12,Loyal Users
88685,14,76,341,5,5,5,15,Champions
88759,102,44,99,4,4,4,12,Champions
88930,683,16,104,2,3,4,9,Casual Users
88986,566,11,78,2,2,4,8,Lost
88989,2831,8,9,1,2,1,4,Lost
89382,3151,5,7,1,1,1,3,Lost
89522,111,11,27,4,2,2,8,Promising
90259,405,77,220,3,5,5,13,Loyal Users
90322,2230,8,11,1,2,1,4,Lost
90752,125,9,12,4,2,1,7,Promising
91061,80,77,458,4,5,5,14,Champions
78344,2856,6,18,1,1,2,4,Lost
78381,39,7,26,5,2,2,9,Promising
78480,0,167,485,5,5,5,15,Champions
78773,1701,8,9,1,2,1,4,Lost
78971,110,69,255,4,5,5,14,Champions
79109,1107,43,124,2,4,4,10,At Risk
79290,92,6,26,4,1,2,7,Promising
79648,45,83,297,5,5,5,15,Champions
80176,54,62,279,5,5,5,15,Champions
80210,130,13,73,4,3,4,11,Loyal Users
80233,729,26,58,2,4,3,9,At Risk
80352,131,13,58,4,3,3,10,Loyal Users
80691,5280,6,24,1,1,2,4,Lost
80806,12,29,33,5,4,3,12,Loyal Users
80942,387,42,107,3,4,4,11,Loyal Users
81392,274,5,78,3,1,4,8,Casual Users
81722,117,16,20,4,3,2,9,Loyal Users
81928,282,15,39,3,3,3,9,Loyal Users
82280,536,10,10,2,2,1,5,Lost
82286,1154,6,20,2,1,2,5,Lost
82368,65,148,453,5,5,5,15,Champions
82456,1902,5,12,1,1,1,3,Lost
82623,159,12,18,4,3,2,9,Loyal Users
82711,669,15,16,2,3,2,7,Casual Users
83103,666,16,41,2,3,3,8,Casual Users
83115,1533,6,29,1,1,2,4,Lost
83124,861,23,121,2,4,4,10,At Risk
83160,29,85,555,5,5,5,15,Champions
83270,11,49,172,5,5,5,15,Champions
83631,88,12,14,4,3,1,8,Loyal Users
83814,9,76,129,5,5,4,14,Champions
83970,219,93,230,3,5,5,13,Loyal Users
84180,410,18,37,3,3,3,9,Loyal Users
84262,249,51,251,3,5,5,13,Loyal Users
84342,536,18,22,2,3,2,7,Casual Users
84405,734,11,33,2,2,3,7,Lost
84450,239,49,233,3,5,5,13,Loyal Users
84538,178,55,74,3,5,4,12,Loyal Users
84549,1532,8,8,1,2,1,4,Lost
84707,26,22,92,5,4,4,13,Champions
85015,2419,12,15,1,3,1,5,Casual Users
85023,458,42,402,3,4,5,12,Loyal Users
85220,394,7,8,3,2,1,6,Casual Users
85403,296,11,43,3,2,3,8,Casual Users
85956,12,139,579,5,5,5,15,Champions
86032,57,90,349,5,5,5,15,Champions
86232,223,14,87,3,3,4,10,Loyal Users
86312,683,7,73,2,2,4,8,Lost
86698,1180,12,23,2,3,2,7,Casual Users
87026,674,7,22,2,2,2,6,Lost
87271,777,20,23,2,3,2,7,Casual Users
87278,102,57,80,4,5,4,13,Champions
87342,476,13,26,2,3,2,7,Casual Users
87911,295,8,11,3,2,1,6,Casual Users
88018,3297,11,26,1,2,2,5,Lost
88116,427,43,76,3,4,4,11,Loyal Users
88560,3662,5,32,1,1,3,5,Lost
88742,87,10,14,4,2,1,7,Promising
88801,2578,7,10,1,2,1,4,Lost
89090,229,17,35,3,3,3,9,Loyal Users
89093,709,5,19,2,1,2,5,Lost
89180,1839,5,5,1,1,1,3,Lost
89378,73,76,443,4,5,5,14,Champions
89608,4,62,102,5,5,4,14,Champions
90199,2172,7,9,1,2,1,4,Lost
90255,26,116,395,5,5,5,15,Champions
90630,962,18,26,2,3,2,7,Casual Users
78409,5,16,17,5,3,2,10,Loyal Users
78488,1597,16,100,1,3,4,8,Casual Users
78660,1146,31,171,2,4,5,11,At Risk
78693,1500,18,44,1,3,3,7,Casual Users
79140,123,21,67,4,3,4,11,Loyal Users
79176,126,13,14,4,3,1,8,Loyal Users
79540,132,24,47,4,4,3,11,Loyal Users
79884,30,17,75,5,3,4,12,Loyal Users
79936,111,129,300,4,5,5,14,Champions
80057,119,132,633,4,5,5,14,Champions
80186,7,80,280,5,5,5,15,Champions
80302,162,25,60,4,4,3,11,Loyal Users
80452,113,100,707,4,5,5,14,Champions
80559,2267,16,23,1,3,2,6,Casual Users
81062,1104,6,25,2,1,2,5,Lost
81291,494,7,31,2,2,2,6,Lost
81561,102,20,38,4,3,3,10,Loyal Users
82089,135,7,9,4,2,1,7,Promising
82132,419,5,5,3,1,1,5,Casual Users
82227,23,86,410,5,5,5,15,Champions
82444,133,9,14,4,2,1,7,Promising
82502,857,16,97,2,3,4,9,Casual Users
82971,101,36,106,4,4,4,12,Champions
83319,115,43,60,4,4,3,11,Loyal Users
83347,149,100,393,4,5,5,14,Champions
83747,6,62,152,5,5,5,15,Champions
84020,143,93,261,4,5,5,14,Champions
84106,305,23,101,3,4,4,11,Loyal Users
84361,121,27,92,4,4,4,12,Champions
84413,1571,7,10,1,2,1,4,Lost
84738,161,80,500,4,5,5,14,Champions
84750,118,73,160,4,5,5,14,Champions
85238,62,56,108,5,5,4,14,Champions
85448,1427,18,25,1,3,2,6,Casual Users
85657,420,5,6,3,1,1,5,Casual Users
85764,76,56,102,4,5,4,13,Champions
85889,113,5,7,4,1,1,6,Promising
86088,0,39,99,5,4,4,13,Champions
86374,0,29,39,5,4,3,12,Loyal Users
86871,292,51,115,3,5,4,12,Loyal Users
87096,118,68,179,4,5,5,14,Champions
87335,110,12,121,4,3,4,11,Loyal Users
87530,782,18,148,2,3,5,10,Casual Users
87612,125,9,39,4,2,3,9,Promising
87968,23,95,166,5,5,5,15,Champions
88221,1146,6,9,2,1,1,4,Lost
88340,76,56,64,4,5,4,13,Champions
88411,1103,18,36,2,3,3,8,Casual Users
88426,230,20,97,3,3,4,10,Loyal Users
88749,15,22,55,5,4,3,12,Loyal Users
88901,518,17,41,2,3,3,8,Casual Users
89064,524,9,20,2,2,2,6,Lost
89337,730,5,6,2,1,1,4,Lost
89516,1400,5,7,1,1,1,3,Lost
89572,4285,8,12,1,2,1,4,Lost
89646,155,17,34,4,3,3,10,Loyal Users
89820,71,8,26,4,2,2,8,Promising
90024,744,25,55,2,4,3,9,At Risk
90318,1074,7,19,2,2,2,6,Lost
90502,167,13,50,3,3,3,9,Loyal Users
90924,1,90,206,5,5,5,15,Champions
91001,52,14,57,5,3,3,11,Loyal Users
78290,7,89,591,5,5,5,15,Champions
79151,153,10,13,4,2,1,7,Promising
79671,238,12,91,3,3,4,10,Loyal Users
79787,408,10,60,3,2,3,8,Casual Users
79807,290,84,202,3,5,5,13,Loyal Users
80010,0,47,160,5,5,5,15,Champions
80035,158,7,22,4,2,2,8,Promising
80043,14,31,47,5,4,3,12,Loyal Users
80504,238,37,68,3,4,4,11,Loyal Users
80539,0,77,336,5,5,5,15,Champions
80666,371,15,101,3,3,4,10,Loyal Users
81076,572,42,302,2,4,5,11,At Risk
81086,1427,7,43,1,2,3,6,Lost
81185,2891,5,8,1,1,1,3,Lost
81226,2681,5,35,1,1,3,5,Lost
81328,693,9,10,2,2,1,5,Lost
82007,694,30,46,2,4,3,9,At Risk
82020,427,15,41,3,3,3,9,Loyal Users
82214,995,7,21,2,2,2,6,Lost
82298,80,40,155,4,4,5,13,Champions
82331,461,5,10,3,1,1,5,Casual Users
82843,108,63,310,4,5,5,14,Champions
82902,568,8,24,2,2,2,6,Lost
82986,43,7,8,5,2,1,8,Promising
83228,130,107,157,4,5,5,14,Champions
83381,16,34,43,5,4,3,12,Loyal Users
83768,291,22,41,3,4,3,10,Loyal Users
83866,7,44,57,5,4,3,12,Loyal Users
84081,61,10,23,5,2,2,9,Promising
84243,1227,12,23,2,3,2,7,Casual Users
84638,0,12,15,5,3,1,9,Loyal Users
85255,420,49,72,3,5,4,12,Loyal Users
85449,3972,12,18,1,3,2,6,Casual Users
85550,119,62,103,4,5,4,13,Champions
86294,120,5,16,4,1,2,7,Promising
86453,137,76,126,4,5,4,13,Champions
86625,272,40,145,3,4,4,11,Loyal Users
86947,136,82,510,4,5,5,14,Champions
87044,122,17,129,4,3,4,11,Loyal Users
87467,1512,14,15,1,3,1,5,Casual Users
87738,582,57,181,2,5,5,12,At Risk
87740,97,11,11,4,2,1,7,Promising
87928,2632,10,17,1,2,2,5,Lost
88094,219,19,24,3,3,2,8,Loyal Users
88180,3,82,267,5,5,5,15,Champions
88392,2566,13,13,1,3,1,5,Casual Users
88580,224,46,121,3,5,4,12,Loyal Users
88610,14,83,181,5,5,5,15,Champions
88772,698,25,88,2,4,4,10,At Risk
89008,16,47,77,5,5,4,14,Champions
89204,1305,18,35,1,3,3,7,Casual Users
89358,295,10,26,3,2,2,7,Casual Users
89453,0,19,59,5,3,3,11,Loyal Users
89624,263,7,25,3,2,2,7,Casual Users
89741,268,16,51,3,3,3,9,Loyal Users
89750,140,38,92,4,4,4,12,Champions
89952,105,30,98,4,4,4,12,Champions
89953,1011,5,15,2,1,1,4,Lost
89956,59,9,28,5,2,2,9,Promising
89988,1092,7,18,2,2,2,6,Lost
90148,4,40,53,5,4,3,12,Loyal Users
90224,2,38,52,5,4,3,12,Loyal Users
90451,69,10,100,5,2,4,11,Promising
90617,673,8,8,2,2,1,5,Lost
90936,2056,19,37,1,3,3,7,Casual Users
78504,417,33,91,3,4,4,11,Loyal Users
78814,2837,11,24,1,2,2,5,Lost
79074,1596,5,7,1,1,1,3,Lost
79101,746,21,46,2,3,3,8,Casual Users
79493,935,5,31,2,1,2,5,Lost
79623,116,27,92,4,4,4,12,Champions
79645,4511,6,13,1,1,1,3,Lost
79683,534,7,16,2,2,2,6,Lost
79723,854,6,8,2,1,1,4,Lost
79945,10,24,59,5,4,3,12,Loyal Users
80027,22,97,511,5,5,5,15,Champions
80431,653,17,79,2,3,4,9,Casual Users
80558,868,28,59,2,4,3,9,At Risk
80782,41,98,597,5,5,5,15,Champions
80818,572,14,23,2,3,2,7,Casual Users
80834,2326,6,34,1,1,3,5,Lost
80929,1798,10,45,1,2,3,6,Lost
80945,315,11,35,3,2,3,8,Casual Users
80982,1,37,72,5,4,4,13,Champions
81355,962,12,27,2,3,2,7,Casual Users
81412,23,207,483,5,5,5,15,Champions
81536,178,12,16,3,3,2,8,Loyal Users
81666,155,5,6,4,1,1,6,Promising
82296,309,36,45,3,4,3,10,Loyal Users
82358,306,52,129,3,5,4,12,Loyal Users
82363,2431,5,12,1,1,1,3,Lost
83059,0,36,281,5,4,5,14,Champions
83315,149,9,38,4,2,3,9,Promising
83326,14,39,149,5,4,5,14,Champions
83410,153,39,46,4,4,3,11,Loyal Users
83500,126,26,54,4,4,3,11,Loyal Users
83766,703,11,58,2,2,3,7,Lost
83815,593,20,59,2,3,3,8,Casual Users
84044,271,7,7,3,2,1,6,Casual Users
84125,123,65,269,4,5,5,14,Champions
84235,78,5,29,4,1,2,7,Promising
84245,229,11,35,3,2,3,8,Casual Users
84289,133,10,30,4,2,2,8,Promising
84320,429,18,29,3,3,2,8,Loyal Users
84326,408,10,78,3,2,4,9,Casual Users
84467,103,20,88,4,3,4,11,Loyal Users
84577,4575,7,42,1,2,3,6,Lost
84636,267,32,47,3,4,3,10,Loyal Users
84688,815,12,17,2,3,2,7,Casual Users
84850,426,5,7,3,1,1,5,Casual Users
84927,3958,5,9,1,1,1,3,Lost
85096,1515,8,20,1,2,2,5,Lost
85173,94,66,141,4,5,4,13,Champions
85312,2260,9,17,1,2,2,5,Lost
85406,111,9,20,4,2,2,8,Promising
85458,121,73,152,4,5,5,14,Champions
85799,110,20,81,4,3,4,11,Loyal Users
86921,1313,7,38,1,2,3,6,Lost
87040,107,11,20,4,2,2,8,Promising
87195,87,12,28,4,3,2,9,Loyal Users
87201,136,216,667,4,5,5,14,Champions
87418,530,46,135,2,5,4,11,At Risk
87488,136,97,636,4,5,5,14,Champions
87564,127,77,153,4,5,5,14,Champions
87748,2181,12,12,1,3,1,5,Casual Users
87868,21,100,159,5,5,5,15,Champions
87909,459,18,46,3,3,3,9,Loyal Users
87993,2098,24,60,1,4,3,8,At Risk
88129,10,128,667,5,5,5,15,Champions
88158,834,5,9,2,1,1,4,Lost
88159,325,46,73,3,5,4,12,Loyal Users
88225,535,50,84,2,5,4,11,At Risk
88233,130,11,18,4,2,2,8,Promising
88696,117,105,224,4,5,5,14,Champions
88831,108,25,105,4,4,4,12,Champions
89023,647,83,226,2,5,5,12,At Risk
89384,1437,9,13,1,2,1,4,Lost
89746,34,75,205,5,5,5,15,Champions
89855,4583,8,13,1,2,1,4,Lost
90002,573,9,14,2,2,1,5,Lost
90081,157,34,103,4,4,4,12,Champions
90088,80,20,84,4,3,4,11,Loyal Users
90161,1109,6,6,2,1,1,4,Lost
90249,1122,5,24,2,1,2,5,Lost
90288,160,5,15,4,1,1,6,Promising
90494,28,53,163,5,5,5,15,Champions
90608,10,64,102,5,5,4,14,Champions
90778,3692,5,37,1,1,3,5,Lost
91030,5,119,458,5,5,5,15,Champions
78621,2414,28,46,1,4,3,8,At Risk
78838,582,17,45,2,3,3,8,Casual Users
78855,1376,24,67,1,4,4,9,At Risk
78998,115,37,183,4,4,5,13,Champions
79006,0,94,168,5,5,5,15,Champions
79210,154,15,37,4,3,3,10,Loyal Users
79478,416,35,94,3,4,4,11,Loyal Users
79781,4237,12,24,1,3,2,6,Casual Users
79919,271,58,147,3,5,5,13,Loyal Users
80048,428,16,22,3,3,2,8,Loyal Users
80735,46,107,386,5,5,5,15,Champions
80849,2821,5,7,1,1,1,3,Lost
80996,1521,8,13,1,2,1,4,Lost
81006,29,123,342,5,5,5,15,Champions
81074,142,113,187,4,5,5,14,Champions
81146,40,66,101,5,5,4,14,Champions
81212,7,5,17,5,1,2,8,Promising
81398,167,5,8,3,1,1,5,Casual Users
81469,31,6,16,5,1,2,8,Promising
81531,796,5,6,2,1,1,4,Lost
81607,115,26,79,4,4,4,12,Champions
81659,138,26,110,4,4,4,12,Champions
81759,1193,9,10,2,2,1,5,Lost
82074,1202,11,16,2,2,2,6,Lost
82397,120,22,81,4,4,4,12,Champions
82635,14,95,290,5,5,5,15,Champions
82898,275,29,137,3,4,4,11,Loyal Users
83083,673,7,27,2,2,2,6,Lost
83100,1351,35,55,1,4,3,8,At Risk
83193,139,38,56,4,4,3,11,Loyal Users
84025,346,25,44,3,4,3,10,Loyal Users
84116,1867,7,16,1,2,2,5,Lost
84223,34,5,17,5,1,2,8,Promising
84388,1829,10,14,1,2,1,4,Lost
84643,25,5,11,5,1,1,7,Promising
84692,130,41,64,4,4,4,12,Champions
84957,10,122,417,5,5,5,15,Champions
84982,694,8,16,2,2,2,6,Lost
85417,68,26,35,5,4,3,12,Loyal Users
85442,114,104,176,4,5,5,14,Champions
85549,3535,43,83,1,4,4,9,At Risk
85618,387,6,18,3,1,2,6,Casual Users
85694,107,38,244,4,4,5,13,Champions
85754,108,31,76,4,4,4,12,Champions
85982,420,163,580,3,5,5,13,Loyal Users
86111,970,6,6,2,1,1,4,Lost
86402,4,70,170,5,5,5,15,Champions
86699,149,17,27,4,3,2,9,Loyal Users
86758,4376,5,7,1,1,1,3,Lost
86965,1288,10,11,1,2,1,4,Lost
87155,1799,13,29,1,3,2,6,Casual Users
87308,421,5,6,3,1,1,5,Casual Users
87537,625,17,39,2,3,3,8,Casual Users
88153,128,17,45,4,3,3,10,Loyal Users
88271,1845,6,6,1,1,1,3,Lost
88298,4521,18,59,1,3,3,7,Casual Users
88333,258,9,20,3,2,2,7,Casual Users
88415,30,107,335,5,5,5,15,Champions
88443,257,29,37,3,4,3,10,Loyal Users
88672,129,16,22,4,3,2,9,Loyal Users
89181,434,9,22,3,2,2,7,Casual Users
89368,62,25,58,5,4,3,12,Loyal Users
89685,1777,56,129,1,5,4,10,At Risk
89693,2654,8,9,1,2,1,4,Lost
90016,510,5,5,2,1,1,4,Lost
90166,549,54,86,2,5,4,11,At Risk
90294,3023,9,23,1,2,2,5,Lost
90295,2957,13,21,1,3,2,6,Casual Users
90386,5276,16,43,1,3,3,7,Casual Users
90732,256,18,53,3,3,3,9,Loyal Users
78404,1325,33,209,1,4,5,10,At Risk
78491,2,93,217,5,5,5,15,Champions
78554,1914,6,16,1,1,2,4,Lost
78638,291,27,59,3,4,3,10,Loyal Users
78745,5,28,85,5,4,4,13,Champions
79086,2706,12,26,1,3,2,6,Casual Users
79159,27,12,35,5,3,3,11,Loyal Users
79292,2560,15,58,1,3,3,7,Casual Users
79633,257,27,49,3,4,3,10,Loyal Users
79929,434,11,55,3,2,3,8,Casual Users
80131,7,120,228,5,5,5,15,Champions
80208,118,34,167,4,4,5,13,Champions
80312,133,9,14,4,2,1,7,Promising
80620,8,97,242,5,5,5,15,Champions
80762,2341,8,34,1,2,3,6,Lost
81329,15,82,615,5,5,5,15,Champions
81464,432,21,90,3,3,4,10,Loyal Users
81522,2613,21,64,1,3,4,8,Casual Users
82342,88,77,422,4,5,5,14,Champions
82410,528,16,32,2,3,3,8,Casual Users
82426,2092,7,74,1,2,4,7,Lost
82900,471,24,40,2,4,3,9,At Risk
82914,338,5,9,3,1,1,5,Casual Users
83062,1674,9,14,1,2,1,4,Lost
83065,837,6,16,2,1,2,5,Lost
83094,1992,10,15,1,2,1,4,Lost
83548,1137,8,24,2,2,2,6,Lost
83938,65,33,46,5,4,3,12,Loyal Users
84035,2788,6,7,1,1,1,3,Lost
84175,371,6,13,3,1,1,5,Casual Users
84468,29,25,48,5,4,3,12,Loyal Users
84755,384,21,54,3,3,3,9,Loyal Users
84756,90,8,19,4,2,2,8,Promising
85009,99,37,237,4,4,5,13,Champions
85182,3266,5,25,1,1,2,4,Lost
85782,201,6,6,3,1,1,5,Casual Users
86097,1041,17,21,2,3,2,7,Casual Users
86174,2476,5,13,1,1,1,3,Lost
86245,280,8,11,3,2,1,6,Casual Users
86252,104,66,104,4,5,4,13,Champions
86329,411,6,24,3,1,2,6,Casual Users
86383,242,11,53,3,2,3,8,Casual Users
86944,4,28,128,5,4,4,13,Champions
86974,1085,9,9,2,2,1,5,Lost
87013,268,19,120,3,3,4,10,Loyal Users
87498,120,32,64,4,4,4,12,Champions
87590,411,32,116,3,4,4,11,Loyal Users
87942,471,10,13,2,2,1,5,Lost
88126,278,15,40,3,3,3,9,Loyal Users
88144,687,9,34,2,2,3,7,Lost
88194,141,8,9,4,2,1,7,Promising
88223,1314,9,16,1,2,2,5,Lost
88261,276,15,71,3,3,4,10,Loyal Users
88423,310,10,19,3,2,2,7,Casual Users
88789,691,10,26,2,2,2,6,Lost
88922,45,17,96,5,3,4,12,Loyal Users
89191,994,12,54,2,3,3,8,Casual Users
89611,714,12,17,2,3,2,7,Casual Users
90090,3137,6,8,1,1,1,3,Lost
90300,236,115,384,3,5,5,13,Loyal Users
90366,1335,13,34,1,3,3,7,Casual Users
90377,90,7,15,4,2,1,7,Promising
90707,1965,22,44,1,4,3,8,At Risk
90874,5959,6,9,1,1,1,3,Lost
78704,26,9,20,5,2,2,9,Promising
78721,2,53,116,5,5,4,14,Champions
78771,683,56,394,2,5,5,12,At Risk
78859,4229,5,8,1,1,1,3,Lost
79196,431,21,53,3,3,3,9,Loyal Users
79314,140,11,24,4,2,2,8,Promising
79818,24,13,109,5,3,4,12,Loyal Users
79824,548,9,47,2,2,3,7,Lost
80069,94,20,285,4,3,5,12,Loyal Users
80160,19,119,483,5,5,5,15,Champions
80363,526,7,14,2,2,1,5,Lost
80388,415,6,30,3,1,2,6,Casual Users
80519,681,6,26,2,1,2,5,Lost
80742,1328,31,97,1,4,4,9,At Risk
80796,593,22,125,2,4,4,10,At Risk
80905,39,70,207,5,5,5,15,Champions
81457,530,7,19,2,2,2,6,Lost
81875,283,34,97,3,4,4,11,Loyal Users
82282,783,12,23,2,3,2,7,Casual Users
82294,3698,7,20,1,2,2,5,Lost
82571,1817,26,64,1,4,4,9,At Risk
82620,115,5,7,4,1,1,6,Promising
82736,1920,7,17,1,2,2,5,Lost
82918,145,36,52,4,4,3,11,Loyal Users
83125,417,14,26,3,3,2,8,Loyal Users
83243,669,5,6,2,1,1,4,Lost
83862,3030,6,16,1,1,2,4,Lost
83883,114,39,58,4,4,3,11,Loyal Users
84305,270,24,43,3,4,3,10,Loyal Users
84414,390,49,70,3,5,4,12,Loyal Users
84674,710,6,16,2,1,2,5,Lost
85188,79,93,126,4,5,4,13,Champions
85189,155,19,84,4,3,4,11,Loyal Users
85525,594,14,26,2,3,2,7,Casual Users
85788,875,19,31,2,3,2,7,Casual Users
86538,3686,9,9,1,2,1,4,Lost
86959,247,7,70,3,2,4,9,Casual Users
87077,405,140,452,3,5,5,13,Loyal Users
87722,247,46,167,3,5,5,13,Loyal Users
87781,132,5,5,4,1,1,6,Promising
89399,497,5,12,2,1,1,4,Lost
89400,46,151,319,5,5,5,15,Champions
89425,167,18,27,3,3,2,8,Loyal Users
89460,160,59,140,4,5,4,13,Champions
89490,973,8,10,2,2,1,5,Lost
89619,5807,9,9,1,2,1,4,Lost
89832,425,6,16,3,1,2,6,Casual Users
89996,126,7,17,4,2,2,8,Promising
90233,299,13,27,3,3,2,8,Loyal Users
90382,1861,8,10,1,2,1,4,Lost
90755,2564,10,11,1,2,1,4,Lost
90868,685,23,107,2,4,4,10,At Risk
78575,1167,6,9,2,1,1,4,Lost
79166,73,36,160,4,4,5,13,Champions
79474,2557,5,6,1,1,1,3,Lost
80485,247,27,29,3,4,2,9,Loyal Users
80786,393,11,79,3,2,4,9,Casual Users
80841,1994,9,39,1,2,3,6,Lost
81209,152,121,520,4,5,5,14,Champions
81430,2477,6,9,1,1,1,3,Lost
81590,171,88,298,3,5,5,13,Loyal Users
81918,66,49,175,5,5,5,15,Champions
81933,92,22,70,4,4,4,12,Champions
81950,1116,6,15,2,1,1,4,Lost
82215,640,8,9,2,2,1,5,Lost
82319,136,53,199,4,5,5,14,Champions
82429,1008,21,114,2,3,4,9,Casual Users
83583,292,13,36,3,3,3,9,Loyal Users
83597,2554,6,6,1,1,1,3,Lost
83869,24,60,420,5,5,5,15,Champions
83881,2118,35,73,1,4,4,9,At Risk
84047,747,6,9,2,1,1,4,Lost
84432,1529,15,28,1,3,2,6,Casual Users
84463,1170,34,87,2,4,4,10,At Risk
84717,129,101,175,4,5,5,14,Champions
84893,246,28,81,3,4,4,11,Loyal Users
85066,452,11,15,3,2,1,6,Casual Users
85165,2143,6,9,1,1,1,3,Lost
85601,359,14,36,3,3,3,9,Loyal Users
85943,22,67,79,5,5,4,14,Champions
86592,777,5,16,2,1,2,5,Lost
86676,75,42,138,4,4,4,12,Champions
87602,263,18,83,3,3,4,10,Loyal Users
88054,495,16,41,2,3,3,8,Casual Users
88084,268,11,25,3,2,2,7,Casual Users
88127,1421,7,7,1,2,1,4,Lost
88143,1648,8,15,1,2,1,4,Lost
88347,399,39,101,3,4,4,11,Loyal Users
89073,136,47,186,4,5,5,14,Champions
89220,101,16,38,4,3,3,10,Loyal Users
89451,844,27,39,2,4,3,9,At Risk
89647,30,46,91,5,5,4,14,Champions
89862,2414,5,22,1,1,2,4,Lost
89938,221,21,351,3,3,5,11,Loyal Users
90060,5,6,9,5,1,1,7,Promising
90240,4304,9,40,1,2,3,6,Lost
90498,1846,12,22,1,3,2,6,Casual Users
90699,1657,8,14,1,2,1,4,Lost
78642,24,81,166,5,5,5,15,Champions
78768,80,83,268,4,5,5,14,Champions
79224,93,15,81,4,3,4,11,Loyal Users
79247,6,49,158,5,5,5,15,Champions
79935,1253,11,79,2,2,4,8,Lost
79957,129,12,32,4,3,3,10,Loyal Users
80338,753,8,57,2,2,3,7,Lost
80435,33,19,31,5,3,2,10,Loyal Users
80903,23,122,253,5,5,5,15,Champions
81706,111,7,22,4,2,2,8,Promising
81762,1,17,30,5,3,2,10,Loyal Users
81803,2662,8,17,1,2,2,5,Lost
81870,1171,7,22,2,2,2,6,Lost
81907,1746,9,27,1,2,2,5,Lost
81983,676,6,7,2,1,1,4,Lost
81984,8,39,55,5,4,3,12,Loyal Users
82207,32,67,180,5,5,5,15,Champions
82653,314,26,43,3,4,3,10,Loyal Users
82739,2,13,22,5,3,2,10,Loyal Users
83013,3530,5,20,1,1,2,4,Lost
83295,388,25,35,3,4,3,10,Loyal Users
83303,2001,9,16,1,2,2,5,Lost
83441,106,33,60,4,4,3,11,Loyal Users
83898,1851,10,12,1,2,1,4,Lost
83954,109,54,294,4,5,5,14,Champions
84001,3123,6,10,1,1,1,3,Lost
84218,146,13,51,4,3,3,10,Loyal Users
84255,254,32,52,3,4,3,10,Loyal Users
84279,1435,10,108,1,2,4,7,Lost
84344,33,21,75,5,3,4,12,Loyal Users
84408,746,8,32,2,2,3,7,Lost
84651,39,15,29,5,3,2,10,Loyal Users
85234,10,78,168,5,5,5,15,Champions
85374,46,51,139,5,5,4,14,Champions
85679,129,78,666,4,5,5,14,Champions
85853,360,38,62,3,4,3,10,Loyal Users
86038,5418,7,8,1,2,1,4,Lost
86198,102,17,131,4,3,4,11,Loyal Users
86202,568,6,18,2,1,2,5,Lost
86776,136,30,72,4,4,4,12,Champions
86895,939,11,35,2,2,3,7,Lost
87081,391,9,17,3,2,2,7,Casual Users
87384,1410,5,7,1,1,1,3,Lost
87415,2982,9,22,1,2,2,5,Lost
87532,30,6,10,5,1,1,7,Promising
87702,127,14,25,4,3,2,9,Loyal Users
87917,1143,14,56,2,3,3,8,Casual Users
88091,40,19,44,5,3,3,11,Loyal Users
88171,1954,14,92,1,3,4,8,Casual Users
88232,434,5,11,3,1,1,5,Casual Users
88307,12,40,91,5,4,4,13,Champions
88918,272,8,39,3,2,3,8,Casual Users
88947,855,18,79,2,3,4,9,Casual Users
89197,287,5,34,3,1,3,7,Casual Users
89223,269,7,15,3,2,1,6,Casual Users
89353,1099,12,95,2,3,4,9,Casual Users
89714,66,9,23,5,2,2,9,Promising
90679,35,32,87,5,4,4,13,Champions
90756,601,8,28,2,2,2,6,Lost
90839,243,16,20,3,3,2,8,Loyal Users
90869,135,27,141,4,4,4,12,Champions
90907,209,40,461,3,4,5,12,Loyal Users
90998,1572,8,12,1,2,1,4,Lost
78324,542,24,79,2,4,4,10,At Risk
78474,13,50,186,5,5,5,15,Champions
78738,139,66,190,4,5,5,14,Champions
78917,211,45,205,3,4,5,12,Loyal Users
79048,1079,22,45,2,4,3,9,At Risk
79353,36,93,181,5,5,5,15,Champions
79360,3233,7,10,1,2,1,4,Lost
79701,91,7,23,4,2,2,8,Promising
79951,44,149,393,5,5,5,15,Champions
79983,430,71,193,3,5,5,13,Loyal Users
80964,400,7,8,3,2,1,6,Casual Users
81389,430,106,213,3,5,5,13,Loyal Users
81442,47,124,1007,5,5,5,15,Champions
81746,249,24,45,3,4,3,10,Loyal Users
81955,1820,64,423,1,5,5,11,At Risk
81974,109,25,80,4,4,4,12,Champions
82591,86,37,82,4,4,4,12,Champions
82850,8,18,95,5,3,4,12,Loyal Users
82928,2322,6,12,1,1,1,3,Lost
83260,590,11,61,2,2,3,7,Lost
83369,435,70,206,3,5,5,13,Loyal Users
83407,702,6,9,2,1,1,4,Lost
83611,1173,6,18,2,1,2,5,Lost
83685,4,62,256,5,5,5,15,Champions
83735,1623,14,21,1,3,2,6,Casual Users
83736,15,44,143,5,4,4,13,Champions
83880,184,139,587,3,5,5,13,Loyal Users
84037,249,109,251,3,5,5,13,Loyal Users
84164,74,55,103,4,5,4,13,Champions
84393,1189,37,49,2,4,3,9,At Risk
84454,447,18,51,3,3,3,9,Loyal Users
85043,247,12,54,3,3,3,9,Loyal Users
85178,37,62,507,5,5,5,15,Champions
85299,48,22,78,5,4,4,13,Champions
85565,471,53,88,2,5,4,11,At Risk
85683,0,37,55,5,4,3,12,Loyal Users
85807,327,30,79,3,4,4,11,Loyal Users
86009,12,25,40,5,4,3,12,Loyal Users
86157,1061,12,51,2,3,3,8,Casual Users
86911,1145,5,8,2,1,1,4,Lost
87042,151,15,72,4,3,4,11,Loyal Users
87680,20,39,72,5,4,4,13,Champions
88122,5,17,30,5,3,2,10,Loyal Users
88238,2873,5,11,1,1,1,3,Lost
88387,695,24,73,2,4,4,10,At Risk
88551,83,96,343,4,5,5,14,Champions
88592,997,21,22,2,3,2,7,Casual Users
88631,1000,7,7,2,2,1,5,Lost
89002,689,17,70,2,3,4,9,Casual Users
89143,540,7,35,2,2,3,7,Lost
89173,497,56,80,2,5,4,11,At Risk
89257,132,17,46,4,3,3,10,Loyal Users
89553,2262,13,29,1,3,2,6,Casual Users
90033,117,27,119,4,4,4,12,Champions
90647,299,5,13,3,1,1,5,Casual Users
90856,93,103,501,4,5,5,14,Champions
78307,8,107,428,5,5,5,15,Champions
78744,476,22,39,2,4,3,9,At Risk
78913,1708,6,17,1,1,2,4,Lost
79050,283,15,32,3,3,3,9,Loyal Users
79365,25,89,141,5,5,4,14,Champions
79492,1013,8,45,2,2,3,7,Lost
79949,552,6,13,2,1,1,4,Lost
80007,3124,11,30,1,2,2,5,Lost
80016,703,15,48,2,3,3,8,Casual Users
80430,54,14,92,5,3,4,12,Loyal Users
80812,3711,7,21,1,2,2,5,Lost
80908,17,11,37,5,2,3,10,Promising
81047,59,30,39,5,4,3,12,Loyal Users
81237,276,19,27,3,3,2,8,Loyal Users
81266,331,105,279,3,5,5,13,Loyal Users
81507,2127,14,31,1,3,2,6,Casual Users
81594,689,17,54,2,3,3,8,Casual Users
81661,15,28,47,5,4,3,12,Loyal Users
81914,9,36,73,5,4,4,13,Champions
82101,92,22,104,4,4,4,12,Champions
82479,631,28,43,2,4,3,9,At Risk
82585,977,5,6,2,1,1,4,Lost
82998,696,11,30,2,2,2,6,Lost
83117,3924,6,19,1,1,2,4,Lost
83171,547,18,25,2,3,2,7,Casual Users
83300,576,9,16,2,2,2,6,Lost
83705,360,43,74,3,4,4,11,Loyal Users
83972,909,9,42,2,2,3,7,Lost
84069,39,72,491,5,5,5,15,Champions
84239,67,65,521,5,5,5,15,Champions
84386,132,39,124,4,4,4,12,Champions
84758,990,6,34,2,1,3,6,Lost
84930,71,16,117,4,3,4,11,Loyal Users
85085,15,50,243,5,5,5,15,Champions
85327,117,17,36,4,3,3,10,Loyal Users
85878,216,11,23,3,2,2,7,Casual Users
86055,579,17,54,2,3,3,8,Casual Users
87082,132,42,223,4,4,5,13,Champions
87305,1237,9,60,2,2,3,7,Lost
87310,424,5,7,3,1,1,5,Casual Users
87754,986,5,5,2,1,1,4,Lost
87768,1105,23,261,2,4,5,11,At Risk
87786,987,10,31,2,2,2,6,Lost
87830,34,26,46,5,4,3,12,Loyal Users
87834,27,105,446,5,5,5,15,Champions
88273,422,126,156,3,5,5,13,Loyal Users
88448,124,28,165,4,4,5,13,Champions
88487,95,19,110,4,3,4,11,Loyal Users
88910,278,51,121,3,5,4,12,Loyal Users
88976,362,56,133,3,5,4,12,Loyal Users
89302,228,15,29,3,3,2,8,Loyal Users
90043,272,31,61,3,4,3,10,Loyal Users
90131,1323,9,11,1,2,1,4,Lost
90212,752,7,9,2,2,1,5,Lost
90594,1550,42,549,1,4,5,10,At Risk
90846,1422,5,5,1,1,1,3,Lost
90851,1128,8,20,2,2,2,6,Lost
78740,27,70,211,5,5,5,15,Champions
78816,2,15,24,5,3,2,10,Loyal Users
78915,193,12,40,3,3,3,9,Loyal Users
79041,1829,11,99,1,2,4,7,Lost
79416,669,19,39,2,3,3,8,Casual Users
79765,109,29,72,4,4,4,12,Champions
81178,136,18,34,4,3,3,10,Loyal Users
81190,594,9,17,2,2,2,6,Lost
81214,411,80,380,3,5,5,13,Loyal Users
81297,308,24,33,3,4,3,10,Loyal Users
81454,94,47,422,4,5,5,14,Champions
81655,0,104,456,5,5,5,15,Champions
81675,175,7,18,3,2,2,7,Casual Users
81831,397,5,13,3,1,1,5,Casual Users
82335,413,8,11,3,2,1,6,Casual Users
82362,1135,13,19,2,3,2,7,Casual Users
82438,134,48,108,4,5,4,13,Champions
82648,1843,11,16,1,2,2,5,Lost
82798,553,45,220,2,4,5,11,At Risk
82880,180,22,96,3,4,4,11,Loyal Users
82988,63,101,549,5,5,5,15,Champions
83052,336,25,66,3,4,4,11,Loyal Users
83110,400,29,133,3,4,4,11,Loyal Users
83439,448,23,53,3,4,3,10,Loyal Users
83760,2483,12,30,1,3,2,6,Casual Users
84284,5,28,81,5,4,4,13,Champions
84761,3556,5,9,1,1,1,3,Lost
84809,1087,7,39,2,2,3,7,Lost
84825,862,6,18,2,1,2,5,Lost
84851,63,26,64,5,4,4,13,Champions
85039,82,17,64,4,3,4,11,Loyal Users
85186,270,16,22,3,3,2,8,Loyal Users
85252,546,9,23,2,2,2,6,Lost
85328,846,17,26,2,3,2,7,Casual Users
85382,598,9,15,2,2,1,5,Lost
85490,2413,12,31,1,3,2,6,Casual Users
85504,1110,30,183,2,4,5,11,At Risk
86027,2286,11,24,1,2,2,5,Lost
86548,72,14,17,4,3,2,9,Loyal Users
86814,109,31,61,4,4,3,11,Loyal Users
87315,2602,5,16,1,1,2,4,Lost
87559,0,36,62,5,4,3,12,Loyal Users
87586,137,24,204,4,4,5,13,Champions
87826,132,41,82,4,4,4,12,Champions
88055,26,96,257,5,5,5,15,Champions
88186,383,13,85,3,3,4,10,Loyal Users
88246,560,32,142,2,4,4,10,At Risk
88255,253,20,41,3,3,3,9,Loyal Users
88383,270,14,94,3,3,4,10,Loyal Users
88567,2526,5,11,1,1,1,3,Lost
88768,121,15,54,4,3,3,10,Loyal Users
89729,248,7,12,3,2,1,6,Casual Users
89946,80,80,209,4,5,5,14,Champions
90127,16,27,37,5,4,3,12,Loyal Users
90353,93,147,314,4,5,5,14,Champions
90536,4595,8,8,1,2,1,4,Lost
90832,1,16,27,5,3,2,10,Loyal Users
78557,67,10,40,5,2,3,10,Promising
78712,244,31,98,3,4,4,11,Loyal Users
78833,2152,13,42,1,3,3,7,Casual Users
78974,569,5,10,2,1,1,4,Lost
79535,753,24,62,2,4,3,9,At Risk
79921,609,21,66,2,3,4,9,Casual Users
80009,545,7,15,2,2,1,5,Lost
80132,156,34,102,4,4,4,12,Champions
80145,305,25,136,3,4,4,11,Loyal Users
80531,151,26,58,4,4,3,11,Loyal Users
80537,2462,5,5,1,1,1,3,Lost
80831,109,29,169,4,4,5,13,Champions
80896,54,7,8,5,2,1,8,Promising
80995,227,32,293,3,4,5,12,Loyal Users
81420,826,22,27,2,4,2,8,At Risk
81498,1682,5,9,1,1,1,3,Lost
81686,421,15,50,3,3,3,9,Loyal Users
81820,240,5,22,3,1,2,6,Casual Users
82041,67,134,467,5,5,5,15,Champions
82143,145,17,45,4,3,3,10,Loyal Users
82530,416,10,21,3,2,2,7,Casual Users
82588,1657,12,47,1,3,3,7,Casual Users
82738,305,40,237,3,4,5,12,Loyal Users
82792,6,256,817,5,5,5,15,Champions
83175,460,20,27,3,3,2,8,Loyal Users
83280,320,17,38,3,3,3,9,Loyal Users
83405,607,47,158,2,5,5,12,At Risk
83412,163,100,331,4,5,5,14,Champions
83532,83,16,22,4,3,2,9,Loyal Users
83547,473,28,41,2,4,3,9,At Risk
83637,1597,6,6,1,1,1,3,Lost
83653,683,9,86,2,2,4,8,Lost
83896,153,26,60,4,4,3,11,Loyal Users
83961,314,12,28,3,3,2,8,Loyal Users
84698,2264,5,27,1,1,2,4,Lost
84943,12,28,46,5,4,3,12,Loyal Users
84960,652,9,35,2,2,3,7,Lost
85154,444,20,44,3,3,3,9,Loyal Users
85509,388,42,93,3,4,4,11,Loyal Users
85590,1350,6,8,1,1,1,3,Lost
85842,168,28,112,3,4,4,11,Loyal Users
85978,1803,8,14,1,2,1,4,Lost
85993,49,21,80,5,3,4,12,Loyal Users
86047,493,13,14,2,3,1,6,Casual Users
86389,3165,7,9,1,2,1,4,Lost
86525,347,50,64,3,5,4,12,Loyal Users
86586,724,16,31,2,3,2,7,Casual Users
87031,276,55,106,3,5,4,12,Loyal Users
87048,25,162,248,5,5,5,15,Champions
87058,146,5,21,4,1,2,7,Promising
87161,101,51,154,4,5,5,14,Champions
87317,3213,8,19,1,2,2,5,Lost
87483,23,19,85,5,3,4,12,Loyal Users
87519,248,12,59,3,3,3,9,Loyal Users
87839,2703,18,124,1,3,4,8,Casual Users
87920,8,33,128,5,4,4,13,Champions
88624,2551,6,13,1,1,1,3,Lost
88877,735,11,37,2,2,3,7,Lost
88907,66,83,437,5,5,5,15,Champions
89168,96,8,25,4,2,2,8,Promising
89260,72,51,165,4,5,5,14,Champions
89405,1015,8,13,2,2,1,5,Lost
89778,57,52,378,5,5,5,15,Champions
89803,248,25,31,3,4,2,9,Loyal Users
89833,683,20,35,2,3,3,8,Casual Users
89986,98,50,108,4,5,4,13,Champions
90412,1226,13,30,2,3,2,7,Casual Users
90444,106,43,230,4,4,5,13,Champions
90633,13,27,128,5,4,4,13,Champions
78365,107,8,12,4,2,1,7,Promising
78785,419,7,13,3,2,1,6,Casual Users
78808,216,5,17,3,1,2,6,Casual Users
79062,1761,8,17,1,2,2,5,Lost
79119,34,22,36,5,4,3,12,Loyal Users
79235,351,41,108,3,4,4,11,Loyal Users
79610,418,150,296,3,5,5,13,Loyal Users
79880,5,7,31,5,2,2,9,Promising
79940,258,16,26,3,3,2,8,Loyal Users
80511,323,29,89,3,4,4,11,Loyal Users
80549,202,36,51,3,4,3,10,Loyal Users
80858,1497,6,8,1,1,1,3,Lost
81741,0,14,59,5,3,3,11,Loyal Users
81892,382,20,34,3,3,3,9,Loyal Users
81908,506,5,10,2,1,1,4,Lost
81998,3277,6,15,1,1,1,3,Lost
82150,31,8,26,5,2,2,9,Promising
82418,465,26,46,3,4,3,10,Loyal Users
82939,1156,6,11,2,1,1,4,Lost
83023,128,7,16,4,2,2,8,Promising
83538,314,14,22,3,3,2,8,Loyal Users
83570,544,23,46,2,4,3,9,At Risk
84026,1587,26,50,1,4,3,8,At Risk
84142,98,55,141,4,5,4,13,Champions
84510,3285,17,69,1,3,4,8,Casual Users
84568,77,49,176,4,5,5,14,Champions
84625,598,5,8,2,1,1,4,Lost
84701,2943,5,7,1,1,1,3,Lost
84788,1084,12,32,2,3,3,8,Casual Users
84891,4,114,163,5,5,5,15,Champions
85128,1238,7,11,2,2,1,5,Lost
85443,5,11,17,5,2,2,9,Promising
85697,65,6,19,5,1,2,8,Promising
85758,2239,5,12,1,1,1,3,Lost
85895,61,9,10,5,2,1,8,Promising
85930,131,86,183,4,5,5,14,Champions
85934,826,55,104,2,5,4,11,At Risk
85997,2615,7,28,1,2,2,5,Lost
86352,833,24,77,2,4,4,10,At Risk
86815,264,8,24,3,2,2,7,Casual Users
86836,4288,6,9,1,1,1,3,Lost
86990,589,6,16,2,1,2,5,Lost
87150,3737,5,9,1,1,1,3,Lost
87184,266,24,38,3,4,3,10,Loyal Users
87277,366,15,25,3,3,2,8,Loyal Users
87304,233,72,235,3,5,5,13,Loyal Users
87607,2408,8,16,1,2,2,5,Lost
87706,333,5,9,3,1,1,5,Casual Users
87715,63,7,7,5,2,1,8,Promising
88622,54,24,39,5,4,3,12,Loyal Users
88746,269,14,40,3,3,3,9,Loyal Users
88793,546,14,20,2,3,2,7,Casual Users
88887,2167,19,67,1,3,4,8,Casual Users
88994,7,117,309,5,5,5,15,Champions
89003,113,52,107,4,5,4,13,Champions
89208,14,57,115,5,5,4,14,Champions
89259,521,8,17,2,2,2,6,Lost
89397,1626,10,18,1,2,2,5,Lost
89542,147,25,222,4,4,5,13,Champions
89763,395,14,113,3,3,4,10,Loyal Users
89773,998,8,27,2,2,2,6,Lost
89947,76,76,370,4,5,5,14,Champions
90115,522,22,46,2,4,3,9,At Risk
90423,4713,5,5,1,1,1,3,Lost
90848,836,14,33,2,3,3,8,Casual Users
78340,248,33,60,3,4,3,10,Loyal Users
78977,143,30,131,4,4,4,12,Champions
79400,96,42,130,4,4,4,12,Champions
79605,445,16,47,3,3,3,9,Loyal Users
79896,2345,27,55,1,4,3,8,At Risk
80423,243,21,33,3,3,3,9,Loyal Users
80820,5560,5,7,1,1,1,3,Lost
80900,2402,15,16,1,3,2,6,Casual Users
81327,1980,9,14,1,2,1,4,Lost
82364,2412,7,8,1,2,1,4,Lost
82617,784,13,20,2,3,2,7,Casual Users
82622,587,5,16,2,1,2,5,Lost
82959,1054,5,17,2,1,2,5,Lost
83119,139,7,8,4,2,1,7,Promising
83279,1529,13,33,1,3,3,7,Casual Users
83442,848,7,17,2,2,2,6,Lost
83603,101,65,96,4,5,4,13,Champions
83787,4,31,134,5,4,4,13,Champions
83971,349,20,50,3,3,3,9,Loyal Users
84078,431,6,19,3,1,2,6,Casual Users
84591,1122,6,11,2,1,1,4,Lost
84835,0,110,557,5,5,5,15,Champions
84976,26,75,319,5,5,5,15,Champions
85227,139,19,30,4,3,2,9,Loyal Users
85292,384,23,89,3,4,4,11,Loyal Users
85836,2403,6,11,1,1,1,3,Lost
86031,54,14,122,5,3,4,12,Loyal Users
86077,86,14,149,4,3,5,12,Loyal Users
86146,5,18,66,5,3,4,12,Loyal Users
86641,92,21,39,4,3,3,10,Loyal Users
86786,5,78,173,5,5,5,15,Champions
86838,1079,49,183,2,5,5,12,At Risk
87134,136,50,219,4,5,5,14,Champions
87272,164,99,108,4,5,4,13,Champions
87343,98,60,239,4,5,5,14,Champions
87646,120,126,322,4,5,5,14,Champions
87799,2641,7,7,1,2,1,4,Lost
88001,7,52,293,5,5,5,15,Champions
88033,40,11,32,5,2,3,10,Promising
88300,265,15,15,3,3,1,7,Loyal Users
88506,19,35,48,5,4,3,12,Loyal Users
88888,20,53,123,5,5,4,14,Champions
89018,2,89,673,5,5,5,15,Champions
89124,2823,10,14,1,2,1,4,Lost
89128,621,20,60,2,3,3,8,Casual Users
89149,119,90,144,4,5,4,13,Champions
89394,674,8,14,2,2,1,5,Lost
89556,639,26,37,2,4,3,9,At Risk
89582,16,10,49,5,2,3,10,Promising
89583,113,13,24,4,3,2,9,Loyal Users
89828,28,50,170,5,5,5,15,Champions
89933,423,17,31,3,3,2,8,Loyal Users
89949,795,5,6,2,1,1,4,Lost
90020,1711,6,28,1,1,2,4,Lost
90074,881,8,9,2,2,1,5,Lost
90705,140,6,15,4,1,1,6,Promising
90823,137,42,176,4,4,5,13,Champions
78328,254,14,61,3,3,3,9,Loyal Users
78471,120,93,156,4,5,5,14,Champions
78851,424,28,51,3,4,3,10,Loyal Users
79289,278,7,39,3,2,3,8,Casual Users
79862,729,8,11,2,2,1,5,Lost
80169,276,14,52,3,3,3,9,Loyal Users
80565,575,17,88,2,3,4,9,Casual Users
80730,11,9,13,5,2,1,8,Promising
81145,619,9,10,2,2,1,5,Lost
81547,585,18,36,2,3,3,8,Casual Users
81707,2,78,346,5,5,5,15,Champions
81798,3188,6,30,1,1,2,4,Lost
82028,148,5,20,4,1,2,7,Promising
82361,135,115,332,4,5,5,14,Champions
82422,103,110,474,4,5,5,14,Champions
82435,4,15,23,5,3,2,10,Loyal Users
82595,118,62,218,4,5,5,14,Champions
82614,3985,11,14,1,2,1,4,Lost
83066,1556,7,12,1,2,1,4,Lost
83111,124,20,28,4,3,2,9,Loyal Users
83320,57,9,16,5,2,2,9,Promising
83387,271,5,10,3,1,1,5,Casual Users
83432,83,43,212,4,4,5,13,Champions
83447,1578,12,16,1,3,2,6,Casual Users
83578,443,13,33,3,3,3,9,Loyal Users
83944,1526,7,19,1,2,2,5,Lost
84064,2693,26,84,1,4,4,9,At Risk
84617,161,5,10,4,1,1,6,Promising
84668,32,16,42,5,3,3,11,Loyal Users
84746,2420,14,21,1,3,2,6,Casual Users
85054,744,40,246,2,4,5,11,At Risk
85200,230,9,28,3,2,2,7,Casual Users
85265,1161,11,29,2,2,2,6,Lost
85291,67,19,33,5,3,3,11,Loyal Users
85311,281,9,87,3,2,4,9,Casual Users
85331,1721,17,28,1,3,2,6,Casual Users
85976,2117,9,13,1,2,1,4,Lost
86005,129,71,148,4,5,5,14,Champions
86114,189,33,58,3,4,3,10,Loyal Users
86865,119,14,41,4,3,3,10,Loyal Users
87407,127,26,122,4,4,4,12,Champions
87515,822,10,43,2,2,3,7,Lost
87608,214,5,33,3,1,3,7,Casual Users
87872,708,5,7,2,1,1,4,Lost
87907,26,30,61,5,4,3,12,Loyal Users
87953,27,20,46,5,3,3,11,Loyal Users
87957,4860,37,199,1,4,5,10,At Risk
87985,49,62,453,5,5,5,15,Champions
88200,257,41,95,3,4,4,11,Loyal Users
88331,1575,41,74,1,4,4,9,At Risk
88366,2124,6,12,1,1,1,3,Lost
88753,571,11,16,2,2,2,6,Lost
88806,30,6,10,5,1,1,7,Promising
89012,415,34,75,3,4,4,11,Loyal Users
90022,461,6,20,3,1,2,6,Casual Users
90217,566,35,70,2,4,4,10,At Risk
90231,124,42,150,4,4,5,13,Champions
90397,149,32,295,4,4,5,13,Champions
90708,156,11,58,4,2,3,9,Promising
90753,1297,10,17,1,2,2,5,Lost
90829,368,11,29,3,2,2,7,Casual Users
90915,6113,5,5,1,1,1,3,Lost
78303,26,30,199,5,4,5,14,Champions
78390,1031,26,48,2,4,3,9,At Risk
78476,1505,16,83,1,3,4,8,Casual Users
78493,985,23,67,2,4,4,10,At Risk
78607,519,25,36,2,4,3,9,At Risk
78611,127,14,38,4,3,3,10,Loyal Users
78734,92,37,252,4,4,5,13,Champions
78973,3755,50,93,1,5,4,10,At Risk
79019,1017,5,43,2,1,3,6,Lost
79441,30,42,169,5,4,5,14,Champions
79719,590,5,12,2,1,1,4,Lost
79766,913,16,40,2,3,3,8,Casual Users
80184,94,118,320,4,5,5,14,Champions
80310,849,13,25,2,3,2,7,Casual Users
80793,14,61,133,5,5,4,14,Champions
80895,5,36,65,5,4,4,13,Champions
81282,413,17,38,3,3,3,9,Loyal Users
81353,56,53,250,5,5,5,15,Champions
81862,557,13,62,2,3,3,8,Casual Users
82003,35,6,8,5,1,1,7,Promising
82145,2065,16,36,1,3,3,7,Casual Users
82337,171,25,39,3,4,3,10,Loyal Users
83002,358,5,44,3,1,3,7,Casual Users
83207,1976,24,92,1,4,4,9,At Risk
83564,260,9,23,3,2,2,7,Casual Users
83624,1030,26,129,2,4,4,10,At Risk
83642,459,20,44,3,3,3,9,Loyal Users
83757,2747,10,39,1,2,3,6,Lost
83803,23,54,165,5,5,5,15,Champions
83806,219,24,49,3,4,3,10,Loyal Users
83831,2585,6,9,1,1,1,3,Lost
84079,2,95,150,5,5,5,15,Champions
84099,723,22,73,2,4,4,10,At Risk
84174,683,11,33,2,2,3,7,Lost
84205,16,85,317,5,5,5,15,Champions
84641,1351,37,79,1,4,4,9,At Risk
84727,2,68,293,5,5,5,15,Champions
84942,2243,9,45,1,2,3,6,Lost
85103,3414,6,13,1,1,1,3,Lost
85320,180,20,92,3,3,4,10,Loyal Users
85829,673,14,48,2,3,3,8,Casual Users
85841,1986,5,8,1,1,1,3,Lost
86199,5541,6,9,1,1,1,3,Lost
86379,81,10,33,4,2,3,9,Promising
86713,71,61,251,4,5,5,14,Champions
87049,419,6,6,3,1,1,5,Casual Users
87492,1766,13,31,1,3,2,6,Casual Users
87497,125,15,103,4,3,4,11,Loyal Users
87548,817,21,34,2,3,3,8,Casual Users
88235,31,68,146,5,5,4,14,Champions
88258,4,14,44,5,3,3,11,Loyal Users
88419,6,127,295,5,5,5,15,Champions
89335,12,12,24,5,3,2,10,Loyal Users
89396,31,166,206,5,5,5,15,Champions
89474,1415,13,47,1,3,3,7,Casual Users
89728,1958,7,7,1,2,1,4,Lost
89941,3259,5,6,1,1,1,3,Lost
90206,2482,26,75,1,4,4,9,At Risk
90355,775,5,26,2,1,2,5,Lost
90509,580,6,6,2,1,1,4,Lost
90607,142,34,69,4,4,4,12,Champions
90694,13,184,340,5,5,5,15,Champions
90861,87,7,26,4,2,2,8,Promising
90982,143,18,90,4,3,4,11,Loyal Users
78577,121,70,396,4,5,5,14,Champions
78612,1357,6,14,1,1,1,3,Lost
78632,571,21,210,2,3,5,10,Casual Users
78667,26,141,444,5,5,5,15,Champions
79549,2106,7,11,1,2,1,4,Lost
79710,145,51,118,4,5,4,13,Champions
80140,74,27,217,4,4,5,13,Champions
80175,438,75,250,3,5,5,13,Loyal Users
80178,3108,16,27,1,3,2,6,Casual Users
80286,1976,15,95,1,3,4,8,Casual Users
80719,19,62,82,5,5,4,14,Champions
81910,728,8,18,2,2,2,6,Lost
82005,962,7,9,2,2,1,5,Lost
82377,637,6,19,2,1,2,5,Lost
82848,359,13,16,3,3,2,8,Loyal Users
82978,114,52,250,4,5,5,14,Champions
83057,23,142,382,5,5,5,15,Champions
83202,146,10,37,4,2,3,9,Promising
83267,281,6,24,3,1,2,6,Casual Users
83311,163,11,16,4,2,2,8,Promising
83749,135,8,14,4,2,1,7,Promising
83914,86,8,21,4,2,2,8,Promising
83916,232,65,210,3,5,5,13,Loyal Users
84119,3,39,94,5,4,4,13,Champions
84296,1314,13,30,1,3,2,6,Casual Users
84426,235,27,100,3,4,4,11,Loyal Users
84550,513,18,28,2,3,2,7,Casual Users
85086,6,104,342,5,5,5,15,Champions
85235,1806,9,48,1,2,3,6,Lost
85396,1917,8,11,1,2,1,4,Lost
85463,1251,6,6,2,1,1,4,Lost
85627,157,26,101,4,4,4,12,Champions
85925,12,140,448,5,5,5,15,Champions
86101,226,111,165,3,5,5,13,Loyal Users
86162,2224,91,145,1,5,4,10,At Risk
86304,11,44,223,5,4,5,14,Champions
86373,449,35,85,3,4,4,11,Loyal Users
86504,230,39,144,3,4,4,11,Loyal Users
86714,184,7,8,3,2,1,6,Casual Users
86897,1720,8,15,1,2,1,4,Lost
87090,212,17,68,3,3,4,10,Loyal Users
87683,1255,5,18,2,1,2,5,Lost
87721,573,22,74,2,4,4,10,At Risk
88441,11,20,43,5,3,3,11,Loyal Users
88556,430,20,53,3,3,3,9,Loyal Users
88760,1543,12,28,1,3,2,6,Casual Users
88979,1539,6,15,1,1,1,3,Lost
89041,104,38,60,4,4,3,11,Loyal Users
89533,50,18,50,5,3,3,11,Loyal Users
89587,678,57,204,2,5,5,12,At Risk
89859,837,14,20,2,3,2,7,Casual Users
89934,26,96,440,5,5,5,15,Champions
90425,2019,7,8,1,2,1,4,Lost
90465,132,64,187,4,5,5,14,Champions
90511,353,123,384,3,5,5,13,Loyal Users
90696,33,6,17,5,1,2,8,Promising
90798,227,26,189,3,4,5,12,Loyal Users
78337,1244,8,9,2,2,1,5,Lost
78511,1274,8,12,1,2,1,4,Lost
78540,937,9,97,2,2,4,8,Lost
78573,191,7,45,3,2,3,8,Casual Users
78644,811,6,24,2,1,2,5,Lost
78651,431,14,56,3,3,3,9,Loyal Users
78678,3,77,174,5,5,5,15,Champions
79063,405,9,91,3,2,4,9,Casual Users
79184,481,38,55,2,4,3,9,At Risk
79315,843,25,110,2,4,4,10,At Risk
80134,2688,5,6,1,1,1,3,Lost
80291,4955,6,13,1,1,1,3,Lost
80555,0,63,210,5,5,5,15,Champions
81123,2134,7,83,1,2,4,7,Lost
81289,5,50,118,5,5,4,14,Champions
81318,0,85,260,5,5,5,15,Champions
82042,23,154,355,5,5,5,15,Champions
82352,138,62,109,4,5,4,13,Champions
82613,1696,14,18,1,3,2,6,Casual Users
82855,259,15,22,3,3,2,8,Loyal Users
82985,419,8,20,3,2,2,7,Casual Users
83816,116,9,46,4,2,3,9,Promising
84852,406,40,80,3,4,4,11,Loyal Users
84857,129,18,41,4,3,3,10,Loyal Users
84920,277,22,88,3,4,4,11,Loyal Users
85148,2,63,185,5,5,5,15,Champions
85552,3801,10,50,1,2,3,6,Lost
85602,978,22,58,2,4,3,9,At Risk
86000,139,31,58,4,4,3,11,Loyal Users
86034,75,88,850,4,5,5,14,Champions
86151,278,5,6,3,1,1,5,Casual Users
86172,65,40,202,5,4,5,14,Champions
86180,1274,18,78,1,3,4,8,Casual Users
86318,33,93,468,5,5,5,15,Champions
86330,129,52,251,4,5,5,14,Champions
86571,183,83,482,3,5,5,13,Loyal Users
86705,45,101,224,5,5,5,15,Champions
86802,285,7,17,3,2,2,7,Casual Users
86813,31,46,172,5,5,5,15,Champions
86829,236,23,134,3,4,4,11,Loyal Users
87029,5,63,517,5,5,5,15,Champions
87288,1423,61,154,1,5,5,11,At Risk
87569,997,11,41,2,2,3,7,Lost
87784,272,37,87,3,4,4,11,Loyal Users
87843,592,14,33,2,3,3,8,Casual Users
88047,147,109,473,4,5,5,14,Champions
88196,1188,5,18,2,1,2,5,Lost
88295,373,12,27,3,3,2,8,Loyal Users
88317,918,16,80,2,3,4,9,Casual Users
88344,110,54,126,4,5,4,13,Champions
88502,139,12,25,4,3,2,9,Loyal Users
88615,135,12,22,4,3,2,9,Loyal Users
88963,516,5,5,2,1,1,4,Lost
89096,1125,8,15,2,2,1,5,Lost
89195,250,25,64,3,4,4,11,Loyal Users
89293,577,17,32,2,3,3,8,Casual Users
89791,680,18,56,2,3,3,8,Casual Users
90139,152,25,94,4,4,4,12,Champions
90170,1241,15,18,2,3,2,7,Casual Users
90356,39,19,63,5,3,4,12,Loyal Users
90378,546,5,6,2,1,1,4,Lost
90436,66,5,10,5,1,1,7,Promising
90602,749,16,20,2,3,2,7,Casual Users
90720,997,21,33,2,3,3,8,Casual Users
78433,162,13,64,4,3,4,11,Loyal Users
78462,2039,6,80,1,1,4,6,Lost
78722,17,8,17,5,2,2,9,Promising
78842,101,22,44,4,4,3,11,Loyal Users
79179,102,15,95,4,3,4,11,Loyal Users
79245,285,11,24,3,2,2,7,Casual Users
79256,1867,21,47,1,3,3,7,Casual Users
79816,235,5,21,3,1,2,6,Casual Users
79869,76,38,79,4,4,4,12,Champions
79953,169,17,126,3,3,4,10,Loyal Users
80779,97,16,59,4,3,3,10,Loyal Users
80891,1329,40,398,1,4,5,10,At Risk
81435,1612,5,7,1,1,1,3,Lost
81840,34,36,118,5,4,4,13,Champions
82082,1740,6,7,1,1,1,3,Lost
82306,61,99,189,5,5,5,15,Champions
82489,110,36,194,4,4,5,13,Champions
82553,23,36,161,5,4,5,14,Champions
82619,422,15,126,3,3,4,10,Loyal Users
82853,3282,42,258,1,4,5,10,At Risk
83263,1874,65,79,1,5,4,10,At Risk
83359,109,59,164,4,5,5,14,Champions
83582,688,7,8,2,2,1,5,Lost
83658,142,58,129,4,5,4,13,Champions
83726,299,31,114,3,4,4,11,Loyal Users
84168,45,42,75,5,4,4,13,Champions
84440,103,29,37,4,4,3,11,Loyal Users
84613,268,13,111,3,3,4,10,Loyal Users
84911,20,54,317,5,5,5,15,Champions
85611,7,33,102,5,4,4,13,Champions
85615,130,31,251,4,4,5,13,Champions
85947,370,10,37,3,2,3,8,Casual Users
85989,852,7,21,2,2,2,6,Lost
86510,98,31,126,4,4,4,12,Champions
86604,122,51,151,4,5,5,14,Champions
87434,94,31,132,4,4,4,12,Champions
87649,1418,6,6,1,1,1,3,Lost
87747,1374,5,24,1,1,2,4,Lost
87767,840,9,26,2,2,2,6,Lost
87927,74,155,449,4,5,5,14,Champions
88531,20,54,350,5,5,5,15,Champions
88701,110,14,78,4,3,4,11,Loyal Users
88880,76,6,9,4,1,1,6,Promising
89328,543,6,26,2,1,2,5,Lost
89430,4768,9,23,1,2,2,5,Lost
89683,173,6,8,3,1,1,5,Casual Users
89864,291,8,19,3,2,2,7,Casual Users
89897,46,34,98,5,4,4,13,Champions
90946,182,9,12,3,2,1,6,Casual Users
91014,3245,7,13,1,2,1,4,Lost
78896,78,127,433,4,5,5,14,Champions
78969,278,21,25,3,3,2,8,Loyal Users
79334,138,164,531,4,5,5,14,Champions
79404,270,5,6,3,1,1,5,Casual Users
79667,16,58,206,5,5,5,15,Champions
79744,1693,11,37,1,2,3,6,Lost
79826,901,14,36,2,3,3,8,Casual Users
80543,8,70,312,5,5,5,15,Champions
80582,1088,11,19,2,2,2,6,Lost
80866,2852,5,15,1,1,1,3,Lost
80937,142,49,182,4,5,5,14,Champions
81020,64,50,270,5,5,5,15,Champions
81210,71,77,297,4,5,5,14,Champions
81858,142,26,71,4,4,4,12,Champions
82156,415,35,145,3,4,4,11,Loyal Users
82274,2293,5,12,1,1,1,3,Lost
82284,169,83,119,3,5,4,12,Loyal Users
82288,941,12,13,2,3,1,6,Casual Users
82449,72,43,354,4,4,5,13,Champions
82810,13,7,24,5,2,2,9,Promising
83003,140,20,45,4,3,3,10,Loyal Users
83779,24,104,484,5,5,5,15,Champions
84012,107,76,216,4,5,5,14,Champions
84124,144,31,80,4,4,4,12,Champions
84219,122,111,214,4,5,5,14,Champions
84322,572,23,66,2,4,4,10,At Risk
84325,83,38,53,4,4,3,11,Loyal Users
84329,167,21,107,3,3,4,10,Loyal Users
84786,262,46,173,3,5,5,13,Loyal Users
84968,88,109,218,4,5,5,14,Champions
85064,15,133,405,5,5,5,15,Champions
85139,669,6,12,2,1,1,4,Lost
85378,1994,12,16,1,3,2,6,Casual Users
85648,2965,5,5,1,1,1,3,Lost
85831,2418,6,11,1,1,1,3,Lost
85936,103,38,119,4,4,4,12,Champions
85945,172,9,24,3,2,2,7,Casual Users
86126,101,40,123,4,4,4,12,Champions
86395,6,57,275,5,5,5,15,Champions
86923,145,22,55,4,4,3,11,Loyal Users
87200,409,5,11,3,1,1,5,Casual Users
87397,656,14,61,2,3,3,8,Casual Users
87584,1099,5,14,2,1,1,4,Lost
87825,2985,7,37,1,2,3,6,Lost
88002,26,136,353,5,5,5,15,Champions
88063,260,25,53,3,4,3,10,Loyal Users
88133,64,77,166,5,5,5,15,Champions
88268,248,23,33,3,4,3,10,Loyal Users
88321,3293,9,12,1,2,1,4,Lost
88465,151,15,53,4,3,3,10,Loyal Users
88605,734,49,86,2,5,4,11,At Risk
88683,367,20,127,3,3,4,10,Loyal Users
88810,607,5,17,2,1,2,5,Lost
88935,26,208,294,5,5,5,15,Champions
89232,33,167,707,5,5,5,15,Champions
89263,3951,9,10,1,2,1,4,Lost
89270,125,103,252,4,5,5,14,Champions
89282,127,26,79,4,4,4,12,Champions
89491,64,32,54,5,4,3,12,Loyal Users
89503,222,54,78,3,5,4,12,Loyal Users
89659,1267,11,15,1,2,1,4,Lost
90067,2407,5,12,1,1,1,3,Lost
90076,16,102,122,5,5,4,14,Champions
90163,1414,19,35,1,3,3,7,Casual Users
90538,1070,7,12,2,2,1,5,Lost
90576,3881,5,7,1,1,1,3,Lost
90938,4263,9,11,1,2,1,4,Lost
90966,258,69,168,3,5,5,13,Loyal Users
78459,34,104,194,5,5,5,15,Champions
78944,395,6,17,3,1,2,6,Casual Users
79227,136,125,423,4,5,5,14,Champions
79635,24,119,761,5,5,5,15,Champions
80044,440,43,84,3,4,4,11,Loyal Users
80348,78,35,113,4,4,4,12,Champions
80505,5032,10,15,1,2,1,4,Lost
80683,25,10,49,5,2,3,10,Promising
80813,57,42,177,5,4,5,14,Champions
81386,1009,23,57,2,4,3,9,At Risk
81735,4708,5,5,1,1,1,3,Lost
82367,60,63,122,5,5,4,14,Champions
82630,929,35,71,2,4,4,10,At Risk
82751,75,9,67,4,2,4,10,Promising
82823,119,36,186,4,4,5,13,Champions
83404,1393,12,30,1,3,2,6,Casual Users
83650,1938,13,28,1,3,2,6,Casual Users
83820,559,5,9,2,1,1,4,Lost
83828,3695,6,19,1,1,2,4,Lost
83829,42,6,16,5,1,2,8,Promising
83999,20,86,204,5,5,5,15,Champions
84055,1632,6,14,1,1,1,3,Lost
84063,144,5,6,4,1,1,6,Promising
84350,32,28,49,5,4,3,12,Loyal Users
84427,156,13,22,4,3,2,9,Loyal Users
84695,526,33,73,2,4,4,10,At Risk
84979,739,26,49,2,4,3,9,At Risk
85224,2,143,261,5,5,5,15,Champions
85266,675,6,10,2,1,1,4,Lost
85345,447,19,59,3,3,3,9,Loyal Users
85473,566,8,20,2,2,2,6,Lost
86001,905,6,11,2,1,1,4,Lost
86057,93,25,35,4,4,3,11,Loyal Users
86155,455,8,26,3,2,2,7,Casual Users
86431,1398,14,89,1,3,4,8,Casual Users
86476,938,9,25,2,2,2,6,Lost
86543,76,47,85,4,5,4,13,Champions
86602,573,11,16,2,2,2,6,Lost
86643,259,25,208,3,4,5,12,Loyal Users
86701,278,38,82,3,4,4,11,Loyal Users
86855,865,5,53,2,1,3,6,Lost
86893,3233,5,12,1,1,1,3,Lost
86987,379,19,120,3,3,4,10,Loyal Users
87323,526,7,31,2,2,2,6,Lost
87487,526,13,41,2,3,3,8,Casual Users
87520,181,68,190,3,5,5,13,Loyal Users
87535,1,20,101,5,3,4,12,Loyal Users
87579,713,5,6,2,1,1,4,Lost
87704,296,6,29,3,1,2,6,Casual Users
87726,4203,6,7,1,1,1,3,Lost
87811,695,23,96,2,4,4,10,At Risk
88050,375,97,200,3,5,5,13,Loyal Users
88085,304,19,38,3,3,3,9,Loyal Users
88244,454,5,54,3,1,3,7,Casual Users
88328,269,10,20,3,2,2,7,Casual Users
88702,421,5,7,3,1,1,5,Casual Users
88898,80,14,15,4,3,1,8,Loyal Users
89108,30,29,73,5,4,4,13,Champions
89485,3474,6,8,1,1,1,3,Lost
90464,269,77,286,3,5,5,13,Loyal Users
90682,930,10,16,2,2,2,6,Lost
90748,298,85,219,3,5,5,13,Loyal Users
90791,3408,9,41,1,2,3,6,Lost
90867,123,21,99,4,3,4,11,Loyal Users
90959,282,18,99,3,3,4,10,Loyal Users
90961,817,8,15,2,2,1,5,Lost
78423,1184,17,44,2,3,3,8,Casual Users
78548,991,7,12,2,2,1,5,Lost
78584,126,29,64,4,4,4,12,Champions
78663,1144,10,59,2,2,3,7,Lost
79016,19,30,116,5,4,4,13,Champions
79099,309,54,142,3,5,4,12,Loyal Users
79455,1810,6,10,1,1,1,3,Lost
79506,39,6,10,5,1,1,7,Promising
80119,290,8,29,3,2,2,7,Casual Users
80598,88,19,136,4,3,4,11,Loyal Users
81039,593,5,7,2,1,1,4,Lost
81396,60,91,568,5,5,5,15,Champions
81422,105,20,28,4,3,2,9,Loyal Users
81471,3392,8,12,1,2,1,4,Lost
81849,648,9,18,2,2,2,6,Lost
81954,180,23,141,3,4,4,11,Loyal Users
82198,150,11,35,4,2,3,9,Promising
83001,262,9,30,3,2,2,7,Casual Users
83095,3729,15,34,1,3,3,7,Casual Users
83420,413,38,60,3,4,3,10,Loyal Users
83545,77,33,147,4,4,5,13,Champions
83595,424,6,16,3,1,2,6,Casual Users
83671,5259,6,8,1,1,1,3,Lost
83832,112,37,115,4,4,4,12,Champions
83974,392,55,128,3,5,4,12,Loyal Users
84466,709,20,112,2,3,4,9,Casual Users
84621,283,51,105,3,5,4,12,Loyal Users
84768,239,32,104,3,4,4,11,Loyal Users
84934,1099,11,17,2,2,2,6,Lost
85108,53,63,205,5,5,5,15,Champions
85113,43,75,201,5,5,5,15,Champions
85125,850,12,18,2,3,2,7,Casual Users
85554,1428,26,84,1,4,4,9,At Risk
85616,195,72,382,3,5,5,13,Loyal Users
85629,721,6,24,2,1,2,5,Lost
85805,437,17,27,3,3,2,8,Loyal Users
85932,588,25,69,2,4,4,10,At Risk
86100,166,68,125,3,5,4,12,Loyal Users
86227,1677,6,18,1,1,2,4,Lost
86272,110,60,177,4,5,5,14,Champions
86356,570,32,35,2,4,3,9,At Risk
86386,90,5,13,4,1,1,6,Promising
86718,645,9,12,2,2,1,5,Lost
86764,415,9,12,3,2,1,6,Casual Users
86767,505,12,13,2,3,1,6,Casual Users
87116,990,15,18,2,3,2,7,Casual Users
87365,71,9,13,4,2,1,7,Promising
87433,113,50,125,4,5,4,13,Champions
87443,267,32,38,3,4,3,10,Loyal Users
87572,173,13,58,3,3,3,9,Loyal Users
87665,84,58,113,4,5,4,13,Champions
87866,12,46,135,5,5,4,14,Champions
87895,685,8,14,2,2,1,5,Lost
87999,1589,12,19,1,3,2,6,Casual Users
88114,1097,8,34,2,2,3,7,Lost
88545,9,61,264,5,5,5,15,Champions
89078,1182,16,41,2,3,3,8,Casual Users
89148,4409,5,7,1,1,1,3,Lost
89199,158,29,66,4,4,4,12,Champions
89420,1493,6,16,1,1,2,4,Lost
89599,270,22,51,3,4,3,10,Loyal Users
89616,27,16,45,5,3,3,11,Loyal Users
89794,159,9,14,4,2,1,7,Promising
89959,7,181,477,5,5,5,15,Champions
90015,107,14,19,4,3,2,9,Loyal Users
90599,63,17,28,5,3,2,10,Loyal Users
90768,1160,19,40,2,3,3,8,Casual Users
90894,12,82,535,5,5,5,15,Champions
90981,30,116,247,5,5,5,15,Champions
78430,469,7,20,3,2,2,7,Casual Users
78498,2704,5,22,1,1,2,4,Lost
79328,1268,13,27,1,3,2,6,Casual Users
79330,435,32,74,3,4,4,11,Loyal Users
79445,695,21,34,2,3,3,8,Casual Users
79925,6,163,199,5,5,5,15,Champions
79950,91,51,237,4,5,5,14,Champions
80095,72,38,41,4,4,3,11,Loyal Users
81784,383,7,9,3,2,1,6,Casual Users
81895,261,33,104,3,4,4,11,Loyal Users
81989,539,14,53,2,3,3,8,Casual Users
82066,454,16,23,3,3,2,8,Loyal Users
82068,596,11,27,2,2,2,6,Lost
82369,18,123,912,5,5,5,15,Champions
82378,19,7,22,5,2,2,9,Promising
82805,1650,7,13,1,2,1,4,Lost
82911,1471,10,23,1,2,2,5,Lost
83265,131,5,5,4,1,1,6,Promising
83345,694,8,32,2,2,3,7,Lost
83584,3,98,313,5,5,5,15,Champions
83888,1082,13,33,2,3,3,8,Casual Users
83937,1797,19,33,1,3,3,7,Casual Users
83941,11,136,460,5,5,5,15,Champions
84193,217,37,50,3,4,3,10,Loyal Users
84434,572,14,25,2,3,2,7,Casual Users
84459,816,5,12,2,1,1,4,Lost
84601,115,24,35,4,4,3,11,Loyal Users
84681,49,38,51,5,4,3,12,Loyal Users
85202,42,5,5,5,1,1,7,Promising
86075,72,40,127,4,4,4,12,Champions
86332,676,11,31,2,2,2,6,Lost
86446,160,31,74,4,4,4,12,Champions
86579,7,53,111,5,5,4,14,Champions
86645,189,38,50,3,4,3,10,Loyal Users
86853,4289,17,36,1,3,3,7,Casual Users
87068,1,26,61,5,4,3,12,Loyal Users
87226,271,6,23,3,1,2,6,Casual Users
87550,263,44,91,3,4,4,11,Loyal Users
87745,515,5,13,2,1,1,4,Lost
88012,428,6,13,3,1,1,5,Casual Users
88320,1794,8,32,1,2,3,6,Lost
88450,0,39,100,5,4,4,13,Champions
88623,586,38,55,2,4,3,9,At Risk
88711,3,39,128,5,4,4,13,Champions
89032,19,77,126,5,5,4,14,Champions
89039,295,35,162,3,4,5,12,Loyal Users
89055,25,66,169,5,5,5,15,Champions
89071,86,62,231,4,5,5,14,Champions
89365,128,36,163,4,4,5,13,Champions
89786,23,156,437,5,5,5,15,Champions
89848,0,127,564,5,5,5,15,Champions
90000,63,17,34,5,3,3,11,Loyal Users
90064,166,13,15,3,3,1,7,Loyal Users
90323,263,8,9,3,2,1,6,Casual Users
90621,53,18,30,5,3,2,10,Loyal Users
90782,1680,6,14,1,1,1,3,Lost
90810,2752,9,28,1,2,2,5,Lost
78861,60,58,213,5,5,5,15,Champions
78927,416,12,22,3,3,2,8,Loyal Users
79131,588,5,13,2,1,1,4,Lost
79161,13,5,22,5,1,2,8,Promising
79211,843,12,35,2,3,3,8,Casual Users
79263,698,8,16,2,2,2,6,Lost
79329,419,11,32,3,2,3,8,Casual Users
79344,1828,19,39,1,3,3,7,Casual Users
80014,2122,9,17,1,2,2,5,Lost
80230,966,6,22,2,1,2,5,Lost
80297,17,37,58,5,4,3,12,Loyal Users
80327,38,9,44,5,2,3,10,Promising
81418,174,58,151,3,5,5,13,Loyal Users
81438,4400,6,11,1,1,1,3,Lost
81499,384,11,16,3,2,2,7,Casual Users
81500,220,8,18,3,2,2,7,Casual Users
81806,103,31,85,4,4,4,12,Champions
81879,368,66,180,3,5,5,13,Loyal Users
81923,92,82,168,4,5,5,14,Champions
82060,101,25,99,4,4,4,12,Champions
82183,451,15,23,3,3,2,8,Loyal Users
82295,87,32,127,4,4,4,12,Champions
82308,1048,9,15,2,2,1,5,Lost
82328,1806,26,63,1,4,4,9,At Risk
83045,13,43,61,5,4,3,12,Loyal Users
83123,378,28,101,3,4,4,11,Loyal Users
83163,156,159,457,4,5,5,14,Champions
83220,104,10,15,4,2,1,7,Promising
83287,129,11,27,4,2,2,8,Promising
83294,365,15,50,3,3,3,9,Loyal Users
83334,242,17,78,3,3,4,10,Loyal Users
83424,4297,31,49,1,4,3,8,At Risk
83513,238,30,50,3,4,3,10,Loyal Users
83577,700,28,39,2,4,3,9,At Risk
84160,2273,8,25,1,2,2,5,Lost
84363,134,30,209,4,4,5,13,Champions
84390,286,8,33,3,2,3,8,Casual Users
84461,109,89,341,4,5,5,14,Champions
84580,12,35,65,5,4,4,13,Champions
84713,2583,10,25,1,2,2,5,Lost
84881,41,122,193,5,5,5,15,Champions
85160,15,24,46,5,4,3,12,Loyal Users
85192,616,5,5,2,1,1,4,Lost
85404,117,129,333,4,5,5,14,Champions
85464,952,6,9,2,1,1,4,Lost
85483,71,19,32,4,3,3,10,Loyal Users
85682,86,48,106,4,5,4,13,Champions
85850,2512,7,10,1,2,1,4,Lost
86225,695,16,34,2,3,3,8,Casual Users
86246,1264,5,12,1,1,1,3,Lost
86794,147,20,40,4,3,3,10,Loyal Users
86928,2,175,381,5,5,5,15,Champions
86980,2492,11,33,1,2,3,6,Lost
87760,262,5,7,3,1,1,5,Casual Users
87789,504,8,15,2,2,1,5,Lost
87864,113,75,164,4,5,5,14,Champions
87919,10,56,81,5,5,4,14,Champions
88075,135,34,53,4,4,3,11,Loyal Users
88381,395,10,22,3,2,2,7,Casual Users
88408,3869,12,44,1,3,3,7,Casual Users
88543,111,30,81,4,4,4,12,Champions
88561,144,14,41,4,3,3,10,Loyal Users
88944,688,8,19,2,2,2,6,Lost
89519,294,10,13,3,2,1,6,Casual Users
89532,475,13,34,2,3,3,8,Casual Users
89566,2108,5,27,1,1,2,4,Lost
90037,1245,6,8,2,1,1,4,Lost
90151,311,9,21,3,2,2,7,Casual Users
90262,551,22,173,2,4,5,11,At Risk
90634,37,13,20,5,3,2,10,Loyal Users
90997,108,206,378,4,5,5,14,Champions
79233,1506,16,75,1,3,4,8,Casual Users
80385,1171,7,7,2,2,1,5,Lost
80673,491,19,36,2,3,3,8,Casual Users
81285,13,40,138,5,4,4,13,Champions
81394,116,62,263,4,5,5,14,Champions
81423,412,35,115,3,4,4,11,Loyal Users
82021,408,6,21,3,1,2,6,Casual Users
82382,696,10,21,2,2,2,6,Lost
82655,94,11,17,4,2,2,8,Promising
82895,1977,10,15,1,2,1,4,Lost
83105,2216,9,23,1,2,2,5,Lost
83268,0,131,453,5,5,5,15,Champions
83282,136,19,47,4,3,3,10,Loyal Users
83580,1739,13,72,1,3,4,8,Casual Users
83688,2251,5,5,1,1,1,3,Lost
84435,415,24,118,3,4,4,11,Loyal Users
84442,427,13,48,3,3,3,9,Loyal Users
84547,165,25,107,4,4,4,12,Champions
84853,1422,5,13,1,1,1,3,Lost
84905,5442,9,22,1,2,2,5,Lost
84987,4271,5,22,1,1,2,4,Lost
85216,702,9,36,2,2,3,7,Lost
85326,531,13,24,2,3,2,7,Casual Users
85482,236,62,124,3,5,4,12,Loyal Users
85523,27,15,21,5,3,2,10,Loyal Users
85702,90,15,82,4,3,4,11,Loyal Users
85730,816,15,66,2,3,4,9,Casual Users
85958,3425,7,22,1,2,2,5,Lost
86062,101,7,45,4,2,3,9,Promising
86393,137,61,259,4,5,5,14,Champions
86414,2170,8,19,1,2,2,5,Lost
86624,136,32,70,4,4,4,12,Champions
86723,1820,18,67,1,3,4,8,Casual Users
86744,67,8,16,5,2,2,9,Promising
86754,130,11,12,4,2,1,7,Promising
86875,1429,15,33,1,3,3,7,Casual Users
87033,815,11,21,2,2,2,6,Lost
87336,1289,30,56,1,4,3,8,At Risk
87376,831,6,11,2,1,1,4,Lost
87567,3634,5,18,1,1,2,4,Lost
87588,80,46,320,4,5,5,14,Champions
87597,1500,5,17,1,1,2,4,Lost
87625,1790,7,7,1,2,1,4,Lost
87668,148,5,53,4,1,3,8,Promising
87765,40,48,390,5,5,5,15,Champions
87977,644,19,76,2,3,4,9,Casual Users
88015,29,7,14,5,2,1,8,Promising
88022,1790,5,6,1,1,1,3,Lost
88080,126,11,31,4,2,2,8,Promising
88306,135,12,32,4,3,3,10,Loyal Users
88378,83,77,460,4,5,5,14,Champions
88516,976,5,7,2,1,1,4,Lost
88740,1782,7,13,1,2,1,4,Lost
88754,135,11,60,4,2,3,9,Promising
88756,2408,5,8,1,1,1,3,Lost
88997,114,43,184,4,4,5,13,Champions
89111,1283,5,30,1,1,2,4,Lost
89253,968,17,35,2,3,3,8,Casual Users
89524,1261,12,21,1,3,2,6,Casual Users
89557,756,10,27,2,2,2,6,Lost
89780,883,43,73,2,4,4,10,At Risk
89839,416,7,15,3,2,1,6,Casual Users
89842,130,13,106,4,3,4,11,Loyal Users
90204,733,6,10,2,1,1,4,Lost
90263,879,15,17,2,3,2,7,Casual Users
90424,412,37,180,3,4,5,12,Loyal Users
90442,2413,14,52,1,3,3,7,Casual Users
90697,2266,5,5,1,1,1,3,Lost
90770,72,132,532,4,5,5,14,Champions
90977,2581,5,7,1,1,1,3,Lost
78694,405,16,34,3,3,3,9,Loyal Users
79149,265,31,46,3,4,3,10,Loyal Users
79345,683,7,14,2,2,1,5,Lost
79523,6,50,86,5,5,4,14,Champions
79567,3853,7,8,1,2,1,4,Lost
79835,165,13,14,4,3,1,8,Loyal Users
79871,3406,7,8,1,2,1,4,Lost
79972,255,21,56,3,3,3,9,Loyal Users
80096,277,19,59,3,3,3,9,Loyal Users
80148,323,11,98,3,2,4,9,Casual Users
80149,2458,5,7,1,1,1,3,Lost
80182,9,57,95,5,5,4,14,Champions
80187,229,129,476,3,5,5,13,Loyal Users
80875,312,105,288,3,5,5,13,Loyal Users
80953,124,106,116,4,5,4,13,Champions
80954,4686,12,32,1,3,3,7,Casual Users
81059,2721,6,17,1,1,2,4,Lost
81344,731,6,18,2,1,2,5,Lost
81417,5231,7,32,1,2,3,6,Lost
81510,69,32,235,5,4,5,14,Champions
81845,583,15,15,2,3,1,6,Casual Users
82113,831,28,174,2,4,5,11,At Risk
82487,1172,22,59,2,4,3,9,At Risk
82550,375,35,118,3,4,4,11,Loyal Users
83142,3127,5,5,1,1,1,3,Lost
83238,1125,16,32,2,3,3,8,Casual Users
83344,8,70,474,5,5,5,15,Champions
83475,13,82,184,5,5,5,15,Champions
83810,17,91,183,5,5,5,15,Champions
83956,1488,19,30,1,3,2,6,Casual Users
84085,30,129,428,5,5,5,15,Champions
84280,15,57,106,5,5,4,14,Champions
84286,17,23,75,5,4,4,13,Champions
84311,990,8,15,2,2,1,5,Lost
84721,130,26,148,4,4,5,13,Champions
84914,2363,26,46,1,4,3,8,At Risk
85222,546,20,89,2,3,4,9,Casual Users
85223,65,37,220,5,4,5,14,Champions
85239,319,67,220,3,5,5,13,Loyal Users
85369,95,109,385,4,5,5,14,Champions
85851,1479,5,28,1,1,2,4,Lost
86364,660,7,45,2,2,3,7,Lost
86452,765,15,18,2,3,2,7,Casual Users
86475,757,14,44,2,3,3,8,Casual Users
86711,8,40,244,5,4,5,14,Champions
86728,227,21,63,3,3,4,10,Loyal Users
87463,58,10,30,5,2,2,9,Promising
87651,613,11,47,2,2,3,7,Lost
87698,49,199,519,5,5,5,15,Champions
87792,434,6,15,3,1,1,5,Casual Users
87820,104,48,152,4,5,5,14,Champions
88086,150,14,31,4,3,2,9,Loyal Users
88192,2414,39,64,1,4,4,9,At Risk
88352,1626,6,7,1,1,1,3,Lost
88519,22,64,150,5,5,5,15,Champions
89508,1661,8,11,1,2,1,4,Lost
89703,562,8,9,2,2,1,5,Lost
90093,282,13,27,3,3,2,8,Loyal Users
90596,124,32,96,4,4,4,12,Champions
90952,1116,20,35,2,3,3,8,Casual Users
78619,2444,13,24,1,3,2,6,Casual Users
78782,80,31,79,4,4,4,12,Champions
79335,506,12,21,2,3,2,7,Casual Users
79340,11,101,226,5,5,5,15,Champions
79486,2,105,251,5,5,5,15,Champions
79601,11,37,141,5,4,4,13,Champions
79611,500,103,643,2,5,5,12,At Risk
79622,155,15,94,4,3,4,11,Loyal Users
79708,113,18,227,4,3,5,12,Loyal Users
79941,13,74,126,5,5,4,14,Champions
80838,295,50,255,3,5,5,13,Loyal Users
81414,408,10,43,3,2,3,8,Casual Users
81596,101,14,54,4,3,3,10,Loyal Users
81773,250,14,70,3,3,4,10,Loyal Users
81877,1305,28,76,1,4,4,9,At Risk
81885,253,59,97,3,5,4,12,Loyal Users
81942,666,8,19,2,2,2,6,Lost
81961,31,79,181,5,5,5,15,Champions
81990,27,18,63,5,3,4,12,Loyal Users
82027,1535,30,66,1,4,4,9,At Risk
82434,401,9,22,3,2,2,7,Casual Users
82455,2,74,198,5,5,5,15,Champions
82540,146,57,97,4,5,4,13,Champions
82562,4456,7,7,1,2,1,4,Lost
82616,291,50,84,3,5,4,12,Loyal Users
82759,466,52,120,3,5,4,12,Loyal Users
83215,14,65,113,5,5,4,14,Champions
83259,97,77,198,4,5,5,14,Champions
83884,2687,8,16,1,2,2,5,Lost
84535,127,40,143,4,4,4,12,Champions
84714,99,20,61,4,3,3,10,Loyal Users
85177,1446,5,35,1,1,3,5,Lost
85215,379,14,31,3,3,2,8,Loyal Users
85267,77,33,146,4,4,4,12,Champions
85711,3271,7,40,1,2,3,6,Lost
85998,962,32,62,2,4,3,9,At Risk
86263,12,5,5,5,1,1,7,Promising
86407,249,28,93,3,4,4,11,Loyal Users
86468,716,16,31,2,3,2,7,Casual Users
86556,11,94,282,5,5,5,15,Champions
86642,1990,6,11,1,1,1,3,Lost
86708,3685,5,7,1,1,1,3,Lost
86863,30,7,26,5,2,2,9,Promising
86989,796,9,20,2,2,2,6,Lost
87016,2102,19,56,1,3,3,7,Casual Users
87652,151,6,15,4,1,1,6,Promising
88431,1627,13,13,1,3,1,5,Casual Users
88656,785,6,65,2,1,4,7,Lost
88820,44,50,267,5,5,5,15,Champions
88946,1475,6,21,1,1,2,4,Lost
89264,884,7,11,2,2,1,5,Lost
89274,146,16,30,4,3,2,9,Loyal Users
89434,710,14,64,2,3,4,9,Casual Users
89639,127,78,181,4,5,5,14,Champions
89749,116,9,21,4,2,2,8,Promising
89838,13,62,117,5,5,4,14,Champions
90079,275,19,68,3,3,4,10,Loyal Users
90401,412,19,79,3,3,4,10,Loyal Users
90445,51,163,780,5,5,5,15,Champions
90518,131,30,109,4,4,4,12,Champions
90641,1474,8,8,1,2,1,4,Lost
90963,258,26,68,3,4,4,11,Loyal Users
78332,390,8,74,3,2,4,9,Casual Users
78360,149,10,30,4,2,2,8,Promising
78541,3,75,225,5,5,5,15,Champions
78763,2193,9,17,1,2,2,5,Lost
78790,4721,9,10,1,2,1,4,Lost
79136,32,101,492,5,5,5,15,Champions
79446,194,7,14,3,2,1,6,Casual Users
79491,1111,6,13,2,1,1,4,Lost
79749,2678,8,17,1,2,2,5,Lost
80068,416,59,303,3,5,5,13,Loyal Users
80322,82,67,388,4,5,5,14,Champions
80809,161,75,124,4,5,4,13,Champions
81350,10,36,75,5,4,4,13,Champions
81432,123,16,40,4,3,3,10,Loyal Users
81581,119,51,108,4,5,4,13,Champions
81699,262,31,85,3,4,4,11,Loyal Users
82390,59,32,206,5,4,5,14,Champions
82416,401,130,280,3,5,5,13,Loyal Users
82560,176,34,37,3,4,3,10,Loyal Users
82570,838,14,146,2,3,4,9,Casual Users
82587,60,102,556,5,5,5,15,Champions
82770,104,131,270,4,5,5,14,Champions
82953,257,11,62,3,2,3,8,Casual Users
83044,165,8,16,4,2,2,8,Promising
83085,1361,6,20,1,1,2,4,Lost
83129,568,8,30,2,2,2,6,Lost
83452,8,14,30,5,3,2,10,Loyal Users
83775,428,11,15,3,2,1,6,Casual Users
83830,1360,6,7,1,1,1,3,Lost
83909,856,7,9,2,2,1,5,Lost
84082,106,124,557,4,5,5,14,Champions
84192,565,12,34,2,3,3,8,Casual Users
84258,4569,5,8,1,1,1,3,Lost
84592,3530,12,24,1,3,2,6,Casual Users
84716,0,18,64,5,3,4,12,Loyal Users
84856,928,5,22,2,1,2,5,Lost
85194,847,7,16,2,2,2,6,Lost
85243,233,8,40,3,2,3,8,Casual Users
85343,2260,8,14,1,2,1,4,Lost
85470,7,15,57,5,3,3,11,Loyal Users
85770,5540,5,28,1,1,2,4,Lost
86123,395,20,90,3,3,4,10,Loyal Users
86404,2618,6,57,1,1,3,5,Lost
86630,523,14,68,2,3,4,9,Casual Users
86710,79,90,478,4,5,5,14,Champions
86864,667,9,12,2,2,1,5,Lost
86915,15,85,336,5,5,5,15,Champions
86916,5009,6,10,1,1,1,3,Lost
87356,118,23,121,4,4,4,12,Champions
87417,1537,5,15,1,1,1,3,Lost
87527,422,33,65,3,4,4,11,Loyal Users
87795,0,126,241,5,5,5,15,Champions
87806,1841,8,11,1,2,1,4,Lost
87930,36,32,448,5,4,5,14,Champions
87997,56,58,132,5,5,4,14,Champions
88034,364,5,27,3,1,2,6,Casual Users
88500,46,5,7,5,1,1,7,Promising
88934,3759,6,9,1,1,1,3,Lost
88993,263,12,50,3,3,3,9,Loyal Users
89104,84,69,252,4,5,5,14,Champions
89224,1416,14,71,1,3,4,8,Casual Users
89240,145,9,24,4,2,2,8,Promising
89449,3170,5,6,1,1,1,3,Lost
89548,139,7,43,4,2,3,9,Promising
89954,1257,39,155,2,4,5,11,At Risk
89990,101,31,190,4,4,5,13,Champions
90110,55,76,122,5,5,4,14,Champions
90156,93,80,100,4,5,4,13,Champions
90341,639,5,24,2,1,2,5,Lost
90527,96,61,367,4,5,5,14,Champions
90899,75,19,85,4,3,4,11,Loyal Users
90939,408,19,20,3,3,2,8,Loyal Users
78726,92,83,151,4,5,5,14,Champions
78758,306,13,65,3,3,4,10,Loyal Users
79194,145,35,53,4,4,3,11,Loyal Users
79783,307,52,213,3,5,5,13,Loyal Users
79810,12,17,152,5,3,5,13,Loyal Users
79813,727,9,20,2,2,2,6,Lost
79892,722,18,27,2,3,2,7,Casual Users
80070,879,9,9,2,2,1,5,Lost
80323,451,9,9,3,2,1,6,Casual Users
80397,106,16,32,4,3,3,10,Loyal Users
80515,414,7,17,3,2,2,7,Casual Users
80823,847,11,19,2,2,2,6,Lost
81342,439,21,195,3,3,5,11,Loyal Users
81434,3378,5,6,1,1,1,3,Lost
81732,1389,76,895,1,5,5,11,At Risk
81899,1520,28,151,1,4,5,10,At Risk
81905,1856,14,33,1,3,3,7,Casual Users
81919,4160,5,8,1,1,1,3,Lost
82010,628,14,20,2,3,2,7,Casual Users
82480,8,112,249,5,5,5,15,Champions
82482,586,10,47,2,2,3,7,Lost
82627,961,17,101,2,3,4,9,Casual Users
82881,494,19,91,2,3,4,9,Casual Users
83179,529,30,77,2,4,4,10,At Risk
83376,1059,26,52,2,4,3,9,At Risk
83388,2397,15,49,1,3,3,7,Casual Users
83413,721,30,85,2,4,4,10,At Risk
83632,20,17,127,5,3,4,12,Loyal Users
83765,82,7,28,4,2,2,8,Promising
83794,812,8,30,2,2,2,6,Lost
84212,1266,8,42,1,2,3,6,Lost
84421,986,11,16,2,2,2,6,Lost
84447,1287,7,28,1,2,2,5,Lost
84722,24,102,390,5,5,5,15,Champions
84950,45,102,623,5,5,5,15,Champions
85228,216,18,52,3,3,3,9,Loyal Users
85413,79,59,165,4,5,5,14,Champions
85486,405,13,27,3,3,2,8,Loyal Users
86068,21,38,301,5,4,5,14,Champions
86867,1922,5,10,1,1,1,3,Lost
86884,426,32,64,3,4,4,11,Loyal Users
87112,647,28,154,2,4,5,11,At Risk
87283,147,13,82,4,3,4,11,Loyal Users
87613,684,8,11,2,2,1,5,Lost
87685,87,10,15,4,2,1,7,Promising
87728,177,76,175,3,5,5,13,Loyal Users
87857,1162,16,44,2,3,3,8,Casual Users
88115,1833,7,12,1,2,1,4,Lost
88190,0,18,32,5,3,3,11,Loyal Users
88339,81,118,402,4,5,5,14,Champions
88364,335,20,119,3,3,4,10,Loyal Users
88402,2684,5,25,1,1,2,4,Lost
88959,5,41,118,5,4,4,13,Champions
89447,180,17,21,3,3,2,8,Loyal Users
89554,1634,5,40,1,1,3,5,Lost
89721,1663,6,10,1,1,1,3,Lost
89745,754,5,7,2,1,1,4,Lost
89962,149,67,97,4,5,4,13,Champions
90274,1422,24,112,1,4,4,9,At Risk
90453,1810,16,52,1,3,3,7,Casual Users
90828,1855,11,20,1,2,2,5,Lost
90957,287,18,36,3,3,3,9,Loyal Users
78545,157,7,72,4,2,4,10,Promising
78635,116,65,189,4,5,5,14,Champions
78815,2536,5,31,1,1,2,4,Lost
78932,338,15,20,3,3,2,8,Loyal Users
79091,23,12,17,5,3,2,10,Loyal Users
79214,27,48,106,5,5,4,14,Champions
79629,708,72,308,2,5,5,12,At Risk
79905,392,35,85,3,4,4,11,Loyal Users
80270,1152,16,52,2,3,3,8,Casual Users
80289,101,20,63,4,3,4,11,Loyal Users
80481,694,11,57,2,2,3,7,Lost
80724,403,46,175,3,5,5,13,Loyal Users
81278,18,96,351,5,5,5,15,Champions
81689,810,14,48,2,3,3,8,Casual Users
82157,1457,8,9,1,2,1,4,Lost
82316,281,9,86,3,2,4,9,Casual Users
82573,82,6,14,4,1,1,6,Promising
82772,837,28,45,2,4,3,9,At Risk
82884,303,32,134,3,4,4,11,Loyal Users
83005,1412,10,32,1,2,3,6,Lost
83601,289,6,17,3,1,2,6,Casual Users
83630,2026,17,31,1,3,2,6,Casual Users
83638,14,12,28,5,3,2,10,Loyal Users
83659,228,32,151,3,4,5,12,Loyal Users
84254,77,69,401,4,5,5,14,Champions
84366,1656,5,7,1,1,1,3,Lost
84406,14,6,13,5,1,1,7,Promising
84455,39,12,17,5,3,2,10,Loyal Users
84582,80,15,52,4,3,3,10,Loyal Users
84712,347,54,89,3,5,4,12,Loyal Users
84811,241,30,51,3,4,3,10,Loyal Users
84871,1057,64,291,2,5,5,12,At Risk
85089,67,63,287,5,5,5,15,Champions
85218,1914,5,56,1,1,3,5,Lost
85494,1485,10,31,1,2,2,5,Lost
85924,241,7,34,3,2,3,8,Casual Users
86124,2626,6,11,1,1,1,3,Lost
86720,234,13,26,3,3,2,8,Loyal Users
87052,5602,5,8,1,1,1,3,Lost
87353,487,7,21,2,2,2,6,Lost
88484,1726,7,7,1,2,1,4,Lost
88576,1112,69,261,2,5,5,12,At Risk
88650,83,17,29,4,3,2,9,Loyal Users
88873,24,59,210,5,5,5,15,Champions
88967,430,5,14,3,1,1,5,Casual Users
88996,23,27,157,5,4,5,14,Champions
89329,128,34,130,4,4,4,12,Champions
89662,101,24,32,4,4,3,11,Loyal Users
89698,118,7,9,4,2,1,7,Promising
89823,996,29,45,2,4,3,9,At Risk
89853,1,60,128,5,5,4,14,Champions
89894,174,19,62,3,3,3,9,Loyal Users
90078,465,11,54,3,2,3,8,Casual Users
90182,299,16,16,3,3,2,8,Loyal Users
90346,417,35,174,3,4,5,12,Loyal Users
90531,1454,27,79,1,4,4,9,At Risk
90580,3875,6,10,1,1,1,3,Lost
90766,4,6,9,5,1,1,7,Promising
90809,883,5,5,2,1,1,4,Lost
90845,4,18,43,5,3,3,11,Loyal Users
90993,1731,6,8,1,1,1,3,Lost
91022,416,7,12,3,2,1,6,Casual Users
78366,745,9,28,2,2,2,6,Lost
78418,155,37,48,4,4,3,11,Loyal Users
78583,472,9,14,2,2,1,5,Lost
78701,45,96,281,5,5,5,15,Champions
78736,93,26,64,4,4,4,12,Champions
78812,93,102,191,4,5,5,14,Champions
78846,31,71,272,5,5,5,15,Champions
79071,81,85,254,4,5,5,14,Champions
79875,68,71,304,5,5,5,15,Champions
80005,3,22,67,5,4,4,13,Champions
80015,486,12,25,2,3,2,7,Casual Users
80193,156,69,123,4,5,4,13,Champions
80258,124,7,96,4,2,4,10,Promising
80600,561,17,26,2,3,2,7,Casual Users
80678,1530,10,32,1,2,3,6,Lost
80967,128,58,216,4,5,5,14,Champions
80993,63,21,59,5,3,3,11,Loyal Users
81316,211,36,222,3,4,5,12,Loyal Users
81572,831,7,9,2,2,1,5,Lost
81770,2173,6,15,1,1,1,3,Lost
81789,121,56,79,4,5,4,13,Champions
81799,471,6,76,2,1,4,7,Lost
82093,169,11,24,3,2,2,7,Casual Users
82152,139,26,99,4,4,4,12,Champions
82173,251,51,76,3,5,4,12,Loyal Users
82503,1978,11,106,1,2,4,7,Lost
82533,231,6,12,3,1,1,5,Casual Users
82576,658,24,137,2,4,4,10,At Risk
83200,977,6,12,2,1,1,4,Lost
83306,843,6,34,2,1,3,6,Lost
83507,25,112,557,5,5,5,15,Champions
83639,2122,6,19,1,1,2,4,Lost
83649,11,70,194,5,5,5,15,Champions
83700,111,7,21,4,2,2,8,Promising
83924,60,35,128,5,4,4,13,Champions
84042,13,10,13,5,2,1,8,Promising
84490,368,6,9,3,1,1,5,Casual Users
84633,610,41,200,2,4,5,11,At Risk
84974,17,113,203,5,5,5,15,Champions
85134,53,23,40,5,4,3,12,Loyal Users
85279,541,10,40,2,2,3,7,Lost
85645,1219,7,26,2,2,2,6,Lost
85751,2418,8,23,1,2,2,5,Lost
85863,3221,21,63,1,3,4,8,Casual Users
85864,404,15,45,3,3,3,9,Loyal Users
85921,134,15,111,4,3,4,11,Loyal Users
86231,156,6,47,4,1,3,8,Promising
86305,2121,21,159,1,3,5,9,Casual Users
86485,715,6,15,2,1,1,4,Lost
86693,180,78,232,3,5,5,13,Loyal Users
86837,3238,11,29,1,2,2,5,Lost
86914,58,128,272,5,5,5,15,Champions
87107,1082,21,57,2,3,3,8,Casual Users
87284,100,5,8,4,1,1,6,Promising
87332,1166,9,19,2,2,2,6,Lost
87603,37,12,45,5,3,3,11,Loyal Users
87950,1180,56,171,2,5,5,12,At Risk
87971,857,24,105,2,4,4,10,At Risk
88280,11,6,41,5,1,3,9,Promising
88529,2255,6,26,1,1,2,4,Lost
88661,122,33,124,4,4,4,12,Champions
88773,4010,18,32,1,3,3,7,Casual Users
89441,1268,7,45,1,2,3,6,Lost
90158,418,71,126,3,5,4,12,Loyal Users
90329,19,91,187,5,5,5,15,Champions
90441,786,10,36,2,2,3,7,Lost
90600,4837,39,135,1,4,4,9,At Risk
90742,130,86,160,4,5,5,14,Champions
91045,325,88,142,3,5,4,12,Loyal Users
78299,566,6,14,2,1,1,4,Lost
78416,53,38,53,5,4,3,12,Loyal Users
78438,10,161,396,5,5,5,15,Champions
78453,173,13,35,3,3,3,9,Loyal Users
78739,1949,9,9,1,2,1,4,Lost
78873,353,12,44,3,3,3,9,Loyal Users
79347,116,56,358,4,5,5,14,Champions
79465,19,50,89,5,5,4,14,Champions
79834,1704,9,17,1,2,2,5,Lost
79930,752,12,37,2,3,3,8,Casual Users
80263,153,91,225,4,5,5,14,Champions
80275,1053,83,154,2,5,5,12,At Risk
80408,4073,32,40,1,4,3,8,At Risk
80528,250,26,49,3,4,3,10,Loyal Users
80655,2,5,6,5,1,1,7,Promising
80770,136,22,48,4,4,3,11,Loyal Users
80963,1471,7,10,1,2,1,4,Lost
81012,20,56,461,5,5,5,15,Champions
81336,813,23,35,2,4,3,9,At Risk
81366,1803,15,151,1,3,5,9,Casual Users
81371,13,67,170,5,5,5,15,Champions
81463,939,7,22,2,2,2,6,Lost
81775,144,13,34,4,3,3,10,Loyal Users
81859,48,41,64,5,4,4,13,Champions
81890,149,29,72,4,4,4,12,Champions
81902,1308,11,18,1,2,2,5,Lost
81922,356,47,134,3,5,4,12,Loyal Users
81964,113,46,92,4,5,4,13,Champions
82023,338,8,8,3,2,1,6,Casual Users
82277,120,149,475,4,5,5,14,Champions
82404,99,7,7,4,2,1,7,Promising
82417,1624,5,5,1,1,1,3,Lost
82951,77,14,46,4,3,3,10,Loyal Users
83046,1834,6,13,1,1,1,3,Lost
83178,667,6,7,2,1,1,4,Lost
83208,40,36,277,5,4,5,14,Champions
83234,186,10,45,3,2,3,8,Casual Users
83350,2737,10,33,1,2,3,6,Lost
83518,4662,9,10,1,2,1,4,Lost
84017,275,99,149,3,5,5,13,Loyal Users
84039,430,13,23,3,3,2,8,Loyal Users
84334,130,14,79,4,3,4,11,Loyal Users
84343,774,12,25,2,3,2,7,Casual Users
84605,78,166,292,4,5,5,14,Champions
84815,411,29,40,3,4,3,10,Loyal Users
84890,77,177,462,4,5,5,14,Champions
85305,272,5,5,3,1,1,5,Casual Users
85336,587,9,10,2,2,1,5,Lost
85551,3559,10,10,1,2,1,4,Lost
85577,70,52,209,4,5,5,14,Champions
85626,385,13,16,3,3,2,8,Loyal Users
86742,379,46,130,3,5,4,12,Loyal Users
87102,255,6,24,3,1,2,6,Casual Users
87267,1741,12,14,1,3,1,5,Casual Users
87618,129,28,52,4,4,3,11,Loyal Users
87886,224,37,74,3,4,4,11,Loyal Users
88056,203,43,86,3,4,4,11,Loyal Users
88164,1007,13,64,2,3,4,9,Casual Users
88276,316,43,54,3,4,3,10,Loyal Users
88483,5,69,101,5,5,4,14,Champions
88620,2704,8,16,1,2,2,5,Lost
88882,836,6,18,2,1,2,5,Lost
88917,40,10,50,5,2,3,10,Promising
88968,224,20,61,3,3,3,9,Loyal Users
89193,255,9,14,3,2,1,6,Casual Users
89288,140,13,13,4,3,1,8,Loyal Users
89699,1498,5,22,1,1,2,4,Lost
90408,2196,5,7,1,1,1,3,Lost
90551,1886,5,23,1,1,2,4,Lost
90590,2693,6,29,1,1,2,4,Lost
90619,4984,7,18,1,2,2,5,Lost
90847,1795,5,8,1,1,1,3,Lost
91024,371,37,80,3,4,4,11,Loyal Users
91041,8,136,761,5,5,5,15,Champions
91058,875,9,18,2,2,2,6,Lost
78696,990,17,23,2,3,2,7,Casual Users
78791,16,30,59,5,4,3,12,Loyal Users
78964,394,12,37,3,3,3,9,Loyal Users
78976,13,115,163,5,5,5,15,Champions
79114,1875,8,16,1,2,2,5,Lost
79432,103,63,225,4,5,5,14,Champions
79596,586,15,44,2,3,3,8,Casual Users
79794,1402,16,43,1,3,3,7,Casual Users
80449,2397,6,7,1,1,1,3,Lost
80586,31,10,53,5,2,3,10,Promising
80614,432,23,33,3,4,3,10,Loyal Users
80811,1433,5,10,1,1,1,3,Lost
81055,242,10,36,3,2,3,8,Casual Users
81379,110,68,200,4,5,5,14,Champions
81529,128,13,32,4,3,3,10,Loyal Users
82067,834,14,31,2,3,2,7,Casual Users
82266,406,45,106,3,4,4,11,Loyal Users
82394,144,60,145,4,5,4,13,Champions
82494,68,61,159,5,5,5,15,Champions
82987,15,40,63,5,4,4,13,Champions
83156,263,34,146,3,4,4,11,Loyal Users
83173,31,55,121,5,5,4,14,Champions
83621,107,30,113,4,4,4,12,Champions
84603,487,7,10,2,2,1,5,Lost
84847,106,9,20,4,2,2,8,Promising
84887,1611,14,42,1,3,3,7,Casual Users
84941,84,39,52,4,4,3,11,Loyal Users
85738,271,26,59,3,4,3,10,Loyal Users
85772,394,6,19,3,1,2,6,Casual Users
86105,104,31,278,4,4,5,13,Champions
86217,1195,9,62,2,2,3,7,Lost
86380,3027,62,111,1,5,4,10,At Risk
86666,122,49,105,4,5,4,13,Champions
86963,258,12,23,3,3,2,8,Loyal Users
87370,15,29,78,5,4,4,13,Champions
87461,993,5,9,2,1,1,4,Lost
87674,123,18,23,4,3,2,9,Loyal Users
88185,1424,11,32,1,2,3,6,Lost
88219,117,33,223,4,4,5,13,Champions
88395,11,14,23,5,3,2,10,Loyal Users
88406,102,19,66,4,3,4,11,Loyal Users
88808,2282,22,64,1,4,4,9,At Risk
88980,160,6,25,4,1,2,7,Promising
89025,77,27,69,4,4,4,12,Champions
89254,244,50,206,3,5,5,13,Loyal Users
89261,2081,13,29,1,3,2,6,Casual Users
89454,464,57,289,3,5,5,13,Loyal Users
89559,513,13,68,2,3,4,9,Casual Users
89585,72,19,80,4,3,4,11,Loyal Users
89779,4746,7,24,1,2,2,5,Lost
89875,121,59,498,4,5,5,14,Champions
89957,108,7,11,4,2,1,7,Promising
89995,36,76,147,5,5,5,15,Champions
90084,101,123,467,4,5,5,14,Champions
90098,159,7,26,4,2,2,8,Promising
90265,83,5,12,4,1,1,6,Promising
90292,1183,8,31,2,2,2,6,Lost
90312,791,7,14,2,2,1,5,Lost
90387,668,14,36,2,3,3,8,Casual Users
90521,3,7,10,5,2,1,8,Promising
90734,183,7,34,3,2,3,8,Casual Users
90830,109,15,31,4,3,2,9,Loyal Users
90860,13,84,236,5,5,5,15,Champions
90892,1557,17,41,1,3,3,7,Casual Users
90979,1314,20,51,1,3,3,7,Casual Users
91018,109,10,11,4,2,1,7,Promising
78407,2305,8,12,1,2,1,4,Lost
78429,37,10,34,5,2,3,10,Promising
78442,1564,7,10,1,2,1,4,Lost
79304,94,47,175,4,5,5,14,Champions
79809,140,52,101,4,5,4,13,Champions
80577,565,16,47,2,3,3,8,Casual Users
80760,462,9,19,3,2,2,7,Casual Users
80803,1007,14,20,2,3,2,7,Casual Users
80870,721,12,13,2,3,1,6,Casual Users
81003,1285,14,25,1,3,2,6,Casual Users
81167,10,167,492,5,5,5,15,Champions
81391,993,5,24,2,1,2,5,Lost
81809,1425,14,82,1,3,4,8,Casual Users
81812,1572,12,33,1,3,3,7,Casual Users
81842,590,6,9,2,1,1,4,Lost
82024,40,48,269,5,5,5,15,Champions
82087,2289,73,268,1,5,5,11,At Risk
82106,892,6,6,2,1,1,4,Lost
82146,91,83,387,4,5,5,14,Champions
82201,115,30,162,4,4,5,13,Champions
82457,531,21,54,2,3,3,8,Casual Users
82485,116,10,13,4,2,1,7,Promising
82531,9,109,596,5,5,5,15,Champions
82536,3123,6,6,1,1,1,3,Lost
82728,448,12,22,3,3,2,8,Loyal Users
83313,716,10,27,2,2,2,6,Lost
83373,2391,12,16,1,3,2,6,Casual Users
83467,417,8,25,3,2,2,7,Casual Users
84189,147,49,406,4,5,5,14,Champions
84267,5,14,45,5,3,3,11,Loyal Users
84787,126,12,31,4,3,2,9,Loyal Users
84864,695,9,12,2,2,1,5,Lost
85151,282,7,10,3,2,1,6,Casual Users
85294,437,33,112,3,4,4,11,Loyal Users
85380,13,174,650,5,5,5,15,Champions
85394,155,13,54,4,3,3,10,Loyal Users
85617,1435,13,23,1,3,2,6,Casual Users
85996,157,36,186,4,4,5,13,Champions
86086,23,47,60,5,5,3,13,Loyal Users
86233,69,25,133,5,4,4,13,Champions
86284,1288,7,44,1,2,3,6,Lost
86353,133,9,34,4,2,3,9,Promising
86576,120,12,48,4,3,3,10,Loyal Users
86709,2575,7,12,1,2,1,4,Lost
87751,1837,13,106,1,3,4,8,Casual Users
88031,1526,41,68,1,4,4,9,At Risk
88539,436,6,8,3,1,1,5,Casual Users
88885,110,12,18,4,3,2,9,Loyal Users
88971,424,19,94,3,3,4,10,Loyal Users
88985,308,32,66,3,4,4,11,Loyal Users
89308,1822,10,12,1,2,1,4,Lost
89391,61,22,134,5,4,4,13,Champions
89681,257,7,30,3,2,2,7,Casual Users
89884,2555,7,8,1,2,1,4,Lost
89888,5032,8,8,1,2,1,4,Lost
89889,155,9,29,4,2,2,8,Promising
89973,4147,6,37,1,1,3,5,Lost
90462,80,12,33,4,3,3,10,Loyal Users
90506,6,61,182,5,5,5,15,Champions
90722,1121,8,26,2,2,2,6,Lost
90749,673,5,6,2,1,1,4,Lost
90896,13,131,524,5,5,5,15,Champions
91002,410,10,11,3,2,1,6,Casual Users
78376,258,14,93,3,3,4,10,Loyal Users
78518,1107,15,69,2,3,4,9,Casual Users
78755,323,23,29,3,4,2,9,Loyal Users
78809,272,66,243,3,5,5,13,Loyal Users
78831,404,36,241,3,4,5,12,Loyal Users
79510,1008,8,12,2,2,1,5,Lost
79602,227,20,43,3,3,3,9,Loyal Users
79616,252,13,134,3,3,4,10,Loyal Users
79617,45,94,217,5,5,5,15,Champions
79712,2293,5,19,1,1,2,4,Lost
79846,117,41,83,4,4,4,12,Champions
79922,39,15,52,5,3,3,11,Loyal Users
80021,2259,41,384,1,4,5,10,At Risk
80065,10,25,103,5,4,4,13,Champions
80072,141,48,55,4,5,3,12,Loyal Users
80367,986,17,25,2,3,2,7,Casual Users
80525,1802,5,11,1,1,1,3,Lost
80601,417,9,22,3,2,2,7,Casual Users
80853,28,60,114,5,5,4,14,Champions
81258,3932,5,12,1,1,1,3,Lost
81387,4001,10,16,1,2,2,5,Lost
81896,292,18,46,3,3,3,9,Loyal Users
82317,35,90,342,5,5,5,15,Champions
82389,4397,5,31,1,1,2,4,Lost
82460,34,27,102,5,4,4,13,Champions
83113,2444,6,14,1,1,1,3,Lost
83343,2712,6,10,1,1,1,3,Lost
83917,249,15,37,3,3,3,9,Loyal Users
83965,220,41,186,3,4,5,12,Loyal Users
84097,1723,10,15,1,2,1,4,Lost
84194,32,42,80,5,4,4,13,Champions
84211,25,27,146,5,4,4,13,Champions
84328,1,12,22,5,3,2,10,Loyal Users
84333,460,15,92,3,3,4,10,Loyal Users
84437,2,148,367,5,5,5,15,Champions
84446,3,51,255,5,5,5,15,Champions
85517,1244,16,36,2,3,3,8,Casual Users
85519,108,87,132,4,5,4,13,Champions
85753,356,32,68,3,4,4,11,Loyal Users
85809,420,28,49,3,4,3,10,Loyal Users
85813,152,33,92,4,4,4,12,Champions
86063,838,7,22,2,2,2,6,Lost
86281,142,14,21,4,3,2,9,Loyal Users
86887,253,15,44,3,3,3,9,Loyal Users
86978,284,10,127,3,2,4,9,Casual Users
87660,624,51,138,2,5,4,11,At Risk
88117,537,18,34,2,3,3,8,Casual Users
88314,12,20,28,5,3,2,10,Loyal Users
88579,94,99,337,4,5,5,14,Champions
88706,2809,10,39,1,2,3,6,Lost
88799,1323,5,29,1,1,2,4,Lost
88977,113,5,5,4,1,1,6,Promising
89327,120,86,385,4,5,5,14,Champions
89398,3887,16,36,1,3,3,7,Casual Users
89538,30,15,23,5,3,2,10,Loyal Users
89656,595,9,10,2,2,1,5,Lost
89713,427,5,6,3,1,1,5,Casual Users
89895,46,17,69,5,3,4,12,Loyal Users
90593,3392,6,8,1,1,1,3,Lost
90726,272,8,16,3,2,2,7,Casual Users
78341,621,11,56,2,2,3,7,Lost
78439,18,39,93,5,4,4,13,Champions
78589,1516,6,14,1,1,1,3,Lost
78953,249,33,75,3,4,4,11,Loyal Users
79036,655,8,10,2,2,1,5,Lost
79318,2144,5,5,1,1,1,3,Lost
79504,108,14,30,4,3,2,9,Loyal Users
79585,58,12,13,5,3,1,9,Loyal Users
79980,156,59,279,4,5,5,14,Champions
80376,292,12,17,3,3,2,8,Loyal Users
80529,508,8,14,2,2,1,5,Lost
80661,366,50,144,3,5,4,12,Loyal Users
80835,36,61,334,5,5,5,15,Champions
81238,240,21,59,3,3,3,9,Loyal Users
81239,1,30,54,5,4,3,12,Loyal Users
81241,46,72,347,5,5,5,15,Champions
81314,8,43,224,5,4,5,14,Champions
81838,263,50,81,3,5,4,12,Loyal Users
82059,461,10,65,3,2,4,9,Casual Users
82170,1011,5,16,2,1,2,5,Lost
82252,1488,19,80,1,3,4,8,Casual Users
82658,44,41,177,5,4,5,14,Champions
83018,148,20,35,4,3,3,10,Loyal Users
83120,76,7,9,4,2,1,7,Promising
83185,940,5,21,2,1,2,5,Lost
83310,1227,8,42,2,2,3,7,Lost
83728,373,8,20,3,2,2,7,Casual Users
83846,263,38,186,3,4,5,12,Loyal Users
83852,112,35,130,4,4,4,12,Champions
84395,275,6,13,3,1,1,5,Casual Users
84498,173,34,189,3,4,5,12,Loyal Users
84665,2018,12,28,1,3,2,6,Casual Users
84769,4,42,113,5,4,4,13,Champions
85053,12,23,82,5,4,4,13,Champions
85075,6,66,225,5,5,5,15,Champions
85090,813,23,109,2,4,4,10,At Risk
85361,176,15,161,3,3,5,11,Loyal Users
85391,154,42,70,4,4,4,12,Champions
86040,435,11,23,3,2,2,7,Casual Users
86493,215,19,46,3,3,3,9,Loyal Users
86844,783,8,71,2,2,4,8,Lost
87079,27,107,208,5,5,5,15,Champions
87095,2660,8,47,1,2,3,6,Lost
87136,250,78,502,3,5,5,13,Loyal Users
87149,2234,7,28,1,2,2,5,Lost
87481,4125,8,13,1,2,1,4,Lost
87504,59,69,293,5,5,5,15,Champions
87639,44,5,11,5,1,1,7,Promising
87687,1265,11,18,1,2,2,5,Lost
87797,46,63,120,5,5,4,14,Champions
87837,1360,15,34,1,3,3,7,Casual Users
88351,268,44,282,3,4,5,12,Loyal Users
88548,232,48,130,3,5,4,12,Loyal Users
88628,10,101,206,5,5,5,15,Champions
89082,205,31,62,3,4,3,10,Loyal Users
89137,65,5,12,5,1,1,7,Promising
89526,118,43,207,4,4,5,13,Champions
89613,581,7,8,2,2,1,5,Lost
89757,566,10,39,2,2,3,7,Lost
89961,1455,6,8,1,1,1,3,Lost
89971,117,20,56,4,3,3,10,Loyal Users
90013,3388,5,8,1,1,1,3,Lost
90159,270,18,26,3,3,2,8,Loyal Users
90198,871,16,45,2,3,3,8,Casual Users
90317,4178,8,72,1,2,4,7,Lost
90350,3011,5,10,1,1,1,3,Lost
90675,573,18,57,2,3,3,8,Casual Users
90855,52,61,99,5,5,4,14,Champions
90928,998,104,160,2,5,5,12,At Risk
78356,1270,8,15,1,2,1,4,Lost
78370,125,6,10,4,1,1,6,Promising
78426,36,160,466,5,5,5,15,Champions
78449,13,100,199,5,5,5,15,Champions
78468,199,11,33,3,2,3,8,Casual Users
78673,16,31,202,5,4,5,14,Champions
78697,17,88,180,5,5,5,15,Champions
79201,2477,6,73,1,1,4,6,Lost
79606,807,7,16,2,2,2,6,Lost
79909,293,8,26,3,2,2,7,Casual Users
80025,18,117,127,5,5,4,14,Champions
80063,20,30,89,5,4,4,13,Champions
80074,25,69,184,5,5,5,15,Champions
80959,2970,13,58,1,3,3,7,Casual Users
81066,508,5,6,2,1,1,4,Lost
81390,241,22,36,3,4,3,10,Loyal Users
82135,4,191,1038,5,5,5,15,Champions
82563,104,22,185,4,4,5,13,Champions
82768,53,104,587,5,5,5,15,Champions
82892,2170,6,8,1,1,1,3,Lost
83077,1073,11,11,2,2,1,5,Lost
83130,134,8,15,4,2,1,7,Promising
83235,978,7,7,2,2,1,5,Lost
83568,94,86,382,4,5,5,14,Champions
83932,437,38,115,3,4,4,11,Loyal Users
84407,41,103,147,5,5,5,15,Champions
84574,1108,14,24,2,3,2,7,Casual Users
84686,104,32,50,4,4,3,11,Loyal Users
85204,46,6,15,5,1,1,7,Promising
85208,149,9,36,4,2,3,9,Promising
85423,414,10,18,3,2,2,7,Casual Users
85786,526,20,34,2,3,3,8,Casual Users
85969,134,88,144,4,5,4,13,Champions
86136,372,19,35,3,3,3,9,Loyal Users
86363,30,53,187,5,5,5,15,Champions
86526,648,7,38,2,2,3,7,Lost
86565,30,22,52,5,4,3,12,Loyal Users
86902,910,30,45,2,4,3,9,At Risk
87051,1024,26,77,2,4,4,10,At Risk
87386,859,10,17,2,2,2,6,Lost
87453,4,12,75,5,3,4,12,Loyal Users
87454,420,11,43,3,2,3,8,Casual Users
87877,1080,20,40,2,3,3,8,Casual Users
87963,292,9,13,3,2,1,6,Casual Users
88010,94,45,151,4,4,5,13,Champions
88140,3636,11,45,1,2,3,6,Lost
88220,2,56,103,5,5,4,14,Champions
88951,3,120,245,5,5,5,15,Champions
89027,1261,8,17,1,2,2,5,Lost
89081,96,64,105,4,5,4,13,Champions
89099,5,28,40,5,4,3,12,Loyal Users
89136,129,121,231,4,5,5,14,Champions
89614,13,24,89,5,4,4,13,Champions
89734,688,8,21,2,2,2,6,Lost
89775,981,6,8,2,1,1,4,Lost
90253,4122,12,26,1,3,2,6,Casual Users
90337,737,8,11,2,2,1,5,Lost
90492,103,26,183,4,4,5,13,Champions
90512,65,9,30,5,2,2,9,Promising
90750,736,57,87,2,5,4,11,At Risk
90767,2596,8,20,1,2,2,5,Lost
90827,96,74,389,4,5,5,14,Champions
90960,169,14,20,3,3,2,8,Loyal Users
91053,22,15,66,5,3,4,12,Loyal Users
78311,11,55,104,5,5,4,14,Champions
78412,586,9,11,2,2,1,5,Lost
78754,971,8,29,2,2,2,6,Lost
79100,425,5,8,3,1,1,5,Casual Users
79153,7,16,28,5,3,2,10,Loyal Users
79177,102,22,151,4,4,5,13,Champions
79269,22,39,84,5,4,4,13,Champions
79324,746,5,51,2,1,3,6,Lost
79547,82,50,91,4,5,4,13,Champions
79841,126,78,213,4,5,5,14,Champions
79861,127,29,36,4,4,3,11,Loyal Users
80792,1008,5,6,2,1,1,4,Lost
80956,740,8,17,2,2,2,6,Lost
81056,694,26,45,2,4,3,9,At Risk
81358,994,25,55,2,4,3,9,At Risk
81698,2860,22,52,1,4,3,8,At Risk
81736,65,38,154,5,4,5,14,Champions
82092,811,5,5,2,1,1,4,Lost
82110,310,7,21,3,2,2,7,Casual Users
82189,606,22,49,2,4,3,9,At Risk
82257,1144,18,27,2,3,2,7,Casual Users
82916,57,15,182,5,3,5,13,Loyal Users
83004,85,215,520,4,5,5,14,Champions
83055,33,39,95,5,4,4,13,Champions
83060,71,49,189,4,5,5,14,Champions
83276,898,18,35,2,3,3,8,Casual Users
83398,116,127,264,4,5,5,14,Champions
83486,1808,8,14,1,2,1,4,Lost
83551,28,14,28,5,3,2,10,Loyal Users
83587,1,83,190,5,5,5,15,Champions
83692,50,38,73,5,4,4,13,Champions
84002,1,61,245,5,5,5,15,Champions
84679,788,15,90,2,3,4,9,Casual Users
84827,142,10,43,4,2,3,9,Promising
84931,811,5,6,2,1,1,4,Lost
85277,114,43,191,4,4,5,13,Champions
85344,149,64,115,4,5,4,13,Champions
85591,2854,15,26,1,3,2,6,Casual Users
85596,46,22,47,5,4,3,12,Loyal Users
85724,832,5,5,2,1,1,4,Lost
85856,114,25,41,4,4,3,11,Loyal Users
86286,822,15,50,2,3,3,8,Casual Users
86870,38,87,216,5,5,5,15,Champions
87005,669,9,39,2,2,3,7,Lost
87213,431,8,12,3,2,1,6,Casual Users
87292,360,24,66,3,4,4,11,Loyal Users
87542,114,27,37,4,4,3,11,Loyal Users
87807,2965,24,86,1,4,4,9,At Risk
88011,501,8,15,2,2,1,5,Lost
88175,445,17,21,3,3,2,8,Loyal Users
88302,39,88,128,5,5,4,14,Champions
88515,56,130,548,5,5,5,15,Champions
88780,112,91,302,4,5,5,14,Champions
89170,82,29,54,4,4,3,11,Loyal Users
89444,1023,6,14,2,1,1,4,Lost
89911,2996,7,11,1,2,1,4,Lost
90077,276,11,20,3,2,2,7,Casual Users
90308,416,9,14,3,2,1,6,Casual Users
90310,935,6,12,2,1,1,4,Lost
90486,3858,22,32,1,4,3,8,At Risk
78585,544,32,50,2,4,3,9,At Risk
78707,411,10,76,3,2,4,9,Casual Users
78895,1967,14,64,1,3,4,8,Casual Users
78997,993,5,13,2,1,1,4,Lost
79185,1,23,43,5,4,3,12,Loyal Users
79503,305,18,68,3,3,4,10,Loyal Users
79773,168,73,202,3,5,5,13,Loyal Users
79868,2837,8,12,1,2,1,4,Lost
79937,1678,11,14,1,2,1,4,Lost
79960,160,10,38,4,2,3,9,Promising
79970,219,9,30,3,2,2,7,Casual Users
79998,1244,57,184,2,5,5,12,At Risk
80060,407,5,14,3,1,1,5,Casual Users
80100,2088,8,38,1,2,3,6,Lost
80104,231,65,217,3,5,5,13,Loyal Users
80384,805,62,238,2,5,5,12,At Risk
80426,1233,27,48,2,4,3,9,At Risk
80864,12,29,80,5,4,4,13,Champions
81105,4742,6,12,1,1,1,3,Lost
81264,1047,13,17,2,3,2,7,Casual Users
81402,1797,5,24,1,1,2,4,Lost
81671,16,48,292,5,5,5,15,Champions
81677,67,12,19,5,3,2,10,Loyal Users
81709,24,116,710,5,5,5,15,Champions
81969,4445,5,5,1,1,1,3,Lost
82234,163,53,162,4,5,5,14,Champions
82692,3624,10,12,1,2,1,4,Lost
82946,1407,6,22,1,1,2,4,Lost
83107,24,176,492,5,5,5,15,Champions
83137,108,91,259,4,5,5,14,Champions
83599,75,28,80,4,4,4,12,Champions
83905,3749,8,17,1,2,2,5,Lost
84423,1817,19,238,1,3,5,9,Casual Users
84470,257,10,17,3,2,2,7,Casual Users
85121,464,6,9,3,1,1,5,Casual Users
85310,716,6,8,2,1,1,4,Lost
85894,834,7,21,2,2,2,6,Lost
86043,755,17,28,2,3,2,7,Casual Users
86067,437,6,19,3,1,2,6,Casual Users
86103,266,39,41,3,4,3,10,Loyal Users
86594,1977,5,10,1,1,1,3,Lost
86685,567,22,212,2,4,5,11,At Risk
86734,202,38,136,3,4,4,11,Loyal Users
86851,882,8,38,2,2,3,7,Lost
87063,74,30,92,4,4,4,12,Champions
87099,10,47,126,5,5,4,14,Champions
87165,122,17,54,4,3,3,10,Loyal Users
87279,3225,18,34,1,3,3,7,Casual Users
87558,273,16,71,3,3,4,10,Loyal Users
87832,118,12,59,4,3,3,10,Loyal Users
87881,23,188,435,5,5,5,15,Champions
87944,89,29,95,4,4,4,12,Champions
87965,5016,6,27,1,1,2,4,Lost
88003,22,14,51,5,3,3,11,Loyal Users
88286,4553,10,13,1,2,1,4,Lost
88637,1157,16,49,2,3,3,8,Casual Users
88848,416,16,34,3,3,3,9,Loyal Users
88895,79,61,209,4,5,5,14,Champions
89211,2550,20,152,1,3,5,9,Casual Users
89244,5239,6,6,1,1,1,3,Lost
89814,136,16,32,4,3,3,10,Loyal Users
90087,799,8,19,2,2,2,6,Lost
90399,687,28,52,2,4,3,9,At Risk
90417,3,13,104,5,3,4,12,Loyal Users
90554,146,19,32,4,3,3,10,Loyal Users
90673,1407,12,18,1,3,2,6,Casual Users
78405,714,14,16,2,3,2,7,Casual Users
78641,25,175,470,5,5,5,15,Champions
78827,117,112,171,4,5,5,14,Champions
79007,608,19,50,2,3,3,8,Casual Users
79087,2994,6,11,1,1,1,3,Lost
79374,2564,5,24,1,1,2,4,Lost
79831,130,10,23,4,2,2,8,Promising
80231,102,8,17,4,2,2,8,Promising
80425,1070,9,13,2,2,1,5,Lost
80629,2002,5,9,1,1,1,3,Lost
80755,1,70,262,5,5,5,15,Champions
80938,2556,8,24,1,2,2,5,Lost
81065,319,18,111,3,3,4,10,Loyal Users
81261,2997,26,34,1,4,3,8,At Risk
81503,3604,18,32,1,3,3,7,Casual Users
81515,1309,7,9,1,2,1,4,Lost
81618,5118,17,26,1,3,2,6,Casual Users
81635,81,57,100,4,5,4,13,Champions
81782,277,38,151,3,4,5,12,Loyal Users
81944,108,31,170,4,4,5,13,Champions
81973,74,43,204,4,4,5,13,Champions
82011,6,24,33,5,4,3,12,Loyal Users
82035,573,12,19,2,3,2,7,Casual Users
82268,125,49,63,4,5,4,13,Champions
82318,0,49,143,5,5,4,14,Champions
82713,271,27,68,3,4,4,11,Loyal Users
83257,0,13,107,5,3,4,12,Loyal Users
83512,87,31,107,4,4,4,12,Champions
83535,68,16,32,5,3,3,11,Loyal Users
83591,0,53,85,5,5,4,14,Champions
83714,109,11,53,4,2,3,9,Promising
83734,379,21,41,3,3,3,9,Loyal Users
83890,430,15,16,3,3,2,8,Loyal Users
84019,227,49,309,3,5,5,13,Loyal Users
84054,540,24,31,2,4,2,8,At Risk
84257,988,9,22,2,2,2,6,Lost
84862,534,24,178,2,4,5,11,At Risk
85164,147,18,43,4,3,3,10,Loyal Users
85300,850,15,80,2,3,4,9,Casual Users
85325,145,44,73,4,4,4,12,Champions
85762,1415,6,17,1,1,2,4,Lost
85827,5989,11,29,1,2,2,5,Lost
85901,2425,9,47,1,2,3,6,Lost
86168,2751,5,5,1,1,1,3,Lost
86257,133,6,27,4,1,2,7,Promising
86473,461,5,5,3,1,1,5,Casual Users
87140,2737,5,12,1,1,1,3,Lost
87264,118,6,9,4,1,1,6,Promising
87430,52,102,353,5,5,5,15,Champions
87544,1425,16,33,1,3,3,7,Casual Users
87755,0,31,71,5,4,4,13,Champions
88040,31,10,59,5,2,3,10,Promising
88257,753,28,109,2,4,4,10,At Risk
88472,400,6,6,3,1,1,5,Casual Users
88697,2213,5,10,1,1,1,3,Lost
89076,82,21,35,4,3,3,10,Loyal Users
89415,1959,30,53,1,4,3,8,At Risk
90062,1134,5,36,2,1,3,6,Lost
90256,676,10,29,2,2,2,6,Lost
90284,196,89,335,3,5,5,13,Loyal Users
90427,1,57,246,5,5,5,15,Champions
90434,1978,7,36,1,2,3,6,Lost
90519,126,13,135,4,3,4,11,Loyal Users
90546,1769,9,19,1,2,2,5,Lost
90837,822,15,34,2,3,3,8,Casual Users
78292,464,7,58,3,2,3,8,Casual Users
78393,694,21,111,2,3,4,9,Casual Users
78600,3,68,343,5,5,5,15,Champions
78690,4828,7,28,1,2,2,5,Lost
78979,504,8,19,2,2,2,6,Lost
78981,4259,57,148,1,5,5,11,At Risk
79386,460,10,25,3,2,2,7,Casual Users
79392,424,16,32,3,3,3,9,Loyal Users
79516,1329,6,20,1,1,2,4,Lost
79733,646,137,324,2,5,5,12,At Risk
79761,1108,12,25,2,3,2,7,Casual Users
80155,439,26,28,3,4,2,9,Loyal Users
80473,41,29,69,5,4,4,13,Champions
80474,3,106,528,5,5,5,15,Champions
80700,1491,7,7,1,2,1,4,Lost
81126,867,5,9,2,1,1,4,Lost
81243,101,32,53,4,4,3,11,Loyal Users
81302,240,7,42,3,2,3,8,Casual Users
81351,35,22,76,5,4,4,13,Champions
81426,5227,13,18,1,3,2,6,Casual Users
81644,104,83,504,4,5,5,14,Champions
81744,11,152,525,5,5,5,15,Champions
81819,584,22,50,2,4,3,9,At Risk
81924,1,62,228,5,5,5,15,Champions
82073,3846,9,39,1,2,3,6,Lost
82097,638,33,93,2,4,4,10,At Risk
82350,1684,6,20,1,1,2,4,Lost
82447,3401,6,8,1,1,1,3,Lost
82605,2546,8,13,1,2,1,4,Lost
82885,1029,6,11,2,1,1,4,Lost
83416,26,62,555,5,5,5,15,Champions
83703,568,16,27,2,3,2,7,Casual Users
83721,42,61,121,5,5,4,14,Champions
84159,1192,5,9,2,1,1,4,Lost
84312,4713,8,32,1,2,3,6,Lost
84387,36,41,109,5,4,4,13,Champions
84487,722,19,110,2,3,4,9,Casual Users
85637,90,88,154,4,5,5,14,Champions
85660,3,9,20,5,2,2,9,Promising
86229,132,19,129,4,3,4,11,Loyal Users
86355,4472,5,9,1,1,1,3,Lost
86376,830,7,11,2,2,1,5,Lost
86519,437,17,61,3,3,3,9,Loyal Users
86843,432,19,73,3,3,4,10,Loyal Users
86919,0,21,31,5,3,2,10,Loyal Users
87030,77,76,191,4,5,5,14,Champions
87173,144,14,50,4,3,3,10,Loyal Users
87526,272,12,115,3,3,4,10,Loyal Users
87764,42,8,11,5,2,1,8,Promising
87779,19,31,215,5,4,5,14,Champions
87780,2743,5,9,1,1,1,3,Lost
87884,303,10,15,3,2,1,6,Casual Users
88530,477,8,35,2,2,3,7,Lost
88635,12,6,28,5,1,2,8,Promising
89069,3007,6,28,1,1,2,4,Lost
89299,26,98,353,5,5,5,15,Champions
89494,152,5,6,4,1,1,6,Promising
89908,300,6,6,3,1,1,5,Casual Users
89977,720,6,7,2,1,1,4,Lost
90102,584,20,79,2,3,4,9,Casual Users
90683,41,107,526,5,5,5,15,Champions
78467,1,11,22,5,2,2,9,Promising
78482,126,10,83,4,2,4,10,Promising
78728,1154,6,16,2,1,2,5,Lost
78888,2696,9,18,1,2,2,5,Lost
79004,230,25,42,3,4,3,10,Loyal Users
79191,148,70,157,4,5,5,14,Champions
79351,429,9,15,3,2,1,6,Casual Users
79488,516,5,12,2,1,1,4,Lost
79513,304,16,35,3,3,3,9,Loyal Users
79533,3940,6,29,1,1,2,4,Lost
79636,1999,6,6,1,1,1,3,Lost
79717,9,40,193,5,4,5,14,Champions
80257,36,21,52,5,3,3,11,Loyal Users
80729,70,127,759,4,5,5,14,Champions
80748,408,7,20,3,2,2,7,Casual Users
80769,1148,39,114,2,4,4,10,At Risk
80986,50,84,412,5,5,5,15,Champions
81141,1161,12,37,2,3,3,8,Casual Users
81495,138,23,95,4,4,4,12,Champions
81573,570,5,5,2,1,1,4,Lost
81614,290,15,57,3,3,3,9,Loyal Users
81631,826,23,38,2,4,3,9,At Risk
81705,2689,5,10,1,1,1,3,Lost
81742,502,7,21,2,2,2,6,Lost
81811,0,97,289,5,5,5,15,Champions
81871,111,107,619,4,5,5,14,Champions
82656,1,24,65,5,4,4,13,Champions
82962,19,66,380,5,5,5,15,Champions
83038,7,30,71,5,4,4,13,Champions
83450,785,6,58,2,1,3,6,Lost
83738,5646,6,11,1,1,1,3,Lost
83741,46,5,6,5,1,1,7,Promising
83796,85,31,85,4,4,4,12,Champions
83875,3550,10,47,1,2,3,6,Lost
83933,146,7,9,4,2,1,7,Promising
84495,1078,23,104,2,4,4,10,At Risk
84551,10,20,56,5,3,3,11,Loyal Users
84734,2143,8,17,1,2,2,5,Lost
84935,2967,10,15,1,2,1,4,Lost
84989,544,49,197,2,5,5,12,At Risk
85048,2985,7,7,1,2,1,4,Lost
85199,28,12,17,5,3,2,10,Loyal Users
85498,380,87,291,3,5,5,13,Loyal Users
85540,396,46,95,3,5,4,12,Loyal Users
85605,262,68,150,3,5,5,13,Loyal Users
85783,2238,5,7,1,1,1,3,Lost
85902,876,12,30,2,3,2,7,Casual Users
86165,849,8,27,2,2,2,6,Lost
86186,1938,13,22,1,3,2,6,Casual Users
87093,566,21,40,2,3,3,8,Casual Users
87176,506,18,28,2,3,2,7,Casual Users
87577,44,5,8,5,1,1,7,Promising
87798,469,23,76,3,4,4,11,Loyal Users
87869,313,12,18,3,3,2,8,Loyal Users
88071,1133,13,51,2,3,3,8,Casual Users
88155,384,14,91,3,3,4,10,Loyal Users
88359,961,8,22,2,2,2,6,Lost
88534,1027,23,101,2,4,4,10,At Risk
88654,865,7,23,2,2,2,6,Lost
88671,92,14,36,4,3,3,10,Loyal Users
88914,121,26,47,4,4,3,11,Loyal Users
88975,282,34,129,3,4,4,11,Loyal Users
89245,269,31,90,3,4,4,11,Loyal Users
89360,2,233,704,5,5,5,15,Champions
89455,1991,8,8,1,2,1,4,Lost
89480,1463,12,22,1,3,2,6,Casual Users
89635,1157,13,18,2,3,2,7,Casual Users
89755,248,10,15,3,2,1,6,Casual Users
89992,1198,8,49,2,2,3,7,Lost
90154,149,40,160,4,4,5,13,Champions
90176,127,6,8,4,1,1,6,Promising
90429,5085,5,5,1,1,1,3,Lost
90792,434,52,214,3,5,5,13,Loyal Users
90909,1228,13,30,2,3,2,7,Casual Users
91003,1822,7,17,1,2,2,5,Lost
91040,337,16,40,3,3,3,9,Loyal Users
78296,18,120,406,5,5,5,15,Champions
78592,132,103,390,4,5,5,14,Champions
78866,673,17,41,2,3,3,8,Casual Users
79125,25,156,380,5,5,5,15,Champions
79355,424,5,24,3,1,2,6,Casual Users
79408,33,29,87,5,4,4,13,Champions
79607,89,107,536,4,5,5,14,Champions
79693,448,5,6,3,1,1,5,Casual Users
79946,255,111,296,3,5,5,13,Loyal Users
80147,25,69,366,5,5,5,15,Champions
80808,184,54,91,3,5,4,12,Loyal Users
80901,126,9,10,4,2,1,7,Promising
80918,3170,11,11,1,2,1,4,Lost
81005,104,37,104,4,4,4,12,Champions
81483,1694,33,66,1,4,4,9,At Risk
81525,30,8,55,5,2,3,10,Promising
81593,493,15,30,2,3,2,7,Casual Users
81805,152,5,5,4,1,1,6,Promising
81985,126,35,84,4,4,4,12,Champions
81997,1,22,146,5,4,4,13,Champions
82009,17,157,290,5,5,5,15,Champions
82174,394,18,27,3,3,2,8,Loyal Users
82557,374,5,5,3,1,1,5,Casual Users
82760,115,49,247,4,5,5,14,Champions
82947,2000,5,9,1,1,1,3,Lost
83122,2096,15,32,1,3,3,7,Casual Users
83647,358,14,50,3,3,3,9,Loyal Users
83657,84,20,36,4,3,3,10,Loyal Users
83771,11,29,229,5,4,5,14,Champions
84104,2131,23,50,1,4,3,8,At Risk
84133,2960,8,12,1,2,1,4,Lost
84443,276,38,112,3,4,4,11,Loyal Users
84892,2,116,322,5,5,5,15,Champions
85246,977,35,71,2,4,4,10,At Risk
85659,3501,5,44,1,1,3,5,Lost
85745,133,34,203,4,4,5,13,Champions
86153,3270,8,40,1,2,3,6,Lost
86311,1221,41,263,2,4,5,11,At Risk
86545,202,10,41,3,2,3,8,Casual Users
86584,276,19,33,3,3,3,9,Loyal Users
86621,119,7,31,4,2,2,8,Promising
86639,1515,5,12,1,1,1,3,Lost
86690,7,90,317,5,5,5,15,Champions
87113,182,29,59,3,4,3,10,Loyal Users
87127,253,73,154,3,5,5,13,Loyal Users
87194,106,68,162,4,5,5,14,Champions
87215,1017,9,21,2,2,2,6,Lost
87359,533,14,47,2,3,3,8,Casual Users
87406,493,9,29,2,2,2,6,Lost
88030,450,25,83,3,4,4,11,Loyal Users
88121,631,20,147,2,3,5,10,Casual Users
88197,2934,8,82,1,2,4,7,Lost
88281,19,58,240,5,5,5,15,Champions
88473,296,9,16,3,2,2,7,Casual Users
88536,294,64,178,3,5,5,13,Loyal Users
88847,406,21,96,3,3,4,10,Loyal Users
88929,579,8,9,2,2,1,5,Lost
88984,2412,17,78,1,3,4,8,Casual Users
89171,103,15,53,4,3,3,10,Loyal Users
89333,5,62,230,5,5,5,15,Champions
89520,135,47,95,4,5,4,13,Champions
89700,666,53,170,2,5,5,12,At Risk
90291,4150,5,32,1,1,3,5,Lost
90302,459,7,68,3,2,4,9,Casual Users
90315,822,8,129,2,2,4,8,Lost
90478,3014,5,8,1,1,1,3,Lost
90746,82,9,33,4,2,3,9,Promising
78295,876,7,22,2,2,2,6,Lost
78514,825,21,61,2,3,3,8,Casual Users
78868,98,31,77,4,4,4,12,Champions
78893,524,11,13,2,2,1,5,Lost
79429,5821,7,16,1,2,2,5,Lost
79650,406,19,90,3,3,4,10,Loyal Users
79790,1829,5,9,1,1,1,3,Lost
79904,70,14,56,4,3,3,10,Loyal Users
80036,282,34,43,3,4,3,10,Loyal Users
80111,409,24,43,3,4,3,10,Loyal Users
80167,839,9,15,2,2,1,5,Lost
80183,71,36,205,4,4,5,13,Champions
80287,138,5,9,4,1,1,6,Promising
80553,2426,7,16,1,2,2,5,Lost
80609,268,31,100,3,4,4,11,Loyal Users
80665,976,11,33,2,2,3,7,Lost
80686,58,129,574,5,5,5,15,Champions
80855,317,10,34,3,2,3,8,Casual Users
81263,0,16,32,5,3,3,11,Loyal Users
81267,1636,25,59,1,4,3,8,At Risk
81321,859,16,71,2,3,4,9,Casual Users
81468,117,23,83,4,4,4,12,Champions
81583,108,83,260,4,5,5,14,Champions
82212,112,8,21,4,2,2,8,Promising
82334,263,9,18,3,2,2,7,Casual Users
82345,1825,10,14,1,2,1,4,Lost
83025,94,32,86,4,4,4,12,Champions
83524,421,7,26,3,2,2,7,Casual Users
84401,1462,8,12,1,2,1,4,Lost
84834,167,35,92,3,4,4,11,Loyal Users
85080,56,78,203,5,5,5,15,Champions
85081,305,20,30,3,3,2,8,Loyal Users
85198,1743,38,48,1,4,3,8,At Risk
85213,128,18,120,4,3,4,11,Loyal Users
85229,117,20,140,4,3,4,11,Loyal Users
85289,108,48,187,4,5,5,14,Champions
85725,1288,10,14,1,2,1,4,Lost
85826,523,15,22,2,3,2,7,Casual Users
86052,4298,5,12,1,1,1,3,Lost
86112,418,20,55,3,3,3,9,Loyal Users
86648,125,6,34,4,1,3,8,Promising
86695,104,121,666,4,5,5,14,Champions
86840,722,8,21,2,2,2,6,Lost
87004,415,55,196,3,5,5,13,Loyal Users
87401,44,8,16,5,2,2,9,Promising
87476,305,61,185,3,5,5,13,Loyal Users
88128,477,13,55,2,3,3,8,Casual Users
89031,3825,5,33,1,1,3,5,Lost
89066,1127,15,37,2,3,3,8,Casual Users
89187,11,106,375,5,5,5,15,Champions
89209,1236,6,25,2,1,2,5,Lost
89586,2730,9,31,1,2,2,5,Lost
89742,1191,5,17,2,1,2,5,Lost
89812,1701,13,48,1,3,3,7,Casual Users
89880,90,37,78,4,4,4,12,Champions
89944,94,54,301,4,5,5,14,Champions
89997,626,9,28,2,2,2,6,Lost
90065,1146,9,10,2,2,1,5,Lost
90178,613,32,56,2,4,3,9,At Risk
90499,857,16,117,2,3,4,9,Casual Users
90615,3691,6,8,1,1,1,3,Lost
78342,955,14,41,2,3,3,8,Casual Users
78379,291,52,288,3,5,5,13,Loyal Users
78624,52,58,146,5,5,4,14,Champions
79412,258,8,45,3,2,3,8,Casual Users
79661,9,144,264,5,5,5,15,Champions
79796,2714,26,60,1,4,3,8,At Risk
80101,127,28,83,4,4,4,12,Champions
80159,538,12,16,2,3,2,7,Casual Users
80588,1876,5,5,1,1,1,3,Lost
80606,1461,7,12,1,2,1,4,Lost
80709,4,12,68,5,3,4,12,Loyal Users
80752,477,9,71,2,2,4,8,Lost
80859,623,7,11,2,2,1,5,Lost
80890,29,41,150,5,4,5,14,Champions
81096,289,38,48,3,4,3,10,Loyal Users
81130,2845,6,8,1,1,1,3,Lost
81184,160,5,7,4,1,1,6,Promising
81251,8,53,132,5,5,4,14,Champions
81334,102,78,131,4,5,4,13,Champions
81993,72,12,41,4,3,3,10,Loyal Users
81996,377,30,44,3,4,3,10,Loyal Users
82025,4153,8,26,1,2,2,5,Lost
82137,1,123,736,5,5,5,15,Champions
82194,66,120,297,5,5,5,15,Champions
82199,8,73,120,5,5,4,14,Champions
82776,449,23,125,3,4,4,11,Loyal Users
83210,728,5,24,2,1,2,5,Lost
83363,2722,7,14,1,2,1,4,Lost
83894,839,5,8,2,1,1,4,Lost
83963,4,60,439,5,5,5,15,Champions
84077,422,5,5,3,1,1,5,Casual Users
84252,2514,6,10,1,1,1,3,Lost
84360,1413,30,143,1,4,4,9,At Risk
84378,1265,27,59,1,4,3,8,At Risk
84462,385,22,53,3,4,3,10,Loyal Users
84766,861,34,45,2,4,3,9,At Risk
84781,399,21,37,3,3,3,9,Loyal Users
85045,5,156,417,5,5,5,15,Champions
85526,49,122,395,5,5,5,15,Champions
85692,92,50,67,4,5,4,13,Champions
85755,53,73,140,5,5,4,14,Champions
85795,831,13,63,2,3,4,9,Casual Users
85885,1819,6,28,1,1,2,4,Lost
86021,1035,33,128,2,4,4,10,At Risk
86196,381,6,19,3,1,2,6,Casual Users
86455,255,89,153,3,5,5,13,Loyal Users
86749,134,12,17,4,3,2,9,Loyal Users
86826,369,42,273,3,4,5,12,Loyal Users
86858,15,13,84,5,3,4,12,Loyal Users
86883,141,35,97,4,4,4,12,Champions
86992,1073,26,81,2,4,4,10,At Risk
87206,26,9,20,5,2,2,9,Promising
87258,5,21,84,5,3,4,12,Loyal Users
88520,852,5,7,2,1,1,4,Lost
88607,1907,9,10,1,2,1,4,Lost
88803,501,115,216,2,5,5,12,At Risk
89152,4932,8,9,1,2,1,4,Lost
89169,285,43,130,3,4,4,11,Loyal Users
89246,168,13,137,3,3,4,10,Loyal Users
89505,1273,6,29,1,1,2,4,Lost
89535,1870,8,21,1,2,2,5,Lost
89657,1630,5,5,1,1,1,3,Lost
90533,11,112,377,5,5,5,15,Champions
90622,2726,6,16,1,1,2,4,Lost
90787,124,17,55,4,3,3,10,Loyal Users
90934,130,68,233,4,5,5,14,Champions
78291,22,6,14,5,1,1,7,Promising
78623,139,18,122,4,3,4,11,Loyal Users
78698,441,7,18,3,2,2,7,Casual Users
79157,1552,8,10,1,2,1,4,Lost
79240,985,17,43,2,3,3,8,Casual Users
79356,382,6,45,3,1,3,7,Casual Users
79447,1014,39,52,2,4,3,9,At Risk
79688,464,7,10,3,2,1,6,Casual Users
80087,33,57,124,5,5,4,14,Champions
80262,847,11,15,2,2,1,5,Lost
80264,1289,12,45,1,3,3,7,Casual Users
80329,1129,5,13,2,1,1,4,Lost
80557,2211,20,57,1,3,3,7,Casual Users
80676,2881,13,36,1,3,3,7,Casual Users
80991,165,66,293,4,5,5,14,Champions
81046,51,94,199,5,5,5,15,Champions
81211,1443,6,23,1,1,2,4,Lost
81232,113,73,416,4,5,5,14,Champions
81372,13,99,164,5,5,5,15,Champions
81540,28,6,21,5,1,2,8,Promising
81670,79,71,213,4,5,5,14,Champions
81751,311,18,50,3,3,3,9,Loyal Users
82297,1694,7,15,1,2,1,4,Lost
82791,2847,6,12,1,1,1,3,Lost
82893,1111,5,7,2,1,1,4,Lost
82896,82,17,112,4,3,4,11,Loyal Users
83089,298,103,118,3,5,4,12,Loyal Users
83602,3469,16,107,1,3,4,8,Casual Users
83689,108,48,62,4,5,3,12,Loyal Users
83943,20,61,142,5,5,4,14,Champions
84005,3381,12,54,1,3,3,7,Casual Users
84030,301,19,77,3,3,4,10,Loyal Users
84330,1528,5,5,1,1,1,3,Lost
84340,112,142,565,4,5,5,14,Champions
84385,8,40,185,5,4,5,14,Champions
84841,262,21,52,3,3,3,9,Loyal Users
84955,381,44,56,3,4,3,10,Loyal Users
85150,1459,13,16,1,3,2,6,Casual Users
85410,428,5,5,3,1,1,5,Casual Users
86289,0,172,388,5,5,5,15,Champions
86889,436,24,56,3,4,3,10,Loyal Users
86925,253,69,125,3,5,4,12,Loyal Users
86988,236,29,66,3,4,4,11,Loyal Users
87220,94,114,226,4,5,5,14,Champions
87355,5,53,399,5,5,5,15,Champions
87424,249,43,112,3,4,4,11,Loyal Users
87449,140,8,18,4,2,2,8,Promising
87529,4429,5,39,1,1,3,5,Lost
87592,1030,20,62,2,3,3,8,Casual Users
87756,14,139,573,5,5,5,15,Champions
88335,1172,41,100,2,4,4,10,At Risk
88533,262,14,18,3,3,2,8,Loyal Users
88633,151,42,66,4,4,4,12,Champions
88658,3814,16,25,1,3,2,6,Casual Users
88659,121,69,124,4,5,4,13,Champions
88786,5232,5,10,1,1,1,3,Lost
89015,157,26,54,4,4,3,11,Loyal Users
89026,13,49,103,5,5,4,14,Champions
89186,482,49,256,2,5,5,12,At Risk
89371,256,47,73,3,5,4,12,Loyal Users
89410,2470,12,20,1,3,2,6,Casual Users
89808,552,26,122,2,4,4,10,At Risk
90222,410,20,92,3,3,4,10,Loyal Users
90305,292,80,226,3,5,5,13,Loyal Users
90671,45,28,108,5,4,4,13,Champions
90714,822,14,31,2,3,2,7,Casual Users
90728,8,62,402,5,5,5,15,Champions
90730,623,5,48,2,1,3,6,Lost
91011,92,33,54,4,4,3,11,Loyal Users
91031,3041,5,22,1,1,2,4,Lost
78422,355,32,70,3,4,4,11,Loyal Users
78543,568,9,19,2,2,2,6,Lost
78849,565,17,102,2,3,4,9,Casual Users
79017,1557,41,63,1,4,4,9,At Risk
79343,2264,5,8,1,1,1,3,Lost
79582,2254,9,41,1,2,3,6,Lost
79906,3702,37,87,1,4,4,9,At Risk
80109,3128,12,22,1,3,2,6,Casual Users
80507,21,39,90,5,4,4,13,Champions
80664,1784,9,14,1,2,1,4,Lost
80922,24,19,31,5,3,2,10,Loyal Users
81090,116,22,38,4,4,3,11,Loyal Users
81310,14,131,614,5,5,5,15,Champions
81556,2006,8,26,1,2,2,5,Lost
82015,11,114,219,5,5,5,15,Champions
82783,150,112,234,4,5,5,14,Champions
82827,446,14,85,3,3,4,10,Loyal Users
82906,98,14,35,4,3,3,10,Loyal Users
82972,70,18,36,4,3,3,10,Loyal Users
83029,604,18,22,2,3,2,7,Casual Users
83064,0,41,109,5,4,4,13,Champions
83144,9,80,337,5,5,5,15,Champions
83353,3576,8,24,1,2,2,5,Lost
83480,244,8,29,3,2,2,7,Casual Users
83609,139,12,30,4,3,2,9,Loyal Users
83697,292,6,13,3,1,1,5,Casual Users
83745,981,9,15,2,2,1,5,Lost
83989,0,10,23,5,2,2,9,Promising
84131,1127,6,6,2,1,1,4,Lost
84277,12,36,48,5,4,3,12,Loyal Users
84283,315,20,85,3,3,4,10,Loyal Users
84845,1441,6,8,1,1,1,3,Lost
84971,1373,25,28,1,4,2,7,At Risk
85115,284,5,17,3,1,2,6,Casual Users
85281,167,9,15,3,2,1,6,Casual Users
85420,1710,8,22,1,2,2,5,Lost
85937,272,23,51,3,4,3,10,Loyal Users
85957,92,47,374,4,5,5,14,Champions
86065,1272,11,50,1,2,3,6,Lost
86118,77,9,68,4,2,4,10,Promising
86269,857,21,104,2,3,4,9,Casual Users
86703,869,7,30,2,2,2,6,Lost
86986,84,55,253,4,5,5,14,Champions
86998,82,16,112,4,3,4,11,Loyal Users
87234,2444,5,13,1,1,1,3,Lost
87723,1403,6,39,1,1,3,5,Lost
87829,46,65,229,5,5,5,15,Champions
88348,247,60,301,3,5,5,13,Loyal Users
88357,1576,10,23,1,2,2,5,Lost
88403,113,27,184,4,4,5,13,Champions
88992,1415,8,9,1,2,1,4,Lost
89063,3113,18,56,1,3,3,7,Casual Users
89101,695,8,10,2,2,1,5,Lost
89458,37,109,463,5,5,5,15,Champions
89759,2177,14,23,1,3,2,6,Casual Users
89869,842,8,39,2,2,3,7,Lost
90027,108,99,426,4,5,5,14,Champions
90488,825,9,21,2,2,2,6,Lost
90516,150,25,81,4,4,4,12,Champions
90719,88,36,230,4,4,5,13,Champions
90908,3621,8,17,1,2,2,5,Lost
78306,1212,5,11,2,1,1,4,Lost
78646,37,6,22,5,1,2,8,Promising
79459,1002,12,19,2,3,2,7,Casual Users
79914,13,90,304,5,5,5,15,Champions
80265,1399,7,19,1,2,2,5,Lost
80487,273,54,85,3,5,4,12,Loyal Users
80520,957,111,566,2,5,5,12,At Risk
80833,19,62,177,5,5,5,15,Champions
80926,624,25,45,2,4,3,9,At Risk
80950,1001,5,6,2,1,1,4,Lost
81407,1415,8,34,1,2,3,6,Lost
81431,145,42,118,4,4,4,12,Champions
81553,32,32,62,5,4,3,12,Loyal Users
81808,252,12,52,3,3,3,9,Loyal Users
82121,622,21,43,2,3,3,8,Casual Users
82310,48,120,432,5,5,5,15,Champions
82593,128,16,93,4,3,4,11,Loyal Users
82640,93,104,270,4,5,5,14,Champions
82664,58,14,37,5,3,3,11,Loyal Users
83195,179,9,28,3,2,2,7,Casual Users
83362,14,60,228,5,5,5,15,Champions
83434,984,28,49,2,4,3,9,At Risk
83879,418,9,17,3,2,2,7,Casual Users
84023,131,36,78,4,4,4,12,Champions
84052,2521,26,50,1,4,3,8,At Risk
84083,5,45,83,5,4,4,13,Champions
84229,1112,8,14,2,2,1,5,Lost
84263,406,29,137,3,4,4,11,Loyal Users
84332,73,57,138,4,5,4,13,Champions
84676,401,8,10,3,2,1,6,Casual Users
84821,805,76,172,2,5,5,12,At Risk
85143,1684,7,26,1,2,2,5,Lost
85319,240,27,48,3,4,3,10,Loyal Users
85466,40,8,106,5,2,4,11,Promising
85808,75,125,508,4,5,5,14,Champions
85868,992,22,77,2,4,4,10,At Risk
85984,0,74,176,5,5,5,15,Champions
86089,2069,12,74,1,3,4,8,Casual Users
86121,4298,8,19,1,2,2,5,Lost
86267,498,25,93,2,4,4,10,At Risk
86869,53,9,17,5,2,2,9,Promising
86991,81,34,192,4,4,5,13,Champions
87067,277,11,69,3,2,4,9,Casual Users
87122,145,15,33,4,3,3,10,Loyal Users
87256,723,38,90,2,4,4,10,At Risk
87391,651,24,53,2,4,3,9,At Risk
87743,86,132,214,4,5,5,14,Champions
88205,811,6,9,2,1,1,4,Lost
88259,39,179,217,5,5,5,15,Champions
88323,5731,8,53,1,2,3,6,Lost
88581,1290,10,60,1,2,3,6,Lost
88982,3554,6,6,1,1,1,3,Lost
89472,30,111,365,5,5,5,15,Champions
89521,1590,33,64,1,4,4,9,At Risk
89637,2434,7,10,1,2,1,4,Lost
90126,2530,5,6,1,1,1,3,Lost
90342,0,100,180,5,5,5,15,Champions
78313,120,32,64,4,4,4,12,Champions
78614,144,30,109,4,4,4,12,Champions
78691,5433,25,61,1,4,3,8,At Risk
79018,222,13,53,3,3,3,9,Loyal Users
79908,157,21,117,4,3,4,11,Loyal Users
80077,665,18,145,2,3,4,9,Casual Users
80573,419,21,55,3,3,3,9,Loyal Users
80626,6,176,562,5,5,5,15,Champions
80699,413,10,49,3,2,3,8,Casual Users
81160,53,25,95,5,4,4,13,Champions
81479,3551,7,8,1,2,1,4,Lost
81826,103,8,56,4,2,3,9,Promising
81863,451,6,8,3,1,1,5,Casual Users
82176,3651,5,10,1,1,1,3,Lost
82221,423,47,178,3,5,5,13,Loyal Users
82307,128,19,222,4,3,5,12,Loyal Users
82819,4,55,125,5,5,4,14,Champions
82851,26,102,260,5,5,5,15,Champions
83299,125,112,398,4,5,5,14,Champions
83328,173,8,16,3,2,2,7,Casual Users
83552,1147,20,35,2,3,3,8,Casual Users
83713,1368,7,13,1,2,1,4,Lost
83748,2,196,285,5,5,5,15,Champions
84117,382,97,293,3,5,5,13,Loyal Users
84166,286,10,26,3,2,2,7,Casual Users
84493,452,11,21,3,2,2,7,Casual Users
84865,125,91,431,4,5,5,14,Champions
84875,111,20,31,4,3,2,9,Loyal Users
85027,155,10,11,4,2,1,7,Promising
85716,438,22,31,3,4,2,9,Loyal Users
85913,11,50,97,5,5,4,14,Champions
85931,362,12,57,3,3,3,9,Loyal Users
85979,91,32,162,4,4,5,13,Champions
86418,26,59,215,5,5,5,15,Champions
87088,460,5,9,3,1,1,5,Casual Users
87181,38,27,51,5,4,3,12,Loyal Users
87238,1116,20,80,2,3,4,9,Casual Users
87248,131,15,125,4,3,4,11,Loyal Users
87316,171,5,6,3,1,1,5,Casual Users
87414,124,116,502,4,5,5,14,Champions
87427,256,15,87,3,3,4,10,Loyal Users
87935,9,5,7,5,1,1,7,Promising
88013,296,70,147,3,5,5,13,Loyal Users
88188,12,92,478,5,5,5,15,Champions
88528,3369,9,13,1,2,1,4,Lost
89103,117,7,13,4,2,1,7,Promising
89387,105,84,99,4,5,4,13,Champions
89642,951,7,8,2,2,1,5,Lost
89654,2835,8,8,1,2,1,4,Lost
90045,79,128,411,4,5,5,14,Champions
90051,1881,7,13,1,2,1,4,Lost
90071,267,11,11,3,2,1,6,Casual Users
90080,15,55,73,5,5,4,14,Champions
90173,1004,11,27,2,2,2,6,Lost
90316,2329,5,5,1,1,1,3,Lost
90349,1102,10,10,2,2,1,5,Lost
90618,1003,11,23,2,2,2,6,Lost
90866,46,175,533,5,5,5,15,Champions
90964,14,90,175,5,5,5,15,Champions
90971,1954,5,9,1,1,1,3,Lost
90983,577,9,18,2,2,2,6,Lost
78284,118,57,111,4,5,4,13,Champions
78509,80,35,94,4,4,4,12,Champions
78631,1195,24,49,2,4,3,9,At Risk
79295,4445,6,20,1,1,2,4,Lost
79482,4743,13,15,1,3,1,5,Casual Users
79519,711,22,103,2,4,4,10,At Risk
79554,3126,11,31,1,2,2,5,Lost
79695,92,25,71,4,4,4,12,Champions
79901,23,68,333,5,5,5,15,Champions
79913,412,11,13,3,2,1,6,Casual Users
80003,70,20,125,4,3,4,11,Loyal Users
80039,6138,67,88,1,5,4,10,At Risk
80244,133,6,13,4,1,1,6,Promising
80589,2403,8,18,1,2,2,5,Lost
80961,11,57,145,5,5,4,14,Champions
80972,1979,5,5,1,1,1,3,Lost
81115,151,23,32,4,4,3,11,Loyal Users
81555,832,5,8,2,1,1,4,Lost
81753,1,181,654,5,5,5,15,Champions
81807,2084,8,22,1,2,2,5,Lost
81891,161,14,66,4,3,4,11,Loyal Users
81903,2363,10,27,1,2,2,5,Lost
82063,1849,14,22,1,3,2,6,Casual Users
82292,909,55,63,2,5,4,11,At Risk
82594,4,137,582,5,5,5,15,Champions
82650,143,50,90,4,5,4,13,Champions
82712,4539,8,15,1,2,1,4,Lost
82903,1606,5,16,1,1,2,4,Lost
83196,1950,53,118,1,5,4,10,At Risk
83617,110,8,10,4,2,1,7,Promising
83666,4644,12,23,1,3,2,6,Casual Users
84607,3560,7,13,1,2,1,4,Lost
84680,205,12,22,3,3,2,8,Loyal Users
84691,122,89,442,4,5,5,14,Champions
84757,1979,10,29,1,2,2,5,Lost
84762,2,120,529,5,5,5,15,Champions
84783,106,5,5,4,1,1,6,Promising
85035,2541,6,26,1,1,2,4,Lost
85231,3579,16,21,1,3,2,6,Casual Users
85232,23,21,41,5,3,3,11,Loyal Users
85661,365,8,16,3,2,2,7,Casual Users
85854,2662,5,6,1,1,1,3,Lost
86094,1001,5,16,2,1,2,5,Lost
86188,1847,28,41,1,4,3,8,At Risk
86461,133,7,8,4,2,1,7,Promising
86634,1160,5,9,2,1,1,4,Lost
86752,124,74,407,4,5,5,14,Champions
87009,2020,21,35,1,3,3,7,Casual Users
87804,984,36,51,2,4,3,9,At Risk
87951,2859,27,42,1,4,3,8,At Risk
87992,740,5,5,2,1,1,4,Lost
88095,28,8,48,5,2,3,10,Promising
88301,1425,7,11,1,2,1,4,Lost
88325,568,28,55,2,4,3,9,At Risk
88584,35,7,46,5,2,3,10,Promising
88722,122,8,52,4,2,3,9,Promising
89218,1104,33,198,2,4,5,11,At Risk
89631,4599,5,6,1,1,1,3,Lost
90036,131,10,20,4,2,2,8,Promising
90239,12,133,315,5,5,5,15,Champions
90359,4,43,49,5,4,3,12,Loyal Users
90458,2969,6,16,1,1,2,4,Lost
90831,1658,16,31,1,3,2,6,Casual Users
78446,402,25,45,3,4,3,10,Loyal Users
78650,333,8,14,3,2,1,6,Casual Users
78718,803,7,13,2,2,1,5,Lost
78779,1738,8,27,1,2,2,5,Lost
78792,998,48,119,2,5,4,11,At Risk
78880,143,42,104,4,4,4,12,Champions
79054,438,10,41,3,2,3,8,Casual Users
79657,10,81,209,5,5,5,15,Champions
79993,61,15,52,5,3,3,11,Loyal Users
80510,118,51,111,4,5,4,13,Champions
80874,2304,5,7,1,1,1,3,Lost
81098,2717,8,10,1,2,1,4,Lost
81279,30,14,121,5,3,4,12,Loyal Users
81558,122,33,88,4,4,4,12,Champions
81719,2399,5,48,1,1,3,5,Lost
81818,21,35,51,5,4,3,12,Loyal Users
82053,2990,10,60,1,2,3,6,Lost
82574,284,8,43,3,2,3,8,Casual Users
82697,129,12,13,4,3,1,8,Loyal Users
82769,174,135,572,3,5,5,13,Loyal Users
82801,9,15,33,5,3,3,11,Loyal Users
82879,0,65,279,5,5,5,15,Champions
82981,1644,19,21,1,3,2,6,Casual Users
83050,223,19,78,3,3,4,10,Loyal Users
83213,363,42,164,3,4,5,12,Loyal Users
83266,399,13,24,3,3,2,8,Loyal Users
83360,3882,5,5,1,1,1,3,Lost
84341,371,6,15,3,1,1,5,Casual Users
84375,417,7,7,3,2,1,6,Casual Users
85146,838,18,38,2,3,3,8,Casual Users
85175,41,45,107,5,4,4,13,Champions
85556,126,46,68,4,5,4,13,Champions
85824,1548,6,11,1,1,1,3,Lost
86132,264,16,144,3,3,4,10,Loyal Users
86469,79,144,340,4,5,5,14,Champions
86518,697,9,15,2,2,1,5,Lost
86653,994,13,26,2,3,2,7,Casual Users
86682,269,43,296,3,4,5,12,Loyal Users
86759,1382,6,19,1,1,2,4,Lost
86881,26,23,73,5,4,4,13,Champions
87298,783,5,80,2,1,4,7,Lost
87378,1886,7,43,1,2,3,6,Lost
87459,526,18,32,2,3,3,8,Casual Users
87534,108,16,26,4,3,2,9,Loyal Users
87580,5,29,57,5,4,3,12,Loyal Users
87635,698,9,24,2,2,2,6,Lost
87873,459,13,20,3,3,2,8,Loyal Users
88245,2414,9,48,1,2,3,6,Lost
88526,19,7,76,5,2,4,11,Promising
88572,569,24,66,2,4,4,10,At Risk
89351,6,19,90,5,3,4,12,Loyal Users
89558,215,9,41,3,2,3,8,Casual Users
90269,104,20,113,4,3,4,11,Loyal Users
90281,491,7,20,2,2,2,6,Lost
90539,541,17,42,2,3,3,8,Casual Users
78452,8,79,125,5,5,4,14,Champions
78836,1432,6,10,1,1,1,3,Lost
78889,101,96,148,4,5,5,14,Champions
78963,1091,49,343,2,5,5,12,At Risk
79084,515,28,45,2,4,3,9,At Risk
79372,1074,13,16,2,3,2,7,Casual Users
79414,1755,39,220,1,4,5,10,At Risk
80162,122,22,46,4,4,3,11,Loyal Users
80330,384,51,213,3,5,5,13,Loyal Users
80371,554,7,13,2,2,1,5,Lost
80551,155,21,54,4,3,3,10,Loyal Users
80568,113,146,653,4,5,5,14,Champions
80710,106,45,91,4,4,4,12,Champions
80921,12,120,432,5,5,5,15,Champions
81008,489,17,110,2,3,4,9,Casual Users
81196,162,17,94,4,3,4,11,Loyal Users
81669,315,38,98,3,4,4,11,Loyal Users
81833,72,42,98,4,4,4,12,Champions
81930,774,15,93,2,3,4,9,Casual Users
81966,852,24,45,2,4,3,9,At Risk
82002,2228,11,13,1,2,1,4,Lost
82270,38,13,13,5,3,1,9,Loyal Users
82442,5012,6,7,1,1,1,3,Lost
82729,665,7,20,2,2,2,6,Lost
82934,150,29,83,4,4,4,12,Champions
83032,4238,5,10,1,1,1,3,Lost
83226,421,38,47,3,4,3,10,Loyal Users
83588,169,25,69,3,4,4,11,Loyal Users
83967,703,6,50,2,1,3,6,Lost
83985,3164,26,67,1,4,4,9,At Risk
84697,715,37,53,2,4,3,9,At Risk
84814,577,10,24,2,2,2,6,Lost
84910,413,11,30,3,2,2,7,Casual Users
85135,87,72,97,4,5,4,13,Champions
85399,173,8,35,3,2,3,8,Casual Users
85768,1106,15,27,2,3,2,7,Casual Users
86242,946,86,409,2,5,5,12,At Risk
86299,780,12,12,2,3,1,6,Casual Users
86500,697,7,7,2,2,1,5,Lost
86807,239,48,205,3,5,5,13,Loyal Users
86824,37,12,24,5,3,2,10,Loyal Users
87246,1314,12,50,1,3,3,7,Casual Users
87307,265,12,28,3,3,2,8,Loyal Users
87322,65,16,26,5,3,2,10,Loyal Users
87617,67,14,49,5,3,3,11,Loyal Users
87658,1,68,145,5,5,4,14,Champions
87923,25,41,167,5,4,5,14,Champions
87938,41,101,156,5,5,5,15,Champions
87995,1151,21,77,2,3,4,9,Casual Users
88038,583,52,79,2,5,4,11,At Risk
88434,280,23,109,3,4,4,11,Loyal Users
88727,365,19,76,3,3,4,10,Loyal Users
88738,123,107,490,4,5,5,14,Champions
88824,405,49,159,3,5,5,13,Loyal Users
89978,5875,14,26,1,3,2,6,Casual Users
90028,1194,24,31,2,4,2,8,At Risk
90266,988,6,14,2,1,1,4,Lost
90391,8,30,67,5,4,4,13,Champions
90468,107,10,60,4,2,3,9,Promising
90583,954,25,44,2,4,3,9,At Risk
90620,130,104,194,4,5,5,14,Champions
90913,70,55,176,4,5,5,14,Champions
78569,1762,5,22,1,1,2,4,Lost
78835,767,15,41,2,3,3,8,Casual Users
79013,20,82,331,5,5,5,15,Champions
79058,694,25,48,2,4,3,9,At Risk
79075,31,5,10,5,1,1,7,Promising
79103,1566,7,7,1,2,1,4,Lost
79294,2131,8,19,1,2,2,5,Lost
79923,3480,7,43,1,2,3,6,Lost
80031,1407,9,15,1,2,1,4,Lost
80106,32,121,493,5,5,5,15,Champions
80205,683,12,14,2,3,1,6,Casual Users
80248,1024,9,12,2,2,1,5,Lost
80288,568,17,107,2,3,4,9,Casual Users
80341,8,16,40,5,3,3,11,Loyal Users
80353,2692,16,126,1,3,4,8,Casual Users
80647,155,13,67,4,3,4,11,Loyal Users
80794,268,14,23,3,3,2,8,Loyal Users
80828,136,5,11,4,1,1,6,Promising
80851,177,14,24,3,3,2,8,Loyal Users
80980,31,185,386,5,5,5,15,Champions
81092,112,8,21,4,2,2,8,Promising
81163,1675,6,6,1,1,1,3,Lost
81364,657,8,13,2,2,1,5,Lost
81551,102,67,142,4,5,4,13,Champions
81802,266,9,31,3,2,2,7,Casual Users
82037,363,9,27,3,2,2,7,Casual Users
82226,1419,5,9,1,1,1,3,Lost
82674,117,99,240,4,5,5,14,Champions
82795,4308,8,20,1,2,2,5,Lost
83081,4,23,35,5,4,3,12,Loyal Users
83191,19,35,134,5,4,4,13,Champions
83365,1143,6,6,2,1,1,4,Lost
83484,2539,8,14,1,2,1,4,Lost
83906,113,14,45,4,3,3,10,Loyal Users
83920,105,8,10,4,2,1,7,Promising
84045,973,53,104,2,5,4,11,At Risk
84152,145,24,130,4,4,4,12,Champions
84383,3413,7,8,1,2,1,4,Lost
84509,1334,19,40,1,3,3,7,Casual Users
85069,556,16,43,2,3,3,8,Casual Users
85412,969,14,21,2,3,2,7,Casual Users
85488,415,54,180,3,5,5,13,Loyal Users
85757,2934,7,36,1,2,3,6,Lost
85905,2305,16,39,1,3,3,7,Casual Users
86025,153,40,148,4,4,5,13,Champions
86113,661,7,9,2,2,1,5,Lost
86200,677,5,27,2,1,2,5,Lost
86280,1217,7,21,2,2,2,6,Lost
86633,257,36,112,3,4,4,11,Loyal Users
86692,2492,8,18,1,2,2,5,Lost
86834,1085,14,32,2,3,3,8,Casual Users
86868,1529,7,10,1,2,1,4,Lost
86899,350,14,45,3,3,3,9,Loyal Users
87575,253,38,188,3,4,5,12,Loyal Users
87636,943,15,21,2,3,2,7,Casual Users
87677,92,20,29,4,3,2,9,Loyal Users
87990,94,20,60,4,3,3,10,Loyal Users
88210,156,11,15,4,2,1,7,Promising
88390,82,57,159,4,5,5,14,Champions
88456,168,52,156,3,5,5,13,Loyal Users
88481,1501,34,247,1,4,5,10,At Risk
88925,963,25,61,2,4,3,9,At Risk
89172,2129,11,19,1,2,2,5,Lost
89324,428,38,92,3,4,4,11,Loyal Users
89418,722,28,36,2,4,3,9,At Risk
89478,546,25,185,2,4,5,11,At Risk
89726,92,5,5,4,1,1,6,Promising
89766,572,13,15,2,3,1,6,Casual Users
89821,1436,23,31,1,4,2,7,At Risk
89893,82,22,147,4,4,5,13,Champions
90108,1012,10,34,2,2,3,7,Lost
90137,2,80,166,5,5,5,15,Champions
90301,547,9,13,2,2,1,5,Lost
90513,1464,13,14,1,3,1,5,Casual Users
90577,92,24,61,4,4,3,11,Loyal Users
91050,3166,7,17,1,2,2,5,Lost
78733,30,59,327,5,5,5,15,Champions
79152,127,13,38,4,3,3,10,Loyal Users
79199,2537,19,36,1,3,3,7,Casual Users
79391,414,12,49,3,3,3,9,Loyal Users
79443,164,6,6,4,1,1,6,Promising
79571,2268,8,30,1,2,2,5,Lost
79943,406,8,32,3,2,3,8,Casual Users
80050,3353,29,119,1,4,4,9,At Risk
80089,91,106,326,4,5,5,14,Champions
80125,15,73,185,5,5,5,15,Champions
80299,1965,6,9,1,1,1,3,Lost
80313,98,30,59,4,4,3,11,Loyal Users
80414,128,24,114,4,4,4,12,Champions
80536,8,6,17,5,1,2,8,Promising
80675,1068,38,62,2,4,3,9,At Risk
80839,673,19,26,2,3,2,7,Casual Users
80897,5979,12,20,1,3,2,6,Casual Users
80930,1267,6,9,1,1,1,3,Lost
81015,744,26,53,2,4,3,9,At Risk
81135,1954,9,21,1,2,2,5,Lost
81207,10,30,67,5,4,4,13,Champions
81381,22,47,69,5,5,4,14,Champions
81428,327,9,58,3,2,3,8,Casual Users
81473,479,82,234,2,5,5,12,At Risk
81477,83,16,52,4,3,3,10,Loyal Users
81637,2418,9,22,1,2,2,5,Lost
81729,1164,17,65,2,3,4,9,Casual Users
81747,3290,85,263,1,5,5,11,At Risk
82043,74,58,103,4,5,4,13,Champions
82285,695,16,21,2,3,2,7,Casual Users
82545,120,28,292,4,4,5,13,Champions
82723,405,7,12,3,2,1,6,Casual Users
83068,153,89,481,4,5,5,14,Champions
83096,269,39,151,3,4,5,12,Loyal Users
83322,88,18,36,4,3,3,10,Loyal Users
83628,25,55,73,5,5,4,14,Champions
83841,1089,5,10,2,1,1,4,Lost
84059,110,38,90,4,4,4,12,Champions
84076,555,71,169,2,5,5,12,At Risk
84336,422,35,102,3,4,4,11,Loyal Users
84465,598,8,109,2,2,4,8,Lost
84646,34,28,55,5,4,3,12,Loyal Users
84719,715,49,138,2,5,4,11,At Risk
84806,1416,15,46,1,3,3,7,Casual Users
85067,134,87,397,4,5,5,14,Champions
85497,156,30,71,4,4,4,12,Champions
85499,185,10,21,3,2,2,7,Casual Users
85502,429,10,66,3,2,4,9,Casual Users
85545,952,5,5,2,1,1,4,Lost
85718,546,30,67,2,4,4,10,At Risk
85912,252,18,37,3,3,3,9,Loyal Users
86219,194,49,59,3,5,3,11,Loyal Users
86277,338,35,141,3,4,4,11,Loyal Users
86506,1529,5,6,1,1,1,3,Lost
87166,4416,6,9,1,1,1,3,Lost
87175,124,16,77,4,3,4,11,Loyal Users
87426,813,19,34,2,3,3,8,Casual Users
87506,87,14,137,4,3,4,11,Loyal Users
87838,85,18,85,4,3,4,11,Loyal Users
88067,3559,5,15,1,1,1,3,Lost
88072,118,24,61,4,4,3,11,Loyal Users
88272,500,11,40,2,2,3,7,Lost
88416,683,13,16,2,3,2,7,Casual Users
88667,103,51,120,4,5,4,13,Champions
89395,158,43,93,4,4,4,12,Champions
89602,263,11,24,3,2,2,7,Casual Users
89802,3081,5,5,1,1,1,3,Lost
89883,70,28,48,4,4,3,11,Loyal Users
89885,10,14,46,5,3,3,11,Loyal Users
90195,4141,5,8,1,1,1,3,Lost
90373,35,60,98,5,5,4,14,Champions
90888,94,5,7,4,1,1,6,Promising
90901,785,7,69,2,2,4,8,Lost
90948,828,11,39,2,2,3,7,Lost
78283,69,184,353,5,5,5,15,Champions
78384,2079,6,115,1,1,4,6,Lost
78523,114,55,177,4,5,5,14,Champions
78762,9,50,188,5,5,5,15,Champions
78865,130,73,102,4,5,4,13,Champions
79469,25,61,91,5,5,4,14,Champions
79856,22,53,479,5,5,5,15,Champions
80428,422,17,23,3,3,2,8,Loyal Users
80597,261,6,43,3,1,3,7,Casual Users
81605,163,56,169,4,5,5,14,Champions
81623,1248,8,12,2,2,1,5,Lost
81645,189,69,108,3,5,4,12,Loyal Users
82816,1089,21,50,2,3,3,8,Casual Users
82846,979,10,11,2,2,1,5,Lost
83021,7,161,536,5,5,5,15,Champions
83042,9,29,102,5,4,4,13,Champions
83051,19,81,123,5,5,4,14,Champions
83431,1002,6,6,2,1,1,4,Lost
84086,2433,15,26,1,3,2,6,Casual Users
84233,109,81,181,4,5,5,14,Champions
84347,282,39,75,3,4,4,11,Loyal Users
84416,691,16,38,2,3,3,8,Casual Users
84503,1490,7,13,1,2,1,4,Lost
84732,460,5,6,3,1,1,5,Casual Users
84802,26,95,297,5,5,5,15,Champions
85367,1583,5,16,1,1,2,4,Lost
85429,60,13,46,5,3,3,11,Loyal Users
86015,600,11,14,2,2,1,5,Lost
86071,1371,8,9,1,2,1,4,Lost
86258,133,25,38,4,4,3,11,Loyal Users
86275,683,28,43,2,4,3,9,At Risk
86618,118,17,54,4,3,3,10,Loyal Users
86880,1299,14,55,1,3,3,7,Casual Users
86909,435,6,10,3,1,1,5,Casual Users
87015,231,39,203,3,4,5,12,Loyal Users
87076,131,21,80,4,3,4,11,Loyal Users
87921,79,21,168,4,3,5,12,Loyal Users
88145,424,31,44,3,4,3,10,Loyal Users
88669,20,43,76,5,4,4,13,Champions
88687,50,69,142,5,5,4,14,Champions
88834,2,20,74,5,3,4,12,Loyal Users
88857,577,5,29,2,1,2,5,Lost
89024,23,61,270,5,5,5,15,Champions
89291,258,8,15,3,2,1,6,Casual Users
89303,246,33,112,3,4,4,11,Loyal Users
89306,1091,38,154,2,4,5,11,At Risk
89576,885,17,25,2,3,2,7,Casual Users
89737,286,13,19,3,3,2,8,Loyal Users
89764,240,6,9,3,1,1,5,Casual Users
90113,24,54,95,5,5,4,14,Champions
90202,831,10,11,2,2,1,5,Lost
90230,1733,13,37,1,3,3,7,Casual Users
90241,220,33,94,3,4,4,11,Loyal Users
90246,589,13,67,2,3,4,9,Casual Users
90591,1669,6,18,1,1,2,4,Lost
90686,165,61,75,4,5,4,13,Champions
90718,3,108,387,5,5,5,15,Champions
90733,159,29,68,4,4,4,12,Champions
90751,237,19,40,3,3,3,9,Loyal Users
78601,113,73,201,4,5,5,14,Champions
78916,2400,9,18,1,2,2,5,Lost
78960,978,5,18,2,1,2,5,Lost
79092,443,17,27,3,3,2,8,Loyal Users
79565,120,23,162,4,4,5,13,Champions
79692,6,69,392,5,5,5,15,Champions
79703,77,8,46,4,2,3,9,Promising
79755,407,15,78,3,3,4,10,Loyal Users
80154,150,5,18,4,1,2,7,Promising
80317,535,18,65,2,3,4,9,Casual Users
80450,114,37,107,4,4,4,12,Champions
80499,33,37,113,5,4,4,13,Champions
80514,115,95,266,4,5,5,14,Champions
80595,1172,9,15,2,2,1,5,Lost
80682,10,131,290,5,5,5,15,Champions
80771,92,9,34,4,2,3,9,Promising
80934,0,13,30,5,3,2,10,Loyal Users
81004,130,40,83,4,4,4,12,Champions
81030,66,91,458,5,5,5,15,Champions
82134,70,65,305,4,5,5,14,Champions
82148,1172,6,8,2,1,1,4,Lost
82365,17,146,409,5,5,5,15,Champions
82407,2838,138,564,1,5,5,11,At Risk
82717,92,16,72,4,3,4,11,Loyal Users
82861,692,10,29,2,2,2,6,Lost
82874,303,12,32,3,3,3,9,Loyal Users
82983,177,43,417,3,4,5,12,Loyal Users
83027,112,18,49,4,3,3,10,Loyal Users
83121,3,23,64,5,4,4,13,Champions
83371,379,18,105,3,3,4,10,Loyal Users
83608,323,27,43,3,4,3,10,Loyal Users
84113,126,28,99,4,4,4,12,Champions
84185,2414,9,12,1,2,1,4,Lost
84410,2268,17,27,1,3,2,6,Casual Users
84546,97,17,55,4,3,3,10,Loyal Users
84664,274,9,11,3,2,1,6,Casual Users
84804,132,9,18,4,2,2,8,Promising
84836,0,52,114,5,5,4,14,Champions
84984,74,83,301,4,5,5,14,Champions
85389,1513,5,8,1,1,1,3,Lost
85397,3072,11,29,1,2,2,5,Lost
85435,317,13,86,3,3,4,10,Loyal Users
85460,38,23,129,5,4,4,13,Champions
85609,102,9,52,4,2,3,9,Promising
85892,714,5,6,2,1,1,4,Lost
85983,5,24,65,5,4,4,13,Champions
86193,113,80,231,4,5,5,14,Champions
86247,39,193,427,5,5,5,15,Champions
86271,1410,10,24,1,2,2,5,Lost
86346,839,7,32,2,2,3,7,Lost
86535,101,24,86,4,4,4,12,Champions
86611,117,26,64,4,4,4,12,Champions
86689,1059,7,12,2,2,1,5,Lost
86985,703,15,20,2,3,2,7,Casual Users
87289,94,6,13,4,1,1,6,Promising
87524,2772,23,60,1,4,3,8,At Risk
87615,246,34,85,3,4,4,11,Loyal Users
87689,144,30,53,4,4,3,11,Loyal Users
87690,3262,13,27,1,3,2,6,Casual Users
87989,100,24,46,4,4,3,11,Loyal Users
88240,148,62,154,4,5,5,14,Champions
88242,195,8,66,3,2,4,9,Casual Users
88367,16,23,39,5,4,3,12,Loyal Users
88388,106,15,45,4,3,3,10,Loyal Users
88594,554,24,51,2,4,3,9,At Risk
88755,414,7,17,3,2,2,7,Casual Users
89338,813,5,15,2,1,1,4,Lost
89590,92,62,126,4,5,4,13,Champions
89664,208,14,35,3,3,3,9,Loyal Users
89840,101,56,217,4,5,5,14,Champions
90007,433,5,15,3,1,1,5,Casual Users
90096,121,108,540,4,5,5,14,Champions
90143,1257,19,47,2,3,3,8,Casual Users
90503,4,42,214,5,4,5,14,Champions
90716,1408,13,28,1,3,2,6,Casual Users
90956,568,7,28,2,2,2,6,Lost
78461,3873,15,60,1,3,3,7,Casual Users
79385,237,54,397,3,5,5,13,Loyal Users
79434,35,19,39,5,3,3,11,Loyal Users
79583,34,5,32,5,1,3,9,Promising
79618,165,75,276,4,5,5,14,Champions
79803,291,83,327,3,5,5,13,Loyal Users
80357,127,20,84,4,3,4,11,Loyal Users
80469,79,59,254,4,5,5,14,Champions
80702,1462,7,23,1,2,2,5,Lost
80726,10,29,114,5,4,4,13,Champions
81292,166,23,73,3,4,4,11,Loyal Users
81676,477,5,13,2,1,1,4,Lost
81777,992,16,36,2,3,3,8,Casual Users
82061,13,147,616,5,5,5,15,Champions
82165,18,84,306,5,5,5,15,Champions
82561,994,29,88,2,4,4,10,At Risk
82975,71,17,69,4,3,4,11,Loyal Users
82989,12,34,74,5,4,4,13,Champions
83043,1722,9,13,1,2,1,4,Lost
83155,2212,10,15,1,2,1,4,Lost
83356,3157,6,35,1,1,3,5,Lost
84111,414,8,10,3,2,1,6,Casual Users
84226,569,9,56,2,2,3,7,Lost
84304,293,32,42,3,4,3,10,Loyal Users
85050,571,6,9,2,1,1,4,Lost
85534,44,72,344,5,5,5,15,Champions
85587,1665,6,7,1,1,1,3,Lost
86177,217,40,78,3,4,4,11,Loyal Users
86214,130,43,97,4,4,4,12,Champions
86215,992,5,12,2,1,1,4,Lost
86361,139,14,49,4,3,3,10,Loyal Users
86854,5033,6,7,1,1,1,3,Lost
86861,2,113,367,5,5,5,15,Champions
86904,66,9,38,5,2,3,10,Promising
87002,18,66,241,5,5,5,15,Champions
87231,119,84,237,4,5,5,14,Champions
87299,1356,8,41,1,2,3,6,Lost
87402,847,6,9,2,1,1,4,Lost
87793,91,32,192,4,4,5,13,Champions
87821,1507,9,9,1,2,1,4,Lost
87880,270,5,5,3,1,1,5,Casual Users
87926,113,13,30,4,3,2,9,Loyal Users
88461,1276,5,5,1,1,1,3,Lost
88604,90,65,81,4,5,4,13,Champions
88761,2620,5,61,1,1,3,5,Lost
89290,857,6,10,2,1,1,4,Lost
89317,630,6,6,2,1,1,4,Lost
89482,4332,10,25,1,2,2,5,Lost
89577,1541,6,10,1,1,1,3,Lost
89722,1654,5,11,1,1,1,3,Lost
89785,314,25,102,3,4,4,11,Loyal Users
89942,127,84,433,4,5,5,14,Champions
90286,209,22,159,3,4,5,12,Loyal Users
91059,149,24,37,4,4,3,11,Loyal Users
78570,22,20,32,5,3,3,11,Loyal Users
78634,264,23,55,3,4,3,10,Loyal Users
78822,1264,6,8,1,1,1,3,Lost
79020,1143,5,8,2,1,1,4,Lost
79202,1443,7,13,1,2,1,4,Lost
79244,3046,18,49,1,3,3,7,Casual Users
79321,569,11,45,2,2,3,7,Lost
79448,1729,7,9,1,2,1,4,Lost
79458,102,92,289,4,5,5,14,Champions
79872,583,18,35,2,3,3,8,Casual Users
80103,807,7,62,2,2,3,7,Lost
80668,1520,7,32,1,2,3,6,Lost
80739,105,6,9,4,1,1,6,Promising
81309,371,12,34,3,3,3,9,Loyal Users
81324,795,6,8,2,1,1,4,Lost
81406,39,61,78,5,5,4,14,Champions
81424,1130,20,40,2,3,3,8,Casual Users
81560,530,37,63,2,4,4,10,At Risk
81640,80,42,423,4,4,5,13,Champions
81776,242,123,212,3,5,5,13,Loyal Users
81881,994,5,9,2,1,1,4,Lost
82108,64,63,526,5,5,5,15,Champions
82393,313,7,28,3,2,2,7,Casual Users
82807,366,6,7,3,1,1,5,Casual Users
83471,421,5,5,3,1,1,5,Casual Users
83504,110,6,10,4,1,1,6,Promising
83729,77,31,63,4,4,4,12,Champions
84236,4059,9,16,1,2,2,5,Lost
84431,543,15,22,2,3,2,7,Casual Users
84449,38,34,172,5,4,5,14,Champions
84655,43,117,377,5,5,5,15,Champions
84729,133,6,8,4,1,1,6,Promising
84749,140,53,310,4,5,5,14,Champions
84873,3031,5,9,1,1,1,3,Lost
84896,440,19,25,3,3,2,8,Loyal Users
85298,838,6,15,2,1,1,4,Lost
85313,569,81,489,2,5,5,12,At Risk
85818,2,135,883,5,5,5,15,Champions
86458,177,61,208,3,5,5,13,Loyal Users
86976,87,77,294,4,5,5,14,Champions
87218,140,23,52,4,4,3,11,Loyal Users
87241,170,10,28,3,2,2,7,Casual Users
87329,3,66,110,5,5,4,14,Champions
87486,29,41,87,5,4,4,13,Champions
88260,357,42,205,3,4,5,12,Loyal Users
88565,450,46,89,3,5,4,12,Loyal Users
88818,77,10,11,4,2,1,7,Promising
89125,195,60,154,3,5,5,13,Loyal Users
89183,149,7,19,4,2,2,8,Promising
89747,1052,9,14,2,2,1,5,Lost
90091,33,6,7,5,1,1,7,Promising
90140,427,8,16,3,2,2,7,Casual Users
90403,701,5,12,2,1,1,4,Lost
90677,1713,8,10,1,2,1,4,Lost
91033,229,8,8,3,2,1,6,Casual Users
78354,259,111,464,3,5,5,13,Loyal Users
78496,1347,10,28,1,2,2,5,Lost
78537,58,31,139,5,4,4,13,Champions
78907,342,23,71,3,4,4,11,Loyal Users
79014,158,40,59,4,4,3,11,Loyal Users
79359,809,19,49,2,3,3,8,Casual Users
79494,1619,5,7,1,1,1,3,Lost
79762,981,192,601,2,5,5,12,At Risk
79823,154,17,180,4,3,5,12,Loyal Users
80311,1029,10,32,2,2,3,7,Lost
80386,140,27,101,4,4,4,12,Champions
80470,2130,8,29,1,2,2,5,Lost
80741,2572,5,37,1,1,3,5,Lost
80772,105,93,379,4,5,5,14,Champions
80785,163,22,41,4,4,3,11,Loyal Users
80914,4615,5,8,1,1,1,3,Lost
81088,2527,7,28,1,2,2,5,Lost
81472,110,7,36,4,2,3,9,Promising
81506,479,10,20,2,2,2,6,Lost
82782,2452,11,13,1,2,1,4,Lost
83231,2408,5,21,1,1,2,4,Lost
83262,402,37,116,3,4,4,11,Loyal Users
83805,706,21,42,2,3,3,8,Casual Users
84353,849,5,7,2,1,1,4,Lost
84480,2746,5,10,1,1,1,3,Lost
84520,137,6,16,4,1,2,7,Promising
84946,992,10,21,2,2,2,6,Lost
84962,277,21,93,3,3,4,10,Loyal Users
85613,13,8,134,5,2,4,11,Promising
85776,128,25,37,4,4,3,11,Loyal Users
85883,6,108,214,5,5,5,15,Champions
86416,1239,13,21,2,3,2,7,Casual Users
86442,148,9,26,4,2,2,8,Promising
86770,236,26,46,3,4,3,10,Loyal Users
87148,1106,5,22,2,1,2,5,Lost
87446,125,42,64,4,4,4,12,Champions
87466,807,22,65,2,4,4,10,At Risk
87477,38,35,165,5,4,5,14,Champions
87735,760,6,13,2,1,1,4,Lost
88042,221,5,20,3,1,2,6,Casual Users
88653,515,8,8,2,2,1,5,Lost
88776,120,105,311,4,5,5,14,Champions
89536,184,20,26,3,3,2,8,Loyal Users
89638,137,7,13,4,2,1,7,Promising
89720,1827,6,6,1,1,1,3,Lost
89740,533,5,6,2,1,1,4,Lost
89813,525,11,43,2,2,3,7,Lost
89830,973,27,62,2,4,3,9,At Risk
90142,2632,8,13,1,2,1,4,Lost
90530,19,54,136,5,5,4,14,Champions
90760,441,11,24,3,2,2,7,Casual Users
90985,133,12,20,4,3,2,9,Loyal Users
78427,109,24,54,4,4,3,11,Loyal Users
78576,161,20,37,4,3,3,10,Loyal Users
79040,17,12,34,5,3,3,11,Loyal Users
79471,233,48,116,3,5,4,12,Loyal Users
79507,24,7,15,5,2,1,8,Promising
79518,1599,9,16,1,2,2,5,Lost
79931,423,11,28,3,2,2,7,Casual Users
80075,114,42,373,4,4,5,13,Champions
80080,663,17,50,2,3,3,8,Casual Users
80173,2040,12,22,1,3,2,6,Casual Users
80304,1265,6,18,1,1,2,4,Lost
80466,200,100,164,3,5,5,13,Loyal Users
80637,1814,5,9,1,1,1,3,Lost
80653,3283,7,17,1,2,2,5,Lost
80819,2959,6,45,1,1,3,5,Lost
80994,1299,9,24,1,2,2,5,Lost
81085,69,26,68,5,4,4,13,Champions
81296,1000,22,69,2,4,4,10,At Risk
81317,70,14,39,4,3,3,10,Loyal Users
81591,16,38,295,5,4,5,14,Champions
81959,130,36,211,4,4,5,13,Champions
82263,235,72,489,3,5,5,13,Loyal Users
82433,735,47,331,2,5,5,12,At Risk
82586,230,34,165,3,4,5,12,Loyal Users
82852,1423,43,95,1,4,4,9,At Risk
82908,27,78,164,5,5,5,15,Champions
83099,189,31,181,3,4,5,12,Loyal Users
83236,301,34,126,3,4,4,11,Loyal Users
83349,398,5,13,3,1,1,5,Casual Users
83521,820,8,54,2,2,3,7,Lost
83619,278,30,46,3,4,3,10,Loyal Users
83707,372,7,14,3,2,1,6,Casual Users
83976,54,136,466,5,5,5,15,Champions
84394,1083,17,96,2,3,4,9,Casual Users
84501,516,6,27,2,1,2,5,Lost
85251,1029,43,83,2,4,4,10,At Risk
85780,13,5,11,5,1,1,7,Promising
85833,124,20,50,4,3,3,10,Loyal Users
85845,2141,9,17,1,2,2,5,Lost
85897,1374,9,25,1,2,2,5,Lost
86810,1114,21,53,2,3,3,8,Casual Users
86920,208,10,93,3,2,4,9,Casual Users
87001,101,13,36,4,3,3,10,Loyal Users
87500,47,18,34,5,3,3,11,Loyal Users
87858,103,103,438,4,5,5,14,Champions
88202,101,111,496,4,5,5,14,Champions
88570,1228,10,38,2,2,3,7,Lost
88644,108,5,34,4,1,3,8,Promising
88657,494,11,17,2,2,2,6,Lost
88777,1014,13,32,2,3,3,8,Casual Users
88854,74,24,123,4,4,4,12,Champions
89247,0,117,357,5,5,5,15,Champions
89598,1362,16,35,1,3,3,7,Casual Users
89924,30,24,51,5,4,3,12,Loyal Users
89955,361,12,35,3,3,3,9,Loyal Users
90260,2,151,541,5,5,5,15,Champions
90371,671,7,19,2,2,2,6,Lost
90605,1408,14,51,1,3,3,7,Casual Users
90706,1236,24,139,2,4,4,10,At Risk
90919,82,18,37,4,3,3,10,Loyal Users
78648,585,25,39,2,4,3,9,At Risk
78826,136,16,33,4,3,3,10,Loyal Users
78882,736,5,22,2,1,2,5,Lost
79044,2282,9,18,1,2,2,5,Lost
79250,114,68,144,4,5,4,13,Champions
79283,566,5,35,2,1,3,6,Lost
79375,129,87,116,4,5,4,13,Champions
79383,72,5,34,4,1,3,8,Promising
79451,1149,11,21,2,2,2,6,Lost
79521,234,33,165,3,4,5,12,Loyal Users
79858,72,120,408,4,5,5,14,Champions
80237,2396,7,14,1,2,1,4,Lost
80333,185,6,18,3,1,2,6,Casual Users
80925,540,16,40,2,3,3,8,Casual Users
80927,42,7,21,5,2,2,9,Promising
81024,2,62,201,5,5,5,15,Champions
81162,101,7,8,4,2,1,7,Promising
81419,230,26,44,3,4,3,10,Loyal Users
81601,2242,6,7,1,1,1,3,Lost
81731,410,16,20,3,3,2,8,Loyal Users
81733,10,15,48,5,3,3,11,Loyal Users
81790,4590,7,7,1,2,1,4,Lost
81927,105,7,17,4,2,2,8,Promising
82604,55,108,180,5,5,5,15,Champions
82845,86,13,44,4,3,3,10,Loyal Users
83392,240,58,268,3,5,5,13,Loyal Users
83501,259,67,183,3,5,5,13,Loyal Users
84011,70,35,131,4,4,4,12,Champions
84092,0,64,91,5,5,4,14,Champions
84220,7,138,1438,5,5,5,15,Champions
84539,384,6,6,3,1,1,5,Casual Users
84561,392,7,17,3,2,2,7,Casual Users
84585,165,72,261,4,5,5,14,Champions
84754,872,8,11,2,2,1,5,Lost
84991,20,48,254,5,5,5,15,Champions
84997,30,27,63,5,4,4,13,Champions
85478,34,8,31,5,2,2,9,Promising
85668,177,87,182,3,5,5,13,Loyal Users
86029,273,13,20,3,3,2,8,Loyal Users
86108,933,36,85,2,4,4,10,At Risk
86236,500,17,115,2,3,4,9,Casual Users
86314,554,7,7,2,2,1,5,Lost
86601,141,14,16,4,3,2,9,Loyal Users
86657,101,39,92,4,4,4,12,Champions
86777,559,8,11,2,2,1,5,Lost
86792,11,145,727,5,5,5,15,Champions
86806,2,185,745,5,5,5,15,Champions
86847,7,178,517,5,5,5,15,Champions
86850,636,10,16,2,2,2,6,Lost
87196,459,159,257,3,5,5,13,Loyal Users
87255,64,64,201,5,5,5,15,Champions
87318,0,115,460,5,5,5,15,Champions
87340,150,39,132,4,4,4,12,Champions
87605,759,6,9,2,1,1,4,Lost
87696,139,43,74,4,4,4,12,Champions
87734,820,8,16,2,2,2,6,Lost
87851,296,12,21,3,3,2,8,Loyal Users
87852,104,5,16,4,1,2,7,Promising
88023,5192,11,30,1,2,2,5,Lost
88184,50,18,78,5,3,4,12,Loyal Users
88354,403,20,24,3,3,2,8,Loyal Users
88454,1728,5,5,1,1,1,3,Lost
88480,82,58,125,4,5,4,13,Champions
88651,124,35,174,4,4,5,13,Champions
88794,18,106,869,5,5,5,15,Champions
89126,106,36,63,4,4,4,12,Champions
89144,514,10,19,2,2,2,6,Lost
90026,1876,11,12,1,2,1,4,Lost
90052,247,18,46,3,3,3,9,Loyal Users
90226,23,13,18,5,3,2,10,Loyal Users
90282,81,101,161,4,5,5,14,Champions
90455,26,80,243,5,5,5,15,Champions
90637,444,20,52,3,3,3,9,Loyal Users
90872,15,7,11,5,2,1,8,Promising
78590,3960,7,10,1,2,1,4,Lost
78613,245,18,63,3,3,4,10,Loyal Users
78618,1097,8,17,2,2,2,6,Lost
78823,172,44,135,3,4,4,11,Loyal Users
78845,21,75,247,5,5,5,15,Champions
78994,3232,39,55,1,4,3,8,At Risk
78995,165,26,29,4,4,2,10,Loyal Users
79354,130,9,30,4,2,2,8,Promising
79367,23,135,643,5,5,5,15,Champions
79460,1637,13,48,1,3,3,7,Casual Users
79786,231,16,19,3,3,2,8,Loyal Users
79916,329,28,63,3,4,4,11,Loyal Users
80239,7,11,33,5,2,3,10,Promising
80440,975,7,26,2,2,2,6,Lost
80462,72,45,146,4,4,4,12,Champions
80512,1,86,384,5,5,5,15,Champions
81128,139,30,99,4,4,4,12,Champions
81325,21,6,28,5,1,2,8,Promising
81352,3566,9,20,1,2,2,5,Lost
81538,21,58,114,5,5,4,14,Champions
81904,1011,5,43,2,1,3,6,Lost
82267,2834,5,5,1,1,1,3,Lost
82811,8,56,363,5,5,5,15,Champions
82837,2,94,482,5,5,5,15,Champions
82910,462,13,19,3,3,2,8,Loyal Users
82940,276,37,63,3,4,4,11,Loyal Users
82967,137,9,18,4,2,2,8,Promising
83017,715,41,225,2,4,5,11,At Risk
83088,1281,19,35,1,3,3,7,Casual Users
83154,176,13,17,3,3,2,8,Loyal Users
83730,33,24,107,5,4,4,13,Champions
83882,432,12,38,3,3,3,9,Loyal Users
83953,9,20,97,5,3,4,12,Loyal Users
84158,117,13,47,4,3,3,10,Loyal Users
84176,4,26,66,5,4,4,13,Champions
84623,2395,12,44,1,3,3,7,Casual Users
84807,383,61,87,3,5,4,12,Loyal Users
85010,1255,11,39,2,2,3,7,Lost
85012,397,8,22,3,2,2,7,Casual Users
85225,267,69,253,3,5,5,13,Loyal Users
85264,107,15,56,4,3,3,10,Loyal Users
85302,232,6,17,3,1,2,6,Casual Users
85415,79,7,11,4,2,1,7,Promising
85489,86,73,126,4,5,4,13,Champions
85646,37,27,50,5,4,3,12,Loyal Users
85839,1022,8,98,2,2,4,8,Lost
86205,434,14,45,3,3,3,9,Loyal Users
86408,548,99,321,2,5,5,12,At Risk
86558,181,15,21,3,3,2,8,Loyal Users
86719,541,18,56,2,3,3,8,Casual Users
86733,384,11,22,3,2,2,7,Casual Users
86977,875,10,12,2,2,1,5,Lost
87118,4,29,48,5,4,3,12,Loyal Users
87208,1160,11,18,2,2,2,6,Lost
87273,580,7,17,2,2,2,6,Lost
87287,1452,22,156,1,4,5,10,At Risk
88154,914,23,44,2,4,3,9,At Risk
88318,144,15,21,4,3,2,9,Loyal Users
88429,2725,7,8,1,2,1,4,Lost
88482,1850,7,48,1,2,3,6,Lost
88557,24,60,134,5,5,4,14,Champions
88559,35,62,171,5,5,5,15,Champions
88641,1668,26,89,1,4,4,9,At Risk
88912,65,12,89,5,3,4,12,Loyal Users
89091,211,12,16,3,3,2,8,Loyal Users
89202,100,30,105,4,4,4,12,Champions
89286,1194,40,155,2,4,5,11,At Risk
89738,1445,29,59,1,4,3,8,At Risk
89964,1612,9,15,1,2,1,4,Lost
90041,3,29,141,5,4,4,13,Champions
90248,184,10,30,3,2,2,7,Casual Users
90343,214,15,20,3,3,2,8,Loyal Users
90510,10,11,93,5,2,4,11,Promising
90652,1747,20,82,1,3,4,8,Casual Users
90975,223,7,12,3,2,1,6,Casual Users
78373,33,52,140,5,5,4,14,Champions
78844,160,27,33,4,4,3,11,Loyal Users
79095,137,64,106,4,5,4,13,Champions
79366,1238,5,5,2,1,1,4,Lost
79413,1406,8,23,1,2,2,5,Lost
80290,800,19,37,2,3,3,8,Casual Users
80541,45,114,666,5,5,5,15,Champions
80758,119,10,102,4,2,4,10,Promising
80902,400,22,51,3,4,3,10,Loyal Users
81290,303,73,174,3,5,5,13,Loyal Users
81375,477,20,49,2,3,3,8,Casual Users
81925,415,17,46,3,3,3,9,Loyal Users
82336,23,36,186,5,4,5,14,Champions
83190,549,32,159,2,4,5,11,At Risk
83557,227,21,32,3,3,3,9,Loyal Users
83776,5,192,469,5,5,5,15,Champions
84725,267,7,13,3,2,1,6,Casual Users
85158,1679,5,21,1,1,2,4,Lost
85472,298,12,20,3,3,2,8,Loyal Users
85580,2915,24,85,1,4,4,9,At Risk
85593,258,22,100,3,4,4,11,Loyal Users
85699,337,16,19,3,3,2,8,Loyal Users
85802,131,100,140,4,5,4,13,Champions
86104,1058,20,45,2,3,3,8,Casual Users
86748,422,51,89,3,5,4,12,Loyal Users
86768,92,101,275,4,5,5,14,Champions
86772,283,47,84,3,5,4,12,Loyal Users
86938,804,35,258,2,4,5,11,At Risk
87139,669,11,45,2,2,3,7,Lost
87174,119,16,27,4,3,2,9,Loyal Users
87641,535,34,207,2,4,5,11,At Risk
87803,294,19,30,3,3,2,8,Loyal Users
87853,117,20,33,4,3,3,10,Loyal Users
87929,236,52,126,3,5,4,12,Loyal Users
88181,3858,8,18,1,2,2,5,Lost
88449,18,157,405,5,5,5,15,Champions
88511,284,6,20,3,1,2,6,Casual Users
88587,54,25,214,5,4,5,14,Champions
89403,12,16,32,5,3,3,11,Loyal Users
89547,412,33,246,3,4,5,12,Loyal Users
89687,16,15,29,5,3,2,10,Loyal Users
89694,361,12,28,3,3,2,8,Loyal Users
89841,1412,7,47,1,2,3,6,Lost
89917,296,25,41,3,4,3,10,Loyal Users
90307,395,59,138,3,5,4,12,Loyal Users
90532,1094,7,21,2,2,2,6,Lost
91009,126,36,109,4,4,4,12,Champions
78544,220,43,87,3,4,4,11,Loyal Users
78685,30,159,314,5,5,5,15,Champions
78811,12,23,101,5,4,4,13,Champions
78922,416,25,42,3,4,3,10,Loyal Users
79030,569,6,15,2,1,1,4,Lost
79160,116,5,7,4,1,1,6,Promising
79164,19,54,168,5,5,5,15,Champions
79209,454,24,98,3,4,4,11,Loyal Users
79454,2213,6,15,1,1,1,3,Lost
79649,321,15,25,3,3,2,8,Loyal Users
79740,395,31,49,3,4,3,10,Loyal Users
79757,837,6,15,2,1,1,4,Lost
79954,241,6,19,3,1,2,6,Casual Users
80204,12,107,809,5,5,5,15,Champions
81114,611,7,18,2,2,2,6,Lost
81121,230,12,56,3,3,3,9,Loyal Users
81330,2932,21,31,1,3,2,6,Casual Users
81461,585,12,33,2,3,3,8,Casual Users
81484,660,18,146,2,3,4,9,Casual Users
81931,268,13,56,3,3,3,9,Loyal Users
82085,425,7,15,3,2,1,6,Casual Users
82103,13,22,40,5,4,3,12,Loyal Users
82357,24,62,265,5,5,5,15,Champions
82414,131,38,49,4,4,3,11,Loyal Users
82497,2857,5,30,1,1,2,4,Lost
82913,914,20,32,2,3,3,8,Casual Users
83358,238,9,86,3,2,4,9,Casual Users
83444,967,6,11,2,1,1,4,Lost
83751,229,5,23,3,1,2,6,Casual Users
83807,681,5,30,2,1,2,5,Lost
83848,28,199,496,5,5,5,15,Champions
83877,1147,21,25,2,3,2,7,Casual Users
84031,256,41,68,3,4,4,11,Loyal Users
84089,1732,5,14,1,1,1,3,Lost
84208,394,47,222,3,5,5,13,Loyal Users
84301,26,7,9,5,2,1,8,Promising
84422,1,133,284,5,5,5,15,Champions
85029,2917,8,13,1,2,1,4,Lost
85040,840,15,41,2,3,3,8,Casual Users
85248,2,40,98,5,4,4,13,Champions
85288,321,36,392,3,4,5,12,Loyal Users
85541,233,23,37,3,4,3,10,Loyal Users
85559,70,136,473,4,5,5,14,Champions
85750,1044,14,57,2,3,3,8,Casual Users
85789,13,49,130,5,5,4,14,Champions
85855,74,61,166,4,5,5,14,Champions
86002,30,41,100,5,4,4,13,Champions
86138,3357,5,6,1,1,1,3,Lost
86354,1149,23,43,2,4,3,9,At Risk
86678,1150,15,67,2,3,4,9,Casual Users
87190,855,24,29,2,4,2,8,At Risk
87240,14,38,49,5,4,3,12,Loyal Users
87261,122,33,103,4,4,4,12,Champions
87523,377,54,260,3,5,5,13,Loyal Users
87952,294,8,17,3,2,2,7,Casual Users
88131,5017,5,5,1,1,1,3,Lost
88550,7,15,56,5,3,3,11,Loyal Users
88769,21,50,367,5,5,5,15,Champions
88872,151,273,367,4,5,5,14,Champions
89113,605,34,42,2,4,3,9,At Risk
89160,118,30,78,4,4,4,12,Champions
89636,5320,5,5,1,1,1,3,Lost
89655,31,8,37,5,2,3,10,Promising
89658,2145,7,7,1,2,1,4,Lost
89796,148,84,439,4,5,5,14,Champions
89815,726,19,34,2,3,3,8,Casual Users
89879,1578,9,11,1,2,1,4,Lost
89950,2708,8,8,1,2,1,4,Lost
90083,4425,6,6,1,1,1,3,Lost
90203,2,40,86,5,4,4,13,Champions
90505,137,34,96,4,4,4,12,Champions
90581,3302,9,27,1,2,2,5,Lost
91035,425,23,88,3,4,4,11,Loyal Users
78330,554,32,70,2,4,4,10,At Risk
78339,329,15,44,3,3,3,9,Loyal Users
78594,176,35,214,3,4,5,12,Loyal Users
78757,11,96,411,5,5,5,15,Champions
78886,18,14,17,5,3,2,10,Loyal Users
79187,2485,5,8,1,1,1,3,Lost
79663,46,111,329,5,5,5,15,Champions
80017,1565,15,26,1,3,2,6,Casual Users
80316,593,9,95,2,2,4,8,Lost
80454,272,33,147,3,4,5,12,Loyal Users
80705,406,19,41,3,3,3,9,Loyal Users
80932,37,93,216,5,5,5,15,Champions
81991,308,9,14,3,2,1,6,Casual Users
82065,26,8,12,5,2,1,8,Promising
82448,698,19,35,2,3,3,8,Casual Users
82787,1751,13,45,1,3,3,7,Casual Users
82808,2416,6,19,1,1,2,4,Lost
83198,974,12,12,2,3,1,6,Casual Users
83448,250,39,118,3,4,4,11,Loyal Users
83681,2074,6,9,1,1,1,3,Lost
84070,192,58,179,3,5,5,13,Loyal Users
84155,3556,8,16,1,2,2,5,Lost
84178,30,36,128,5,4,4,13,Champions
84266,427,21,28,3,3,2,8,Loyal Users
84409,245,14,34,3,3,3,9,Loyal Users
84457,280,5,6,3,1,1,5,Casual Users
84558,657,21,82,2,3,4,9,Casual Users
84928,2,14,27,5,3,2,10,Loyal Users
85130,44,90,159,5,5,5,15,Champions
85379,444,30,67,3,4,4,11,Loyal Users
85522,1386,7,9,1,2,1,4,Lost
85553,1847,6,9,1,1,1,3,Lost
85739,2405,9,10,1,2,1,4,Lost
86170,2890,6,60,1,1,3,5,Lost
86190,1093,10,15,2,2,1,5,Lost
86223,141,50,69,4,5,4,13,Champions
86610,42,72,331,5,5,5,15,Champions
86917,2840,9,42,1,2,3,6,Lost
86942,939,9,43,2,2,3,7,Lost
87043,5,51,135,5,5,4,14,Champions
87047,2810,20,31,1,3,2,6,Casual Users
87178,849,12,23,2,3,2,7,Casual Users
87334,632,30,70,2,4,4,10,At Risk
87375,93,40,80,4,4,4,12,Champions
88102,11,85,137,5,5,4,14,Champions
88289,962,46,68,2,5,4,11,At Risk
88322,41,19,103,5,3,4,12,Loyal Users
88458,81,73,230,4,5,5,14,Champions
88459,735,18,25,2,3,2,7,Casual Users
88909,3170,5,55,1,1,3,5,Lost
88913,1,144,383,5,5,5,15,Champions
89029,444,14,107,3,3,4,10,Loyal Users
89086,193,26,48,3,4,3,10,Loyal Users
89370,83,29,53,4,4,3,11,Loyal Users
89551,259,24,105,3,4,4,11,Loyal Users
90702,7,43,74,5,4,4,13,Champions
90785,1873,24,103,1,4,4,9,At Risk
90821,2692,8,10,1,2,1,4,Lost
78723,376,52,284,3,5,5,13,Loyal Users
79146,44,28,50,5,4,3,12,Loyal Users
79422,306,16,62,3,3,3,9,Loyal Users
79444,179,6,32,3,1,3,7,Casual Users
79672,548,34,142,2,4,4,10,At Risk
79805,102,27,72,4,4,4,12,Champions
79887,186,10,15,3,2,1,6,Casual Users
80081,1265,5,5,1,1,1,3,Lost
80177,4156,7,14,1,2,1,4,Lost
80278,270,93,511,3,5,5,13,Loyal Users
80650,320,12,22,3,3,2,8,Loyal Users
80882,4147,5,6,1,1,1,3,Lost
80936,9,63,561,5,5,5,15,Champions
80941,1,28,49,5,4,3,12,Loyal Users
81170,175,37,153,3,4,5,12,Loyal Users
81213,62,7,39,5,2,3,10,Promising
81220,25,28,235,5,4,5,14,Champions
81374,12,21,73,5,3,4,12,Loyal Users
81906,261,56,216,3,5,5,13,Loyal Users
82105,72,31,103,4,4,4,12,Champions
82193,0,43,213,5,4,5,14,Champions
82423,2740,6,9,1,1,1,3,Lost
82527,264,5,8,3,1,1,5,Casual Users
82567,411,39,102,3,4,4,11,Loyal Users
82626,154,63,424,4,5,5,14,Champions
82688,1125,10,10,2,2,1,5,Lost
83098,237,7,10,3,2,1,6,Casual Users
83101,5150,6,7,1,1,1,3,Lost
83180,13,19,28,5,3,2,10,Loyal Users
83835,144,14,25,4,3,2,9,Loyal Users
84000,2,95,224,5,5,5,15,Champions
84048,672,6,30,2,1,2,5,Lost
84067,315,5,25,3,1,2,6,Casual Users
84165,609,11,17,2,2,2,6,Lost
84169,43,68,176,5,5,5,15,Champions
84202,571,76,307,2,5,5,12,At Risk
84652,981,16,122,2,3,4,9,Casual Users
84792,412,6,10,3,1,1,5,Casual Users
85157,113,138,244,4,5,5,14,Champions
85316,15,26,80,5,4,4,13,Champions
85365,2932,5,40,1,1,3,5,Lost
85569,1294,11,43,1,2,3,6,Lost
85676,425,56,698,3,5,5,13,Loyal Users
86164,824,14,53,2,3,3,8,Casual Users
86362,241,20,113,3,3,4,10,Loyal Users
86478,218,6,8,3,1,1,5,Casual Users
86595,546,18,50,2,3,3,8,Casual Users
86740,207,15,29,3,3,2,8,Loyal Users
86789,385,8,26,3,2,2,7,Casual Users
86799,3126,6,11,1,1,1,3,Lost
87737,1,157,378,5,5,5,15,Champions
87898,522,17,44,2,3,3,8,Casual Users
88035,16,149,305,5,5,5,15,Champions
88437,418,62,87,3,5,4,12,Loyal Users
88552,60,200,472,5,5,5,15,Champions
88725,2100,102,195,1,5,5,11,At Risk
89255,5055,33,103,1,4,4,9,At Risk
89406,1295,85,224,1,5,5,11,At Risk
89692,1462,23,43,1,4,3,8,At Risk
89702,96,81,117,4,5,4,13,Champions
90160,1288,10,27,1,2,2,5,Lost
90370,66,56,260,5,5,5,15,Champions
90547,3896,5,7,1,1,1,3,Lost
90666,5173,9,13,1,2,1,4,Lost
90917,86,7,8,4,2,1,7,Promising
91015,103,50,96,4,5,4,13,Champions
78387,124,8,15,4,2,1,7,Promising
78415,63,31,85,5,4,4,13,Champions
78830,6,36,44,5,4,3,12,Loyal Users
79028,120,33,81,4,4,4,12,Champions
79150,2433,11,12,1,2,1,4,Lost
79264,751,231,897,2,5,5,12,At Risk
79276,806,6,49,2,1,3,6,Lost
79381,33,87,175,5,5,5,15,Champions
79424,838,7,21,2,2,2,6,Lost
80185,26,13,19,5,3,2,10,Loyal Users
80305,8,140,270,5,5,5,15,Champions
80324,699,6,7,2,1,1,4,Lost
80456,130,87,387,4,5,5,14,Champions
80566,154,133,573,4,5,5,14,Champions
82056,113,133,356,4,5,5,14,Champions
82163,106,111,173,4,5,5,14,Champions
82547,135,19,71,4,3,4,11,Loyal Users
82999,337,22,31,3,4,2,9,Loyal Users
83022,101,15,50,4,3,3,10,Loyal Users
83240,534,6,12,2,1,1,4,Lost
83493,1622,21,77,1,3,4,8,Casual Users
83859,437,22,42,3,4,3,10,Loyal Users
84981,235,21,39,3,3,3,9,Loyal Users
85076,133,55,166,4,5,5,14,Champions
85259,1576,6,6,1,1,1,3,Lost
85400,408,11,161,3,2,5,10,Casual Users
85630,2841,7,20,1,2,2,5,Lost
85670,92,52,137,4,5,4,13,Champions
85787,2,11,36,5,2,3,10,Promising
85909,144,62,158,4,5,5,14,Champions
86030,231,39,70,3,4,4,11,Loyal Users
86059,151,9,30,4,2,2,8,Promising
86102,30,22,37,5,4,3,12,Loyal Users
86218,91,14,53,4,3,3,10,Loyal Users
86375,44,102,177,5,5,5,15,Champions
86852,83,97,350,4,5,5,14,Champions
87143,73,16,29,4,3,2,9,Loyal Users
87445,2559,11,14,1,2,1,4,Lost
87822,10,72,115,5,5,4,14,Champions
88151,145,9,22,4,2,2,8,Promising
88172,6,19,50,5,3,3,11,Loyal Users
88191,1069,19,39,2,3,3,8,Casual Users
88477,126,43,174,4,4,5,13,Champions
88642,101,13,31,4,3,2,9,Loyal Users
88652,30,12,21,5,3,2,10,Loyal Users
89075,57,51,107,5,5,4,14,Champions
89190,109,5,9,4,1,1,6,Promising
89237,366,52,142,3,5,4,12,Loyal Users
89355,0,97,280,5,5,5,15,Champions
89851,1137,10,55,2,2,3,7,Lost
90237,4677,7,7,1,2,1,4,Lost
78359,101,70,226,4,5,5,14,Champions
78374,1,122,404,5,5,5,15,Champions
78587,20,68,544,5,5,5,15,Champions
78731,2593,15,64,1,3,4,8,Casual Users
78897,219,39,249,3,4,5,12,Loyal Users
78984,91,21,58,4,3,3,10,Loyal Users
79073,15,10,15,5,2,1,8,Promising
79116,700,11,26,2,2,2,6,Lost
79537,617,9,26,2,2,2,6,Lost
79632,705,6,6,2,1,1,4,Lost
79750,165,10,24,4,2,2,8,Promising
80144,638,25,55,2,4,3,9,At Risk
80398,11,171,527,5,5,5,15,Champions
80508,2546,24,35,1,4,3,8,At Risk
81001,4,80,362,5,5,5,15,Champions
81049,385,7,40,3,2,3,8,Casual Users
81337,1136,6,8,2,1,1,4,Lost
81701,4970,11,11,1,2,1,4,Lost
81788,13,53,119,5,5,4,14,Champions
81853,400,10,22,3,2,2,7,Casual Users
82235,729,20,36,2,3,3,8,Casual Users
82246,904,21,43,2,3,3,8,Casual Users
82262,6,5,39,5,1,3,9,Promising
82763,739,45,140,2,4,4,10,At Risk
83069,765,10,23,2,2,2,6,Lost
83540,679,10,11,2,2,1,5,Lost
83635,21,7,36,5,2,3,10,Promising
83660,594,6,15,2,1,1,4,Lost
83821,8,30,175,5,4,5,14,Champions
83980,210,13,22,3,3,2,8,Loyal Users
84358,203,24,78,3,4,4,11,Loyal Users
84779,289,49,76,3,5,4,12,Loyal Users
84840,23,54,205,5,5,5,15,Champions
85034,3914,14,21,1,3,2,6,Casual Users
85484,664,49,247,2,5,5,12,At Risk
85690,31,36,69,5,4,4,13,Champions
86140,51,10,49,5,2,3,10,Promising
86417,2118,8,41,1,2,3,6,Lost
86687,688,5,5,2,1,1,4,Lost
86731,113,125,192,4,5,5,14,Champions
87138,1201,71,363,2,5,5,12,At Risk
87552,2023,6,10,1,1,1,3,Lost
87787,122,40,269,4,4,5,13,Champions
88663,144,50,235,4,5,5,14,Champions
88673,95,19,73,4,3,4,11,Loyal Users
88724,14,87,333,5,5,5,15,Champions
89200,298,15,39,3,3,3,9,Loyal Users
89466,46,28,51,5,4,3,12,Loyal Users
89501,429,8,15,3,2,1,6,Casual Users
89545,183,18,145,3,3,4,10,Loyal Users
89704,1244,8,11,2,2,1,5,Lost
89866,159,7,17,4,2,2,8,Promising
89930,968,13,69,2,3,4,9,Casual Users
90040,2409,5,45,1,1,3,5,Lost
90264,1570,10,19,1,2,2,5,Lost
90351,113,36,235,4,4,5,13,Champions
78435,3,69,183,5,5,5,15,Champions
78669,132,7,7,4,2,1,7,Promising
78943,46,71,109,5,5,4,14,Champions
80225,88,40,161,4,4,5,13,Champions
80509,128,103,603,4,5,5,14,Champions
80591,1217,18,25,2,3,2,7,Casual Users
80621,1,144,364,5,5,5,15,Champions
80821,80,13,29,4,3,2,9,Loyal Users
80910,566,9,25,2,2,2,6,Lost
81044,30,73,128,5,5,4,14,Champions
81112,2581,5,29,1,1,2,4,Lost
81188,3883,8,10,1,2,1,4,Lost
81224,1472,6,27,1,1,2,4,Lost
81283,4602,10,14,1,2,1,4,Lost
81311,126,25,141,4,4,4,12,Champions
81415,2128,5,18,1,1,2,4,Lost
81851,1980,9,24,1,2,2,5,Lost
81981,75,41,216,4,4,5,13,Champions
82330,695,5,5,2,1,1,4,Lost
82359,103,18,119,4,3,4,11,Loyal Users
82813,390,12,20,3,3,2,8,Loyal Users
82875,29,26,71,5,4,4,13,Champions
82921,776,9,68,2,2,4,8,Lost
83014,2,28,39,5,4,3,12,Loyal Users
83036,14,36,80,5,4,4,13,Champions
83211,415,21,27,3,3,2,8,Loyal Users
83474,83,18,80,4,3,4,11,Loyal Users
83478,460,13,26,3,3,2,8,Loyal Users
83531,3692,16,34,1,3,3,7,Casual Users
83596,125,32,61,4,4,3,11,Loyal Users
83598,1411,8,14,1,2,1,4,Lost
84274,834,14,30,2,3,2,7,Casual Users
84711,63,18,69,5,3,4,12,Loyal Users
84977,276,8,10,3,2,1,6,Casual Users
85030,75,73,181,4,5,5,14,Champions
85476,31,46,84,5,5,4,14,Champions
85747,1299,11,26,1,2,2,5,Lost
86234,13,95,184,5,5,5,15,Champions
86388,125,27,28,4,4,2,10,Loyal Users
86448,278,19,24,3,3,2,8,Loyal Users
86450,98,33,125,4,4,4,12,Champions
86513,29,27,71,5,4,4,13,Champions
86537,425,11,19,3,2,2,7,Casual Users
86585,1265,6,20,1,1,2,4,Lost
87021,38,116,668,5,5,5,15,Champions
87456,1218,8,30,2,2,2,6,Lost
87554,65,19,30,5,3,2,10,Loyal Users
88247,1138,34,103,2,4,4,10,At Risk
88296,173,18,58,3,3,3,9,Loyal Users
88363,10,8,11,5,2,1,8,Promising
88462,4287,10,39,1,2,3,6,Lost
88836,37,88,315,5,5,5,15,Champions
89084,133,45,241,4,4,5,13,Champions
89177,6,87,567,5,5,5,15,Champions
89383,17,22,34,5,4,3,12,Loyal Users
89419,86,49,59,4,5,3,12,Loyal Users
89481,848,7,9,2,2,1,5,Lost
89923,72,5,38,4,1,3,8,Promising
90250,161,60,69,4,5,4,13,Champions
90474,2096,17,46,1,3,3,7,Casual Users
90672,152,36,68,4,4,4,12,Champions
90886,250,6,12,3,1,1,5,Casual Users
91062,318,7,23,3,2,2,7,Casual Users
78297,183,96,526,3,5,5,13,Loyal Users
79066,131,25,130,4,4,4,12,Champions
79320,376,29,73,3,4,4,11,Loyal Users
79568,574,5,8,2,1,1,4,Lost
79731,1185,17,87,2,3,4,9,Casual Users
79759,3914,15,23,1,3,2,6,Casual Users
79825,861,12,35,2,3,3,8,Casual Users
80250,21,11,26,5,2,2,9,Promising
80370,308,8,48,3,2,3,8,Casual Users
80404,291,34,153,3,4,5,12,Loyal Users
80476,68,6,12,5,1,1,7,Promising
81181,95,46,79,4,5,4,13,Champions
81404,4592,14,42,1,3,3,7,Casual Users
81611,86,122,756,4,5,5,14,Champions
81628,840,13,45,2,3,3,8,Casual Users
81636,5857,25,31,1,4,2,7,At Risk
81663,231,21,31,3,3,2,8,Loyal Users
81678,382,13,15,3,3,1,7,Loyal Users
81856,93,5,12,4,1,1,6,Promising
82069,613,12,24,2,3,2,7,Casual Users
82070,135,11,21,4,2,2,8,Promising
82154,70,43,113,4,4,4,12,Champions
82281,131,10,13,4,2,1,7,Promising
82507,662,19,46,2,3,3,8,Casual Users
82646,516,9,85,2,2,4,8,Lost
83264,102,7,12,4,2,1,7,Promising
83302,9,21,86,5,3,4,12,Loyal Users
83466,252,8,61,3,2,3,8,Casual Users
83495,196,10,55,3,2,3,8,Casual Users
83589,418,10,42,3,2,3,8,Casual Users
83968,3,159,852,5,5,5,15,Champions
84362,650,10,19,2,2,2,6,Lost
84548,137,70,171,4,5,5,14,Champions
84855,669,8,28,2,2,2,6,Lost
84897,444,10,38,3,2,3,8,Casual Users
85071,91,122,251,4,5,5,14,Champions
85140,71,49,184,4,5,5,14,Champions
85688,729,17,61,2,3,3,8,Casual Users
85707,593,18,100,2,3,4,9,Casual Users
85994,138,13,75,4,3,4,11,Loyal Users
86139,642,12,56,2,3,3,8,Casual Users
86435,421,28,59,3,4,3,10,Loyal Users
86591,304,52,107,3,5,4,12,Loyal Users
86779,15,22,38,5,4,3,12,Loyal Users
86784,436,5,6,3,1,1,5,Casual Users
86828,14,9,42,5,2,3,10,Promising
86877,1227,6,8,2,1,1,4,Lost
86996,48,104,643,5,5,5,15,Champions
87012,2435,5,17,1,1,2,4,Lost
87045,154,45,168,4,4,5,13,Champions
87083,652,25,28,2,4,2,8,At Risk
87160,157,80,328,4,5,5,14,Champions
87362,252,50,146,3,5,4,12,Loyal Users
87878,263,15,36,3,3,3,9,Loyal Users
88135,865,41,52,2,4,3,9,At Risk
88521,114,41,323,4,4,5,13,Champions
88634,135,78,342,4,5,5,14,Champions
88856,107,12,27,4,3,2,9,Loyal Users
89300,349,6,24,3,1,2,6,Casual Users
90117,25,88,242,5,5,5,15,Champions
90507,160,22,26,4,4,2,10,Loyal Users
90925,1136,9,25,2,2,2,6,Lost
91010,1265,10,38,1,2,3,6,Lost
78655,116,9,15,4,2,1,7,Promising
78716,660,13,22,2,3,2,7,Casual Users
78806,40,76,191,5,5,5,15,Champions
79728,2007,6,8,1,1,1,3,Lost
80151,84,32,70,4,4,4,12,Champions
80463,97,31,83,4,4,4,12,Champions
81113,721,10,51,2,2,3,7,Lost
81151,411,7,10,3,2,1,6,Casual Users
81229,429,6,53,3,1,3,7,Casual Users
81421,72,54,194,4,5,5,14,Champions
81516,112,19,32,4,3,3,10,Loyal Users
81767,117,19,68,4,3,4,11,Loyal Users
81963,94,17,63,4,3,4,11,Loyal Users
82279,278,13,16,3,3,2,8,Loyal Users
82546,74,14,116,4,3,4,11,Loyal Users
82548,1191,12,21,2,3,2,7,Casual Users
82608,905,49,226,2,5,5,12,At Risk
82703,1115,7,9,2,2,1,5,Lost
83251,44,5,16,5,1,2,8,Promising
83566,62,145,615,5,5,5,15,Champions
83606,123,112,458,4,5,5,14,Champions
83633,1766,16,34,1,3,3,7,Casual Users
83670,260,59,228,3,5,5,13,Loyal Users
83837,38,6,8,5,1,1,7,Promising
83897,13,10,30,5,2,2,9,Promising
83978,261,10,15,3,2,1,6,Casual Users
84775,145,10,26,4,2,2,8,Promising
84813,295,9,38,3,2,3,8,Casual Users
85005,37,11,19,5,2,2,9,Promising
85022,9,47,96,5,5,4,14,Champions
85031,299,34,72,3,4,4,11,Loyal Users
85152,453,7,11,3,2,1,6,Casual Users
85176,49,73,101,5,5,4,14,Champions
85759,107,64,394,4,5,5,14,Champions
85769,79,15,50,4,3,3,10,Loyal Users
85803,1687,11,15,1,2,1,4,Lost
85825,1415,8,12,1,2,1,4,Lost
85935,3313,10,19,1,2,2,5,Lost
85964,358,8,10,3,2,1,6,Casual Users
85971,227,52,87,3,5,4,12,Loyal Users
86224,1419,20,69,1,3,4,8,Casual Users
86521,268,10,28,3,2,2,7,Casual Users
86588,1750,22,41,1,4,3,8,At Risk
86628,412,9,30,3,2,2,7,Casual Users
86950,7,33,75,5,4,4,13,Champions
87054,1436,9,36,1,2,3,6,Lost
87429,268,14,53,3,3,3,9,Loyal Users
87655,1413,7,40,1,2,3,6,Lost
88215,420,7,47,3,2,3,8,Casual Users
88446,568,16,17,2,3,2,7,Casual Users
88774,745,7,20,2,2,2,6,Lost
88904,2151,7,9,1,2,1,4,Lost
89594,431,6,8,3,1,1,5,Casual Users
89620,3677,5,10,1,1,1,3,Lost
89715,104,26,77,4,4,4,12,Champions
90116,9,11,29,5,2,2,9,Promising
90125,3724,22,44,1,4,3,8,At Risk
90149,47,69,161,5,5,5,15,Champions
90331,8,14,19,5,3,2,10,Loyal Users
90426,17,74,108,5,5,4,14,Champions
90565,75,17,36,4,3,3,10,Loyal Users
90665,420,15,74,3,3,4,10,Loyal Users
91048,652,12,16,2,3,2,7,Casual Users
78526,149,23,46,4,4,3,11,Loyal Users
78598,566,6,9,2,1,1,4,Lost
78982,247,80,126,3,5,4,12,Loyal Users
80223,5,22,57,5,4,3,12,Loyal Users
80468,5,97,216,5,5,5,15,Champions
80471,83,33,81,4,4,4,12,Champions
80594,70,25,115,4,4,4,12,Champions
81191,33,42,141,5,4,4,13,Champions
81359,152,20,57,4,3,3,10,Loyal Users
81815,291,10,31,3,2,2,7,Casual Users
82129,503,7,23,2,2,2,6,Lost
82450,1475,6,21,1,1,2,4,Lost
82632,365,69,156,3,5,5,13,Loyal Users
82938,86,42,85,4,4,4,12,Champions
82949,128,45,263,4,4,5,13,Champions
83244,159,6,23,4,1,2,7,Promising
83556,599,6,8,2,1,1,4,Lost
84010,240,14,32,3,3,3,9,Loyal Users
84103,65,13,77,5,3,4,12,Loyal Users
84120,287,55,72,3,5,4,12,Loyal Users
84195,578,32,254,2,4,5,11,At Risk
84384,275,16,50,3,3,3,9,Loyal Users
84660,1852,9,28,1,2,2,5,Lost
84693,2577,5,10,1,1,1,3,Lost
84948,343,13,20,3,3,2,8,Loyal Users
85002,406,6,24,3,1,2,6,Casual Users
85117,278,8,17,3,2,2,7,Casual Users
85257,2587,12,24,1,3,2,6,Casual Users
86060,171,65,118,3,5,4,12,Loyal Users
86069,58,15,52,5,3,3,11,Loyal Users
86208,575,28,107,2,4,4,10,At Risk
86276,573,16,67,2,3,4,9,Casual Users
86667,92,68,88,4,5,4,13,Champions
87419,236,37,41,3,4,3,10,Loyal Users
87428,313,43,161,3,4,5,12,Loyal Users
87695,403,7,14,3,2,1,6,Casual Users
87772,125,16,27,4,3,2,9,Loyal Users
87809,96,19,36,4,3,3,10,Loyal Users
87939,3586,5,12,1,1,1,3,Lost
87970,96,51,104,4,5,4,13,Champions
88058,9,152,344,5,5,5,15,Champions
88147,314,12,14,3,3,1,7,Loyal Users
88170,69,62,151,5,5,5,15,Champions
88677,2152,6,30,1,1,2,4,Lost
88763,23,13,16,5,3,2,10,Loyal Users
88858,96,127,868,4,5,5,14,Champions
89042,29,15,28,5,3,2,10,Loyal Users
89407,267,13,46,3,3,3,9,Loyal Users
89795,140,16,27,4,3,2,9,Loyal Users
89870,417,7,18,3,2,2,7,Casual Users
90086,40,24,36,5,4,3,12,Loyal Users
90508,89,22,172,4,4,5,13,Champions
90582,266,43,110,3,4,4,11,Loyal Users
90807,1139,18,38,2,3,3,8,Casual Users
90878,569,9,102,2,2,4,8,Lost
78436,160,13,119,4,3,4,11,Loyal Users
78533,56,27,174,5,4,5,14,Champions
78652,2575,6,8,1,1,1,3,Lost
79078,91,8,14,4,2,1,7,Promising
79226,309,62,172,3,5,5,13,Loyal Users
79333,490,33,224,2,4,5,11,At Risk
79479,50,25,39,5,4,3,12,Loyal Users
79666,109,69,199,4,5,5,14,Champions
79855,109,10,62,4,2,3,9,Promising
80001,73,22,123,4,4,4,12,Champions
80391,1417,7,10,1,2,1,4,Lost
80418,125,57,200,4,5,5,14,Champions
80634,15,26,50,5,4,3,12,Loyal Users
80869,4148,5,19,1,1,2,4,Lost
81002,232,32,120,3,4,4,11,Loyal Users
81106,999,5,8,2,1,1,4,Lost
81168,176,89,354,3,5,5,13,Loyal Users
81604,199,29,40,3,4,3,10,Loyal Users
81769,26,13,18,5,3,2,10,Loyal Users
81897,4704,6,10,1,1,1,3,Lost
82045,1268,15,80,1,3,4,8,Casual Users
82109,2314,5,10,1,1,1,3,Lost
82312,67,49,101,5,5,4,14,Champions
82406,857,9,11,2,2,1,5,Lost
82683,602,47,103,2,5,4,11,At Risk
82858,1502,30,105,1,4,4,9,At Risk
83651,2567,8,9,1,2,1,4,Lost
83704,49,131,213,5,5,5,15,Champions
83812,148,5,22,4,1,2,7,Promising
84156,660,17,48,2,3,3,8,Casual Users
84246,161,12,34,4,3,3,10,Loyal Users
84365,118,20,53,4,3,3,10,Loyal Users
84500,112,19,86,4,3,4,11,Loyal Users
84606,812,5,39,2,1,3,6,Lost
84863,680,6,16,2,1,2,5,Lost
85122,52,50,70,5,5,4,14,Champions
85409,841,29,124,2,4,4,10,At Risk
85462,108,58,143,4,5,4,13,Champions
85532,3287,10,34,1,2,3,6,Lost
85533,5170,5,9,1,1,1,3,Lost
85698,3087,6,12,1,1,1,3,Lost
85966,5376,5,6,1,1,1,3,Lost
86477,427,15,25,3,3,2,8,Loyal Users
86516,969,63,290,2,5,5,12,At Risk
86522,116,41,219,4,4,5,13,Champions
86542,3930,5,32,1,1,3,5,Lost
86654,101,66,254,4,5,5,14,Champions
86655,2992,6,15,1,1,1,3,Lost
86787,2120,11,62,1,2,3,6,Lost
86972,72,18,49,4,3,3,10,Loyal Users
86981,483,56,110,2,5,4,11,At Risk
87164,3200,15,74,1,3,4,8,Casual Users
87223,126,69,186,4,5,5,14,Champions
87227,322,71,125,3,5,4,12,Loyal Users
87566,29,31,105,5,4,4,13,Champions
87623,30,22,55,5,4,3,12,Loyal Users
87753,147,26,91,4,4,4,12,Champions
87831,4697,9,9,1,2,1,4,Lost
87889,1,73,164,5,5,5,15,Champions
88097,1192,10,56,2,2,3,7,Lost
88262,270,12,15,3,3,1,7,Loyal Users
88329,128,22,48,4,4,3,11,Loyal Users
88492,26,181,302,5,5,5,15,Champions
89388,389,20,46,3,3,3,9,Loyal Users
89731,760,9,9,2,2,1,5,Lost
89849,114,52,327,4,5,5,14,Champions
89936,1226,5,36,2,1,3,6,Lost
89980,49,7,20,5,2,2,9,Promising
90101,277,34,49,3,4,3,10,Loyal Users
90106,161,14,29,4,3,2,9,Loyal Users
90251,3623,9,9,1,2,1,4,Lost
90693,1599,6,13,1,1,1,3,Lost
90735,54,22,131,5,4,4,13,Champions
90935,379,6,6,3,1,1,5,Casual Users
90945,831,32,117,2,4,4,10,At Risk
90958,641,24,66,2,4,4,10,At Risk
78302,124,7,12,4,2,1,7,Promising
78372,4588,5,7,1,1,1,3,Lost
78457,3392,10,28,1,2,2,5,Lost
78525,43,48,138,5,5,4,14,Champions
78708,439,5,5,3,1,1,5,Casual Users
78848,1717,7,9,1,2,1,4,Lost
78949,424,11,46,3,2,3,8,Casual Users
79068,4699,7,11,1,2,1,4,Lost
79279,228,33,43,3,4,3,10,Loyal Users
79440,130,12,54,4,3,3,10,Loyal Users
79468,141,16,72,4,3,4,11,Loyal Users
79561,160,22,55,4,4,3,11,Loyal Users
79604,18,24,71,5,4,4,13,Champions
80115,288,26,74,3,4,4,11,Loyal Users
80164,10,117,443,5,5,5,15,Champions
80318,418,46,136,3,5,4,12,Loyal Users
80472,561,11,25,2,2,2,6,Lost
80648,101,23,35,4,4,3,11,Loyal Users
80696,232,16,55,3,3,3,9,Loyal Users
80749,425,50,131,3,5,4,12,Loyal Users
81029,4,21,33,5,3,3,11,Loyal Users
81103,136,30,63,4,4,4,12,Champions
81253,4584,5,9,1,1,1,3,Lost
81255,17,37,93,5,4,4,13,Champions
81339,135,25,67,4,4,4,12,Champions
81489,618,48,267,2,5,5,12,At Risk
81575,6029,8,8,1,2,1,4,Lost
81657,977,12,66,2,3,4,9,Casual Users
81953,145,6,35,4,1,3,8,Promising
82130,60,8,11,5,2,1,8,Promising
82564,406,10,35,3,2,3,8,Casual Users
82710,1851,137,240,1,5,5,11,At Risk
82734,151,7,24,4,2,2,8,Promising
82862,148,5,13,4,1,1,6,Promising
83181,658,26,71,2,4,4,10,At Risk
83403,110,49,101,4,5,4,13,Champions
83462,399,35,170,3,4,5,12,Loyal Users
83560,19,5,6,5,1,1,7,Promising
83772,1329,30,50,1,4,3,8,At Risk
83907,11,81,119,5,5,4,14,Champions
83913,1547,13,54,1,3,3,7,Casual Users
84008,2464,9,17,1,2,2,5,Lost
84784,1687,7,7,1,2,1,4,Lost
84808,2288,15,37,1,3,3,7,Casual Users
84837,704,13,19,2,3,2,7,Casual Users
85109,39,67,286,5,5,5,15,Champions
85457,7,6,9,5,1,1,7,Promising
85652,411,10,23,3,2,2,7,Casual Users
85655,59,26,40,5,4,3,12,Loyal Users
85814,881,36,336,2,4,5,11,At Risk
85832,2,15,72,5,3,4,12,Loyal Users
86212,2062,15,66,1,3,4,8,Casual Users
86626,93,85,304,4,5,5,14,Champions
86722,9,35,61,5,4,3,12,Loyal Users
86832,552,8,16,2,2,2,6,Lost
87380,7,244,364,5,5,5,15,Champions
88425,50,65,164,5,5,5,15,Champions
88485,432,15,27,3,3,2,8,Loyal Users
88682,645,31,81,2,4,4,10,At Risk
89498,420,9,25,3,2,2,7,Casual Users
89562,72,57,96,4,5,4,13,Champions
89762,2478,6,24,1,1,2,4,Lost
89770,147,9,19,4,2,2,8,Promising
90063,1644,39,94,1,4,4,9,At Risk
90648,14,15,112,5,3,4,12,Loyal Users
90783,3276,7,8,1,2,1,4,Lost
90877,2238,8,41,1,2,3,6,Lost
78508,66,13,19,5,3,2,10,Loyal Users
78530,176,10,12,3,2,1,6,Casual Users
78617,84,58,375,4,5,5,14,Champions
78695,1454,19,30,1,3,2,6,Casual Users
79342,509,12,37,2,3,3,8,Casual Users
79615,2,87,232,5,5,5,15,Champions
79864,2235,8,9,1,2,1,4,Lost
79981,26,96,318,5,5,5,15,Champions
80071,5,69,196,5,5,5,15,Champions
80209,130,35,91,4,4,4,12,Champions
80232,21,83,130,5,5,4,14,Champions
80345,4153,5,8,1,1,1,3,Lost
80524,126,7,28,4,2,2,8,Promising
80533,77,66,93,4,5,4,13,Champions
80540,137,23,69,4,4,4,12,Champions
80607,1164,7,8,2,2,1,5,Lost
80633,1726,8,21,1,2,2,5,Lost
81073,915,7,8,2,2,1,5,Lost
81152,15,66,405,5,5,5,15,Champions
81552,2950,21,97,1,3,4,8,Casual Users
81638,985,6,9,2,1,1,4,Lost
82205,2273,11,56,1,2,3,6,Lost
82514,367,14,17,3,3,2,8,Loyal Users
82867,84,67,212,4,5,5,14,Champions
82942,431,7,10,3,2,1,6,Casual Users
83139,966,18,65,2,3,4,9,Casual Users
83245,426,29,47,3,4,3,10,Loyal Users
83368,107,14,36,4,3,3,10,Loyal Users
83377,412,13,90,3,3,4,10,Loyal Users
83696,78,9,13,4,2,1,7,Promising
84594,2947,5,19,1,1,2,4,Lost
84913,132,44,239,4,4,5,13,Champions
84973,293,45,77,3,4,4,11,Loyal Users
85174,3265,9,23,1,2,2,5,Lost
85436,261,43,245,3,4,5,12,Loyal Users
86413,575,8,55,2,2,3,7,Lost
87125,209,18,103,3,3,4,10,Loyal Users
87204,826,19,166,2,3,5,10,Casual Users
87319,299,29,174,3,4,5,12,Loyal Users
87700,28,10,90,5,2,4,11,Promising
87711,514,6,19,2,1,2,5,Lost
87717,97,27,33,4,4,3,11,Loyal Users
87890,33,17,42,5,3,3,11,Loyal Users
87901,1278,7,16,1,2,2,5,Lost
87975,742,12,27,2,3,2,7,Casual Users
88330,20,9,16,5,2,2,9,Promising
88346,539,9,60,2,2,3,7,Lost
88400,1087,44,153,2,4,5,11,At Risk
88430,146,93,344,4,5,5,14,Champions
88822,451,29,54,3,4,3,10,Loyal Users
88828,259,9,27,3,2,2,7,Casual Users
89007,413,6,10,3,1,1,5,Casual Users
89179,415,9,24,3,2,2,7,Casual Users
89228,262,42,217,3,4,5,12,Loyal Users
89413,2754,34,34,1,4,3,8,At Risk
89573,94,79,132,4,5,4,13,Champions
89800,967,5,34,2,1,3,6,Lost
89826,200,37,59,3,4,3,10,Loyal Users
89836,1458,10,29,1,2,2,5,Lost
89960,8,18,62,5,3,3,11,Loyal Users
89967,36,83,568,5,5,5,15,Champions
90128,1442,23,37,1,4,3,8,At Risk
90132,1395,58,344,1,5,5,11,At Risk
78503,52,25,80,5,4,4,13,Champions
78819,57,7,15,5,2,1,8,Promising
78958,2058,23,68,1,4,4,9,At Risk
79741,166,120,487,3,5,5,13,Loyal Users
79771,3,108,190,5,5,5,15,Champions
79772,3538,5,75,1,1,4,6,Lost
80213,604,114,207,2,5,5,12,At Risk
80267,90,15,38,4,3,3,10,Loyal Users
80411,5,153,239,5,5,5,15,Champions
80429,234,18,43,3,3,3,9,Loyal Users
80617,1447,13,22,1,3,2,6,Casual Users
80946,420,8,18,3,2,2,7,Casual Users
80975,689,10,31,2,2,2,6,Lost
81147,7,16,50,5,3,3,11,Loyal Users
81268,96,33,98,4,4,4,12,Champions
81413,31,84,197,5,5,5,15,Champions
81490,3923,7,16,1,2,2,5,Lost
81816,13,70,131,5,5,4,14,Champions
82127,2840,7,13,1,2,1,4,Lost
82366,121,42,137,4,4,4,12,Champions
82518,83,77,247,4,5,5,14,Champions
82679,348,10,54,3,2,3,8,Casual Users
82761,44,65,406,5,5,5,15,Champions
82840,56,65,257,5,5,5,15,Champions
82926,404,5,5,3,1,1,5,Casual Users
83147,3595,5,6,1,1,1,3,Lost
83153,1414,86,235,1,5,5,11,At Risk
83183,15,77,493,5,5,5,15,Champions
83352,224,26,113,3,4,4,11,Loyal Users
83550,696,7,11,2,2,1,5,Lost
83627,4664,13,14,1,3,1,5,Casual Users
83823,71,7,21,4,2,2,8,Promising
83876,8,9,31,5,2,2,9,Promising
84006,855,12,23,2,3,2,7,Casual Users
84101,6,37,56,5,4,3,12,Loyal Users
84369,36,22,90,5,4,4,13,Champions
84689,2247,10,19,1,2,2,5,Lost
84798,126,49,66,4,5,4,13,Champions
84824,1529,11,15,1,2,1,4,Lost
84879,651,15,24,2,3,2,7,Casual Users
85760,137,7,7,4,2,1,7,Promising
85804,4834,6,25,1,1,2,4,Lost
85816,2035,6,15,1,1,1,3,Lost
85846,24,23,55,5,4,3,12,Loyal Users
86523,2081,14,30,1,3,2,6,Casual Users
86616,45,88,787,5,5,5,15,Champions
86835,133,62,105,4,5,4,13,Champions
86842,421,7,11,3,2,1,6,Casual Users
86975,808,15,24,2,3,2,7,Casual Users
87094,104,69,228,4,5,5,14,Champions
87146,39,9,30,5,2,2,9,Promising
87245,220,8,10,3,2,1,6,Casual Users
87546,278,33,117,3,4,4,11,Loyal Users
88082,125,10,20,4,2,2,8,Promising
88167,847,20,45,2,3,3,8,Casual Users
88884,442,30,136,3,4,4,11,Loyal Users
89053,1854,8,15,1,2,1,4,Lost
89429,243,14,69,3,3,4,10,Loyal Users
90560,20,23,32,5,4,3,12,Loyal Users
90747,3792,8,16,1,2,2,5,Lost
78308,101,39,66,4,4,4,12,Champions
78361,649,19,36,2,3,3,8,Casual Users
79026,1105,32,106,2,4,4,10,At Risk
79216,538,8,71,2,2,4,8,Lost
79384,0,107,696,5,5,5,15,Champions
79499,441,5,21,3,1,2,6,Casual Users
79971,3355,5,7,1,1,1,3,Lost
80112,124,48,61,4,5,3,12,Loyal Users
80143,332,6,13,3,1,1,5,Casual Users
80325,281,13,34,3,3,3,9,Loyal Users
80350,675,77,141,2,5,4,11,At Risk
80720,3538,26,64,1,4,4,9,At Risk
80734,396,6,7,3,1,1,5,Casual Users
80842,2924,14,50,1,3,3,7,Casual Users
80846,747,38,88,2,4,4,10,At Risk
80924,658,23,83,2,4,4,10,At Risk
81281,411,5,7,3,1,1,5,Casual Users
81458,1204,36,50,2,4,3,9,At Risk
81598,190,24,76,3,4,4,11,Loyal Users
81771,136,46,179,4,5,5,14,Champions
81909,138,10,26,4,2,2,8,Promising
81943,3,72,146,5,5,4,14,Champions
82168,17,12,19,5,3,2,10,Loyal Users
82188,54,10,21,5,2,2,9,Promising
82569,77,45,172,4,4,5,13,Champions
83563,43,39,154,5,4,5,14,Champions
83605,656,22,107,2,4,4,10,At Risk
83643,904,6,13,2,1,1,4,Lost
83672,280,24,70,3,4,4,11,Loyal Users
83926,864,37,76,2,4,4,10,At Risk
84051,178,5,9,3,1,1,5,Casual Users
84129,573,27,63,2,4,4,10,At Risk
84291,53,52,73,5,5,4,14,Champions
84315,62,34,64,5,4,4,13,Champions
84339,5,98,674,5,5,5,15,Champions
84428,592,17,97,2,3,4,9,Casual Users
84502,0,13,42,5,3,3,11,Loyal Users
84632,145,16,44,4,3,3,10,Loyal Users
85057,160,9,22,4,2,2,8,Promising
85180,283,44,70,3,4,4,11,Loyal Users
85479,577,19,93,2,3,4,9,Casual Users
86187,80,29,44,4,4,3,11,Loyal Users
86293,4,29,50,5,4,3,12,Loyal Users
86790,9,66,113,5,5,4,14,Champions
87186,545,9,18,2,2,2,6,Lost
87282,10,119,293,5,5,5,15,Champions
87291,219,26,34,3,4,3,10,Loyal Users
87366,769,5,39,2,1,3,6,Lost
87410,3539,6,11,1,1,1,3,Lost
87472,2012,46,70,1,5,4,10,At Risk
87640,657,32,44,2,4,3,9,At Risk
87744,2115,5,29,1,1,2,4,Lost
87933,325,13,20,3,3,2,8,Loyal Users
87981,8,82,210,5,5,5,15,Champions
88433,11,71,229,5,5,5,15,Champions
88468,988,15,25,2,3,2,7,Casual Users
88518,15,48,74,5,5,4,14,Champions
88969,2968,9,13,1,2,1,4,Lost
89530,335,18,82,3,3,4,10,Loyal Users
89819,2273,8,12,1,2,1,4,Lost
90364,233,57,206,3,5,5,13,Loyal Users
90566,72,109,152,4,5,5,14,Champions
90852,8,37,142,5,4,4,13,Champions
90857,132,102,325,4,5,5,14,Champions
78351,101,16,41,4,3,3,10,Loyal Users
78434,2281,5,13,1,1,1,3,Lost
78630,248,22,57,3,4,3,10,Loyal Users
78688,8,92,265,5,5,5,15,Champions
78789,290,6,25,3,1,2,6,Casual Users
78870,51,113,545,5,5,5,15,Champions
79037,1719,20,80,1,3,4,8,Casual Users
79096,142,7,59,4,2,3,9,Promising
79236,1843,6,19,1,1,2,4,Lost
79336,292,6,54,3,1,3,7,Casual Users
79435,437,33,63,3,4,4,11,Loyal Users
79799,58,28,65,5,4,4,13,Champions
79926,145,115,179,4,5,5,14,Champions
79974,4,18,73,5,3,4,12,Loyal Users
79977,680,14,133,2,3,4,9,Casual Users
80127,706,30,137,2,4,4,10,At Risk
80171,3591,24,57,1,4,3,8,At Risk
80374,19,45,197,5,4,5,14,Champions
80444,691,77,219,2,5,5,12,At Risk
80610,5581,14,18,1,3,2,6,Casual Users
80917,3253,11,21,1,2,2,5,Lost
81136,275,20,65,3,3,4,10,Loyal Users
81632,459,6,55,3,1,3,7,Casual Users
81796,106,42,221,4,4,5,13,Champions
81869,71,177,574,4,5,5,14,Champions
82048,119,122,307,4,5,5,14,Champions
82095,2098,6,7,1,1,1,3,Lost
82598,692,5,5,2,1,1,4,Lost
82694,5,110,997,5,5,5,15,Champions
83559,436,39,77,3,4,4,11,Loyal Users
83573,726,7,7,2,2,1,5,Lost
83740,472,6,27,2,1,2,5,Lost
83773,422,14,26,3,3,2,8,Loyal Users
83838,3,25,59,5,4,3,12,Loyal Users
83942,122,80,347,4,5,5,14,Champions
84060,1,47,182,5,5,5,15,Champions
84153,224,27,150,3,4,5,12,Loyal Users
84308,3725,6,16,1,1,2,4,Lost
84377,1651,22,53,1,4,3,8,At Risk
84451,439,5,8,3,1,1,5,Casual Users
84611,78,9,27,4,2,2,8,Promising
84640,157,21,29,4,3,2,9,Loyal Users
84649,137,70,155,4,5,5,14,Champions
84917,86,143,525,4,5,5,14,Champions
85047,429,7,35,3,2,3,8,Casual Users
85056,101,92,252,4,5,5,14,Champions
85269,1951,17,19,1,3,2,6,Casual Users
85356,70,99,331,4,5,5,14,Champions
85445,127,59,181,4,5,5,14,Champions
85492,150,80,142,4,5,4,13,Champions
85527,432,7,10,3,2,1,6,Casual Users
85779,1199,37,154,2,4,5,11,At Risk
85882,1437,5,7,1,1,1,3,Lost
86076,374,26,39,3,4,3,10,Loyal Users
86145,224,9,12,3,2,1,6,Casual Users
86474,417,11,34,3,2,3,8,Casual Users
87203,0,83,442,5,5,5,15,Champions
87403,4782,6,26,1,1,2,4,Lost
87622,10,159,333,5,5,5,15,Champions
87691,25,96,201,5,5,5,15,Champions
87732,124,53,89,4,5,4,13,Champions
88230,2088,11,15,1,2,1,4,Lost
88315,15,96,548,5,5,5,15,Champions
88326,321,14,33,3,3,3,9,Loyal Users
88451,560,12,18,2,3,2,7,Casual Users
88601,128,16,234,4,3,5,12,Loyal Users
88865,230,11,20,3,2,2,7,Casual Users
89593,50,13,29,5,3,2,10,Loyal Users
89610,2471,5,5,1,1,1,3,Lost
89622,1048,5,7,2,1,1,4,Lost
89674,710,32,42,2,4,3,9,At Risk
89909,1951,19,43,1,3,3,7,Casual Users
90114,992,9,53,2,2,3,7,Lost
90562,15,139,314,5,5,5,15,Champions
90601,2,29,70,5,4,4,13,Champions
90632,743,8,9,2,2,1,5,Lost
90645,702,10,14,2,2,1,5,Lost
90654,329,20,39,3,3,3,9,Loyal Users
90685,4841,13,18,1,3,2,6,Casual Users
90805,6,9,29,5,2,2,9,Promising
91032,1009,11,24,2,2,2,6,Lost
91066,1198,10,40,2,2,3,7,Lost
78441,143,39,162,4,4,5,13,Champions
78571,38,82,206,5,5,5,15,Champions
78647,94,13,36,4,3,3,10,Loyal Users
79172,1495,8,13,1,2,1,4,Lost
79215,3146,6,21,1,1,2,4,Lost
79797,183,72,241,3,5,5,13,Loyal Users
79817,80,123,310,4,5,5,14,Champions
80019,96,9,31,4,2,2,8,Promising
80194,1021,12,45,2,3,3,8,Casual Users
80251,113,46,86,4,5,4,13,Champions
80445,113,45,333,4,4,5,13,Champions
80757,248,16,27,3,3,2,8,Loyal Users
80814,110,6,11,4,1,1,6,Promising
80822,111,137,318,4,5,5,14,Champions
80912,1084,10,20,2,2,2,6,Lost
80976,453,10,33,3,2,3,8,Casual Users
81171,163,16,127,4,3,4,11,Loyal Users
81180,109,17,40,4,3,3,10,Loyal Users
81227,768,21,36,2,3,3,8,Casual Users
81467,134,26,36,4,4,3,11,Loyal Users
81717,275,15,17,3,3,2,8,Loyal Users
81975,1976,5,7,1,1,1,3,Lost
82040,409,5,57,3,1,3,7,Casual Users
82100,19,64,146,5,5,4,14,Champions
82273,209,8,11,3,2,1,6,Casual Users
82441,129,13,15,4,3,1,8,Loyal Users
83217,1124,8,11,2,2,1,5,Lost
83716,41,41,249,5,4,5,14,Champions
83720,5453,5,5,1,1,1,3,Lost
83927,2602,18,29,1,3,2,6,Casual Users
84126,587,7,13,2,2,1,5,Lost
84269,2808,7,8,1,2,1,4,Lost
84516,3816,6,24,1,1,2,4,Lost
84581,150,18,67,4,3,4,11,Loyal Users
84972,707,14,26,2,3,2,7,Casual Users
85094,511,5,19,2,1,2,5,Lost
85535,1,73,160,5,5,5,15,Champions
85562,668,6,22,2,1,2,5,Lost
85570,2037,9,25,1,2,2,5,Lost
85732,443,27,124,3,4,4,11,Loyal Users
85968,80,11,22,4,2,2,8,Promising
85991,104,65,161,4,5,5,14,Champions
86085,1580,6,60,1,1,3,5,Lost
86137,411,21,29,3,3,2,8,Loyal Users
86203,1612,7,8,1,2,1,4,Lost
86339,59,12,24,5,3,2,10,Loyal Users
86423,842,5,8,2,1,1,4,Lost
86635,131,22,140,4,4,4,12,Champions
86691,3160,11,19,1,2,2,5,Lost
86820,542,41,261,2,4,5,11,At Risk
87170,34,10,14,5,2,1,8,Promising
87392,139,92,353,4,5,5,14,Champions
87574,605,18,41,2,3,3,8,Casual Users
87954,409,7,12,3,2,1,6,Casual Users
87966,59,109,233,5,5,5,15,Champions
88066,107,29,36,4,4,3,11,Loyal Users
88177,81,21,36,4,3,3,10,Loyal Users
88668,274,14,38,3,3,3,9,Loyal Users
88675,807,6,9,2,1,1,4,Lost
88889,2706,8,12,1,2,1,4,Lost
88899,31,50,92,5,5,4,14,Champions
89022,41,18,40,5,3,3,11,Loyal Users
89408,47,109,468,5,5,5,15,Champions
89603,138,9,29,4,2,2,8,Promising
89640,159,5,6,4,1,1,6,Promising
89684,88,75,123,4,5,4,13,Champions
89744,53,17,25,5,3,2,10,Loyal Users
89991,147,29,102,4,4,4,12,Champions
90225,0,62,122,5,5,4,14,Champions
90313,124,84,147,4,5,5,14,Champions
90375,227,16,25,3,3,2,8,Loyal Users
90394,532,35,82,2,4,4,10,At Risk
90413,4012,11,20,1,2,2,5,Lost
90669,4413,26,84,1,4,4,9,At Risk
78389,926,6,16,2,1,2,5,Lost
78431,6,8,26,5,2,2,9,Promising
78901,465,16,23,3,3,2,8,Loyal Users
79331,806,8,32,2,2,3,7,Lost
79425,703,31,74,2,4,4,10,At Risk
80088,8,16,162,5,3,5,13,Loyal Users
80268,1212,7,21,2,2,2,6,Lost
80293,417,101,383,3,5,5,13,Loyal Users
80406,420,15,27,3,3,2,8,Loyal Users
80407,1528,8,17,1,2,2,5,Lost
80654,326,18,50,3,3,3,9,Loyal Users
80789,514,44,93,2,4,4,10,At Risk
80889,7,227,593,5,5,5,15,Champions
80899,169,8,19,3,2,2,7,Casual Users
81016,1288,14,25,1,3,2,6,Casual Users
81153,2012,5,17,1,1,2,4,Lost
81242,1413,8,46,1,2,3,6,Lost
81523,2005,10,26,1,2,2,5,Lost
81574,217,12,109,3,3,4,10,Loyal Users
81995,2384,24,52,1,4,3,8,At Risk
82645,272,13,66,3,3,4,10,Loyal Users
83367,421,5,12,3,1,1,5,Casual Users
83946,291,36,114,3,4,4,11,Loyal Users
84148,2994,7,20,1,2,2,5,Lost
84179,0,23,52,5,4,3,12,Loyal Users
84285,1161,8,46,2,2,3,7,Lost
84474,1341,12,13,1,3,1,5,Casual Users
84564,125,22,90,4,4,4,12,Champions
84566,1571,12,17,1,3,2,6,Casual Users
85791,5021,10,14,1,2,1,4,Lost
85981,1496,9,34,1,2,3,6,Lost
86159,3728,18,55,1,3,3,7,Casual Users
86334,29,25,56,5,4,3,12,Loyal Users
86466,26,92,265,5,5,5,15,Champions
86589,694,20,47,2,3,3,8,Casual Users
86697,819,7,15,2,2,1,5,Lost
86726,29,127,182,5,5,5,15,Champions
86822,306,20,46,3,3,3,9,Loyal Users
87197,425,45,108,3,4,4,11,Loyal Users
87344,1471,33,119,1,4,4,9,At Risk
87367,1235,10,11,2,2,1,5,Lost
87489,915,12,36,2,3,3,8,Casual Users
87630,118,76,226,4,5,5,14,Champions
87643,1,137,312,5,5,5,15,Champions
88004,54,31,76,5,4,4,13,Champions
88113,2043,6,22,1,1,2,4,Lost
88206,1624,8,16,1,2,2,5,Lost
88216,2,70,365,5,5,5,15,Champions
88266,4998,6,16,1,1,2,4,Lost
88270,1136,5,10,2,1,1,4,Lost
88507,3580,7,45,1,2,3,6,Lost
88735,248,71,105,3,5,4,12,Loyal Users
88850,14,52,94,5,5,4,14,Champions
88905,118,58,162,4,5,5,14,Champions
89443,536,6,11,2,1,1,4,Lost
89751,240,17,41,3,3,3,9,Loyal Users
90089,934,6,6,2,1,1,4,Lost
78448,301,17,95,3,3,4,10,Loyal Users
78479,86,5,21,4,1,2,7,Promising
78717,3,65,333,5,5,5,15,Champions
78749,1014,8,8,2,2,1,5,Lost
78970,19,17,49,5,3,3,11,Loyal Users
78996,1,46,169,5,5,5,15,Champions
79275,1297,7,37,1,2,3,6,Lost
79310,206,17,219,3,3,5,11,Loyal Users
79433,111,25,146,4,4,4,12,Champions
79461,159,9,35,4,2,3,9,Promising
79490,661,13,21,2,3,2,7,Casual Users
80012,430,5,29,3,1,2,6,Casual Users
80049,5,101,533,5,5,5,15,Champions
80488,120,70,216,4,5,5,14,Champions
80563,731,9,27,2,2,2,6,Lost
80701,82,44,181,4,4,5,13,Champions
80711,102,19,42,4,3,3,10,Loyal Users
81221,529,24,37,2,4,3,9,At Risk
81700,1976,9,25,1,2,2,5,Lost
81718,3653,12,25,1,3,2,6,Casual Users
81738,287,7,31,3,2,2,7,Casual Users
82590,94,64,252,4,5,5,14,Champions
82814,388,15,26,3,3,2,8,Loyal Users
83327,165,28,64,4,4,4,12,Champions
83558,3,28,157,5,4,5,14,Champions
83817,533,6,12,2,1,1,4,Lost
83966,64,20,28,5,3,2,10,Loyal Users
84114,110,62,184,4,5,5,14,Champions
84373,537,40,121,2,4,4,10,At Risk
84497,4,26,62,5,4,3,12,Loyal Users
84705,3003,6,9,1,1,1,3,Lost
84793,2847,19,73,1,3,4,8,Casual Users
84854,106,8,11,4,2,1,7,Promising
85114,1546,10,10,1,2,1,4,Lost
85179,542,7,17,2,2,2,6,Lost
85190,8,43,173,5,4,5,14,Champions
85375,527,16,134,2,3,4,9,Casual Users
85765,634,14,16,2,3,2,7,Casual Users
86173,4100,9,13,1,2,1,4,Lost
86456,746,26,123,2,4,4,10,At Risk
86804,221,28,36,3,4,3,10,Loyal Users
87182,135,79,150,4,5,5,14,Champions
87398,46,34,57,5,4,3,12,Loyal Users
87593,409,30,158,3,4,5,12,Loyal Users
87943,1425,8,11,1,2,1,4,Lost
88332,10,24,142,5,4,4,13,Champions
88397,242,81,123,3,5,4,12,Loyal Users
88398,164,5,7,4,1,1,6,Promising
88896,3405,22,106,1,4,4,9,At Risk
88911,417,31,141,3,4,4,11,Loyal Users
89130,644,33,125,2,4,4,10,At Risk
89298,124,22,45,4,4,3,11,Loyal Users
89318,215,6,7,3,1,1,5,Casual Users
89782,16,70,123,5,5,4,14,Champions
89790,783,62,298,2,5,5,12,At Risk
90221,87,23,39,4,4,3,11,Loyal Users
90223,115,43,123,4,4,4,12,Champions
90277,82,53,102,4,5,4,13,Champions
90320,6,6,9,5,1,1,7,Promising
90522,68,40,87,5,4,4,13,Champions
90902,856,16,36,2,3,3,8,Casual Users
90933,1138,5,13,2,1,1,4,Lost
91043,30,14,53,5,3,3,11,Loyal Users
78410,1208,65,413,2,5,5,12,At Risk
78507,512,88,220,2,5,5,12,At Risk
78759,46,55,136,5,5,4,14,Champions
78883,565,18,24,2,3,2,7,Casual Users
78894,613,6,7,2,1,1,4,Lost
79243,3293,12,18,1,3,2,6,Casual Users
79780,1115,24,33,2,4,3,9,At Risk
80438,3,112,397,5,5,5,15,Champions
80612,307,39,120,3,4,4,11,Loyal Users
81411,1650,15,27,1,3,2,6,Casual Users
81451,2448,6,7,1,1,1,3,Lost
81720,273,54,270,3,5,5,13,Loyal Users
82461,81,121,493,4,5,5,14,Champions
82742,239,41,96,3,4,4,11,Loyal Users
82873,26,21,252,5,3,5,13,Loyal Users
83041,1511,8,16,1,2,2,5,Lost
83148,16,184,338,5,5,5,15,Champions
84057,23,20,42,5,3,3,11,Loyal Users
84188,516,17,31,2,3,2,7,Casual Users
84317,135,69,316,4,5,5,14,Champions
84966,30,69,415,5,5,5,15,Champions
85097,96,12,52,4,3,3,10,Loyal Users
85107,123,21,62,4,3,3,10,Loyal Users
85236,1155,14,34,2,3,3,8,Casual Users
85557,207,10,13,3,2,1,6,Casual Users
85581,712,10,17,2,2,2,6,Lost
85817,3,20,45,5,3,3,11,Loyal Users
85891,1871,9,9,1,2,1,4,Lost
85929,13,10,11,5,2,1,8,Promising
86134,31,26,125,5,4,4,13,Champions
86746,1701,7,33,1,2,3,6,Lost
87022,411,8,23,3,2,2,7,Casual Users
87153,260,66,214,3,5,5,13,Loyal Users
87358,390,6,48,3,1,3,7,Casual Users
87395,2406,6,22,1,1,2,4,Lost
87457,764,53,83,2,5,4,11,At Risk
87842,1958,8,8,1,2,1,4,Lost
87860,258,15,49,3,3,3,9,Loyal Users
87903,19,28,53,5,4,3,12,Loyal Users
87980,14,76,160,5,5,5,15,Champions
88241,304,46,61,3,5,3,11,Loyal Users
88577,260,10,24,3,2,2,7,Casual Users
89238,189,13,77,3,3,4,10,Loyal Users
89307,9,14,26,5,3,2,10,Loyal Users
89346,990,5,20,2,1,2,5,Lost
90001,76,26,72,4,4,4,12,Champions
90183,416,5,12,3,1,1,5,Casual Users
90336,835,28,201,2,4,5,11,At Risk
90409,129,73,191,4,5,5,14,Champions
90525,685,24,105,2,4,4,10,At Risk
90700,7,165,246,5,5,5,15,Champions
90731,2954,6,27,1,1,2,4,Lost
91027,26,96,294,5,5,5,15,Champions
78649,61,20,65,5,3,4,12,Loyal Users
78760,14,22,31,5,4,2,11,Loyal Users
79010,122,31,73,4,4,4,12,Champions
79517,579,6,11,2,1,1,4,Lost
79651,553,18,29,2,3,2,7,Casual Users
79713,420,9,31,3,2,2,7,Casual Users
80737,13,91,306,5,5,5,15,Champions
80798,433,6,11,3,1,1,5,Casual Users
80998,8,28,114,5,4,4,13,Champions
81393,7,116,400,5,5,5,15,Champions
81399,140,39,151,4,4,5,13,Champions
81440,306,16,87,3,3,4,10,Loyal Users
81980,600,8,16,2,2,2,6,Lost
82033,2439,5,8,1,1,1,3,Lost
82072,305,71,130,3,5,4,12,Loyal Users
82786,2224,11,22,1,2,2,5,Lost
82834,1840,5,7,1,1,1,3,Lost
83892,12,52,147,5,5,5,15,Champions
83977,256,33,49,3,4,3,10,Loyal Users
84669,1706,8,23,1,2,2,5,Lost
84829,1410,6,28,1,1,2,4,Lost
85084,141,20,26,4,3,2,9,Loyal Users
85102,371,7,30,3,2,2,7,Casual Users
85333,227,14,150,3,3,5,11,Loyal Users
85358,3085,12,75,1,3,4,8,Casual Users
85437,542,6,8,2,1,1,4,Lost
86092,67,172,638,5,5,5,15,Champions
86428,41,56,152,5,5,5,15,Champions
86440,63,99,622,5,5,5,15,Champions
86846,424,16,98,3,3,4,10,Loyal Users
86896,37,92,230,5,5,5,15,Champions
87337,241,68,227,3,5,5,13,Loyal Users
87400,216,7,53,3,2,3,8,Casual Users
87828,13,30,51,5,4,3,12,Loyal Users
87978,17,82,139,5,5,4,14,Champions
87994,1136,8,10,2,2,1,5,Lost
88036,828,6,26,2,1,2,5,Lost
88060,111,43,332,4,4,5,13,Champions
88294,3,87,592,5,5,5,15,Champions
88645,7,18,42,5,3,3,11,Loyal Users
88953,35,78,318,5,5,5,15,Champions
88970,790,28,53,2,4,3,9,At Risk
88978,4265,5,7,1,1,1,3,Lost
89140,12,218,435,5,5,5,15,Champions
89146,1708,5,26,1,1,2,4,Lost
89162,889,5,5,2,1,1,4,Lost
89347,139,105,513,4,5,5,14,Champions
89411,118,134,682,4,5,5,14,Champions
89435,690,30,120,2,4,4,10,At Risk
89462,1701,14,29,1,3,2,6,Casual Users
89597,37,9,25,5,2,2,9,Promising
90475,82,6,21,4,1,2,7,Promising
90504,1769,12,41,1,3,3,7,Casual Users
90970,1102,18,72,2,3,4,9,Casual Users
78473,2,53,174,5,5,5,15,Champions
78593,32,5,12,5,1,1,7,Promising
79170,211,51,75,3,5,4,12,Loyal Users
79573,4366,9,14,1,2,1,4,Lost
79795,1055,14,27,2,3,2,7,Casual Users
79883,428,7,7,3,2,1,6,Casual Users
80137,132,26,49,4,4,3,11,Loyal Users
80203,30,77,258,5,5,5,15,Champions
80298,1381,37,80,1,4,4,9,At Risk
80585,132,10,18,4,2,2,8,Promising
80791,130,24,121,4,4,4,12,Champions
80962,507,8,20,2,2,2,6,Lost
81544,574,17,17,2,3,2,7,Casual Users
81586,402,65,298,3,5,5,13,Loyal Users
81714,172,14,17,3,3,2,8,Loyal Users
81947,857,31,63,2,4,4,10,At Risk
82047,43,33,61,5,4,3,12,Loyal Users
82064,156,21,52,4,3,3,10,Loyal Users
82119,1856,9,101,1,2,4,7,Lost
82149,905,14,25,2,3,2,7,Casual Users
82401,1462,5,10,1,1,1,3,Lost
82474,53,17,35,5,3,3,11,Loyal Users
82747,4264,5,7,1,1,1,3,Lost
82992,113,7,16,4,2,2,8,Promising
83157,351,29,143,3,4,4,11,Loyal Users
83285,15,6,28,5,1,2,8,Promising
83301,2946,5,54,1,1,3,5,Lost
83497,4,100,659,5,5,5,15,Champions
83661,127,51,147,4,5,5,14,Champions
84021,42,71,459,5,5,5,15,Champions
84034,855,16,55,2,3,3,8,Casual Users
84199,16,40,168,5,4,5,14,Champions
84292,37,20,101,5,3,4,12,Loyal Users
84411,416,6,11,3,1,1,5,Casual Users
84703,441,40,68,3,4,4,11,Loyal Users
84770,1230,5,8,2,1,1,4,Lost
84776,19,7,42,5,2,3,10,Promising
84868,7,35,114,5,4,4,13,Champions
85167,298,9,97,3,2,4,9,Casual Users
85393,2541,20,94,1,3,4,8,Casual Users
85441,550,16,30,2,3,2,7,Casual Users
86185,22,115,250,5,5,5,15,Champions
86283,254,6,13,3,1,1,5,Casual Users
86515,23,103,601,5,5,5,15,Champions
86530,81,66,213,4,5,5,14,Champions
86580,3,17,56,5,3,3,11,Loyal Users
87000,218,7,20,3,2,2,7,Casual Users
87490,779,64,90,2,5,4,11,At Risk
87662,281,18,22,3,3,2,8,Loyal Users
87913,174,41,89,3,4,4,11,Loyal Users
87940,160,14,18,4,3,2,9,Loyal Users
88274,1583,9,32,1,2,3,6,Lost
88384,889,7,36,2,2,3,7,Lost
88618,194,39,82,3,4,4,11,Loyal Users
88731,5,31,41,5,4,3,12,Loyal Users
88916,617,46,82,2,5,4,11,At Risk
89028,898,14,29,2,3,2,7,Casual Users
89033,134,9,83,4,2,4,10,Promising
89436,14,22,142,5,4,4,13,Champions
89579,10,15,69,5,3,4,12,Loyal Users
89787,2034,5,25,1,1,2,4,Lost
90463,1848,23,233,1,4,5,10,At Risk
90472,0,118,146,5,5,4,14,Champions
90880,71,27,82,4,4,4,12,Champions
90912,223,27,181,3,4,5,12,Loyal Users
91034,1160,7,10,2,2,1,5,Lost
91060,11,28,61,5,4,3,12,Loyal Users
78536,854,6,29,2,1,2,5,Lost
78551,128,43,87,4,4,4,12,Champions
78687,39,18,30,5,3,2,10,Loyal Users
78802,79,29,62,4,4,3,11,Loyal Users
78926,1067,6,13,2,1,1,4,Lost
78947,579,8,9,2,2,1,5,Lost
79646,125,34,95,4,4,4,12,Champions
79912,304,13,129,3,3,4,10,Loyal Users
79997,208,6,10,3,1,1,5,Casual Users
80229,1529,7,10,1,2,1,4,Lost
80261,1264,17,54,1,3,3,7,Casual Users
80484,407,9,16,3,2,2,7,Casual Users
80546,1807,11,18,1,2,2,5,Lost
80845,2375,7,40,1,2,3,6,Lost
80985,17,17,171,5,3,5,13,Loyal Users
81017,10,38,80,5,4,4,13,Champions
81087,1529,23,32,1,4,3,8,At Risk
81165,2843,11,22,1,2,2,5,Lost
81256,29,12,90,5,3,4,12,Loyal Users
81580,88,20,70,4,3,4,11,Loyal Users
82022,283,15,32,3,3,3,9,Loyal Users
82236,814,41,181,2,4,5,11,At Risk
82309,252,17,40,3,3,3,9,Loyal Users
82662,245,55,148,3,5,5,13,Loyal Users
83031,116,88,164,4,5,5,14,Champions
83496,59,9,36,5,2,3,10,Promising
83505,389,25,49,3,4,3,10,Loyal Users
83527,958,5,7,2,1,1,4,Lost
83677,97,50,129,4,5,4,13,Champions
83706,0,42,61,5,4,3,12,Loyal Users
83955,140,48,275,4,5,5,14,Champions
84016,5273,13,27,1,3,2,6,Casual Users
84139,8,84,343,5,5,5,15,Champions
84163,861,24,93,2,4,4,10,At Risk
84337,1008,10,23,2,2,2,6,Lost
84647,831,25,55,2,4,3,9,At Risk
84670,86,7,14,4,2,1,7,Promising
84763,5,106,148,5,5,5,15,Champions
85127,3903,7,14,1,2,1,4,Lost
85240,1000,5,15,2,1,1,4,Lost
85390,694,6,62,2,1,3,6,Lost
85537,97,7,19,4,2,2,8,Promising
85722,1983,5,7,1,1,1,3,Lost
86033,670,8,8,2,2,1,5,Lost
86049,45,22,67,5,4,4,13,Champions
86599,381,21,44,3,3,3,9,Loyal Users
86684,133,56,219,4,5,5,14,Champions
86859,90,29,198,4,4,5,13,Champions
87247,267,5,6,3,1,1,5,Casual Users
87741,71,12,30,4,3,2,9,Loyal Users
87979,131,18,36,4,3,3,10,Loyal Users
88417,464,14,51,3,3,3,9,Loyal Users
88693,685,6,15,2,1,1,4,Lost
88830,93,110,478,4,5,5,14,Champions
89141,259,8,9,3,2,1,6,Casual Users
89312,1147,17,35,2,3,3,8,Casual Users
89412,127,74,179,4,5,5,14,Champions
89648,1352,13,22,1,3,2,6,Casual Users
89983,0,113,216,5,5,5,15,Champions
90604,136,138,358,4,5,5,14,Champions
90811,608,5,13,2,1,1,4,Lost
90840,103,14,232,4,3,5,12,Loyal Users
78565,843,38,67,2,4,4,10,At Risk
78676,720,19,41,2,3,3,8,Casual Users
78923,1290,6,18,1,1,2,4,Lost
79148,112,18,29,4,3,2,9,Loyal Users
79154,288,24,113,3,4,4,11,Loyal Users
79393,1709,5,5,1,1,1,3,Lost
79621,85,36,70,4,4,4,12,Champions
79685,999,5,10,2,1,1,4,Lost
79848,37,75,186,5,5,5,15,Champions
79852,174,23,63,3,4,4,11,Loyal Users
80282,369,28,72,3,4,4,11,Loyal Users
80497,106,32,134,4,4,4,12,Champions
80583,840,9,9,2,2,1,5,Lost
80618,999,15,18,2,3,2,7,Casual Users
80624,122,129,485,4,5,5,14,Champions
80784,124,28,74,4,4,4,12,Champions
81202,1791,9,36,1,2,3,6,Lost
81752,13,66,92,5,5,4,14,Champions
81764,617,39,47,2,4,3,9,At Risk
82637,374,30,70,3,4,4,11,Loyal Users
82994,831,15,49,2,3,3,8,Casual Users
83364,879,28,112,2,4,4,10,At Risk
83724,400,14,29,3,3,2,8,Loyal Users
84088,845,7,45,2,2,3,7,Lost
84485,289,8,25,3,2,2,7,Casual Users
84544,61,44,202,5,4,5,14,Champions
84657,158,64,483,4,5,5,14,Champions
84658,4417,12,18,1,3,2,6,Casual Users
84702,220,9,21,3,2,2,7,Casual Users
85480,155,6,13,4,1,1,6,Promising
85658,110,5,7,4,1,1,6,Promising
85714,321,23,36,3,4,3,10,Loyal Users
85774,15,148,745,5,5,5,15,Champions
86133,3021,25,83,1,4,4,9,At Risk
86240,943,19,43,2,3,3,8,Casual Users
86405,440,6,40,3,1,3,7,Casual Users
86421,188,58,189,3,5,5,13,Loyal Users
86577,1125,9,25,2,2,2,6,Lost
86945,35,138,315,5,5,5,15,Champions
87131,22,12,14,5,3,1,9,Loyal Users
87581,239,5,9,3,1,1,5,Casual Users
87865,574,13,18,2,3,2,7,Casual Users
88041,2482,7,9,1,2,1,4,Lost
88229,3013,5,5,1,1,1,3,Lost
88336,911,8,14,2,2,1,5,Lost
88405,1045,39,48,2,4,3,9,At Risk
88422,3132,12,27,1,3,2,6,Casual Users
88868,14,29,45,5,4,3,12,Loyal Users
88957,277,15,22,3,3,2,8,Loyal Users
89098,5,13,54,5,3,3,11,Loyal Users
89118,5,60,87,5,5,4,14,Champions
89305,614,9,9,2,2,1,5,Lost
89448,1976,5,9,1,1,1,3,Lost
89569,0,103,212,5,5,5,15,Champions
89667,348,9,10,3,2,1,6,Casual Users
89793,158,23,29,4,4,2,10,Loyal Users
89860,857,5,59,2,1,3,6,Lost
89945,3529,6,11,1,1,1,3,Lost
90141,5636,6,7,1,1,1,3,Lost
90171,149,8,17,4,2,2,8,Promising
90330,2280,6,9,1,1,1,3,Lost
90369,1144,8,14,2,2,1,5,Lost
90796,425,5,10,3,1,1,5,Casual Users
78666,94,13,44,4,3,3,10,Loyal Users
78780,153,73,333,4,5,5,14,Champions
78988,91,43,320,4,4,5,13,Champions
78990,569,5,8,2,1,1,4,Lost
79127,857,41,91,2,4,4,10,At Risk
79788,203,42,347,3,4,5,12,Loyal Users
79849,418,19,27,3,3,2,8,Loyal Users
79881,12,104,346,5,5,5,15,Champions
79961,344,48,275,3,5,5,13,Loyal Users
79982,32,70,130,5,5,4,14,Champions
80061,89,20,29,4,3,2,9,Loyal Users
80744,104,99,829,4,5,5,14,Champions
81125,3497,5,9,1,1,1,3,Lost
81649,539,12,15,2,3,1,6,Casual Users
81652,919,6,30,2,1,2,5,Lost
81679,149,7,12,4,2,1,7,Promising
82315,84,19,70,4,3,4,11,Loyal Users
82708,123,14,40,4,3,3,10,Loyal Users
83024,100,37,86,4,4,4,12,Champions
83108,51,33,153,5,4,5,14,Champions
83777,868,7,10,2,2,1,5,Lost
83996,24,29,79,5,4,4,13,Champions
84860,37,52,195,5,5,5,15,Champions
85346,870,13,17,2,3,2,7,Casual Users
85548,712,5,32,2,1,3,6,Lost
85899,1126,7,9,2,2,1,5,Lost
85951,620,27,38,2,4,3,9,At Risk
86012,75,89,282,4,5,5,14,Champions
86244,844,19,53,2,3,3,8,Casual Users
86467,12,21,58,5,3,3,11,Loyal Users
86491,82,26,81,4,4,4,12,Champions
86529,824,17,35,2,3,3,8,Casual Users
86569,1877,20,33,1,3,3,7,Casual Users
86943,542,26,64,2,4,4,10,At Risk
87055,3,9,42,5,2,3,10,Promising
88065,135,31,220,4,4,5,13,Champions
88098,67,39,125,5,4,4,13,Champions
88341,129,80,330,4,5,5,14,Champions
88362,22,47,103,5,5,4,14,Champions
88504,155,13,41,4,3,3,10,Loyal Users
88698,1570,15,68,1,3,4,8,Casual Users
88825,153,42,109,4,4,4,12,Champions
88954,285,24,110,3,4,4,11,Loyal Users
89127,1226,13,63,2,3,4,9,Casual Users
89549,91,61,130,4,5,4,13,Champions
89650,977,5,9,2,1,1,4,Lost
90169,170,6,7,3,1,1,5,Casual Users
90390,86,8,19,4,2,2,8,Promising
90639,1147,11,41,2,2,3,7,Lost
90662,115,16,49,4,3,3,10,Loyal Users
90678,762,106,486,2,5,5,12,At Risk
78318,1080,6,6,2,1,1,4,Lost
78801,36,92,268,5,5,5,15,Champions
78911,1155,26,115,2,4,4,10,At Risk
78946,121,6,8,4,1,1,6,Promising
79009,204,54,94,3,5,4,12,Loyal Users
79015,809,44,200,2,4,5,11,At Risk
79232,3537,5,21,1,1,2,4,Lost
79390,273,17,37,3,3,3,9,Loyal Users
79401,4,32,63,5,4,4,13,Champions
79436,28,7,38,5,2,3,10,Promising
79756,253,18,61,3,3,3,9,Loyal Users
79768,0,48,80,5,5,4,14,Champions
79888,2847,17,52,1,3,3,7,Casual Users
79928,136,89,254,4,5,5,14,Champions
80121,638,19,135,2,3,4,9,Casual Users
80861,1623,19,83,1,3,4,8,Casual Users
80873,40,44,125,5,4,4,13,Champions
81108,746,7,54,2,2,3,7,Lost
81204,265,10,12,3,2,1,6,Casual Users
81233,122,52,213,4,5,5,14,Champions
81485,30,6,19,5,1,2,8,Promising
81545,80,60,144,4,5,4,13,Champions
81681,1013,43,191,2,4,5,11,At Risk
81760,425,23,28,3,4,2,9,Loyal Users
82029,3,63,174,5,5,5,15,Champions
82464,80,5,21,4,1,2,7,Promising
82466,133,8,10,4,2,1,7,Promising
82870,109,25,236,4,4,5,13,Champions
82995,489,5,86,2,1,4,7,Lost
83140,1688,44,228,1,4,5,10,At Risk
83174,883,40,160,2,4,5,11,At Risk
83182,1141,7,8,2,2,1,5,Lost
83539,135,30,91,4,4,4,12,Champions
83887,215,41,169,3,4,5,12,Loyal Users
83957,498,18,23,2,3,2,7,Casual Users
84222,802,9,9,2,2,1,5,Lost
84231,2419,26,99,1,4,4,9,At Risk
84473,132,19,91,4,3,4,11,Loyal Users
84530,385,15,56,3,3,3,9,Loyal Users
84659,972,7,17,2,2,2,6,Lost
84978,101,21,78,4,3,4,11,Loyal Users
84998,141,77,139,4,5,4,13,Champions
85118,133,25,33,4,4,3,11,Loyal Users
85507,2995,6,27,1,1,2,4,Lost
85640,690,18,27,2,3,2,7,Casual Users
85673,23,66,166,5,5,5,15,Champions
85862,1551,18,20,1,3,2,6,Casual Users
86266,4104,9,28,1,2,2,5,Lost
86430,2269,12,62,1,3,3,7,Casual Users
86607,139,22,36,4,4,3,11,Loyal Users
86821,249,62,277,3,5,5,13,Loyal Users
87006,1860,23,61,1,4,3,8,At Risk
87474,423,7,9,3,2,1,6,Casual Users
87666,283,24,31,3,4,2,9,Loyal Users
87813,3432,6,6,1,1,1,3,Lost
87948,428,5,11,3,1,1,5,Casual Users
88254,577,12,16,2,3,2,7,Casual Users
88350,23,25,33,5,4,3,12,Loyal Users
88421,1456,11,14,1,2,1,4,Lost
88784,3,52,356,5,5,5,15,Champions
89045,2358,21,62,1,3,3,7,Casual Users
89330,451,34,44,3,4,3,10,Loyal Users
89769,81,14,31,4,3,2,9,Loyal Users
90061,91,31,56,4,4,3,11,Loyal Users
90279,123,13,34,4,3,3,10,Loyal Users
90435,98,63,73,4,5,4,13,Champions
90786,3871,19,60,1,3,3,7,Casual Users
90801,1827,8,15,1,2,1,4,Lost
90893,2,128,254,5,5,5,15,Champions
78444,57,23,61,5,4,3,12,Loyal Users
78505,29,58,523,5,5,5,15,Champions
78798,6,146,299,5,5,5,15,Champions
78914,2281,18,83,1,3,4,8,Casual Users
78980,14,51,173,5,5,5,15,Champions
79134,219,16,110,3,3,4,10,Loyal Users
79268,475,58,295,2,5,5,12,At Risk
79670,5,125,260,5,5,5,15,Champions
79774,5000,5,5,1,1,1,3,Lost
79866,2517,16,71,1,3,4,8,Casual Users
80188,106,25,116,4,4,4,12,Champions
80206,8,11,32,5,2,3,10,Promising
80219,3032,6,21,1,1,2,4,Lost
80269,147,39,431,4,4,5,13,Champions
80343,36,11,101,5,2,4,11,Promising
80498,1713,13,301,1,3,5,9,Casual Users
80638,273,35,47,3,4,3,10,Loyal Users
81743,1389,8,8,1,2,1,4,Lost
81886,447,51,168,3,5,5,13,Loyal Users
82515,2541,22,53,1,4,3,8,At Risk
82555,3577,11,16,1,2,2,5,Lost
82727,8,104,517,5,5,5,15,Champions
82815,258,29,166,3,4,5,12,Loyal Users
82833,124,30,56,4,4,3,11,Loyal Users
83054,2392,14,18,1,3,2,6,Casual Users
83134,22,72,166,5,5,5,15,Champions
83305,1153,23,43,2,4,3,9,At Risk
83399,885,9,20,2,2,2,6,Lost
83456,7,43,195,5,4,5,14,Champions
83616,16,10,11,5,2,1,8,Promising
83678,126,96,284,4,5,5,14,Champions
83744,397,15,21,3,3,2,8,Loyal Users
83750,599,5,38,2,1,3,6,Lost
84209,210,17,97,3,3,4,10,Loyal Users
84532,46,7,45,5,2,3,10,Promising
84736,2,85,655,5,5,5,15,Champions
85106,101,43,134,4,4,4,12,Champions
85674,7,36,69,5,4,4,13,Champions
85678,2781,5,9,1,1,1,3,Lost
85696,165,17,33,4,3,3,10,Loyal Users
85941,717,9,10,2,2,1,5,Lost
86150,7,18,22,5,3,2,10,Loyal Users
86534,113,22,81,4,4,4,12,Champions
87180,116,55,332,4,5,5,14,Champions
87263,1941,10,58,1,2,3,6,Lost
87624,465,55,116,3,5,4,12,Loyal Users
87710,50,27,107,5,4,4,13,Champions
88239,27,96,151,5,5,5,15,Champions
88283,961,21,58,2,3,3,8,Casual Users
89021,432,10,31,3,2,2,7,Casual Users
89157,84,20,105,4,3,4,11,Loyal Users
89205,7,13,19,5,3,2,10,Loyal Users
89276,18,5,20,5,1,2,8,Promising
89339,1708,10,18,1,2,2,5,Lost
89341,2608,6,14,1,1,1,3,Lost
89422,140,29,123,4,4,4,12,Champions
89500,440,6,23,3,1,2,6,Casual Users
89512,20,9,10,5,2,1,8,Promising
89678,810,11,15,2,2,1,5,Lost
89679,495,34,47,2,4,3,9,At Risk
89847,40,49,302,5,5,5,15,Champions
90146,87,11,16,4,2,2,8,Promising
90247,24,20,64,5,3,4,12,Loyal Users
90711,1202,8,41,2,2,3,7,Lost
90775,3842,11,12,1,2,1,4,Lost
78547,1,89,296,5,5,5,15,Champions
78599,692,27,153,2,4,5,11,At Risk
79053,3103,17,35,1,3,3,7,Casual Users
79093,292,6,13,3,1,1,5,Casual Users
79162,3133,6,7,1,1,1,3,Lost
79190,54,25,181,5,4,5,14,Champions
79291,135,34,82,4,4,4,12,Champions
79339,30,32,178,5,4,5,14,Champions
79620,1281,6,9,1,1,1,3,Lost
79947,31,98,205,5,5,5,15,Champions
80032,1753,190,388,1,5,5,11,At Risk
80410,427,14,23,3,3,2,8,Loyal Users
80628,2137,13,21,1,3,2,6,Casual Users
80717,79,239,494,4,5,5,14,Champions
80911,18,8,16,5,2,2,9,Promising
80983,218,5,56,3,1,3,7,Casual Users
80990,55,28,46,5,4,3,12,Loyal Users
81841,645,8,10,2,2,1,5,Lost
81857,104,97,302,4,5,5,14,Champions
82469,21,33,53,5,4,3,12,Loyal Users
82538,114,18,36,4,3,3,10,Loyal Users
82554,505,20,49,2,3,3,8,Casual Users
82654,10,46,246,5,5,5,15,Champions
82702,863,27,39,2,4,3,9,At Risk
83056,382,34,83,3,4,4,11,Loyal Users
83733,1275,9,16,1,2,2,5,Lost
83922,1971,52,306,1,5,5,11,At Risk
83984,503,16,61,2,3,3,8,Casual Users
84232,662,6,11,2,1,1,4,Lost
84671,4237,9,13,1,2,1,4,Lost
84947,0,185,608,5,5,5,15,Champions
85156,117,5,31,4,1,2,7,Promising
85306,30,34,172,5,4,5,14,Champions
85337,124,7,30,4,2,2,8,Promising
85366,308,12,42,3,3,3,9,Loyal Users
85775,4019,6,10,1,1,1,3,Lost
86010,19,84,482,5,5,5,15,Champions
86148,111,44,224,4,4,5,13,Champions
86316,605,82,137,2,5,4,11,At Risk
86803,1481,18,47,1,3,3,7,Casual Users
88137,4423,6,66,1,1,4,6,Lost
88278,9,20,55,5,3,3,11,Loyal Users
88319,223,72,405,3,5,5,13,Loyal Users
88442,37,14,19,5,3,2,10,Loyal Users
88562,621,5,6,2,1,1,4,Lost
88762,272,20,51,3,3,3,9,Loyal Users
88921,1839,6,16,1,1,2,4,Lost
88987,13,142,967,5,5,5,15,Champions
89135,1268,15,43,1,3,3,7,Casual Users
89445,409,9,17,3,2,2,7,Casual Users
89666,5384,9,9,1,2,1,4,Lost
89824,379,9,31,3,2,2,7,Casual Users
89901,7,128,271,5,5,5,15,Champions
89916,63,6,18,5,1,2,8,Promising
89985,55,32,140,5,4,4,13,Champions
90167,5838,10,16,1,2,2,5,Lost
90545,110,26,37,4,4,3,11,Loyal Users
90976,294,7,15,3,2,1,6,Casual Users
91012,124,74,383,4,5,5,14,Champions
78395,1697,6,7,1,1,1,3,Lost
78401,224,29,150,3,4,5,12,Loyal Users
78714,10,126,269,5,5,5,15,Champions
78783,625,33,63,2,4,4,10,At Risk
79115,844,9,16,2,2,2,6,Lost
79746,985,6,11,2,1,1,4,Lost
79769,179,84,176,3,5,5,13,Loyal Users
79942,80,8,20,4,2,2,8,Promising
80358,104,9,34,4,2,3,9,Promising
80545,44,186,607,5,5,5,15,Champions
80743,1934,8,25,1,2,2,5,Lost
80816,378,26,34,3,4,3,10,Loyal Users
81129,455,8,15,3,2,1,6,Casual Users
81613,437,13,13,3,3,1,7,Loyal Users
81692,1368,7,37,1,2,3,6,Lost
81847,20,107,237,5,5,5,15,Champions
82052,542,32,37,2,4,3,9,At Risk
82556,7,75,270,5,5,5,15,Champions
82847,663,27,63,2,4,4,10,At Risk
83086,2426,5,7,1,1,1,3,Lost
83332,67,43,89,5,4,4,13,Champions
83530,125,9,23,4,2,2,8,Promising
83576,16,39,205,5,4,5,14,Champions
83634,18,70,164,5,5,5,15,Champions
83756,1971,5,5,1,1,1,3,Lost
83911,560,31,94,2,4,4,10,At Risk
84143,4702,9,10,1,2,1,4,Lost
84678,15,24,117,5,4,4,13,Champions
84687,607,24,46,2,4,3,9,At Risk
84843,2689,6,6,1,1,1,3,Lost
85284,72,58,121,4,5,4,13,Champions
85451,34,10,11,5,2,1,8,Promising
85685,1954,8,22,1,2,2,5,Lost
85691,766,13,43,2,3,3,8,Casual Users
85830,256,11,43,3,2,3,8,Casual Users
85906,397,41,74,3,4,4,11,Loyal Users
86326,2426,6,21,1,1,2,4,Lost
86347,222,96,248,3,5,5,13,Loyal Users
86696,997,5,8,2,1,1,4,Lost
86882,3390,5,25,1,1,2,4,Lost
86890,2258,7,19,1,2,2,5,Lost
87053,84,21,80,4,3,4,11,Loyal Users
87086,89,79,116,4,5,4,13,Champions
87819,841,13,19,2,3,2,7,Casual Users
87892,319,81,151,3,5,5,13,Loyal Users
88134,409,32,98,3,4,4,11,Loyal Users
88204,1888,10,98,1,2,4,7,Lost
88304,638,11,92,2,2,4,8,Lost
88337,271,26,59,3,4,3,10,Loyal Users
88564,8,95,256,5,5,5,15,Champions
88931,543,5,13,2,1,1,4,Lost
88950,166,47,197,3,5,5,13,Loyal Users
89049,1343,24,106,1,4,4,9,At Risk
89132,3,96,326,5,5,5,15,Champions
89426,32,59,127,5,5,4,14,Champions
89652,96,26,88,4,4,4,12,Champions
90075,434,6,14,3,1,1,5,Casual Users
90245,303,7,8,3,2,1,6,Casual Users
90635,71,5,25,4,1,2,7,Promising
90640,2309,23,38,1,4,3,8,At Risk
90826,932,5,5,2,1,1,4,Lost
90844,57,27,54,5,4,3,12,Loyal Users
90910,89,59,98,4,5,4,13,Champions
78363,227,33,64,3,4,4,11,Loyal Users
78636,25,86,321,5,5,5,15,Champions
79155,608,5,12,2,1,1,4,Lost
79349,238,16,126,3,3,4,10,Loyal Users
79423,695,13,15,2,3,1,6,Casual Users
79487,25,119,689,5,5,5,15,Champions
79992,0,14,33,5,3,3,11,Loyal Users
80180,29,5,8,5,1,1,7,Promising
80221,530,36,72,2,4,4,10,At Risk
80306,867,18,148,2,3,5,10,Casual Users
80518,2,47,93,5,5,4,14,Champions
80615,106,83,402,4,5,5,14,Champions
80721,696,13,17,2,3,2,7,Casual Users
80885,168,20,62,3,3,3,9,Loyal Users
81245,1267,17,35,1,3,3,7,Casual Users
81276,9,170,807,5,5,5,15,Champions
81549,2253,5,7,1,1,1,3,Lost
81912,153,46,67,4,5,4,13,Champions
82081,8,22,207,5,4,5,14,Champions
82355,815,6,9,2,1,1,4,Lost
82600,85,32,106,4,4,4,12,Champions
82718,6,34,120,5,4,4,13,Champions
83177,270,7,25,3,2,2,7,Casual Users
83321,15,44,194,5,4,5,14,Champions
83686,130,57,164,4,5,5,14,Champions
83790,76,49,91,4,5,4,13,Champions
84151,151,15,45,4,3,3,10,Loyal Users
84210,1975,6,6,1,1,1,3,Lost
84612,4805,14,37,1,3,3,7,Casual Users
84901,532,50,133,2,5,4,11,At Risk
84938,64,78,219,5,5,5,15,Champions
85465,143,10,25,4,2,2,8,Promising
85834,68,6,6,5,1,1,7,Promising
85872,703,15,25,2,3,2,7,Casual Users
86369,359,58,141,3,5,4,12,Loyal Users
86550,17,127,213,5,5,5,15,Champions
86562,22,71,297,5,5,5,15,Champions
86686,125,68,213,4,5,5,14,Champions
86751,3788,7,7,1,2,1,4,Lost
86952,233,42,104,3,4,4,11,Loyal Users
87060,4,171,313,5,5,5,15,Champions
87252,107,59,215,4,5,5,14,Champions
87611,7,150,395,5,5,5,15,Champions
87791,103,70,432,4,5,5,14,Champions
88231,2004,7,9,1,2,1,4,Lost
88501,639,10,52,2,2,3,7,Lost
88573,21,16,37,5,3,3,11,Loyal Users
88833,780,5,14,2,1,1,4,Lost
89340,92,47,183,4,5,5,14,Champions
89437,209,77,222,3,5,5,13,Loyal Users
89486,173,37,65,3,4,4,11,Loyal Users
89528,568,6,7,2,1,1,4,Lost
89555,2,98,755,5,5,5,15,Champions
89825,81,226,580,4,5,5,14,Champions
90174,6,34,54,5,4,3,12,Loyal Users
90242,337,8,61,3,2,3,8,Casual Users
90289,2123,35,79,1,4,4,9,At Risk
90439,393,6,13,3,1,1,5,Casual Users
90650,863,6,20,2,1,2,5,Lost
90754,274,85,125,3,5,4,12,Loyal Users
90889,142,35,113,4,4,4,12,Champions
90895,172,20,29,3,3,2,8,Loyal Users
90929,229,49,103,3,5,4,12,Loyal Users
90986,16,77,370,5,5,5,15,Champions
78668,1278,38,175,1,4,5,10,At Risk
78692,1862,16,50,1,3,3,7,Casual Users
78774,294,34,53,3,4,3,10,Loyal Users
78965,219,18,33,3,3,3,9,Loyal Users
79088,64,85,424,5,5,5,15,Champions
79118,715,10,12,2,2,1,5,Lost
79626,946,9,17,2,2,2,6,Lost
79722,20,15,106,5,3,4,12,Loyal Users
79838,51,49,208,5,5,5,15,Champions
79927,411,93,133,3,5,4,12,Loyal Users
79934,106,60,210,4,5,5,14,Champions
80020,2111,6,52,1,1,3,5,Lost
80245,1136,6,8,2,1,1,4,Lost
80273,1381,6,8,1,1,1,3,Lost
80296,1357,7,17,1,2,2,5,Lost
80346,960,8,8,2,2,1,5,Lost
80501,162,24,30,4,4,2,10,Loyal Users
80611,394,12,18,3,3,2,8,Loyal Users
80646,3354,5,8,1,1,1,3,Lost
80725,131,107,179,4,5,5,14,Champions
80880,406,7,17,3,2,2,7,Casual Users
81067,541,6,6,2,1,1,4,Lost
81200,139,5,34,4,1,3,8,Promising
81216,2675,6,7,1,1,1,3,Lost
81867,5,228,566,5,5,5,15,Champions
81880,61,135,260,5,5,5,15,Champions
81917,526,30,126,2,4,4,10,At Risk
82172,349,50,93,3,5,4,12,Loyal Users
82217,38,75,217,5,5,5,15,Champions
82584,313,11,28,3,2,2,7,Casual Users
82715,1418,8,16,1,2,2,5,Lost
82780,1680,8,9,1,2,1,4,Lost
82826,1428,5,12,1,1,1,3,Lost
83646,1443,10,33,1,2,3,6,Lost
83668,5025,10,33,1,2,3,6,Lost
83811,476,28,90,2,4,4,10,At Risk
84028,1649,16,30,1,3,2,6,Casual Users
84287,51,14,99,5,3,4,12,Loyal Users
84412,60,41,65,5,4,4,13,Champions
84524,16,24,46,5,4,3,12,Loyal Users
84830,274,19,130,3,3,4,10,Loyal Users
84869,6,14,44,5,3,3,11,Loyal Users
84916,265,7,42,3,2,3,8,Casual Users
84919,26,14,28,5,3,2,10,Loyal Users
85036,413,33,87,3,4,4,11,Loyal Users
85059,113,9,34,4,2,3,9,Promising
85123,1213,5,7,2,1,1,4,Lost
85360,122,75,112,4,5,4,13,Champions
85446,24,17,42,5,3,3,11,Loyal Users
85455,3,7,15,5,2,1,8,Promising
85530,473,7,9,2,2,1,5,Lost
85642,88,34,133,4,4,4,12,Champions
85693,1133,12,18,2,3,2,7,Casual Users
85800,2705,7,41,1,2,3,6,Lost
86265,845,31,50,2,4,3,9,At Risk
86743,3051,10,18,1,2,2,5,Lost
86906,366,15,34,3,3,3,9,Loyal Users
87188,34,13,13,5,3,1,9,Loyal Users
87448,2241,23,105,1,4,4,9,At Risk
87513,1648,16,34,1,3,3,7,Casual Users
87805,2458,10,15,1,2,1,4,Lost
87812,3296,11,73,1,2,4,7,Lost
87941,1328,8,60,1,2,3,6,Lost
88007,4059,5,15,1,1,1,3,Lost
88106,1655,6,107,1,1,4,6,Lost
88174,351,9,44,3,2,3,8,Casual Users
88427,218,15,29,3,3,2,8,Loyal Users
88523,38,71,139,5,5,4,14,Champions
89034,829,6,26,2,1,2,5,Lost
89267,1244,15,27,2,3,2,7,Casual Users
89367,237,11,33,3,2,3,8,Casual Users
89546,29,20,82,5,3,4,12,Loyal Users
89735,658,13,25,2,3,2,7,Casual Users
89845,8,47,93,5,5,4,14,Champions
90584,86,10,18,4,2,2,8,Promising
90717,977,7,12,2,2,1,5,Lost
90833,179,40,172,3,4,5,12,Loyal Users
90838,106,92,212,4,5,5,14,Champions
90885,116,27,46,4,4,3,11,Loyal Users
90980,683,23,74,2,4,4,10,At Risk
78385,1264,26,104,1,4,4,9,At Risk
79027,108,13,52,4,3,3,10,Loyal Users
79135,83,26,125,4,4,4,12,Champions
79219,120,7,34,4,2,3,9,Promising
79252,7,58,161,5,5,5,15,Champions
79288,154,31,249,4,4,5,13,Champions
79569,796,15,33,2,3,3,8,Casual Users
80008,1395,41,112,1,4,4,9,At Risk
80062,283,15,93,3,3,4,10,Loyal Users
80098,692,9,25,2,2,2,6,Lost
80301,279,38,123,3,4,4,11,Loyal Users
80344,297,8,11,3,2,1,6,Casual Users
80409,256,5,6,3,1,1,5,Casual Users
80636,679,23,42,2,4,3,9,At Risk
80670,92,89,158,4,5,5,14,Champions
80916,145,93,207,4,5,5,14,Champions
80969,6,136,187,5,5,5,15,Champions
81447,130,28,92,4,4,4,12,Champions
81634,853,5,8,2,1,1,4,Lost
81787,417,6,11,3,1,1,5,Casual Users
81873,421,14,17,3,3,2,8,Loyal Users
82186,128,8,43,4,2,3,9,Promising
82386,396,17,61,3,3,3,9,Loyal Users
82767,687,13,20,2,3,2,7,Casual Users
82887,1406,6,7,1,1,1,3,Lost
83143,273,26,40,3,4,3,10,Loyal Users
83161,506,8,11,2,2,1,5,Lost
83204,596,10,15,2,2,1,5,Lost
83297,620,8,21,2,2,2,6,Lost
83323,541,75,329,2,5,5,12,At Risk
84507,138,71,203,4,5,5,14,Champions
84694,128,56,272,4,5,5,14,Champions
84823,577,6,7,2,1,1,4,Lost
84899,2425,8,9,1,2,1,4,Lost
84940,8,77,289,5,5,5,15,Champions
84958,120,14,22,4,3,2,9,Loyal Users
85275,19,67,426,5,5,5,15,Champions
85348,1155,9,18,2,2,2,6,Lost
85438,70,65,423,4,5,5,14,Champions
85731,4851,8,8,1,2,1,4,Lost
86315,127,10,53,4,2,3,9,Promising
86436,432,30,303,3,4,5,12,Loyal Users
87183,1668,6,13,1,1,1,3,Lost
87237,1693,5,17,1,1,2,4,Lost
87387,1416,7,8,1,2,1,4,Lost
87545,679,17,207,2,3,5,10,Casual Users
87591,463,8,20,3,2,2,7,Casual Users
87606,592,5,13,2,1,1,4,Lost
87642,295,24,74,3,4,4,11,Loyal Users
87672,1733,8,13,1,2,1,4,Lost
87899,3493,32,79,1,4,4,9,At Risk
88110,3523,11,24,1,2,2,5,Lost
88371,574,28,65,2,4,4,10,At Risk
88723,94,88,195,4,5,5,14,Champions
88779,151,16,69,4,3,4,11,Loyal Users
88823,695,9,14,2,2,1,5,Lost
88928,225,32,62,3,4,3,10,Loyal Users
89001,724,5,14,2,1,1,4,Lost
89701,2823,5,6,1,1,1,3,Lost
89827,640,41,73,2,4,4,10,At Risk
89979,1425,13,21,1,3,2,6,Casual Users
90092,2841,24,36,1,4,3,8,At Risk
90244,441,15,24,3,3,2,8,Loyal Users
90419,158,5,5,4,1,1,6,Promising
90575,262,9,50,3,2,3,8,Casual Users
90704,402,12,34,3,3,3,9,Loyal Users
90996,913,10,55,2,2,3,7,Lost
91026,964,8,12,2,2,1,5,Lost
78810,720,29,106,2,4,4,10,At Risk
79024,50,76,229,5,5,5,15,Champions
79082,154,25,96,4,4,4,12,Champions
79139,4698,16,28,1,3,2,6,Casual Users
79204,3855,6,6,1,1,1,3,Lost
79325,2859,12,36,1,3,3,7,Casual Users
79543,393,7,11,3,2,1,6,Casual Users
79747,10,92,232,5,5,5,15,Champions
79893,242,5,6,3,1,1,5,Casual Users
79907,123,41,61,4,4,3,11,Loyal Users
80334,110,40,208,4,4,5,13,Champions
80892,2747,15,172,1,3,5,9,Casual Users
81040,1550,5,11,1,1,1,3,Lost
81133,475,41,66,2,4,4,10,At Risk
81222,114,17,52,4,3,3,10,Loyal Users
81439,224,71,174,3,5,5,13,Loyal Users
82044,4177,13,71,1,3,4,8,Casual Users
82820,62,78,240,5,5,5,15,Champions
83165,696,18,23,2,3,2,7,Casual Users
83511,395,6,31,3,1,2,6,Casual Users
83652,1839,14,29,1,3,2,6,Casual Users
84157,904,6,11,2,1,1,4,Lost
84201,25,7,7,5,2,1,8,Promising
84228,212,20,187,3,3,5,11,Loyal Users
84452,4261,6,15,1,1,1,3,Lost
84527,242,49,107,3,5,4,12,Loyal Users
84789,149,15,38,4,3,3,10,Loyal Users
84799,1007,8,17,2,2,2,6,Lost
84963,1638,9,28,1,2,2,5,Lost
85416,119,18,80,4,3,4,11,Loyal Users
85518,271,18,102,3,3,4,10,Loyal Users
85610,1101,13,18,2,3,2,7,Casual Users
85638,287,25,55,3,4,3,10,Loyal Users
85822,315,33,105,3,4,4,11,Loyal Users
86175,2128,12,42,1,3,3,7,Casual Users
86285,102,14,23,4,3,2,9,Loyal Users
86462,589,11,66,2,2,4,8,Lost
87154,0,119,288,5,5,5,15,Champions
87205,295,50,105,3,5,4,12,Loyal Users
87244,1,175,345,5,5,5,15,Champions
87321,2352,23,57,1,4,3,8,At Risk
87471,152,10,14,4,2,1,7,Promising
87708,1336,6,11,1,1,1,3,Lost
88141,104,17,25,4,3,2,9,Loyal Users
88267,7,128,639,5,5,5,15,Champions
88660,270,15,29,3,3,2,8,Loyal Users
88798,642,12,15,2,3,1,6,Casual Users
89117,1264,29,44,1,4,3,8,At Risk
89216,3,25,59,5,4,3,12,Loyal Users
89446,583,50,166,2,5,5,12,At Risk
89618,30,39,213,5,4,5,14,Champions
89675,394,157,265,3,5,5,13,Loyal Users
89797,3662,6,14,1,1,1,3,Lost
89801,80,40,117,4,4,4,12,Champions
89852,226,164,409,3,5,5,13,Loyal Users
90926,306,5,6,3,1,1,5,Casual Users
90988,3157,11,27,1,2,2,5,Lost
78317,542,13,15,2,3,1,6,Casual Users
78892,69,95,439,5,5,5,15,Champions
78918,316,32,46,3,4,3,10,Loyal Users
79552,10,15,38,5,3,3,11,Loyal Users
79597,465,65,102,3,5,4,12,Loyal Users
79642,122,31,98,4,4,4,12,Champions
79811,270,35,122,3,4,4,11,Loyal Users
79899,161,29,43,4,4,3,11,Loyal Users
79932,840,12,57,2,3,3,8,Casual Users
80576,4317,24,50,1,4,3,8,At Risk
80581,15,135,192,5,5,5,15,Champions
80939,80,120,223,4,5,5,14,Champions
81331,112,12,61,4,3,3,10,Loyal Users
81408,57,21,127,5,3,4,12,Loyal Users
82102,9,6,9,5,1,1,7,Promising
82610,13,5,19,5,1,2,8,Promising
82691,726,53,98,2,5,4,11,At Risk
83118,2021,18,26,1,3,2,6,Casual Users
83128,52,27,63,5,4,4,13,Champions
83222,337,35,48,3,4,3,10,Loyal Users
83406,423,5,6,3,1,1,5,Casual Users
83482,89,6,7,4,1,1,6,Promising
83981,276,24,64,3,4,4,11,Loyal Users
83988,113,20,28,4,3,2,9,Loyal Users
84062,410,8,19,3,2,2,7,Casual Users
84137,415,8,10,3,2,1,6,Casual Users
84614,122,6,19,4,1,2,7,Promising
84624,43,8,23,5,2,2,9,Promising
84771,265,21,42,3,3,3,9,Loyal Users
84876,85,7,17,4,2,2,8,Promising
85042,171,7,7,3,2,1,6,Casual Users
85046,3,27,113,5,4,4,13,Champions
85293,24,6,130,5,1,4,10,Promising
85524,117,5,10,4,1,1,6,Promising
85597,41,26,28,5,4,2,11,Loyal Users
85721,2404,14,28,1,3,2,6,Casual Users
85727,1238,13,27,2,3,2,7,Casual Users
85733,520,92,439,2,5,5,12,At Risk
85785,1675,10,85,1,2,4,7,Lost
86471,19,56,152,5,5,5,15,Champions
86488,130,17,108,4,3,4,11,Loyal Users
86862,384,8,16,3,2,2,7,Casual Users
87326,1253,13,20,2,3,2,7,Casual Users
87859,403,23,83,3,4,4,11,Loyal Users
88132,28,37,366,5,4,5,14,Champions
88218,100,55,107,4,5,4,13,Champions
88237,3886,8,8,1,2,1,4,Lost
88377,272,40,77,3,4,4,11,Loyal Users
88547,62,8,21,5,2,2,9,Promising
88589,8,30,59,5,4,3,12,Loyal Users
89000,258,7,7,3,2,1,6,Casual Users
89258,8,84,375,5,5,5,15,Champions
89475,4755,5,5,1,1,1,3,Lost
89601,717,8,9,2,2,1,5,Lost
89669,341,13,18,3,3,2,8,Loyal Users
90270,1495,16,30,1,3,2,6,Casual Users
90327,19,190,487,5,5,5,15,Champions
90407,1926,6,8,1,1,1,3,Lost
90973,388,12,27,3,3,2,8,Loyal Users
78420,4917,11,31,1,2,2,5,Lost
78487,879,7,23,2,2,2,6,Lost
78520,193,59,155,3,5,5,13,Loyal Users
79122,277,21,44,3,3,3,9,Loyal Users
79189,1051,9,12,2,2,1,5,Lost
79405,982,11,30,2,2,2,6,Lost
80240,21,28,39,5,4,3,12,Loyal Users
80448,74,64,128,4,5,4,13,Champions
80490,1181,31,103,2,4,4,10,At Risk
80602,177,21,100,3,3,4,10,Loyal Users
80642,230,21,65,3,3,4,10,Loyal Users
80667,614,8,23,2,2,2,6,Lost
80740,24,65,419,5,5,5,15,Champions
80754,247,8,13,3,2,1,6,Casual Users
81134,1304,7,7,1,2,1,4,Lost
81320,336,10,78,3,2,4,9,Casual Users
81564,671,6,12,2,1,1,4,Lost
81883,545,10,40,2,2,3,7,Lost
82090,308,7,16,3,2,2,7,Casual Users
82155,3191,9,11,1,2,1,4,Lost
82169,1360,35,64,1,4,4,9,At Risk
82182,3403,5,9,1,1,1,3,Lost
82302,2460,24,37,1,4,3,8,At Risk
82381,6108,10,10,1,2,1,4,Lost
82510,112,34,66,4,4,4,12,Champions
82677,23,44,123,5,4,4,13,Champions
82720,415,25,92,3,4,4,11,Loyal Users
83453,127,5,45,4,1,3,8,Promising
83463,820,19,92,2,3,4,9,Casual Users
83572,2427,18,36,1,3,3,7,Casual Users
83683,30,291,612,5,5,5,15,Champions
83755,41,65,128,5,5,4,14,Champions
83809,231,36,67,3,4,4,11,Loyal Users
84036,329,19,39,3,3,3,9,Loyal Users
84251,90,105,584,4,5,5,14,Champions
84345,1421,10,23,1,2,2,5,Lost
84371,39,24,103,5,4,4,13,Champions
84733,5436,8,8,1,2,1,4,Lost
84921,2034,9,13,1,2,1,4,Lost
85290,1008,16,19,2,3,2,7,Casual Users
85592,732,25,117,2,4,4,10,At Risk
85828,19,72,211,5,5,5,15,Champions
85867,431,5,33,3,1,3,7,Casual Users
86216,30,6,13,5,1,1,7,Promising
86359,2063,28,65,1,4,4,9,At Risk
86381,0,70,190,5,5,5,15,Champions
86559,135,41,156,4,4,5,13,Champions
86617,2123,5,5,1,1,1,3,Lost
86819,130,34,51,4,4,3,11,Loyal Users
87393,3722,5,53,1,1,3,5,Lost
87444,24,8,19,5,2,2,9,Promising
87509,0,50,207,5,5,5,15,Champions
87599,1799,5,5,1,1,1,3,Lost
87600,124,32,108,4,4,4,12,Champions
87628,126,45,178,4,4,5,13,Champions
88532,17,17,33,5,3,3,11,Loyal Users
88852,719,34,74,2,4,4,10,At Risk
88945,119,29,174,4,4,5,13,Champions
89230,50,11,24,5,2,2,9,Promising
89689,47,26,89,5,4,4,13,Champions
89912,7,57,99,5,5,4,14,Champions
90152,5438,6,12,1,1,1,3,Lost
90526,149,15,47,4,3,3,10,Loyal Users
90789,24,116,254,5,5,5,15,Champions
90937,855,24,70,2,4,4,10,At Risk
78402,101,74,128,4,5,4,13,Champions
78625,523,9,14,2,2,1,5,Lost
78657,52,117,340,5,5,5,15,Champions
78713,2113,5,5,1,1,1,3,Lost
79008,404,5,7,3,1,1,5,Casual Users
79431,3480,9,48,1,2,3,6,Lost
79566,555,6,63,2,1,4,7,Lost
79819,941,39,98,2,4,4,10,At Risk
80190,1973,5,9,1,1,1,3,Lost
80216,447,5,11,3,1,1,5,Casual Users
80477,467,25,105,3,4,4,11,Loyal Users
80863,1440,17,24,1,3,2,6,Casual Users
81429,31,28,136,5,4,4,13,Champions
81466,4202,12,14,1,3,1,5,Casual Users
81595,288,12,29,3,3,2,8,Loyal Users
81665,1221,19,345,2,3,5,10,Casual Users
82180,537,6,6,2,1,1,4,Lost
82254,178,25,141,3,4,4,11,Loyal Users
82258,144,46,120,4,5,4,13,Champions
82647,30,5,10,5,1,1,7,Promising
82701,1144,12,53,2,3,3,8,Casual Users
82905,99,10,19,4,2,2,8,Promising
82976,1996,13,25,1,3,2,6,Casual Users
83340,14,17,105,5,3,4,12,Loyal Users
83561,1867,22,65,1,4,4,9,At Risk
83950,119,36,237,4,4,5,13,Champions
83962,418,5,13,3,1,1,5,Casual Users
84053,42,82,195,5,5,5,15,Champions
84183,1417,5,6,1,1,1,3,Lost
84191,1188,22,27,2,4,2,8,At Risk
84349,277,7,8,3,2,1,6,Casual Users
84374,594,42,93,2,4,4,10,At Risk
84488,606,58,169,2,5,5,12,At Risk
85098,397,31,95,3,4,4,11,Loyal Users
85184,27,85,324,5,5,5,15,Champions
85195,1476,8,187,1,2,5,8,Lost
85209,95,24,26,4,4,2,10,Loyal Users
85285,229,35,94,3,4,4,11,Loyal Users
85777,80,140,528,4,5,5,14,Champions
85884,141,5,8,4,1,1,6,Promising
85911,279,11,15,3,2,1,6,Casual Users
86004,1158,5,5,2,1,1,4,Lost
86125,654,12,15,2,3,1,6,Casual Users
86167,235,35,299,3,4,5,12,Loyal Users
86439,1771,10,110,1,2,4,7,Lost
86552,3219,13,16,1,3,2,6,Casual Users
86560,2808,11,13,1,2,1,4,Lost
86572,571,82,329,2,5,5,12,At Risk
86603,257,6,33,3,1,3,7,Casual Users
86706,412,22,26,3,4,2,9,Loyal Users
87115,5,41,94,5,4,4,13,Champions
87265,2430,11,37,1,2,3,6,Lost
87352,4,76,133,5,5,4,14,Champions
87499,1155,18,36,2,3,3,8,Casual Users
87598,3638,5,34,1,1,3,5,Lost
87778,282,17,110,3,3,4,10,Loyal Users
87946,651,11,133,2,2,4,8,Lost
88214,828,5,16,2,1,2,5,Lost
88439,126,10,14,4,2,1,7,Promising
88467,47,26,61,5,4,3,12,Loyal Users
88878,1340,9,27,1,2,2,5,Lost
89065,156,125,259,4,5,5,14,Champions
89110,98,6,8,4,1,1,6,Promising
89236,187,20,84,3,3,4,10,Loyal Users
89316,3,111,232,5,5,5,15,Champions
89375,142,37,99,4,4,4,12,Champions
89483,424,10,17,3,2,2,7,Casual Users
89857,133,48,386,4,5,5,14,Champions
89948,27,16,35,5,3,3,11,Loyal Users
90032,25,11,17,5,2,2,9,Promising
90068,42,140,237,5,5,5,15,Champions
90121,46,19,35,5,3,3,11,Loyal Users
90542,58,76,144,5,5,4,14,Champions
90793,80,33,47,4,4,3,11,Loyal Users
91337,690,29,64,2,4,4,10,At Risk
91350,92,19,47,4,3,3,10,Loyal Users
91386,611,17,36,2,3,3,8,Casual Users
91558,4249,5,9,1,1,1,3,Lost
91575,868,6,6,2,1,1,4,Lost
91796,1622,7,10,1,2,1,4,Lost
91811,4337,7,17,1,2,2,5,Lost
92079,2224,6,9,1,1,1,3,Lost
92381,103,22,206,4,4,5,13,Champions
92977,3224,9,14,1,2,1,4,Lost
93350,655,6,35,2,1,3,6,Lost
93706,24,71,364,5,5,5,15,Champions
93851,3188,11,22,1,2,2,5,Lost
93947,1225,33,59,2,4,3,9,At Risk
94139,83,47,301,4,5,5,14,Champions
94451,444,21,107,3,3,4,10,Loyal Users
94552,19,67,134,5,5,4,14,Champions
94943,1097,8,70,2,2,4,8,Lost
95135,520,14,20,2,3,2,7,Casual Users
95231,564,14,16,2,3,2,7,Casual Users
95320,6,155,742,5,5,5,15,Champions
95569,408,16,124,3,3,4,10,Loyal Users
95713,358,30,87,3,4,4,11,Loyal Users
95883,196,14,29,3,3,2,8,Loyal Users
95976,292,10,21,3,2,2,7,Casual Users
95999,10,45,234,5,4,5,14,Champions
96010,119,75,258,4,5,5,14,Champions
96066,672,11,15,2,2,1,5,Lost
96186,2145,25,45,1,4,3,8,At Risk
96252,45,17,25,5,3,2,10,Loyal Users
96254,253,42,53,3,4,3,10,Loyal Users
96566,951,12,36,2,3,3,8,Casual Users
96614,2981,10,49,1,2,3,6,Lost
96848,479,33,55,2,4,3,9,At Risk
96898,5299,15,109,1,3,4,8,Casual Users
97339,110,46,96,4,5,4,13,Champions
97469,2433,5,10,1,1,1,3,Lost
97766,2860,5,14,1,1,1,3,Lost
97847,688,8,26,2,2,2,6,Lost
98015,3678,8,14,1,2,1,4,Lost
98186,1413,7,11,1,2,1,4,Lost
98351,261,71,191,3,5,5,13,Loyal Users
98497,201,31,186,3,4,5,12,Loyal Users
98602,1448,16,33,1,3,3,7,Casual Users
98675,270,21,37,3,3,3,9,Loyal Users
98796,24,100,214,5,5,5,15,Champions
98934,881,8,19,2,2,2,6,Lost
99350,289,46,249,3,5,5,13,Loyal Users
99394,423,15,40,3,3,3,9,Loyal Users
99687,869,6,21,2,1,2,5,Lost
91082,25,72,397,5,5,5,15,Champions
91130,3387,9,9,1,2,1,4,Lost
91228,90,115,319,4,5,5,14,Champions
91292,199,79,221,3,5,5,13,Loyal Users
91338,547,44,86,2,4,4,10,At Risk
91494,189,49,163,3,5,5,13,Loyal Users
91803,11,69,233,5,5,5,15,Champions
91865,112,100,131,4,5,4,13,Champions
91974,5458,7,11,1,2,1,4,Lost
92448,381,52,303,3,5,5,13,Loyal Users
92756,456,33,73,3,4,4,11,Loyal Users
92869,571,11,23,2,2,2,6,Lost
93003,110,33,94,4,4,4,12,Champions
93051,1135,5,48,2,1,3,6,Lost
93170,437,6,12,3,1,1,5,Casual Users
93369,8,13,31,5,3,2,10,Loyal Users
93721,381,57,192,3,5,5,13,Loyal Users
93800,31,43,230,5,4,5,14,Champions
93839,5,32,52,5,4,3,12,Loyal Users
94249,1557,12,27,1,3,2,6,Casual Users
94396,1848,5,7,1,1,1,3,Lost
94484,26,30,244,5,4,5,14,Champions
94542,1650,20,78,1,3,4,8,Casual Users
94682,101,39,77,4,4,4,12,Champions
95355,18,101,729,5,5,5,15,Champions
95791,1817,6,32,1,1,3,5,Lost
95852,1845,9,27,1,2,2,5,Lost
95930,412,16,93,3,3,4,10,Loyal Users
96065,287,38,245,3,4,5,12,Loyal Users
96113,298,12,59,3,3,3,9,Loyal Users
96818,147,13,17,4,3,2,9,Loyal Users
97388,2079,5,26,1,1,2,4,Lost
97439,808,13,70,2,3,4,9,Casual Users
97668,972,7,11,2,2,1,5,Lost
97671,2254,5,5,1,1,1,3,Lost
97837,21,42,188,5,4,5,14,Champions
97842,152,105,183,4,5,5,14,Champions
98092,535,37,131,2,4,4,10,At Risk
98325,1301,8,21,1,2,2,5,Lost
98700,126,18,132,4,3,4,11,Loyal Users
98877,2874,31,164,1,4,5,10,At Risk
99351,141,91,245,4,5,5,14,Champions
99440,348,10,25,3,2,2,7,Casual Users
99473,869,32,65,2,4,4,10,At Risk
99582,302,5,6,3,1,1,5,Casual Users
99679,407,9,10,3,2,1,6,Casual Users
91079,2063,7,17,1,2,2,5,Lost
91844,1262,21,106,1,3,4,8,Casual Users
91893,70,77,271,4,5,5,14,Champions
91949,54,82,483,5,5,5,15,Champions
91969,785,5,54,2,1,3,6,Lost
92128,8,41,58,5,4,3,12,Loyal Users
92424,482,9,9,2,2,1,5,Lost
92565,3805,6,25,1,1,2,4,Lost
92763,9,28,87,5,4,4,13,Champions
92799,698,7,11,2,2,1,5,Lost
92848,23,59,107,5,5,4,14,Champions
92980,405,17,90,3,3,4,10,Loyal Users
93262,280,51,155,3,5,5,13,Loyal Users
93585,503,47,210,2,5,5,12,At Risk
93812,410,7,24,3,2,2,7,Casual Users
93906,479,40,124,2,4,4,10,At Risk
94290,790,8,14,2,2,1,5,Lost
94320,1168,16,19,2,3,2,7,Casual Users
94775,37,24,138,5,4,4,13,Champions
94789,63,129,233,5,5,5,15,Champions
94884,1362,17,88,1,3,4,8,Casual Users
95027,416,5,7,3,1,1,5,Casual Users
95817,151,21,64,4,3,4,11,Loyal Users
96011,700,7,15,2,2,1,5,Lost
96315,1,13,47,5,3,3,11,Loyal Users
96347,4276,22,40,1,4,3,8,At Risk
96539,416,39,69,3,4,4,11,Loyal Users
96572,314,11,26,3,2,2,7,Casual Users
96624,531,10,12,2,2,1,5,Lost
96897,91,92,207,4,5,5,14,Champions
96934,161,17,22,4,3,2,9,Loyal Users
97122,587,66,124,2,5,4,11,At Risk
97252,9,143,264,5,5,5,15,Champions
97364,111,34,99,4,4,4,12,Champions
97557,216,47,353,3,5,5,13,Loyal Users
97704,1153,10,10,2,2,1,5,Lost
97757,658,12,14,2,3,1,6,Casual Users
97784,1565,17,53,1,3,3,7,Casual Users
98157,2566,7,11,1,2,1,4,Lost
98159,104,58,207,4,5,5,14,Champions
98577,249,12,37,3,3,3,9,Loyal Users
98732,7,12,38,5,3,3,11,Loyal Users
98770,1587,22,73,1,4,4,9,At Risk
98859,756,13,27,2,3,2,7,Casual Users
99449,138,15,20,4,3,2,9,Loyal Users
99581,2930,37,95,1,4,4,9,At Risk
99814,2494,64,186,1,5,5,11,At Risk
99843,291,78,153,3,5,5,13,Loyal Users
99891,114,11,105,4,2,4,10,Promising
91666,1665,6,6,1,1,1,3,Lost
91746,740,13,33,2,3,3,8,Casual Users
91904,1105,51,232,2,5,5,12,At Risk
92029,3029,45,105,1,4,4,9,At Risk
92237,4564,7,8,1,2,1,4,Lost
92319,2256,6,7,1,1,1,3,Lost
92508,458,60,108,3,5,4,12,Loyal Users
92536,134,12,52,4,3,3,10,Loyal Users
92918,145,29,44,4,4,3,11,Loyal Users
93280,133,25,60,4,4,3,11,Loyal Users
93571,58,33,56,5,4,3,12,Loyal Users
93848,280,9,12,3,2,1,6,Casual Users
93946,3,51,232,5,5,5,15,Champions
94197,32,15,44,5,3,3,11,Loyal Users
94589,273,46,75,3,5,4,12,Loyal Users
94750,161,8,37,4,2,3,9,Promising
94840,1072,16,138,2,3,4,9,Casual Users
94995,1,130,395,5,5,5,15,Champions
95038,554,14,44,2,3,3,8,Casual Users
95532,20,25,37,5,4,3,12,Loyal Users
95559,16,57,297,5,5,5,15,Champions
95932,44,10,24,5,2,2,9,Promising
95985,275,12,33,3,3,3,9,Loyal Users
96267,2765,14,24,1,3,2,6,Casual Users
96476,2628,6,20,1,1,2,4,Lost
96548,4016,5,19,1,1,2,4,Lost
97210,416,5,6,3,1,1,5,Casual Users
97398,422,19,183,3,3,5,11,Loyal Users
97426,3178,10,18,1,2,2,5,Lost
97493,499,12,18,2,3,2,7,Casual Users
97499,443,23,24,3,4,2,9,Loyal Users
97638,93,80,275,4,5,5,14,Champions
97645,240,43,73,3,4,4,11,Loyal Users
97771,152,12,25,4,3,2,9,Loyal Users
97961,466,12,15,3,3,1,7,Loyal Users
98392,16,11,19,5,2,2,9,Promising
98411,1852,11,44,1,2,3,6,Lost
98446,55,10,55,5,2,3,10,Promising
98512,958,12,21,2,3,2,7,Casual Users
98649,25,13,16,5,3,2,10,Loyal Users
98761,406,24,77,3,4,4,11,Loyal Users
98783,494,17,64,2,3,4,9,Casual Users
99016,1682,8,24,1,2,2,5,Lost
99339,402,58,108,3,5,4,12,Loyal Users
99785,141,85,244,4,5,5,14,Champions
91265,127,18,26,4,3,2,9,Loyal Users
91269,168,56,155,3,5,5,13,Loyal Users
91461,134,32,48,4,4,3,11,Loyal Users
91540,90,124,313,4,5,5,14,Champions
91592,153,46,97,4,5,4,13,Champions
91611,266,33,157,3,4,5,12,Loyal Users
91901,38,123,561,5,5,5,15,Champions
92048,413,23,83,3,4,4,11,Loyal Users
92455,79,72,147,4,5,5,14,Champions
92460,259,47,227,3,5,5,13,Loyal Users
92476,837,17,63,2,3,4,9,Casual Users
92636,245,16,95,3,3,4,10,Loyal Users
92656,8,103,320,5,5,5,15,Champions
93091,1552,5,5,1,1,1,3,Lost
93165,6,54,146,5,5,4,14,Champions
93230,1140,6,7,2,1,1,4,Lost
93438,0,56,129,5,5,4,14,Champions
93470,715,115,275,2,5,5,12,At Risk
93590,569,12,56,2,3,3,8,Casual Users
93768,4309,5,20,1,1,2,4,Lost
94122,21,79,275,5,5,5,15,Champions
94154,53,50,52,5,5,3,13,Loyal Users
94294,83,36,175,4,4,5,13,Champions
94308,96,7,11,4,2,1,7,Promising
94441,158,36,193,4,4,5,13,Champions
94968,130,45,130,4,4,4,12,Champions
95106,346,26,117,3,4,4,11,Loyal Users
95167,252,9,19,3,2,2,7,Casual Users
95237,1536,10,17,1,2,2,5,Lost
95975,97,131,460,4,5,5,14,Champions
96160,92,53,236,4,5,5,14,Champions
96231,69,11,33,5,2,3,10,Promising
96852,494,22,52,2,4,3,9,At Risk
98113,111,5,6,4,1,1,6,Promising
98221,7,115,280,5,5,5,15,Champions
98231,1014,22,41,2,4,3,9,At Risk
98255,2485,9,12,1,2,1,4,Lost
98404,1285,18,107,1,3,4,8,Casual Users
98575,1396,9,16,1,2,2,5,Lost
98659,107,19,52,4,3,3,10,Loyal Users
99605,4739,7,13,1,2,1,4,Lost
99914,32,5,158,5,1,5,11,Promising
99997,1068,5,6,2,1,1,4,Lost
91399,127,63,133,4,5,4,13,Champions
91434,1312,5,10,1,1,1,3,Lost
91550,591,8,13,2,2,1,5,Lost
91661,3,12,39,5,3,3,11,Loyal Users
91665,35,48,183,5,5,5,15,Champions
92411,947,7,11,2,2,1,5,Lost
92475,86,10,31,4,2,2,8,Promising
92613,3,74,167,5,5,5,15,Champions
92653,5149,5,34,1,1,3,5,Lost
92958,840,15,52,2,3,3,8,Casual Users
93023,101,67,475,4,5,5,14,Champions
93064,2128,21,39,1,3,3,7,Casual Users
93335,29,121,449,5,5,5,15,Champions
93426,436,13,118,3,3,4,10,Loyal Users
93485,90,9,22,4,2,2,8,Promising
93533,4,8,13,5,2,1,8,Promising
93622,4,89,277,5,5,5,15,Champions
93712,471,19,107,2,3,4,9,Casual Users
93859,3242,65,189,1,5,5,11,At Risk
94540,296,30,66,3,4,4,11,Loyal Users
94578,27,5,55,5,1,3,9,Promising
94606,1121,11,30,2,2,2,6,Lost
95018,38,48,120,5,5,4,14,Champions
95236,135,70,164,4,5,5,14,Champions
95384,385,124,617,3,5,5,13,Loyal Users
95419,150,29,89,4,4,4,12,Champions
95510,3011,7,9,1,2,1,4,Lost
95657,791,21,108,2,3,4,9,Casual Users
95816,68,5,7,5,1,1,7,Promising
95892,275,11,38,3,2,3,8,Casual Users
96719,16,86,329,5,5,5,15,Champions
96751,101,93,280,4,5,5,14,Champions
97038,13,8,12,5,2,1,8,Promising
97085,119,56,158,4,5,5,14,Champions
97245,608,13,19,2,3,2,7,Casual Users
97623,14,71,189,5,5,5,15,Champions
97694,892,6,11,2,1,1,4,Lost
97729,410,10,16,3,2,2,7,Casual Users
97871,73,10,23,4,2,2,8,Promising
97907,844,19,38,2,3,3,8,Casual Users
97918,132,8,44,4,2,3,9,Promising
98362,1440,32,226,1,4,5,10,At Risk
98467,406,28,248,3,4,5,12,Loyal Users
98712,252,6,46,3,1,3,7,Casual Users
98823,253,8,23,3,2,2,7,Casual Users
98828,588,17,173,2,3,5,10,Casual Users
99184,2014,6,16,1,1,2,4,Lost
99252,6,115,477,5,5,5,15,Champions
99303,545,32,94,2,4,4,10,At Risk
99358,3569,7,9,1,2,1,4,Lost
99626,265,16,29,3,3,2,8,Loyal Users
91303,14,37,42,5,4,3,12,Loyal Users
91415,472,29,35,2,4,3,9,At Risk
91612,423,13,86,3,3,4,10,Loyal Users
91683,398,27,120,3,4,4,11,Loyal Users
91952,2,35,131,5,4,4,13,Champions
92135,3299,6,9,1,1,1,3,Lost
92137,79,71,179,4,5,5,14,Champions
92472,70,48,73,4,5,4,13,Champions
92519,109,10,19,4,2,2,8,Promising
92534,1868,5,13,1,1,1,3,Lost
92594,4221,9,14,1,2,1,4,Lost
92989,0,11,28,5,2,2,9,Promising
93362,20,12,50,5,3,3,11,Loyal Users
93504,353,14,31,3,3,2,8,Loyal Users
93710,145,11,51,4,2,3,9,Promising
93769,346,48,275,3,5,5,13,Loyal Users
93991,8,43,187,5,4,5,14,Champions
94082,1,14,53,5,3,3,11,Loyal Users
94241,97,17,33,4,3,3,10,Loyal Users
94422,1087,12,29,2,3,2,7,Casual Users
94608,98,98,432,4,5,5,14,Champions
94836,300,103,143,3,5,4,12,Loyal Users
95109,4818,5,14,1,1,1,3,Lost
95473,117,6,23,4,1,2,7,Promising
95638,253,5,7,3,1,1,5,Casual Users
95663,106,64,314,4,5,5,14,Champions
95793,1547,10,15,1,2,1,4,Lost
95977,94,116,387,4,5,5,14,Champions
96723,151,21,50,4,3,3,10,Loyal Users
96726,532,28,42,2,4,3,9,At Risk
97125,84,39,89,4,4,4,12,Champions
97446,2,68,122,5,5,4,14,Champions
97450,902,86,186,2,5,5,12,At Risk
97600,423,19,63,3,3,4,10,Loyal Users
97604,5514,19,41,1,3,3,7,Casual Users
97978,1695,5,9,1,1,1,3,Lost
98228,3264,7,23,1,2,2,5,Lost
98357,1135,6,7,2,1,1,4,Lost
98542,182,8,115,3,2,4,9,Casual Users
98572,108,20,46,4,3,3,10,Loyal Users
98668,69,46,288,5,5,5,15,Champions
98935,38,39,49,5,4,3,12,Loyal Users
99151,4986,24,30,1,4,2,7,At Risk
99212,138,24,140,4,4,4,12,Champions
99503,119,30,85,4,4,4,12,Champions
99542,315,15,71,3,3,4,10,Loyal Users
99686,12,104,385,5,5,5,15,Champions
99743,200,104,189,3,5,5,13,Loyal Users
91094,3489,8,31,1,2,2,5,Lost
91309,989,10,98,2,2,4,8,Lost
91407,3437,6,8,1,1,1,3,Lost
91535,931,5,6,2,1,1,4,Lost
91851,94,18,36,4,3,3,10,Loyal Users
91896,44,13,23,5,3,2,10,Loyal Users
92409,4101,46,69,1,5,4,10,At Risk
92471,3903,6,9,1,1,1,3,Lost
92488,118,98,162,4,5,5,14,Champions
92783,91,12,16,4,3,2,9,Loyal Users
92817,1094,16,44,2,3,3,8,Casual Users
92862,277,17,81,3,3,4,10,Loyal Users
92963,134,13,16,4,3,2,9,Loyal Users
93385,18,78,182,5,5,5,15,Champions
93734,247,46,104,3,5,4,12,Loyal Users
93874,6,68,170,5,5,5,15,Champions
94164,2667,6,10,1,1,1,3,Lost
94393,4311,5,10,1,1,1,3,Lost
94778,4,109,173,5,5,5,15,Champions
94841,251,20,70,3,3,4,10,Loyal Users
94887,1179,6,9,2,1,1,4,Lost
94944,1858,8,49,1,2,3,6,Lost
94998,3391,5,5,1,1,1,3,Lost
95220,181,47,157,3,5,5,13,Loyal Users
95230,143,10,29,4,2,2,8,Promising
95248,254,33,86,3,4,4,11,Loyal Users
95288,250,20,46,3,3,3,9,Loyal Users
95494,1115,7,7,2,2,1,5,Lost
95743,943,5,10,2,1,1,4,Lost
95992,65,44,181,5,4,5,14,Champions
96330,3395,5,15,1,1,1,3,Lost
96653,3241,9,18,1,2,2,5,Lost
96678,982,15,29,2,3,2,7,Casual Users
96887,533,13,16,2,3,2,7,Casual Users
96909,534,21,97,2,3,4,9,Casual Users
97082,976,17,53,2,3,3,8,Casual Users
97219,155,18,205,4,3,5,12,Loyal Users
97302,3372,7,51,1,2,3,6,Lost
97664,1013,34,78,2,4,4,10,At Risk
97712,694,7,16,2,2,2,6,Lost
97967,689,46,84,2,5,4,11,At Risk
98525,428,31,279,3,4,5,12,Loyal Users
98589,4877,13,15,1,3,1,5,Casual Users
98673,171,108,306,3,5,5,13,Loyal Users
99166,1502,7,45,1,2,3,6,Lost
99425,301,7,16,3,2,2,7,Casual Users
99514,97,23,49,4,4,3,11,Loyal Users
99633,448,6,33,3,1,3,7,Casual Users
99639,857,9,31,2,2,2,6,Lost
99916,168,39,67,3,4,4,11,Loyal Users
91252,180,40,58,3,4,3,10,Loyal Users
91261,8,5,7,5,1,1,7,Promising
91388,447,24,34,3,4,3,10,Loyal Users
91830,115,23,39,4,4,3,11,Loyal Users
91838,969,27,38,2,4,3,9,At Risk
91859,139,59,755,4,5,5,14,Champions
91959,3296,6,6,1,1,1,3,Lost
92076,1982,11,21,1,2,2,5,Lost
92152,3219,9,20,1,2,2,5,Lost
92385,845,5,8,2,1,1,4,Lost
92635,1870,27,30,1,4,2,7,At Risk
93328,2149,6,18,1,1,2,4,Lost
93876,149,6,9,4,1,1,6,Promising
94047,742,11,63,2,2,4,8,Lost
94236,298,31,53,3,4,3,10,Loyal Users
94286,279,16,106,3,3,4,10,Loyal Users
94355,2237,19,47,1,3,3,7,Casual Users
94493,431,6,27,3,1,2,6,Casual Users
94600,543,24,98,2,4,4,10,At Risk
94758,96,68,227,4,5,5,14,Champions
94908,40,22,67,5,4,4,13,Champions
95349,66,78,158,5,5,5,15,Champions
95351,1009,8,36,2,2,3,7,Lost
95431,139,20,59,4,3,3,10,Loyal Users
95704,668,12,29,2,3,2,7,Casual Users
95910,1416,13,33,1,3,3,7,Casual Users
96203,38,114,384,5,5,5,15,Champions
96210,442,44,56,3,4,3,10,Loyal Users
96230,608,14,35,2,3,3,8,Casual Users
96358,894,5,17,2,1,2,5,Lost
96363,103,172,400,4,5,5,14,Champions
96557,681,7,20,2,2,2,6,Lost
96833,148,8,25,4,2,2,8,Promising
96955,5,144,442,5,5,5,15,Champions
97032,123,14,20,4,3,2,9,Loyal Users
97069,69,87,342,5,5,5,15,Champions
97228,5421,19,21,1,3,2,6,Casual Users
97434,532,26,86,2,4,4,10,At Risk
97720,12,6,16,5,1,2,8,Promising
98093,0,24,55,5,4,3,12,Loyal Users
98313,12,105,385,5,5,5,15,Champions
98372,331,8,13,3,2,1,6,Casual Users
98469,26,62,108,5,5,4,14,Champions
98496,821,10,27,2,2,2,6,Lost
98532,136,37,53,4,4,3,11,Loyal Users
98622,7,73,232,5,5,5,15,Champions
91848,5427,7,9,1,2,1,4,Lost
92168,10,38,115,5,4,4,13,Champions
92229,417,5,81,3,1,4,8,Casual Users
92399,736,5,20,2,1,2,5,Lost
92812,1609,18,23,1,3,2,6,Casual Users
92889,129,19,53,4,3,3,10,Loyal Users
92924,84,51,59,4,5,3,12,Loyal Users
93016,102,23,53,4,4,3,11,Loyal Users
93268,347,29,104,3,4,4,11,Loyal Users
93318,46,25,86,5,4,4,13,Champions
93346,1380,6,31,1,1,2,4,Lost
93365,423,7,7,3,2,1,6,Casual Users
93860,1428,13,21,1,3,2,6,Casual Users
94170,391,8,13,3,2,1,6,Casual Users
94205,459,16,22,3,3,2,8,Loyal Users
94309,273,47,159,3,5,5,13,Loyal Users
95004,4580,5,8,1,1,1,3,Lost
95096,1516,8,18,1,2,2,5,Lost
95137,144,70,215,4,5,5,14,Champions
95283,280,62,137,3,5,4,12,Loyal Users
95312,429,21,51,3,3,3,9,Loyal Users
95884,76,27,67,4,4,4,12,Champions
95935,437,11,20,3,2,2,7,Casual Users
96227,15,126,592,5,5,5,15,Champions
96642,81,24,74,4,4,4,12,Champions
96911,556,5,6,2,1,1,4,Lost
96990,1442,5,40,1,1,3,5,Lost
97054,538,5,9,2,1,1,4,Lost
97066,32,8,47,5,2,3,10,Promising
97382,321,14,28,3,3,2,8,Loyal Users
98689,865,14,42,2,3,3,8,Casual Users
99180,513,20,129,2,3,4,9,Casual Users
99275,284,32,62,3,4,3,10,Loyal Users
99570,1621,7,17,1,2,2,5,Lost
99644,694,9,15,2,2,1,5,Lost
99847,263,49,284,3,5,5,13,Loyal Users
99890,626,7,14,2,2,1,5,Lost
91242,254,13,42,3,3,3,9,Loyal Users
91383,5675,7,13,1,2,1,4,Lost
91583,74,29,67,4,4,4,12,Champions
91624,37,43,330,5,4,5,14,Champions
91708,109,36,93,4,4,4,12,Champions
91731,417,20,49,3,3,3,9,Loyal Users
91756,57,48,96,5,5,4,14,Champions
91840,1548,8,49,1,2,3,6,Lost
91900,2175,5,38,1,1,3,5,Lost
91957,28,15,76,5,3,4,12,Loyal Users
92201,24,50,108,5,5,4,14,Champions
92325,3125,11,21,1,2,2,5,Lost
92841,7,27,58,5,4,3,12,Loyal Users
93217,101,6,20,4,1,2,7,Promising
93479,1448,8,14,1,2,1,4,Lost
93579,320,5,11,3,1,1,5,Casual Users
93681,1724,12,17,1,3,2,6,Casual Users
94171,905,11,45,2,2,3,7,Lost
94668,110,31,80,4,4,4,12,Champions
94762,78,42,57,4,4,3,11,Loyal Users
95345,544,7,17,2,2,2,6,Lost
95399,2305,6,14,1,1,1,3,Lost
95441,261,22,49,3,4,3,10,Loyal Users
95491,1714,19,22,1,3,2,6,Casual Users
95577,157,25,86,4,4,4,12,Champions
95639,546,6,10,2,1,1,4,Lost
95830,97,38,90,4,4,4,12,Champions
96013,1112,6,6,2,1,1,4,Lost
96023,0,169,598,5,5,5,15,Champions
96062,0,53,298,5,5,5,15,Champions
96284,24,16,26,5,3,2,10,Loyal Users
96324,412,32,65,3,4,4,11,Loyal Users
96389,313,5,29,3,1,2,6,Casual Users
96426,152,25,43,4,4,3,11,Loyal Users
96547,352,20,54,3,3,3,9,Loyal Users
96834,713,15,62,2,3,3,8,Casual Users
97480,509,5,5,2,1,1,4,Lost
97511,88,12,28,4,3,2,9,Loyal Users
97639,54,32,63,5,4,4,13,Champions
97687,542,9,89,2,2,4,8,Lost
97775,85,171,337,4,5,5,14,Champions
97813,501,10,38,2,2,3,7,Lost
98045,1003,5,14,2,1,1,4,Lost
98235,168,45,202,3,4,5,12,Loyal Users
98247,24,39,137,5,4,4,13,Champions
98403,1280,5,9,1,1,1,3,Lost
98505,1731,12,17,1,3,2,6,Casual Users
98569,905,13,22,2,3,2,7,Casual Users
98707,91,92,127,4,5,4,13,Champions
98854,284,33,138,3,4,4,11,Loyal Users
99188,377,6,8,3,1,1,5,Casual Users
99220,4629,5,15,1,1,1,3,Lost
99269,581,12,20,2,3,2,7,Casual Users
99300,113,21,188,4,3,5,12,Loyal Users
99355,136,75,125,4,5,4,13,Champions
99674,30,20,57,5,3,3,11,Loyal Users
99957,11,11,93,5,2,4,11,Promising
99988,13,14,63,5,3,4,12,Loyal Users
91282,17,34,68,5,4,4,13,Champions
91377,2734,10,63,1,2,4,7,Lost
91748,1,120,676,5,5,5,15,Champions
91768,204,16,25,3,3,2,8,Loyal Users
91816,42,36,77,5,4,4,13,Champions
92217,18,41,229,5,4,5,14,Champions
92620,118,68,240,4,5,5,14,Champions
92630,408,9,46,3,2,3,8,Casual Users
93220,9,84,279,5,5,5,15,Champions
93451,17,21,55,5,3,3,11,Loyal Users
93657,5439,12,24,1,3,2,6,Casual Users
94387,1,68,112,5,5,4,14,Champions
94979,225,6,7,3,1,1,5,Casual Users
95003,2800,5,27,1,1,2,4,Lost
95108,126,8,10,4,2,1,7,Promising
95489,15,72,174,5,5,5,15,Champions
95784,620,8,24,2,2,2,6,Lost
95916,59,10,32,5,2,3,10,Promising
96518,868,5,10,2,1,1,4,Lost
96529,1600,5,14,1,1,1,3,Lost
96680,1793,5,7,1,1,1,3,Lost
96906,363,8,40,3,2,3,8,Casual Users
96929,852,6,13,2,1,1,4,Lost
97021,117,8,13,4,2,1,7,Promising
97399,1342,7,20,1,2,2,5,Lost
98150,150,27,160,4,4,5,13,Champions
98416,65,45,346,5,4,5,14,Champions
99009,4252,5,24,1,1,2,4,Lost
99163,402,7,50,3,2,3,8,Casual Users
99170,875,12,22,2,3,2,7,Casual Users
99229,104,6,39,4,1,3,8,Promising
99411,72,12,23,4,3,2,9,Loyal Users
99434,448,22,65,3,4,4,11,Loyal Users
99464,636,5,19,2,1,2,5,Lost
99472,158,5,8,4,1,1,6,Promising
99599,3,144,456,5,5,5,15,Champions
99699,52,91,619,5,5,5,15,Champions
91190,383,19,27,3,3,2,8,Loyal Users
91416,705,5,10,2,1,1,4,Lost
91514,45,100,184,5,5,5,15,Champions
91610,243,9,9,3,2,1,6,Casual Users
91632,125,106,170,4,5,5,14,Champions
91867,2126,9,14,1,2,1,4,Lost
91933,66,20,43,5,3,3,11,Loyal Users
92398,120,48,214,4,5,5,14,Champions
92581,470,9,20,3,2,2,7,Casual Users
92655,422,57,144,3,5,4,12,Loyal Users
93566,16,114,525,5,5,5,15,Champions
93779,1563,8,12,1,2,1,4,Lost
93997,2303,8,14,1,2,1,4,Lost
94002,15,6,16,5,1,2,8,Promising
94063,846,11,18,2,2,2,6,Lost
94192,596,33,196,2,4,5,11,At Risk
94281,101,14,57,4,3,3,10,Loyal Users
94318,4172,18,34,1,3,3,7,Casual Users
94670,291,7,24,3,2,2,7,Casual Users
94727,1579,10,18,1,2,2,5,Lost
94771,746,14,35,2,3,3,8,Casual Users
95262,2298,9,22,1,2,2,5,Lost
95415,3210,10,54,1,2,3,6,Lost
95455,5409,10,32,1,2,3,6,Lost
95978,135,7,8,4,2,1,7,Promising
96623,90,7,14,4,2,1,7,Promising
96668,2249,6,6,1,1,1,3,Lost
96682,578,17,185,2,3,5,10,Casual Users
96750,14,157,437,5,5,5,15,Champions
96811,291,24,78,3,4,4,11,Loyal Users
96883,430,9,16,3,2,2,7,Casual Users
96958,137,17,40,4,3,3,10,Loyal Users
96977,148,14,32,4,3,3,10,Loyal Users
97683,2838,49,262,1,5,5,11,At Risk
98101,1,10,23,5,2,2,9,Promising
98292,2180,6,37,1,1,3,5,Lost
98310,6,115,522,5,5,5,15,Champions
98522,13,102,197,5,5,5,15,Champions
98631,698,6,9,2,1,1,4,Lost
99137,1598,16,35,1,3,3,7,Casual Users
99885,11,134,425,5,5,5,15,Champions
91417,703,5,11,2,1,1,4,Lost
91476,260,57,75,3,5,4,12,Loyal Users
91596,132,5,50,4,1,3,8,Promising
91605,43,165,390,5,5,5,15,Champions
91642,125,73,338,4,5,5,14,Champions
91728,284,73,232,3,5,5,13,Loyal Users
91804,338,150,429,3,5,5,13,Loyal Users
91993,183,10,16,3,2,2,7,Casual Users
92071,130,22,43,4,4,3,11,Loyal Users
92719,0,30,117,5,4,4,13,Champions
92896,5477,5,7,1,1,1,3,Lost
93086,3005,10,18,1,2,2,5,Lost
93222,415,6,22,3,1,2,6,Casual Users
93574,262,6,27,3,1,2,6,Casual Users
93656,382,19,62,3,3,3,9,Loyal Users
94151,362,79,94,3,5,4,12,Loyal Users
94195,457,18,34,3,3,3,9,Loyal Users
94504,126,11,20,4,2,2,8,Promising
94982,13,72,171,5,5,5,15,Champions
95350,12,134,500,5,5,5,15,Champions
96307,89,7,19,4,2,2,8,Promising
96309,233,68,112,3,5,4,12,Loyal Users
96769,80,66,217,4,5,5,14,Champions
96908,3119,6,26,1,1,2,4,Lost
97062,466,79,136,3,5,4,12,Loyal Users
97146,402,16,30,3,3,2,8,Loyal Users
97424,8,58,80,5,5,4,14,Champions
97866,115,42,63,4,4,4,12,Champions
97899,232,48,237,3,5,5,13,Loyal Users
97900,1530,5,32,1,1,3,5,Lost
98158,1865,8,9,1,2,1,4,Lost
98297,2414,6,22,1,1,2,4,Lost
98504,85,8,19,4,2,2,8,Promising
98615,5862,5,5,1,1,1,3,Lost
98661,5,23,191,5,4,5,14,Champions
98820,879,9,29,2,2,2,6,Lost
98900,133,32,82,4,4,4,12,Champions
99038,369,24,173,3,4,5,12,Loyal Users
99253,790,6,7,2,1,1,4,Lost
99629,128,6,23,4,1,2,7,Promising
99820,1003,23,57,2,4,3,9,At Risk
91278,61,6,9,5,1,1,7,Promising
91325,186,15,86,3,3,4,10,Loyal Users
91453,29,21,45,5,3,3,11,Loyal Users
91578,100,102,394,4,5,5,14,Champions
92060,71,34,114,4,4,4,12,Champions
92355,217,12,36,3,3,3,9,Loyal Users
93078,98,17,94,4,3,4,11,Loyal Users
93121,142,27,53,4,4,3,11,Loyal Users
93265,316,127,254,3,5,5,13,Loyal Users
93334,50,30,76,5,4,4,13,Champions
93336,128,54,77,4,5,4,13,Champions
93348,55,45,138,5,4,4,13,Champions
93496,101,97,176,4,5,5,14,Champions
93599,261,50,240,3,5,5,13,Loyal Users
93682,704,10,47,2,2,3,7,Lost
93718,0,65,74,5,5,4,14,Champions
93720,102,33,124,4,4,4,12,Champions
94513,494,12,32,2,3,3,8,Casual Users
94534,833,5,7,2,1,1,4,Lost
94573,163,58,237,4,5,5,14,Champions
94652,108,16,79,4,3,4,11,Loyal Users
94678,177,11,52,3,2,3,8,Casual Users
94814,2,102,140,5,5,4,14,Champions
95051,183,17,27,3,3,2,8,Loyal Users
95078,1548,5,8,1,1,1,3,Lost
95123,1788,5,5,1,1,1,3,Lost
95199,117,10,35,4,2,3,9,Promising
95304,119,8,36,4,2,3,9,Promising
95432,383,20,26,3,3,2,8,Loyal Users
95520,24,25,46,5,4,3,12,Loyal Users
95667,546,102,226,2,5,5,12,At Risk
95708,7,31,86,5,4,4,13,Champions
95761,40,62,189,5,5,5,15,Champions
95823,680,6,9,2,1,1,4,Lost
95857,984,5,10,2,1,1,4,Lost
95965,1993,24,34,1,4,3,8,At Risk
96270,1551,12,24,1,3,2,6,Casual Users
97006,2553,7,10,1,2,1,4,Lost
97075,20,120,194,5,5,5,15,Champions
97124,27,9,10,5,2,1,8,Promising
97584,1228,5,62,2,1,3,6,Lost
97772,3,71,251,5,5,5,15,Champions
98024,871,30,53,2,4,3,9,At Risk
98118,150,36,42,4,4,3,11,Loyal Users
98208,986,7,8,2,2,1,5,Lost
98456,1324,6,10,1,1,1,3,Lost
98912,288,20,33,3,3,3,9,Loyal Users
99024,70,78,223,4,5,5,14,Champions
99069,0,200,315,5,5,5,15,Champions
99122,7,35,182,5,4,5,14,Champions
99172,455,5,11,3,1,1,5,Casual Users
99221,184,28,47,3,4,3,10,Loyal Users
99270,127,74,101,4,5,4,13,Champions
99788,146,163,467,4,5,5,14,Champions
91109,111,52,194,4,5,5,14,Champions
91179,1976,108,334,1,5,5,11,At Risk
91216,237,9,10,3,2,1,6,Casual Users
91219,2184,5,7,1,1,1,3,Lost
92017,1474,16,32,1,3,3,7,Casual Users
92024,1701,8,35,1,2,3,6,Lost
92031,586,29,89,2,4,4,10,At Risk
92047,946,5,19,2,1,2,5,Lost
92055,409,6,10,3,1,1,5,Casual Users
92467,70,38,64,4,4,4,12,Champions
92643,1,76,306,5,5,5,15,Champions
93011,2490,33,149,1,4,5,10,At Risk
93026,708,10,32,2,2,3,7,Lost
93107,212,10,15,3,2,1,6,Casual Users
93147,477,11,19,2,2,2,6,Lost
93529,3639,5,8,1,1,1,3,Lost
93735,4,9,29,5,2,2,9,Promising
93954,231,39,334,3,4,5,12,Loyal Users
93996,18,103,191,5,5,5,15,Champions
94226,1588,8,16,1,2,2,5,Lost
94237,17,11,21,5,2,2,9,Promising
94796,876,17,22,2,3,2,7,Casual Users
94837,11,37,99,5,4,4,13,Champions
95319,3,189,763,5,5,5,15,Champions
95471,6,49,123,5,5,4,14,Champions
95574,7,77,408,5,5,5,15,Champions
95630,36,65,377,5,5,5,15,Champions
95728,1272,6,16,1,1,2,4,Lost
96146,106,33,104,4,4,4,12,Champions
96287,314,24,45,3,4,3,10,Loyal Users
96430,433,11,19,3,2,2,7,Casual Users
96435,2710,18,36,1,3,3,7,Casual Users
96979,2141,14,32,1,3,3,7,Casual Users
97698,413,9,12,3,2,1,6,Casual Users
97751,2402,79,462,1,5,5,11,At Risk
97781,3,51,143,5,5,4,14,Champions
98048,1829,7,11,1,2,1,4,Lost
98107,1952,6,10,1,1,1,3,Lost
98211,1055,34,68,2,4,4,10,At Risk
98330,74,85,324,4,5,5,14,Champions
98364,108,84,115,4,5,4,13,Champions
98612,5,19,60,5,3,3,11,Loyal Users
99126,72,59,184,4,5,5,14,Champions
99131,417,21,44,3,3,3,9,Loyal Users
99296,675,19,47,2,3,3,8,Casual Users
99447,779,18,41,2,3,3,8,Casual Users
99737,719,12,40,2,3,3,8,Casual Users
99881,661,5,5,2,1,1,4,Lost
99943,7,6,15,5,1,1,7,Promising
99946,144,8,27,4,2,2,8,Promising
91260,1946,68,196,1,5,5,11,At Risk
91552,3127,19,39,1,3,3,7,Casual Users
91586,161,25,77,4,4,4,12,Champions
91787,588,38,194,2,4,5,11,At Risk
92070,812,11,18,2,2,2,6,Lost
92207,1095,27,34,2,4,3,9,At Risk
92647,403,13,16,3,3,2,8,Loyal Users
92680,1625,20,75,1,3,4,8,Casual Users
92856,226,49,63,3,5,4,12,Loyal Users
93342,702,8,21,2,2,2,6,Lost
93404,480,5,9,2,1,1,4,Lost
93476,462,6,11,3,1,1,5,Casual Users
93546,1740,7,12,1,2,1,4,Lost
93697,31,9,46,5,2,3,10,Promising
94454,1719,14,86,1,3,4,8,Casual Users
94716,36,8,26,5,2,2,9,Promising
94754,36,19,58,5,3,3,11,Loyal Users
94824,36,45,337,5,4,5,14,Champions
94848,9,91,205,5,5,5,15,Champions
94925,1270,5,5,1,1,1,3,Lost
94977,2429,5,8,1,1,1,3,Lost
95171,4,35,61,5,4,3,12,Loyal Users
95223,60,126,577,5,5,5,15,Champions
95321,2692,6,11,1,1,1,3,Lost
95428,1503,30,40,1,4,3,8,At Risk
95536,444,6,9,3,1,1,5,Casual Users
95722,130,48,161,4,5,5,14,Champions
95770,143,34,81,4,4,4,12,Champions
95800,669,6,13,2,1,1,4,Lost
96030,29,42,137,5,4,4,13,Champions
96057,4018,8,25,1,2,2,5,Lost
96688,4529,24,24,1,4,2,7,At Risk
96694,4873,8,16,1,2,2,5,Lost
96708,740,10,42,2,2,3,7,Lost
97560,402,27,42,3,4,3,10,Loyal Users
97566,286,5,6,3,1,1,5,Casual Users
97724,112,7,9,4,2,1,7,Promising
98028,4,14,21,5,3,2,10,Loyal Users
98125,32,55,144,5,5,4,14,Champions
98163,132,8,26,4,2,2,8,Promising
98212,158,12,28,4,3,2,9,Loyal Users
98745,392,38,137,3,4,4,11,Loyal Users
98800,93,21,89,4,3,4,11,Loyal Users
98916,70,162,361,4,5,5,14,Champions
98975,69,80,415,5,5,5,15,Champions
99209,684,34,61,2,4,3,9,At Risk
99321,63,23,71,5,4,4,13,Champions
99838,3724,10,17,1,2,2,5,Lost
99866,3162,6,9,1,1,1,3,Lost
91092,1,63,202,5,5,5,15,Champions
91530,68,52,160,5,5,5,15,Champions
91609,574,10,20,2,2,2,6,Lost
91709,473,33,87,2,4,4,10,At Risk
91725,6,91,319,5,5,5,15,Champions
91761,12,47,69,5,5,4,14,Champions
92034,235,9,26,3,2,2,7,Casual Users
92260,430,5,6,3,1,1,5,Casual Users
92557,1156,15,48,2,3,3,8,Casual Users
92562,539,26,95,2,4,4,10,At Risk
92619,1656,5,5,1,1,1,3,Lost
92818,1753,8,41,1,2,3,6,Lost
92960,66,21,170,5,3,5,13,Loyal Users
92993,1300,7,33,1,2,3,6,Lost
93009,3337,11,23,1,2,2,5,Lost
93036,312,14,19,3,3,2,8,Loyal Users
93161,46,80,189,5,5,5,15,Champions
93327,264,13,56,3,3,3,9,Loyal Users
93514,2985,6,10,1,1,1,3,Lost
93616,961,203,622,2,5,5,12,At Risk
93926,699,9,30,2,2,2,6,Lost
94317,269,42,93,3,4,4,11,Loyal Users
94511,14,122,312,5,5,5,15,Champions
94667,517,18,23,2,3,2,7,Casual Users
94798,2278,11,28,1,2,2,5,Lost
94800,664,5,6,2,1,1,4,Lost
94991,116,5,7,4,1,1,6,Promising
95290,390,46,84,3,5,4,12,Loyal Users
95568,991,37,147,2,4,5,11,At Risk
95661,2567,13,28,1,3,2,6,Casual Users
95774,138,28,78,4,4,4,12,Champions
95786,44,95,251,5,5,5,15,Champions
95801,423,43,170,3,4,5,12,Loyal Users
96497,1209,6,7,2,1,1,4,Lost
96664,3401,10,16,1,2,2,5,Lost
96793,1540,71,108,1,5,4,10,At Risk
97033,451,7,8,3,2,1,6,Casual Users
97147,1593,12,178,1,3,5,9,Casual Users
98374,1708,5,5,1,1,1,3,Lost
98652,1327,7,13,1,2,1,4,Lost
98768,2218,10,15,1,2,1,4,Lost
98849,599,9,17,2,2,2,6,Lost
98938,286,14,49,3,3,3,9,Loyal Users
98982,152,6,44,4,1,3,8,Promising
99073,24,15,61,5,3,3,11,Loyal Users
99095,125,60,335,4,5,5,14,Champions
99241,265,26,78,3,4,4,11,Loyal Users
99244,4,138,551,5,5,5,15,Champions
99294,28,36,154,5,4,5,14,Champions
99365,255,5,19,3,1,2,6,Casual Users
99939,826,10,34,2,2,3,7,Lost
91090,148,59,266,4,5,5,14,Champions
91119,168,64,263,3,5,5,13,Loyal Users
91318,1081,21,59,2,3,3,8,Casual Users
91361,448,6,20,3,1,2,6,Casual Users
91404,64,7,23,5,2,2,9,Promising
91656,590,23,86,2,4,4,10,At Risk
91684,570,11,16,2,2,2,6,Lost
91699,2847,6,7,1,1,1,3,Lost
91987,3,150,791,5,5,5,15,Champions
92251,28,66,232,5,5,5,15,Champions
92259,75,107,458,4,5,5,14,Champions
92297,85,62,132,4,5,4,13,Champions
92622,465,27,60,3,4,3,10,Loyal Users
93184,42,59,287,5,5,5,15,Champions
93223,128,85,503,4,5,5,14,Champions
93494,283,8,30,3,2,2,7,Casual Users
93587,289,14,25,3,3,2,8,Loyal Users
93821,673,5,17,2,1,2,5,Lost
94581,4544,5,14,1,1,1,3,Lost
94594,1429,20,56,1,3,3,7,Casual Users
94638,39,17,43,5,3,3,11,Loyal Users
94883,107,18,89,4,3,4,11,Loyal Users
95084,43,210,385,5,5,5,15,Champions
95147,448,25,171,3,4,5,12,Loyal Users
95607,431,28,92,3,4,4,11,Loyal Users
95674,18,22,79,5,4,4,13,Champions
96078,2108,6,29,1,1,2,4,Lost
96190,10,7,11,5,2,1,8,Promising
96394,4420,9,9,1,2,1,4,Lost
96396,640,17,53,2,3,3,8,Casual Users
96541,252,14,15,3,3,1,7,Loyal Users
96567,421,15,34,3,3,3,9,Loyal Users
96601,5955,10,10,1,2,1,4,Lost
97345,587,12,31,2,3,2,7,Casual Users
97595,276,91,191,3,5,5,13,Loyal Users
97809,64,78,139,5,5,4,14,Champions
97819,76,58,331,4,5,5,14,Champions
97860,1121,11,19,2,2,2,6,Lost
98082,323,8,8,3,2,1,6,Casual Users
98141,1973,5,6,1,1,1,3,Lost
98173,7,23,137,5,4,4,13,Champions
98180,123,26,55,4,4,3,11,Loyal Users
98385,4,55,69,5,5,4,14,Champions
98418,55,141,595,5,5,5,15,Champions
98494,1512,5,32,1,1,3,5,Lost
98585,2,60,169,5,5,5,15,Champions
99267,568,11,29,2,2,2,6,Lost
99446,1712,26,45,1,4,3,8,At Risk
99967,266,34,94,3,4,4,11,Loyal Users
99971,309,9,12,3,2,1,6,Casual Users
99992,1137,7,37,2,2,3,7,Lost
91191,885,7,15,2,2,1,5,Lost
91212,44,26,53,5,4,3,12,Loyal Users
91243,160,17,127,4,3,4,11,Loyal Users
91406,1330,14,18,1,3,2,6,Casual Users
91928,4665,5,6,1,1,1,3,Lost
92011,20,66,102,5,5,4,14,Champions
92013,457,7,98,3,2,4,9,Casual Users
92021,613,14,47,2,3,3,8,Casual Users
92095,120,19,30,4,3,2,9,Loyal Users
92114,893,5,5,2,1,1,4,Lost
92449,4001,6,7,1,1,1,3,Lost
93007,18,171,392,5,5,5,15,Champions
93153,29,175,400,5,5,5,15,Champions
93457,501,18,25,2,3,2,7,Casual Users
93484,48,29,52,5,4,3,12,Loyal Users
93545,113,27,116,4,4,4,12,Champions
93829,111,37,135,4,4,4,12,Champions
93900,6,13,73,5,3,4,12,Loyal Users
94110,4,113,548,5,5,5,15,Champions
94132,125,24,67,4,4,4,12,Champions
94314,2041,5,5,1,1,1,3,Lost
94426,116,89,377,4,5,5,14,Champions
94770,832,6,19,2,1,2,5,Lost
94779,288,31,60,3,4,3,10,Loyal Users
94874,688,5,10,2,1,1,4,Lost
94881,29,72,188,5,5,5,15,Champions
94900,137,13,36,4,3,3,10,Loyal Users
95259,679,32,264,2,4,5,11,At Risk
95277,1060,9,22,2,2,2,6,Lost
95422,32,22,54,5,4,3,12,Loyal Users
95449,63,47,231,5,5,5,15,Champions
95642,2888,7,13,1,2,1,4,Lost
95658,357,19,127,3,3,4,10,Loyal Users
95718,547,67,217,2,5,5,12,At Risk
95772,3,5,19,5,1,2,8,Promising
95997,2000,6,24,1,1,2,4,Lost
96097,1445,22,44,1,4,3,8,At Risk
96564,1585,22,34,1,4,3,8,At Risk
96622,210,6,22,3,1,2,6,Casual Users
96995,131,18,61,4,3,3,10,Loyal Users
97272,575,23,83,2,4,4,10,At Risk
97283,2739,6,9,1,1,1,3,Lost
97343,1520,5,14,1,1,1,3,Lost
97404,1548,13,22,1,3,2,6,Casual Users
97411,426,6,29,3,1,2,6,Casual Users
97447,863,10,87,2,2,4,8,Lost
97601,22,54,165,5,5,5,15,Champions
97788,67,43,68,5,4,4,13,Champions
98041,13,63,121,5,5,4,14,Champions
98363,275,27,85,3,4,4,11,Loyal Users
98634,5,64,398,5,5,5,15,Champions
98635,4987,5,5,1,1,1,3,Lost
98855,2709,6,7,1,1,1,3,Lost
99193,708,14,26,2,3,2,7,Casual Users
99251,942,5,16,2,1,2,5,Lost
99713,167,23,32,3,4,3,10,Loyal Users
99831,1515,5,9,1,1,1,3,Lost
99949,4466,17,17,1,3,2,6,Casual Users
91471,23,211,450,5,5,5,15,Champions
91723,1007,9,9,2,2,1,5,Lost
91970,18,24,97,5,4,4,13,Champions
91994,91,66,259,4,5,5,14,Champions
92046,624,23,29,2,4,2,8,At Risk
92167,651,34,304,2,4,5,11,At Risk
92247,418,16,30,3,3,2,8,Loyal Users
92407,411,7,17,3,2,2,7,Casual Users
92707,1007,14,32,2,3,3,8,Casual Users
92728,487,23,50,2,4,3,9,At Risk
92877,353,19,78,3,3,4,10,Loyal Users
92892,140,20,82,4,3,4,11,Loyal Users
93210,47,67,319,5,5,5,15,Champions
93340,1997,17,56,1,3,3,7,Casual Users
94335,1028,25,93,2,4,4,10,At Risk
94381,131,16,72,4,3,4,11,Loyal Users
94456,164,53,263,4,5,5,14,Champions
94597,122,16,21,4,3,2,9,Loyal Users
94697,11,12,31,5,3,2,10,Loyal Users
94890,369,10,65,3,2,4,9,Casual Users
94891,407,28,139,3,4,4,11,Loyal Users
95067,153,33,228,4,4,5,13,Champions
95141,105,28,59,4,4,3,11,Loyal Users
95401,4,16,76,5,3,4,12,Loyal Users
95418,107,7,32,4,2,3,9,Promising
95465,148,5,18,4,1,2,7,Promising
95500,2253,5,40,1,1,3,5,Lost
95591,649,8,18,2,2,2,6,Lost
95980,672,9,11,2,2,1,5,Lost
96364,270,44,69,3,4,4,11,Loyal Users
96423,121,7,40,4,2,3,9,Promising
96701,1811,7,21,1,2,2,5,Lost
96747,446,5,8,3,1,1,5,Casual Users
97003,4,31,76,5,4,4,13,Champions
97026,1004,16,19,2,3,2,7,Casual Users
97190,1257,6,6,2,1,1,4,Lost
97306,34,96,272,5,5,5,15,Champions
97452,4377,6,21,1,1,2,4,Lost
98516,243,5,80,3,1,4,8,Casual Users
98626,6,11,19,5,2,2,9,Promising
98746,2563,6,12,1,1,1,3,Lost
98914,2102,8,18,1,2,2,5,Lost
98971,34,9,12,5,2,1,8,Promising
99014,1848,6,14,1,1,1,3,Lost
99176,9,48,103,5,5,4,14,Champions
99226,264,8,18,3,2,2,7,Casual Users
99572,123,14,25,4,3,2,9,Loyal Users
99577,2630,5,5,1,1,1,3,Lost
99821,151,211,613,4,5,5,14,Champions
99978,1852,14,77,1,3,4,8,Casual Users
99986,155,20,68,4,3,4,11,Loyal Users
91149,125,33,59,4,4,3,11,Loyal Users
91152,304,17,40,3,3,3,9,Loyal Users
91315,170,12,76,3,3,4,10,Loyal Users
91418,398,8,22,3,2,2,7,Casual Users
91692,697,12,19,2,3,2,7,Casual Users
91771,103,5,6,4,1,1,6,Promising
91881,227,9,10,3,2,1,6,Casual Users
92394,65,36,109,5,4,4,13,Champions
92520,386,12,18,3,3,2,8,Loyal Users
92744,412,5,5,3,1,1,5,Casual Users
92805,0,59,175,5,5,5,15,Champions
92931,484,6,27,2,1,2,5,Lost
92969,183,77,307,3,5,5,13,Loyal Users
93249,658,23,60,2,4,3,9,At Risk
93511,41,114,399,5,5,5,15,Champions
93606,123,12,25,4,3,2,9,Loyal Users
93661,386,14,25,3,3,2,8,Loyal Users
94172,781,21,66,2,3,4,9,Casual Users
94562,226,94,212,3,5,5,13,Loyal Users
94623,73,76,223,4,5,5,14,Champions
94699,30,76,386,5,5,5,15,Champions
94880,215,98,228,3,5,5,13,Loyal Users
95125,922,7,51,2,2,3,7,Lost
95380,1849,8,9,1,2,1,4,Lost
95512,4635,5,5,1,1,1,3,Lost
95734,34,45,137,5,4,4,13,Champions
95813,2934,5,7,1,1,1,3,Lost
96482,626,38,95,2,4,4,10,At Risk
96512,3255,7,10,1,2,1,4,Lost
96612,277,12,16,3,3,2,8,Loyal Users
96758,295,19,108,3,3,4,10,Loyal Users
96921,367,9,19,3,2,2,7,Casual Users
97652,46,22,37,5,4,3,12,Loyal Users
97662,1598,6,15,1,1,1,3,Lost
97721,13,42,116,5,4,4,13,Champions
97774,8,94,119,5,5,4,14,Champions
97844,1096,19,49,2,3,3,8,Casual Users
98010,168,20,98,3,3,4,10,Loyal Users
98188,1143,33,159,2,4,5,11,At Risk
98397,1132,6,7,2,1,1,4,Lost
98793,2478,7,12,1,2,1,4,Lost
99105,2834,9,40,1,2,3,6,Lost
99121,106,8,15,4,2,1,7,Promising
99431,1221,14,97,2,3,4,9,Casual Users
91138,921,13,41,2,3,3,8,Casual Users
91251,1074,19,72,2,3,4,9,Casual Users
91440,5717,19,87,1,3,4,8,Casual Users
91754,408,9,37,3,2,3,8,Casual Users
91968,54,62,148,5,5,5,15,Champions
92105,4680,8,9,1,2,1,4,Lost
92158,993,6,9,2,1,1,4,Lost
92212,1833,16,42,1,3,3,7,Casual Users
92266,4329,6,12,1,1,1,3,Lost
92506,332,25,37,3,4,3,10,Loyal Users
92659,2,44,151,5,4,5,14,Champions
92747,2006,33,70,1,4,4,9,At Risk
93034,28,24,63,5,4,4,13,Champions
93110,258,108,131,3,5,4,12,Loyal Users
93129,38,38,158,5,4,5,14,Champions
93173,33,66,353,5,5,5,15,Champions
93254,391,37,59,3,4,3,10,Loyal Users
93604,1256,8,13,2,2,1,5,Lost
93687,290,5,7,3,1,1,5,Casual Users
93840,670,5,7,2,1,1,4,Lost
93969,683,11,19,2,2,2,6,Lost
94037,4280,14,36,1,3,3,7,Casual Users
94328,13,22,88,5,4,4,13,Champions
95074,26,16,65,5,3,4,12,Loyal Users
95103,2407,5,27,1,1,2,4,Lost
95131,241,7,10,3,2,1,6,Casual Users
95187,3548,8,31,1,2,2,5,Lost
95567,18,8,17,5,2,2,9,Promising
95672,172,13,60,3,3,3,9,Loyal Users
95694,17,85,184,5,5,5,15,Champions
95888,3567,11,22,1,2,2,5,Lost
95955,675,11,19,2,2,2,6,Lost
96606,1534,10,13,1,2,1,4,Lost
97214,145,9,15,4,2,1,7,Promising
97289,5,34,61,5,4,3,12,Loyal Users
97454,245,8,47,3,2,3,8,Casual Users
97661,399,7,7,3,2,1,6,Casual Users
97695,92,20,56,4,3,3,10,Loyal Users
97799,382,36,153,3,4,5,12,Loyal Users
97855,2936,5,17,1,1,2,4,Lost
97886,2487,7,13,1,2,1,4,Lost
97939,30,8,16,5,2,2,9,Promising
98534,132,70,404,4,5,5,14,Champions
98555,97,59,130,4,5,4,13,Champions
98676,1866,8,8,1,2,1,4,Lost
98727,2247,34,248,1,4,5,10,At Risk
99375,40,48,84,5,5,4,14,Champions
99398,2577,11,29,1,2,2,5,Lost
99693,13,73,103,5,5,4,14,Champions
99868,28,35,110,5,4,4,13,Champions
91694,229,27,30,3,4,2,9,Loyal Users
92331,274,5,5,3,1,1,5,Casual Users
92405,18,86,464,5,5,5,15,Champions
92465,2,88,296,5,5,5,15,Champions
92686,1991,10,30,1,2,2,5,Lost
92721,94,15,26,4,3,2,9,Loyal Users
92894,588,11,23,2,2,2,6,Lost
92967,5061,6,47,1,1,3,5,Lost
93085,115,74,216,4,5,5,14,Champions
93105,170,18,114,3,3,4,10,Loyal Users
93332,133,69,118,4,5,4,13,Champions
93552,142,233,863,4,5,5,14,Champions
93801,109,45,169,4,4,5,13,Champions
93976,37,59,101,5,5,4,14,Champions
94045,1468,41,89,1,4,4,9,At Risk
94068,2,109,489,5,5,5,15,Champions
94193,92,62,254,4,5,5,14,Champions
94295,790,10,17,2,2,2,6,Lost
94472,129,119,451,4,5,5,14,Champions
94835,1842,5,22,1,1,2,4,Lost
95105,1883,19,76,1,3,4,8,Casual Users
95427,178,5,7,3,1,1,5,Casual Users
95785,25,27,194,5,4,5,14,Champions
95881,390,126,582,3,5,5,13,Loyal Users
96020,149,9,15,4,2,1,7,Promising
96663,2135,9,17,1,2,2,5,Lost
96717,656,11,41,2,2,3,7,Lost
96949,262,196,305,3,5,5,13,Loyal Users
97081,1998,6,13,1,1,1,3,Lost
97923,2810,9,21,1,2,2,5,Lost
98053,415,8,18,3,2,2,7,Casual Users
98099,1,125,290,5,5,5,15,Champions
98538,4,45,209,5,4,5,14,Champions
98551,194,33,176,3,4,5,12,Loyal Users
98674,1233,9,53,2,2,3,7,Lost
98765,149,36,49,4,4,3,11,Loyal Users
99027,101,57,325,4,5,5,14,Champions
99049,29,52,93,5,5,4,14,Champions
91512,2243,5,8,1,1,1,3,Lost
91635,113,11,28,4,2,2,8,Promising
91873,109,106,206,4,5,5,14,Champions
91917,436,6,21,3,1,2,6,Casual Users
92189,2837,5,6,1,1,1,3,Lost
92270,710,12,15,2,3,1,6,Casual Users
92306,54,149,835,5,5,5,15,Champions
92470,94,164,484,4,5,5,14,Champions
92545,73,14,55,4,3,3,10,Loyal Users
92725,660,49,114,2,5,4,11,At Risk
92880,432,9,40,3,2,3,8,Casual Users
93205,223,60,262,3,5,5,13,Loyal Users
93450,2,155,310,5,5,5,15,Champions
93564,24,43,178,5,4,5,14,Champions
93763,1704,6,15,1,1,1,3,Lost
93983,164,5,5,4,1,1,6,Promising
94176,47,6,10,5,1,1,7,Promising
94566,432,5,27,3,1,2,6,Casual Users
94609,495,7,25,2,2,2,6,Lost
95190,1443,7,10,1,2,1,4,Lost
95286,114,35,85,4,4,4,12,Champions
95482,616,5,6,2,1,1,4,Lost
95783,241,31,54,3,4,3,10,Loyal Users
95819,7,12,35,5,3,3,11,Loyal Users
96481,585,9,20,2,2,2,6,Lost
96825,4,58,386,5,5,5,15,Champions
96871,124,62,323,4,5,5,14,Champions
97074,15,13,69,5,3,4,12,Loyal Users
97485,101,95,166,4,5,5,14,Champions
97518,246,10,12,3,2,1,6,Casual Users
97739,28,126,269,5,5,5,15,Champions
97763,91,11,37,4,2,3,9,Promising
97776,230,28,106,3,4,4,11,Loyal Users
97868,2252,6,6,1,1,1,3,Lost
98090,533,5,9,2,1,1,4,Lost
98244,32,8,24,5,2,2,9,Promising
98322,1416,14,38,1,3,3,7,Casual Users
98368,134,9,12,4,2,1,7,Promising
98655,4759,12,39,1,3,3,7,Casual Users
98696,130,6,34,4,1,3,8,Promising
98721,1276,7,65,1,2,4,7,Lost
99064,23,25,43,5,4,3,12,Loyal Users
99173,950,7,31,2,2,2,6,Lost
99646,839,12,22,2,3,2,7,Casual Users
99753,1820,17,115,1,3,4,8,Casual Users
99774,564,14,65,2,3,4,9,Casual Users
99839,123,38,52,4,4,3,11,Loyal Users
99857,138,8,24,4,2,2,8,Promising
91616,1459,7,33,1,2,3,6,Lost
91778,152,6,14,4,1,1,6,Promising
91815,534,8,17,2,2,2,6,Lost
91956,293,13,27,3,3,2,8,Loyal Users
92022,11,48,113,5,5,4,14,Champions
92084,412,9,106,3,2,4,9,Casual Users
92155,231,15,33,3,3,3,9,Loyal Users
92801,6,34,182,5,4,5,14,Champions
92981,1710,13,15,1,3,1,5,Casual Users
92988,1957,6,41,1,1,3,5,Lost
93132,133,19,192,4,3,5,12,Loyal Users
93247,2233,8,18,1,2,2,5,Lost
93742,1190,30,119,2,4,4,10,At Risk
94113,5,92,309,5,5,5,15,Champions
94371,76,41,136,4,4,4,12,Champions
94655,808,13,29,2,3,2,7,Casual Users
94764,381,34,78,3,4,4,11,Loyal Users
94833,258,52,247,3,5,5,13,Loyal Users
94859,92,118,382,4,5,5,14,Champions
94914,2187,14,58,1,3,3,7,Casual Users
95169,219,56,117,3,5,4,12,Loyal Users
95338,1,134,442,5,5,5,15,Champions
95375,67,7,49,5,2,3,10,Promising
95390,265,16,20,3,3,2,8,Loyal Users
96568,121,66,150,4,5,5,14,Champions
97013,481,25,194,2,4,5,11,At Risk
97086,2097,12,38,1,3,3,7,Casual Users
97151,122,74,182,4,5,5,14,Champions
98057,1581,5,14,1,1,1,3,Lost
98332,16,46,94,5,5,4,14,Champions
98539,120,52,278,4,5,5,14,Champions
98584,39,58,83,5,5,4,14,Champions
99133,677,18,29,2,3,2,7,Casual Users
99565,62,48,159,5,5,5,15,Champions
99617,115,232,339,4,5,5,14,Champions
99622,14,171,501,5,5,5,15,Champions
91372,1023,9,12,2,2,1,5,Lost
91485,384,65,349,3,5,5,13,Loyal Users
91634,1427,10,12,1,2,1,4,Lost
91720,114,9,17,4,2,2,8,Promising
92089,3096,5,13,1,1,1,3,Lost
92144,689,7,7,2,2,1,5,Lost
92192,3,25,75,5,4,4,13,Champions
92346,2633,5,11,1,1,1,3,Lost
92358,467,27,32,3,4,3,10,Loyal Users
92397,588,5,18,2,1,2,5,Lost
92528,150,6,18,4,1,2,7,Promising
92624,738,19,54,2,3,3,8,Casual Users
92625,2749,35,71,1,4,4,9,At Risk
92957,2667,24,145,1,4,4,9,At Risk
93299,24,58,310,5,5,5,15,Champions
93317,15,100,365,5,5,5,15,Champions
93384,548,18,39,2,3,3,8,Casual Users
93578,229,66,127,3,5,4,12,Loyal Users
94080,268,103,304,3,5,5,13,Loyal Users
94424,1,11,54,5,2,3,10,Promising
95238,373,13,22,3,3,2,8,Loyal Users
95765,95,9,31,4,2,2,8,Promising
95828,981,31,137,2,4,4,10,At Risk
95941,4,48,206,5,5,5,15,Champions
96236,83,15,67,4,3,4,11,Loyal Users
96338,1794,18,35,1,3,3,7,Casual Users
96354,195,16,68,3,3,4,10,Loyal Users
96511,117,29,46,4,4,3,11,Loyal Users
96526,401,7,8,3,2,1,6,Casual Users
96781,145,5,8,4,1,1,6,Promising
96828,55,20,58,5,3,3,11,Loyal Users
96928,616,6,17,2,1,2,5,Lost
97264,601,24,117,2,4,4,10,At Risk
97528,90,87,248,4,5,5,14,Champions
97734,11,18,21,5,3,2,10,Loyal Users
97780,244,19,26,3,3,2,8,Loyal Users
97838,820,20,159,2,3,5,10,Casual Users
97958,267,13,17,3,3,2,8,Loyal Users
98007,15,8,24,5,2,2,9,Promising
98174,2135,5,18,1,1,2,4,Lost
98334,281,9,16,3,2,2,7,Casual Users
98617,48,88,409,5,5,5,15,Champions
99271,377,21,26,3,3,2,8,Loyal Users
99290,1029,6,6,2,1,1,4,Lost
99710,94,7,14,4,2,1,7,Promising
91254,1382,12,22,1,3,2,6,Casual Users
91273,313,6,10,3,1,1,5,Casual Users
91321,1716,29,52,1,4,3,8,At Risk
91716,125,14,55,4,3,3,10,Loyal Users
91839,1590,5,9,1,1,1,3,Lost
92058,101,96,458,4,5,5,14,Champions
92205,151,121,152,4,5,5,14,Champions
92436,76,58,195,4,5,5,14,Champions
92682,134,24,43,4,4,3,11,Loyal Users
92775,134,14,107,4,3,4,11,Loyal Users
93727,385,22,99,3,4,4,11,Loyal Users
94142,778,28,56,2,4,3,9,At Risk
94217,653,9,27,2,2,2,6,Lost
94470,306,41,52,3,4,3,10,Loyal Users
94625,4673,10,13,1,2,1,4,Lost
94769,689,8,21,2,2,2,6,Lost
94984,1,18,79,5,3,4,12,Loyal Users
95179,0,29,124,5,4,4,13,Champions
95395,219,87,276,3,5,5,13,Loyal Users
95566,1966,8,14,1,2,1,4,Lost
95709,850,7,42,2,2,3,7,Lost
96071,2838,15,18,1,3,2,6,Casual Users
96181,130,17,26,4,3,2,9,Loyal Users
96211,406,17,39,3,3,3,9,Loyal Users
96456,3333,6,10,1,1,1,3,Lost
96735,192,16,29,3,3,2,8,Loyal Users
96856,1416,9,95,1,2,4,7,Lost
97194,140,62,220,4,5,5,14,Champions
97226,126,28,195,4,4,5,13,Champions
97514,4538,6,9,1,1,1,3,Lost
97597,317,11,19,3,2,2,7,Casual Users
97672,262,40,138,3,4,4,11,Loyal Users
97885,255,6,6,3,1,1,5,Casual Users
97948,163,146,447,4,5,5,14,Champions
98029,861,7,14,2,2,1,5,Lost
98044,2587,6,8,1,1,1,3,Lost
98349,0,69,184,5,5,5,15,Champions
98533,1613,5,30,1,1,2,4,Lost
98640,276,5,29,3,1,2,6,Casual Users
98641,1308,33,148,1,4,5,10,At Risk
98750,1842,11,25,1,2,2,5,Lost
98964,162,5,8,4,1,1,6,Promising
99136,3535,9,28,1,2,2,5,Lost
99213,13,92,306,5,5,5,15,Champions
99217,197,133,419,3,5,5,13,Loyal Users
99373,1870,5,12,1,1,1,3,Lost
99517,604,7,9,2,2,1,5,Lost
99524,105,10,11,4,2,1,7,Promising
99993,1766,27,52,1,4,3,8,At Risk
91183,247,5,17,3,1,2,6,Casual Users
91346,74,5,17,4,1,2,7,Promising
91693,3468,14,87,1,3,4,8,Casual Users
91935,65,103,603,5,5,5,15,Champions
92273,1797,5,12,1,1,1,3,Lost
92456,365,27,117,3,4,4,11,Loyal Users
93019,2743,6,21,1,1,2,4,Lost
93214,1700,9,29,1,2,2,5,Lost
93469,427,12,16,3,3,2,8,Loyal Users
93958,1013,18,35,2,3,3,8,Casual Users
93979,83,45,60,4,4,3,11,Loyal Users
94185,106,83,266,4,5,5,14,Champions
94503,106,25,41,4,4,3,11,Loyal Users
95404,129,50,182,4,5,5,14,Champions
95448,168,30,42,3,4,3,10,Loyal Users
95590,271,28,49,3,4,3,10,Loyal Users
95971,6,6,6,5,1,1,7,Promising
96003,162,25,40,4,4,3,11,Loyal Users
96036,326,25,100,3,4,4,11,Loyal Users
96697,5225,17,62,1,3,3,7,Casual Users
97112,304,11,24,3,2,2,7,Casual Users
97176,11,109,380,5,5,5,15,Champions
97281,334,8,22,3,2,2,7,Casual Users
97458,323,26,122,3,4,4,11,Loyal Users
97745,1318,17,26,1,3,2,6,Casual Users
97875,169,11,25,3,2,2,7,Casual Users
98066,308,15,57,3,3,3,9,Loyal Users
98114,119,20,56,4,3,3,10,Loyal Users
98259,1217,23,64,2,4,4,10,At Risk
98665,1117,70,359,2,5,5,12,At Risk
98979,37,69,140,5,5,4,14,Champions
99090,285,15,22,3,3,2,8,Loyal Users
99225,100,27,39,4,4,3,11,Loyal Users
99727,158,31,61,4,4,3,11,Loyal Users
99781,1119,104,216,2,5,5,12,At Risk
99826,3,98,282,5,5,5,15,Champions
99886,2983,9,34,1,2,3,6,Lost
99895,810,6,26,2,1,2,5,Lost
99973,1437,31,42,1,4,3,8,At Risk
91135,414,74,152,3,5,5,13,Loyal Users
91239,5499,9,13,1,2,1,4,Lost
91250,850,8,11,2,2,1,5,Lost
91263,115,78,164,4,5,5,14,Champions
91339,302,6,14,3,1,1,5,Casual Users
91345,869,12,33,2,3,3,8,Casual Users
92149,872,7,17,2,2,2,6,Lost
92380,25,40,264,5,4,5,14,Champions
92445,126,49,106,4,5,4,13,Champions
92652,109,27,50,4,4,3,11,Loyal Users
92890,405,5,29,3,1,2,6,Casual Users
92902,2,13,31,5,3,2,10,Loyal Users
92927,853,5,6,2,1,1,4,Lost
92929,3202,14,21,1,3,2,6,Casual Users
93088,30,174,1093,5,5,5,15,Champions
93093,6,30,48,5,4,3,12,Loyal Users
93101,148,65,192,4,5,5,14,Champions
93527,609,5,6,2,1,1,4,Lost
93559,890,6,7,2,1,1,4,Lost
93621,1743,9,29,1,2,2,5,Lost
93625,0,84,235,5,5,5,15,Champions
93694,1,110,261,5,5,5,15,Champions
94316,1129,5,24,2,1,2,5,Lost
94704,233,31,74,3,4,4,11,Loyal Users
94793,215,6,24,3,1,2,6,Casual Users
94812,1415,14,22,1,3,2,6,Casual Users
94854,850,7,13,2,2,1,5,Lost
95049,3858,5,14,1,1,1,3,Lost
95206,1343,5,16,1,1,2,4,Lost
95354,29,40,132,5,4,4,13,Champions
95636,720,38,65,2,4,4,10,At Risk
95729,2,78,166,5,5,5,15,Champions
95886,2379,6,6,1,1,1,3,Lost
96187,39,16,26,5,3,2,10,Loyal Users
96198,993,9,50,2,2,3,7,Lost
96337,111,15,19,4,3,2,9,Loyal Users
96412,593,16,24,2,3,2,7,Casual Users
96594,79,110,567,4,5,5,14,Champions
97058,2160,6,9,1,1,1,3,Lost
97274,44,76,154,5,5,5,15,Champions
97294,106,11,141,4,2,4,10,Promising
97483,1429,6,7,1,1,1,3,Lost
97609,1595,15,86,1,3,4,8,Casual Users
97849,286,10,72,3,2,4,9,Casual Users
98197,587,7,17,2,2,2,6,Lost
98375,15,15,27,5,3,2,10,Loyal Users
98737,2170,8,17,1,2,2,5,Lost
98850,577,6,16,2,1,2,5,Lost
99055,37,35,388,5,4,5,14,Champions
99291,976,23,56,2,4,3,9,At Risk
99550,3492,7,12,1,2,1,4,Lost
99613,52,76,274,5,5,5,15,Champions
99715,4589,5,7,1,1,1,3,Lost
99925,518,22,44,2,4,3,9,At Risk
91213,37,86,148,5,5,5,15,Champions
91342,6,9,34,5,2,3,10,Promising
91680,107,34,234,4,4,5,13,Champions
91780,224,8,72,3,2,4,9,Casual Users
92124,422,23,68,3,4,4,11,Loyal Users
92199,3,48,220,5,5,5,15,Champions
92220,510,7,23,2,2,2,6,Lost
92227,2847,5,7,1,1,1,3,Lost
92404,689,44,258,2,4,5,11,At Risk
92591,18,28,30,5,4,2,11,Loyal Users
92608,85,12,35,4,3,3,10,Loyal Users
92914,688,26,105,2,4,4,10,At Risk
93200,12,108,198,5,5,5,15,Champions
93506,127,31,45,4,4,3,11,Loyal Users
93765,3450,8,13,1,2,1,4,Lost
93865,418,19,29,3,3,2,8,Loyal Users
94061,909,7,103,2,2,4,8,Lost
94647,845,6,6,2,1,1,4,Lost
94772,23,151,315,5,5,5,15,Champions
95082,34,22,89,5,4,4,13,Champions
95119,581,60,214,2,5,5,12,At Risk
95412,418,12,58,3,3,3,9,Loyal Users
95469,4272,5,9,1,1,1,3,Lost
95538,274,10,17,3,2,2,7,Casual Users
95645,393,45,61,3,4,3,10,Loyal Users
95912,8,9,33,5,2,3,10,Promising
96120,709,17,70,2,3,4,9,Casual Users
96137,1562,9,20,1,2,2,5,Lost
96569,256,21,35,3,3,3,9,Loyal Users
96703,13,97,172,5,5,5,15,Champions
96748,90,15,67,4,3,4,11,Loyal Users
97235,152,17,64,4,3,4,11,Loyal Users
97432,234,12,31,3,3,2,8,Loyal Users
97495,2478,9,17,1,2,2,5,Lost
97988,5,6,14,5,1,1,7,Promising
98276,1549,6,7,1,1,1,3,Lost
98326,7,62,346,5,5,5,15,Champions
98438,2779,12,86,1,3,4,8,Casual Users
98440,156,6,8,4,1,1,6,Promising
98904,826,57,403,2,5,5,12,At Risk
99153,4417,10,19,1,2,2,5,Lost
99235,28,123,379,5,5,5,15,Champions
99236,372,14,60,3,3,3,9,Loyal Users
99877,957,7,18,2,2,2,6,Lost
91425,534,11,21,2,2,2,6,Lost
91454,3083,97,160,1,5,5,11,At Risk
92351,101,104,172,4,5,5,14,Champions
93040,755,28,34,2,4,3,9,At Risk
93104,422,16,43,3,3,3,9,Loyal Users
93196,3245,9,22,1,2,2,5,Lost
93401,33,118,332,5,5,5,15,Champions
93410,243,86,141,3,5,4,12,Loyal Users
93548,2263,5,14,1,1,1,3,Lost
93867,713,18,37,2,3,3,8,Casual Users
93938,750,6,16,2,1,2,5,Lost
94148,53,16,31,5,3,2,10,Loyal Users
94305,492,9,77,2,2,4,8,Lost
94641,1544,11,23,1,2,2,5,Lost
95021,25,105,318,5,5,5,15,Champions
95176,13,52,321,5,5,5,15,Champions
95289,139,60,79,4,5,4,13,Champions
95356,1257,5,8,2,1,1,4,Lost
95712,6,38,97,5,4,4,13,Champions
95766,151,53,82,4,5,4,13,Champions
96553,140,26,33,4,4,3,11,Loyal Users
96973,2965,6,23,1,1,2,4,Lost
97055,18,147,496,5,5,5,15,Champions
97063,1002,19,71,2,3,4,9,Casual Users
97113,3370,5,9,1,1,1,3,Lost
97171,1074,8,43,2,2,3,7,Lost
97617,154,16,19,4,3,2,9,Loyal Users
97892,129,120,346,4,5,5,14,Champions
97893,15,75,185,5,5,5,15,Champions
97910,534,39,68,2,4,4,10,At Risk
97959,2567,24,38,1,4,3,8,At Risk
98032,101,80,257,4,5,5,14,Champions
98567,820,8,34,2,2,3,7,Lost
99553,14,25,35,5,4,3,12,Loyal Users
99732,797,8,29,2,2,2,6,Lost
91167,3403,7,24,1,2,2,5,Lost
91555,539,21,84,2,3,4,9,Casual Users
91682,979,6,7,2,1,1,4,Lost
91698,408,27,119,3,4,4,11,Loyal Users
91763,42,50,160,5,5,5,15,Champions
91766,5,9,14,5,2,1,8,Promising
91876,2989,8,11,1,2,1,4,Lost
91986,107,68,455,4,5,5,14,Champions
92101,933,12,41,2,3,3,8,Casual Users
92420,6,51,158,5,5,5,15,Champions
92726,720,8,58,2,2,3,7,Lost
92754,56,93,143,5,5,4,14,Champions
92760,279,17,31,3,3,2,8,Loyal Users
92922,1257,5,22,2,1,2,5,Lost
93015,234,21,237,3,3,5,11,Loyal Users
93049,663,39,139,2,4,4,10,At Risk
93207,3870,6,12,1,1,1,3,Lost
93251,2984,8,122,1,2,4,7,Lost
93366,1851,5,6,1,1,1,3,Lost
93453,804,5,6,2,1,1,4,Lost
93580,330,15,32,3,3,3,9,Loyal Users
94005,2557,13,32,1,3,3,7,Casual Users
94747,0,42,235,5,4,5,14,Champions
95063,1792,7,15,1,2,1,4,Lost
95542,129,48,175,4,5,5,14,Champions
95624,106,98,311,4,5,5,14,Champions
95818,12,12,63,5,3,4,12,Loyal Users
95882,956,6,11,2,1,1,4,Lost
96051,4127,10,58,1,2,3,6,Lost
96222,3746,9,11,1,2,1,4,Lost
96376,7,92,124,5,5,4,14,Champions
96468,1122,18,37,2,3,3,8,Casual Users
96830,418,5,33,3,1,3,7,Casual Users
97502,1750,9,11,1,2,1,4,Lost
97611,159,60,96,4,5,4,13,Champions
97754,88,40,274,4,4,5,13,Champions
98124,1859,8,9,1,2,1,4,Lost
98130,576,36,66,2,4,4,10,At Risk
98405,2092,9,27,1,2,2,5,Lost
98598,23,63,102,5,5,4,14,Champions
98662,3670,6,59,1,1,3,5,Lost
98787,80,9,12,4,2,1,7,Promising
98976,3667,43,113,1,4,4,9,At Risk
99171,694,50,191,2,5,5,12,At Risk
99384,26,102,344,5,5,5,15,Champions
91291,9,168,898,5,5,5,15,Champions
91739,317,14,17,3,3,2,8,Loyal Users
91992,143,50,120,4,5,4,13,Champions
92065,266,11,19,3,2,2,7,Casual Users
92094,448,16,43,3,3,3,9,Loyal Users
92148,99,48,88,4,5,4,13,Champions
92214,691,10,33,2,2,3,7,Lost
92522,426,16,40,3,3,3,9,Loyal Users
92945,576,24,50,2,4,3,9,At Risk
93000,325,22,58,3,4,3,10,Loyal Users
93144,161,13,31,4,3,2,9,Loyal Users
93253,69,25,88,5,4,4,13,Champions
93278,37,20,31,5,3,2,10,Loyal Users
93337,336,50,163,3,5,5,13,Loyal Users
93437,3699,39,71,1,4,4,9,At Risk
93689,5053,5,5,1,1,1,3,Lost
93753,40,34,51,5,4,3,12,Loyal Users
94161,108,9,18,4,2,2,8,Promising
94460,36,10,34,5,2,3,10,Promising
94671,30,78,342,5,5,5,15,Champions
94885,386,7,31,3,2,2,7,Casual Users
94898,838,11,32,2,2,3,7,Lost
95005,531,13,29,2,3,2,7,Casual Users
95117,263,108,187,3,5,5,13,Loyal Users
95180,420,23,50,3,4,3,10,Loyal Users
95357,436,8,15,3,2,1,6,Casual Users
95391,914,9,17,2,2,2,6,Lost
95589,143,47,164,4,5,5,14,Champions
95909,253,34,86,3,4,4,11,Loyal Users
95944,4,117,172,5,5,5,15,Champions
96018,4594,6,10,1,1,1,3,Lost
96202,143,19,174,4,3,5,12,Loyal Users
96225,89,160,429,4,5,5,14,Champions
96457,1643,12,23,1,3,2,6,Casual Users
96670,1380,7,11,1,2,1,4,Lost
96709,1260,7,13,1,2,1,4,Lost
96889,3690,11,23,1,2,2,5,Lost
97037,167,14,41,3,3,3,9,Loyal Users
97589,305,10,12,3,2,1,6,Casual Users
97850,16,106,455,5,5,5,15,Champions
97983,379,6,29,3,1,2,6,Casual Users
98004,21,34,124,5,4,4,13,Champions
98073,4,22,66,5,4,4,13,Champions
98106,1054,11,59,2,2,3,7,Lost
98273,0,26,190,5,4,5,14,Champions
98452,32,79,169,5,5,5,15,Champions
98613,162,71,227,4,5,5,14,Champions
98693,175,24,33,3,4,3,10,Loyal Users
98966,828,21,60,2,3,3,8,Casual Users
99310,52,33,136,5,4,4,13,Champions
99385,479,7,10,2,2,1,5,Lost
99457,19,37,79,5,4,4,13,Champions
99987,2544,6,7,1,1,1,3,Lost
91122,2546,8,11,1,2,1,4,Lost
91150,287,7,13,3,2,1,6,Casual Users
91246,128,68,284,4,5,5,14,Champions
91561,2689,30,125,1,4,4,9,At Risk
91606,538,16,16,2,3,2,7,Casual Users
91824,70,131,190,4,5,5,14,Champions
91996,402,8,14,3,2,1,6,Casual Users
92222,265,18,32,3,3,3,9,Loyal Users
92708,138,20,40,4,3,3,10,Loyal Users
92813,1300,6,15,1,1,1,3,Lost
92891,339,7,12,3,2,1,6,Casual Users
92910,1849,8,10,1,2,1,4,Lost
93162,1446,15,28,1,3,2,6,Casual Users
93227,3699,5,6,1,1,1,3,Lost
93355,131,12,23,4,3,2,9,Loyal Users
93402,65,112,240,5,5,5,15,Champions
93520,65,116,256,5,5,5,15,Champions
93794,2820,5,26,1,1,2,4,Lost
94582,213,36,223,3,4,5,12,Loyal Users
94736,64,52,119,5,5,4,14,Champions
94799,263,13,39,3,3,3,9,Loyal Users
94894,46,28,86,5,4,4,13,Champions
94932,582,10,14,2,2,1,5,Lost
95070,126,9,32,4,2,3,9,Promising
95224,113,48,79,4,5,4,13,Champions
95394,72,87,190,4,5,5,14,Champions
95626,282,24,28,3,4,2,9,Loyal Users
95690,658,15,36,2,3,3,8,Casual Users
96055,273,23,88,3,4,4,11,Loyal Users
96056,76,77,396,4,5,5,14,Champions
96075,46,78,243,5,5,5,15,Champions
96149,154,71,172,4,5,5,14,Champions
96178,27,80,130,5,5,4,14,Champions
96253,417,12,27,3,3,2,8,Loyal Users
96262,585,38,243,2,4,5,11,At Risk
96299,3,140,354,5,5,5,15,Champions
96616,252,44,64,3,4,4,11,Loyal Users
96812,731,35,76,2,4,4,10,At Risk
96832,137,55,198,4,5,5,14,Champions
97030,2,66,164,5,5,5,15,Champions
97315,29,43,104,5,4,4,13,Champions
97394,11,21,25,5,3,2,10,Loyal Users
97422,445,12,33,3,3,3,9,Loyal Users
97546,133,87,476,4,5,5,14,Champions
97765,703,13,125,2,3,4,9,Casual Users
98168,561,12,19,2,3,2,7,Casual Users
98178,1530,5,15,1,1,1,3,Lost
98220,9,68,125,5,5,4,14,Champions
98333,38,41,68,5,4,4,13,Champions
98463,839,6,21,2,1,2,5,Lost
98592,8,24,30,5,4,2,11,Loyal Users
98724,2,36,297,5,4,5,14,Champions
98752,17,81,165,5,5,5,15,Champions
98769,97,63,266,4,5,5,14,Champions
98985,449,13,46,3,3,3,9,Loyal Users
99476,2414,7,8,1,2,1,4,Lost
99614,831,16,119,2,3,4,9,Casual Users
99619,22,108,443,5,5,5,15,Champions
91080,3558,54,91,1,5,4,10,At Risk
91097,1576,15,22,1,3,2,6,Casual Users
91194,1137,14,38,2,3,3,8,Casual Users
91284,66,80,139,5,5,4,14,Champions
91712,3645,6,11,1,1,1,3,Lost
91880,16,15,36,5,3,3,11,Loyal Users
92117,1471,7,27,1,2,2,5,Lost
92175,352,12,28,3,3,2,8,Loyal Users
92252,306,44,141,3,4,4,11,Loyal Users
92316,241,15,45,3,3,3,9,Loyal Users
92540,10,10,73,5,2,4,11,Promising
92612,131,55,487,4,5,5,14,Champions
92768,116,5,6,4,1,1,6,Promising
92788,37,115,587,5,5,5,15,Champions
93142,115,86,198,4,5,5,14,Champions
93309,9,22,59,5,4,3,12,Loyal Users
93563,301,28,44,3,4,3,10,Loyal Users
93573,2079,5,26,1,1,2,4,Lost
93823,58,9,17,5,2,2,9,Promising
94523,123,29,185,4,4,5,13,Champions
94541,8,7,24,5,2,2,9,Promising
94646,9,16,90,5,3,4,12,Loyal Users
94751,336,15,17,3,3,2,8,Loyal Users
94811,2223,5,10,1,1,1,3,Lost
95012,140,64,243,4,5,5,14,Champions
95014,5705,11,11,1,2,1,4,Lost
95061,369,5,6,3,1,1,5,Casual Users
95175,307,35,57,3,4,3,10,Loyal Users
95306,1418,7,14,1,2,1,4,Lost
95308,390,24,212,3,4,5,12,Loyal Users
95423,67,57,342,5,5,5,15,Champions
95517,422,12,17,3,3,2,8,Loyal Users
95539,206,41,220,3,4,5,12,Loyal Users
95544,254,16,63,3,3,4,10,Loyal Users
95692,79,34,57,4,4,3,11,Loyal Users
95779,50,112,472,5,5,5,15,Champions
95836,92,102,427,4,5,5,14,Champions
95858,5020,17,83,1,3,4,8,Casual Users
96007,2021,7,16,1,2,2,5,Lost
96012,616,11,25,2,2,2,6,Lost
96081,281,5,12,3,1,1,5,Casual Users
96151,102,83,488,4,5,5,14,Champions
96166,135,27,79,4,4,4,12,Champions
96344,624,20,64,2,3,4,9,Casual Users
96957,4528,17,20,1,3,2,6,Casual Users
97381,75,29,67,4,4,4,12,Champions
97542,270,8,26,3,2,2,7,Casual Users
97794,531,8,60,2,2,3,7,Lost
97985,276,7,9,3,2,1,6,Casual Users
98074,95,83,122,4,5,4,13,Champions
98160,882,6,11,2,1,1,4,Lost
98350,2184,6,10,1,1,1,3,Lost
98387,2842,7,13,1,2,1,4,Lost
98490,32,34,50,5,4,3,12,Loyal Users
98885,430,17,33,3,3,3,9,Loyal Users
98911,90,57,398,4,5,5,14,Champions
99124,421,6,14,3,1,1,5,Casual Users
99203,4630,6,29,1,1,2,4,Lost
99419,125,42,94,4,4,4,12,Champions
99506,4,42,140,5,4,4,13,Champions
99842,65,13,74,5,3,4,12,Loyal Users
99862,435,28,140,3,4,4,11,Loyal Users
91204,232,9,88,3,2,4,9,Casual Users
91601,1441,6,7,1,1,1,3,Lost
91977,172,16,71,3,3,4,10,Loyal Users
92025,268,5,55,3,1,3,7,Casual Users
92108,1407,7,21,1,2,2,5,Lost
92481,157,46,145,4,5,4,13,Champions
92911,1840,16,57,1,3,3,7,Casual Users
92975,522,22,32,2,4,3,9,At Risk
92992,968,24,33,2,4,3,9,At Risk
93211,1039,6,12,2,1,1,4,Lost
93482,295,14,54,3,3,3,9,Loyal Users
93669,3682,12,14,1,3,1,5,Casual Users
93791,1,80,224,5,5,5,15,Champions
94149,699,6,9,2,1,1,4,Lost
94215,171,43,266,3,4,5,12,Loyal Users
94223,239,27,165,3,4,5,12,Loyal Users
94418,143,41,141,4,4,4,12,Champions
94486,40,8,29,5,2,2,9,Promising
94584,407,26,86,3,4,4,11,Loyal Users
94627,0,71,329,5,5,5,15,Champions
95009,423,31,63,3,4,4,11,Loyal Users
95124,2,22,124,5,4,4,13,Champions
95144,1699,9,23,1,2,2,5,Lost
95670,59,48,112,5,5,4,14,Champions
95700,1905,11,21,1,2,2,5,Lost
96233,424,7,10,3,2,1,6,Casual Users
96473,527,16,101,2,3,4,9,Casual Users
96562,0,52,116,5,5,4,14,Champions
96989,44,85,280,5,5,5,15,Champions
97001,2402,12,25,1,3,2,6,Casual Users
97117,83,134,425,4,5,5,14,Champions
97538,252,16,59,3,3,3,9,Loyal Users
97627,421,32,42,3,4,3,10,Loyal Users
97911,3428,6,7,1,1,1,3,Lost
98430,264,22,47,3,4,3,10,Loyal Users
98554,418,13,68,3,3,4,10,Loyal Users
98629,29,5,7,5,1,1,7,Promising
98773,6,10,67,5,2,4,11,Promising
98945,153,28,134,4,4,4,12,Champions
99167,1008,16,26,2,3,2,7,Casual Users
99331,228,15,98,3,3,4,10,Loyal Users
99906,992,17,102,2,3,4,9,Casual Users
91108,148,24,30,4,4,2,10,Loyal Users
91302,2826,13,77,1,3,4,8,Casual Users
91529,132,32,60,4,4,3,11,Loyal Users
91863,103,7,28,4,2,2,8,Promising
92240,577,6,20,2,1,2,5,Lost
92301,871,28,46,2,4,3,9,At Risk
92401,285,40,174,3,4,5,12,Loyal Users
92482,257,16,27,3,3,2,8,Loyal Users
92720,993,23,58,2,4,3,9,At Risk
92946,98,6,16,4,1,2,7,Promising
92952,2414,5,14,1,1,1,3,Lost
93117,4076,6,6,1,1,1,3,Lost
93668,1935,6,11,1,1,1,3,Lost
93955,432,5,7,3,1,1,5,Casual Users
93956,111,32,56,4,4,3,11,Loyal Users
94163,353,16,23,3,3,2,8,Loyal Users
94200,56,88,284,5,5,5,15,Champions
94363,69,169,587,5,5,5,15,Champions
94401,913,10,21,2,2,2,6,Lost
95035,6,99,403,5,5,5,15,Champions
95068,59,27,200,5,4,5,14,Champions
95129,422,9,13,3,2,1,6,Casual Users
95264,237,14,170,3,3,5,11,Loyal Users
95556,14,49,164,5,5,5,15,Champions
95725,139,7,10,4,2,1,7,Promising
96014,3945,6,11,1,1,1,3,Lost
96116,434,10,10,3,2,1,6,Casual Users
96302,3848,8,28,1,2,2,5,Lost
96348,19,143,283,5,5,5,15,Champions
96660,2474,12,33,1,3,3,7,Casual Users
96666,24,80,182,5,5,5,15,Champions
97142,83,59,94,4,5,4,13,Champions
97197,81,50,120,4,5,4,13,Champions
98016,316,94,121,3,5,4,12,Loyal Users
98548,140,12,33,4,3,3,10,Loyal Users
98784,1119,8,8,2,2,1,5,Lost
99207,948,8,10,2,2,1,5,Lost
99487,163,115,352,4,5,5,14,Champions
99490,702,24,88,2,4,4,10,At Risk
99658,3593,5,25,1,1,2,4,Lost
99977,1331,5,12,1,1,1,3,Lost
91199,110,21,54,4,3,3,10,Loyal Users
91224,3838,9,14,1,2,1,4,Lost
91413,688,7,8,2,2,1,5,Lost
92163,253,68,322,3,5,5,13,Loyal Users
92572,961,45,68,2,4,4,10,At Risk
92668,0,37,247,5,4,5,14,Champions
92730,132,10,27,4,2,2,8,Promising
92789,131,21,79,4,3,4,11,Loyal Users
92821,149,34,64,4,4,4,12,Champions
92887,419,7,11,3,2,1,6,Casual Users
92932,2245,24,44,1,4,3,8,At Risk
93004,368,38,96,3,4,4,11,Loyal Users
93156,39,25,58,5,4,3,12,Loyal Users
93415,3,105,295,5,5,5,15,Champions
93460,2396,7,14,1,2,1,4,Lost
93503,1093,153,532,2,5,5,12,At Risk
93764,55,21,37,5,3,3,11,Loyal Users
93770,139,33,158,4,4,5,13,Champions
93856,18,83,137,5,5,4,14,Champions
94220,1434,5,8,1,1,1,3,Lost
94474,2858,9,15,1,2,1,4,Lost
94633,1593,9,12,1,2,1,4,Lost
94805,385,54,70,3,5,4,12,Loyal Users
94822,161,21,28,4,3,2,9,Loyal Users
95025,192,230,299,3,5,5,13,Loyal Users
95112,1640,15,39,1,3,3,7,Casual Users
95425,124,5,15,4,1,1,6,Promising
95528,30,82,132,5,5,4,14,Champions
95551,1940,5,9,1,1,1,3,Lost
96048,671,6,9,2,1,1,4,Lost
96248,2413,27,46,1,4,3,8,At Risk
96669,12,11,29,5,2,2,9,Promising
96671,1996,29,115,1,4,4,9,At Risk
96707,3,24,40,5,4,3,12,Loyal Users
96876,2,12,46,5,3,3,11,Loyal Users
96890,177,50,127,3,5,4,12,Loyal Users
97384,815,10,42,2,2,3,7,Lost
97675,1687,7,8,1,2,1,4,Lost
97874,226,19,26,3,3,2,8,Loyal Users
98708,2608,6,10,1,1,1,3,Lost
98853,59,19,24,5,3,2,10,Loyal Users
99053,940,7,79,2,2,4,8,Lost
99062,153,5,21,4,1,2,7,Promising
99282,853,5,18,2,1,2,5,Lost
99474,20,39,130,5,4,4,13,Champions
99865,1,98,421,5,5,5,15,Champions
99979,3584,6,8,1,1,1,3,Lost
91538,8,162,618,5,5,5,15,Champions
91615,625,6,22,2,1,2,5,Lost
91718,1798,9,52,1,2,3,6,Lost
91749,1647,11,21,1,2,2,5,Lost
91869,4,28,82,5,4,4,13,Champions
92072,4240,5,17,1,1,2,4,Lost
92564,16,90,493,5,5,5,15,Champions
92616,284,44,226,3,4,5,12,Loyal Users
93025,62,56,128,5,5,4,14,Champions
93082,102,12,24,4,3,2,9,Loyal Users
93493,21,243,447,5,5,5,15,Champions
93772,259,290,558,3,5,5,13,Loyal Users
93934,669,13,65,2,3,4,9,Casual Users
93945,37,60,110,5,5,4,14,Champions
94150,2265,11,34,1,2,3,6,Lost
94733,122,35,114,4,4,4,12,Champions
94907,27,23,31,5,4,2,11,Loyal Users
95136,1153,42,154,2,4,5,11,At Risk
95273,942,37,105,2,4,4,10,At Risk
95794,409,7,16,3,2,2,7,Casual Users
95865,290,28,39,3,4,3,10,Loyal Users
95942,4724,14,21,1,3,2,6,Casual Users
96045,850,10,21,2,2,2,6,Lost
96425,112,89,206,4,5,5,14,Champions
96609,991,5,19,2,1,2,5,Lost
96696,229,7,27,3,2,2,7,Casual Users
96946,2885,91,361,1,5,5,11,At Risk
97051,575,15,69,2,3,4,9,Casual Users
97077,27,76,392,5,5,5,15,Champions
97380,46,68,122,5,5,4,14,Champions
97428,542,10,64,2,2,4,8,Lost
97498,10,46,190,5,5,5,15,Champions
97676,92,32,134,4,4,4,12,Champions
98003,177,53,102,3,5,4,12,Loyal Users
98027,227,83,462,3,5,5,13,Loyal Users
98119,33,5,5,5,1,1,7,Promising
98203,43,78,83,5,5,4,14,Champions
98692,7,8,9,5,2,1,8,Promising
98836,317,83,308,3,5,5,13,Loyal Users
99405,152,61,228,4,5,5,14,Champions
99451,563,6,7,2,1,1,4,Lost
99537,43,40,91,5,4,4,13,Champions
99575,108,87,212,4,5,5,14,Champions
91104,31,39,145,5,4,4,13,Champions
91401,117,6,32,4,1,3,8,Promising
92102,266,36,65,3,4,4,11,Loyal Users
92310,88,110,770,4,5,5,14,Champions
92457,119,28,52,4,4,3,11,Loyal Users
92849,124,56,175,4,5,5,14,Champions
93095,28,117,370,5,5,5,15,Champions
93115,132,6,32,4,1,3,8,Promising
93135,104,66,348,4,5,5,14,Champions
93234,243,7,7,3,2,1,6,Casual Users
94000,37,19,35,5,3,3,11,Loyal Users
94062,298,6,20,3,1,2,6,Casual Users
94100,209,5,5,3,1,1,5,Casual Users
94233,101,17,49,4,3,3,10,Loyal Users
94277,105,36,114,4,4,4,12,Champions
94334,253,21,139,3,3,4,10,Loyal Users
94415,1250,9,16,2,2,2,6,Lost
94666,4698,5,13,1,1,1,3,Lost
95166,698,17,22,2,3,2,7,Casual Users
95256,1554,24,36,1,4,3,8,At Risk
95372,323,5,5,3,1,1,5,Casual Users
95898,127,11,13,4,2,1,7,Promising
96133,1,49,346,5,5,5,15,Champions
96163,148,6,13,4,1,1,6,Promising
96240,28,17,21,5,3,2,10,Loyal Users
96319,255,7,10,3,2,1,6,Casual Users
96401,132,16,114,4,3,4,11,Loyal Users
96675,68,11,29,5,2,2,9,Promising
97158,516,11,56,2,2,3,7,Lost
97182,1500,12,28,1,3,2,6,Casual Users
97562,220,33,138,3,4,4,11,Loyal Users
97586,429,22,65,3,4,4,11,Loyal Users
97950,1237,13,16,2,3,2,7,Casual Users
98060,62,45,176,5,4,5,14,Champions
98803,12,34,81,5,4,4,13,Champions
99113,153,40,192,4,4,5,13,Champions
99232,1210,16,20,2,3,2,7,Casual Users
99276,351,29,109,3,4,4,11,Loyal Users
99600,170,88,469,3,5,5,13,Loyal Users
99956,5,25,117,5,4,4,13,Champions
91308,106,24,83,4,4,4,12,Champions
91429,304,19,43,3,3,3,9,Loyal Users
91574,9,91,165,5,5,5,15,Champions
92172,805,5,84,2,1,4,7,Lost
92271,1117,12,122,2,3,4,9,Casual Users
92330,9,133,332,5,5,5,15,Champions
92489,241,74,187,3,5,5,13,Loyal Users
92743,54,14,35,5,3,3,11,Loyal Users
92923,6,21,41,5,3,3,11,Loyal Users
93311,1089,19,40,2,3,3,8,Casual Users
93523,60,102,496,5,5,5,15,Champions
93933,32,13,40,5,3,3,11,Loyal Users
93949,2288,11,35,1,2,3,6,Lost
93966,142,16,27,4,3,2,9,Loyal Users
94034,941,19,81,2,3,4,9,Casual Users
94098,61,7,41,5,2,3,10,Promising
94476,878,101,387,2,5,5,12,At Risk
94831,606,21,28,2,3,2,7,Casual Users
95102,1863,13,16,1,3,2,6,Casual Users
95104,156,24,35,4,4,3,11,Loyal Users
95258,5794,27,79,1,4,4,9,At Risk
95462,397,54,354,3,5,5,13,Loyal Users
95649,76,13,99,4,3,4,11,Loyal Users
95875,1998,5,17,1,1,2,4,Lost
95922,16,7,8,5,2,1,8,Promising
96264,173,12,34,3,3,3,9,Loyal Users
96365,706,8,38,2,2,3,7,Lost
96378,1037,77,212,2,5,5,12,At Risk
96790,160,23,178,4,4,5,13,Champions
96809,42,20,276,5,3,5,13,Loyal Users
96872,238,12,21,3,3,2,8,Loyal Users
96888,0,96,141,5,5,4,14,Champions
97179,2101,16,25,1,3,2,6,Casual Users
97633,24,99,222,5,5,5,15,Champions
97848,0,37,82,5,4,4,13,Champions
98017,46,16,28,5,3,2,10,Loyal Users
98037,343,9,10,3,2,1,6,Casual Users
98153,26,25,97,5,4,4,13,Champions
98238,408,16,29,3,3,2,8,Loyal Users
98459,1358,15,42,1,3,3,7,Casual Users
98599,965,20,34,2,3,3,8,Casual Users
98702,150,13,105,4,3,4,11,Loyal Users
98804,8,35,74,5,4,4,13,Champions
99592,87,22,41,4,4,3,11,Loyal Users
99659,137,156,349,4,5,5,14,Champions
99688,30,9,31,5,2,2,9,Promising
99756,711,16,26,2,3,2,7,Casual Users
91140,146,5,15,4,1,1,6,Promising
91155,267,14,83,3,3,4,10,Loyal Users
91203,23,14,64,5,3,4,12,Loyal Users
91427,431,32,56,3,4,3,10,Loyal Users
91519,161,32,40,4,4,3,11,Loyal Users
91663,4578,7,17,1,2,2,5,Lost
91671,408,36,52,3,4,3,10,Loyal Users
92412,143,15,43,4,3,3,10,Loyal Users
92827,446,5,14,3,1,1,5,Casual Users
92916,2,8,15,5,2,1,8,Promising
93001,1879,5,22,1,1,2,4,Lost
93123,1406,10,18,1,2,2,5,Lost
93509,571,17,25,2,3,2,7,Casual Users
93530,4108,11,23,1,2,2,5,Lost
93600,396,6,15,3,1,1,5,Casual Users
93701,429,24,40,3,4,3,10,Loyal Users
93854,155,39,122,4,4,4,12,Champions
94285,36,108,296,5,5,5,15,Champions
94601,765,10,17,2,2,2,6,Lost
94700,135,102,680,4,5,5,14,Champions
94749,9,24,43,5,4,3,12,Loyal Users
94917,907,12,50,2,3,3,8,Casual Users
95073,738,7,13,2,2,1,5,Lost
95083,1485,12,20,1,3,2,6,Casual Users
95143,110,51,82,4,5,4,13,Champions
95331,4449,5,18,1,1,2,4,Lost
95795,43,167,625,5,5,5,15,Champions
95843,161,61,135,4,5,4,13,Champions
95911,408,7,56,3,2,3,8,Casual Users
95960,90,54,173,4,5,5,14,Champions
96042,1696,8,42,1,2,3,6,Lost
96276,1834,5,32,1,1,3,5,Lost
96498,2723,7,11,1,2,1,4,Lost
96536,74,79,186,4,5,5,14,Champions
96932,421,7,11,3,2,1,6,Casual Users
97115,413,11,27,3,2,2,7,Casual Users
97195,1689,12,21,1,3,2,6,Casual Users
97347,273,20,72,3,3,4,10,Loyal Users
97836,2973,7,16,1,2,2,5,Lost
98289,619,33,186,2,4,5,11,At Risk
98359,969,32,98,2,4,4,10,At Risk
98468,264,57,255,3,5,5,13,Loyal Users
98507,18,169,781,5,5,5,15,Champions
99285,1391,16,20,1,3,2,6,Casual Users
99940,91,50,80,4,5,4,13,Champions
99947,3006,15,20,1,3,2,6,Casual Users
91112,132,118,477,4,5,5,14,Champions
91147,2531,6,18,1,1,2,4,Lost
91576,88,20,37,4,3,3,10,Loyal Users
92077,40,53,103,5,5,4,14,Champions
92430,397,7,21,3,2,2,7,Casual Users
92493,6012,8,10,1,2,1,4,Lost
92549,727,14,23,2,3,2,7,Casual Users
92590,7,40,62,5,4,3,12,Loyal Users
92599,14,77,351,5,5,5,15,Champions
92674,1974,12,36,1,3,3,7,Casual Users
93711,153,7,19,4,2,2,8,Promising
93879,806,10,10,2,2,1,5,Lost
93923,83,36,128,4,4,4,12,Champions
93963,368,5,23,3,1,2,6,Casual Users
94399,144,11,20,4,2,2,8,Promising
94427,26,52,82,5,5,4,14,Champions
94508,1450,11,19,1,2,2,5,Lost
94519,45,70,382,5,5,5,15,Champions
94617,2013,9,12,1,2,1,4,Lost
94865,262,20,39,3,3,3,9,Loyal Users
95002,7,52,112,5,5,4,14,Champions
95048,1566,24,152,1,4,5,10,At Risk
95162,133,6,7,4,1,1,6,Promising
95225,104,14,93,4,3,4,11,Loyal Users
95374,1099,31,54,2,4,3,9,At Risk
95837,2197,15,22,1,3,2,6,Casual Users
95890,504,34,162,2,4,5,11,At Risk
96209,842,192,594,2,5,5,12,At Risk
96352,106,58,88,4,5,4,13,Champions
96531,269,10,29,3,2,2,7,Casual Users
96804,415,23,105,3,4,4,11,Loyal Users
96914,88,6,29,4,1,2,7,Promising
96984,47,56,378,5,5,5,15,Champions
97106,120,6,9,4,1,1,6,Promising
97220,422,58,86,3,5,4,12,Loyal Users
97787,533,19,65,2,3,4,9,Casual Users
98000,104,21,63,4,3,4,11,Loyal Users
98166,227,18,70,3,3,4,10,Loyal Users
98295,144,17,93,4,3,4,11,Loyal Users
98502,2226,8,20,1,2,2,5,Lost
98606,2083,13,16,1,3,2,6,Casual Users
98630,125,14,18,4,3,2,9,Loyal Users
98697,694,16,29,2,3,2,7,Casual Users
98895,300,10,16,3,2,2,7,Casual Users
98933,126,36,84,4,4,4,12,Champions
99211,15,18,35,5,3,3,11,Loyal Users
99423,77,13,110,4,3,4,11,Loyal Users
99551,1,5,8,5,1,1,7,Promising
99623,287,16,41,3,3,3,9,Loyal Users
99945,75,52,213,4,5,5,14,Champions
91154,1019,7,17,2,2,2,6,Lost
91536,4387,5,8,1,1,1,3,Lost
91594,2444,7,7,1,2,1,4,Lost
91997,406,52,142,3,5,4,12,Loyal Users
92156,138,9,37,4,2,3,9,Promising
92169,71,8,24,4,2,2,8,Promising
92196,11,139,337,5,5,5,15,Champions
92304,87,11,18,4,2,2,8,Promising
92516,1674,6,10,1,1,1,3,Lost
92580,3,106,290,5,5,5,15,Champions
92621,2600,5,8,1,1,1,3,Lost
92696,18,37,428,5,4,5,14,Champions
92718,101,41,173,4,4,5,13,Champions
93063,2620,12,16,1,3,2,6,Casual Users
93490,1097,8,17,2,2,2,6,Lost
93492,394,10,24,3,2,2,7,Casual Users
93495,1222,18,34,2,3,3,8,Casual Users
93837,1403,5,5,1,1,1,3,Lost
94135,53,47,303,5,5,5,15,Champions
94352,272,20,37,3,3,3,9,Loyal Users
94639,581,25,37,2,4,3,9,At Risk
94674,412,21,56,3,3,3,9,Loyal Users
94838,1392,6,49,1,1,3,5,Lost
95091,149,5,8,4,1,1,6,Promising
95113,423,7,12,3,2,1,6,Casual Users
95149,433,30,123,3,4,4,11,Loyal Users
95243,110,83,128,4,5,4,13,Champions
95257,434,12,116,3,3,4,10,Loyal Users
95640,133,64,90,4,5,4,13,Champions
95957,2,24,26,5,4,2,11,Loyal Users
96294,57,20,34,5,3,3,11,Loyal Users
96443,384,19,34,3,3,3,9,Loyal Users
96563,1359,13,88,1,3,4,8,Casual Users
96652,817,14,34,2,3,3,8,Casual Users
97111,680,9,12,2,2,1,5,Lost
97134,49,56,294,5,5,5,15,Champions
97414,444,12,19,3,3,2,8,Loyal Users
97468,3106,15,54,1,3,3,7,Casual Users
97880,676,5,8,2,1,1,4,Lost
98134,256,32,82,3,4,4,11,Loyal Users
98324,2555,6,13,1,1,1,3,Lost
98358,263,26,47,3,4,3,10,Loyal Users
98444,1796,5,15,1,1,1,3,Lost
98462,257,5,38,3,1,3,7,Casual Users
98487,354,6,36,3,1,3,7,Casual Users
98780,1805,8,20,1,2,2,5,Lost
99058,573,7,14,2,2,1,5,Lost
99390,40,64,262,5,5,5,15,Champions
99643,27,24,56,5,4,3,12,Loyal Users
99836,436,5,11,3,1,1,5,Casual Users
99850,10,99,566,5,5,5,15,Champions
91159,247,9,38,3,2,3,8,Casual Users
91744,969,8,102,2,2,4,8,Lost
91812,263,5,32,3,1,3,7,Casual Users
91914,3,109,411,5,5,5,15,Champions
92036,3135,8,13,1,2,1,4,Lost
92282,1587,5,6,1,1,1,3,Lost
92352,670,37,179,2,4,5,11,At Risk
92554,683,9,9,2,2,1,5,Lost
92734,394,75,309,3,5,5,13,Loyal Users
93029,1435,14,16,1,3,2,6,Casual Users
93289,844,6,14,2,1,1,4,Lost
93363,3235,6,14,1,1,1,3,Lost
93507,3638,11,18,1,2,2,5,Lost
93929,12,31,73,5,4,4,13,Champions
94207,3,16,32,5,3,3,11,Loyal Users
94421,423,5,9,3,1,1,5,Casual Users
94928,113,26,46,4,4,3,11,Loyal Users
94934,5704,5,10,1,1,1,3,Lost
94996,3554,5,7,1,1,1,3,Lost
95010,34,26,45,5,4,3,12,Loyal Users
95042,5155,5,7,1,1,1,3,Lost
95456,2022,11,16,1,2,2,5,Lost
95581,1633,24,115,1,4,4,9,At Risk
96331,8,15,24,5,3,2,10,Loyal Users
96478,115,26,69,4,4,4,12,Champions
96677,45,18,25,5,3,2,10,Loyal Users
96805,336,7,47,3,2,3,8,Casual Users
96991,1752,7,65,1,2,4,7,Lost
97153,435,5,12,3,1,1,5,Casual Users
97159,205,31,176,3,4,5,12,Loyal Users
97216,208,20,194,3,3,5,11,Loyal Users
97489,3234,5,5,1,1,1,3,Lost
97569,322,13,33,3,3,3,9,Loyal Users
97628,253,31,274,3,4,5,12,Loyal Users
97655,119,6,17,4,1,2,7,Promising
97826,863,10,25,2,2,2,6,Lost
97881,424,5,11,3,1,1,5,Casual Users
98477,2003,35,87,1,4,4,9,At Risk
98726,10,152,579,5,5,5,15,Champions
98743,6,38,58,5,4,3,12,Loyal Users
99015,1164,14,21,2,3,2,7,Casual Users
99037,563,7,43,2,2,3,7,Lost
99078,33,76,181,5,5,5,15,Champions
99218,4823,7,11,1,2,1,4,Lost
99647,351,25,96,3,4,4,11,Loyal Users
99938,1596,6,8,1,1,1,3,Lost
91103,1832,9,13,1,2,1,4,Lost
91387,1573,8,11,1,2,1,4,Lost
91554,154,18,28,4,3,2,9,Loyal Users
91654,363,38,59,3,4,3,10,Loyal Users
92244,5231,15,52,1,3,3,7,Casual Users
92314,691,6,6,2,1,1,4,Lost
92634,155,11,16,4,2,2,8,Promising
92716,183,63,148,3,5,5,13,Loyal Users
93133,3004,7,9,1,2,1,4,Lost
93498,326,63,295,3,5,5,13,Loyal Users
93541,169,27,49,3,4,3,10,Loyal Users
93698,474,9,37,2,2,3,7,Lost
93914,411,20,49,3,3,3,9,Loyal Users
94267,7,15,73,5,3,4,12,Loyal Users
94574,88,10,15,4,2,1,7,Promising
94607,355,26,52,3,4,3,10,Loyal Users
94629,44,8,33,5,2,3,10,Promising
94742,449,22,33,3,4,3,10,Loyal Users
94860,158,8,13,4,2,1,7,Promising
94896,550,18,37,2,3,3,8,Casual Users
94912,642,29,63,2,4,4,10,At Risk
95267,132,75,156,4,5,5,14,Champions
95496,744,9,22,2,2,2,6,Lost
95509,218,17,84,3,3,4,10,Loyal Users
95525,104,50,78,4,5,4,13,Champions
95596,122,11,55,4,2,3,9,Promising
95604,159,103,236,4,5,5,14,Champions
95968,414,27,36,3,4,3,10,Loyal Users
96269,40,44,185,5,4,5,14,Champions
96461,347,11,12,3,2,1,6,Casual Users
96644,1656,8,8,1,2,1,4,Lost
96722,238,6,13,3,1,1,5,Casual Users
96823,2410,5,17,1,1,2,4,Lost
96964,11,9,24,5,2,2,9,Promising
96967,895,15,44,2,3,3,8,Casual Users
97040,2,14,20,5,3,2,10,Loyal Users
97201,43,9,25,5,2,2,9,Promising
97311,5,66,82,5,5,4,14,Champions
97822,334,25,76,3,4,4,11,Loyal Users
98447,1324,16,41,1,3,3,7,Casual Users
98597,97,7,17,4,2,2,8,Promising
98619,291,5,5,3,1,1,5,Casual Users
99026,1932,32,132,1,4,4,9,At Risk
99045,243,26,147,3,4,5,12,Loyal Users
99249,1891,5,32,1,1,3,5,Lost
99320,129,13,89,4,3,4,11,Loyal Users
99932,16,47,389,5,5,5,15,Champions
91180,617,5,12,2,1,1,4,Lost
91475,34,28,40,5,4,3,12,Loyal Users
91496,177,15,28,3,3,2,8,Loyal Users
91511,18,35,159,5,4,5,14,Champions
92379,417,5,7,3,1,1,5,Casual Users
92440,424,8,10,3,2,1,6,Casual Users
92526,116,59,300,4,5,5,14,Champions
92711,30,14,40,5,3,3,11,Loyal Users
92905,1030,100,125,2,5,4,11,At Risk
92912,76,30,224,4,4,5,13,Champions
93213,1419,5,10,1,1,1,3,Lost
93326,714,5,48,2,1,3,6,Lost
93613,422,57,78,3,5,4,12,Loyal Users
93730,2,92,473,5,5,5,15,Champions
94060,4407,16,79,1,3,4,8,Casual Users
94141,115,10,27,4,2,2,8,Promising
94160,254,34,276,3,4,5,12,Loyal Users
94449,169,14,32,3,3,3,9,Loyal Users
95249,1986,8,22,1,2,2,5,Lost
95797,887,88,360,2,5,5,12,At Risk
95938,1279,8,15,1,2,1,4,Lost
95983,83,16,29,4,3,2,9,Loyal Users
96208,63,33,307,5,4,5,14,Champions
96491,1278,28,71,1,4,4,9,At Risk
96542,1703,10,20,1,2,2,5,Lost
96593,420,26,64,3,4,4,11,Loyal Users
96808,80,83,153,4,5,5,14,Champions
96860,3849,9,22,1,2,2,5,Lost
97024,1011,10,19,2,2,2,6,Lost
97656,4,32,61,5,4,3,12,Loyal Users
97732,270,42,55,3,4,3,10,Loyal Users
97761,346,30,66,3,4,4,11,Loyal Users
97919,1017,7,16,2,2,2,6,Lost
98079,1,74,151,5,5,5,15,Champions
98476,114,66,232,4,5,5,14,Champions
98841,27,13,42,5,3,3,11,Loyal Users
98958,3690,12,72,1,3,4,8,Casual Users
99050,2,155,513,5,5,5,15,Champions
99526,533,12,66,2,3,4,9,Casual Users
99791,35,14,135,5,3,4,12,Loyal Users
99872,3,131,429,5,5,5,15,Champions
99969,1825,10,17,1,2,2,5,Lost
91128,2082,5,15,1,1,1,3,Lost
91730,89,39,68,4,4,4,12,Champions
92336,1,51,167,5,5,5,15,Champions
92501,388,9,15,3,2,1,6,Casual Users
92571,12,26,75,5,4,4,13,Champions
92870,283,11,12,3,2,1,6,Casual Users
93312,931,28,119,2,4,4,10,At Risk
93333,307,13,18,3,3,2,8,Loyal Users
93421,410,6,46,3,1,3,7,Casual Users
94104,969,15,32,2,3,3,8,Casual Users
94194,112,5,5,4,1,1,6,Promising
94829,160,95,174,4,5,5,14,Champions
95034,1163,7,7,2,2,1,5,Lost
95367,552,15,24,2,3,2,7,Casual Users
95714,245,12,27,3,3,2,8,Loyal Users
96117,3405,8,40,1,2,3,6,Lost
96256,131,16,27,4,3,2,9,Loyal Users
96621,544,11,22,2,2,2,6,Lost
97028,699,9,16,2,2,2,6,Lost
97035,609,14,30,2,3,2,7,Casual Users
97304,9,36,143,5,4,4,13,Champions
97400,286,18,70,3,3,4,10,Loyal Users
97531,0,154,438,5,5,5,15,Champions
97594,273,15,17,3,3,2,8,Loyal Users
97599,3093,15,32,1,3,3,7,Casual Users
97621,737,15,74,2,3,4,9,Casual Users
97659,1870,5,45,1,1,3,5,Lost
98248,4003,5,6,1,1,1,3,Lost
98253,5,82,264,5,5,5,15,Champions
98563,2852,51,168,1,5,5,11,At Risk
99042,2955,14,25,1,3,2,6,Casual Users
99318,274,52,146,3,5,4,12,Loyal Users
99359,101,15,105,4,3,4,11,Loyal Users
99376,971,5,14,2,1,1,4,Lost
99428,754,5,17,2,1,2,5,Lost
99730,4,59,122,5,5,4,14,Champions
99777,2547,12,21,1,3,2,6,Casual Users
91795,432,56,202,3,5,5,13,Loyal Users
91852,207,7,16,3,2,2,7,Casual Users
91858,520,76,338,2,5,5,12,At Risk
91878,151,16,108,4,3,4,11,Loyal Users
91947,431,37,84,3,4,4,11,Loyal Users
92151,127,19,36,4,3,3,10,Loyal Users
92432,654,16,28,2,3,2,7,Casual Users
92874,123,22,52,4,4,3,11,Loyal Users
93073,88,75,346,4,5,5,14,Champions
93087,1516,7,14,1,2,1,4,Lost
93163,1396,6,15,1,1,1,3,Lost
93521,250,134,335,3,5,5,13,Loyal Users
93736,130,8,53,4,2,3,9,Promising
93930,618,10,69,2,2,4,8,Lost
94008,3765,9,15,1,2,1,4,Lost
94250,2339,5,6,1,1,1,3,Lost
94366,78,29,72,4,4,4,12,Champions
94386,322,7,28,3,2,2,7,Casual Users
94400,1702,5,6,1,1,1,3,Lost
94440,5,39,175,5,4,5,14,Champions
94725,256,35,47,3,4,3,10,Loyal Users
94850,688,15,20,2,3,2,7,Casual Users
94892,822,7,40,2,2,3,7,Lost
95563,1971,7,12,1,2,1,4,Lost
95582,226,34,76,3,4,4,11,Loyal Users
95790,2130,7,27,1,2,2,5,Lost
95833,586,11,21,2,2,2,6,Lost
95950,54,41,127,5,4,4,13,Champions
96064,269,8,22,3,2,2,7,Casual Users
96440,25,45,144,5,4,4,13,Champions
96647,3256,6,13,1,1,1,3,Lost
96773,2117,12,46,1,3,3,7,Casual Users
96942,104,154,434,4,5,5,14,Champions
97548,2171,20,45,1,3,3,7,Casual Users
97650,1594,7,12,1,2,1,4,Lost
98179,4415,16,52,1,3,3,7,Casual Users
98206,704,36,239,2,4,5,11,At Risk
98239,1242,11,24,2,2,2,6,Lost
98277,1281,14,55,1,3,3,7,Casual Users
98681,177,67,210,3,5,5,13,Loyal Users
99116,381,23,122,3,4,4,11,Loyal Users
99165,3413,5,15,1,1,1,3,Lost
99210,33,43,152,5,4,5,14,Champions
91175,0,25,104,5,4,4,13,Champions
91621,430,44,132,3,4,4,11,Loyal Users
91823,695,5,10,2,1,1,4,Lost
91855,435,8,18,3,2,2,7,Casual Users
91902,1517,6,9,1,1,1,3,Lost
92028,4130,5,7,1,1,1,3,Lost
92042,94,35,210,4,4,5,13,Champions
92142,137,8,102,4,2,4,10,Promising
92323,14,8,10,5,2,1,8,Promising
92454,2409,6,15,1,1,1,3,Lost
92495,547,13,17,2,3,2,7,Casual Users
93176,495,8,10,2,2,1,5,Lost
93306,431,5,8,3,1,1,5,Casual Users
93370,122,25,116,4,4,4,12,Champions
94017,695,24,207,2,4,5,11,At Risk
94158,2687,5,5,1,1,1,3,Lost
94260,5372,12,13,1,3,1,5,Casual Users
94567,1,150,312,5,5,5,15,Champions
94765,153,20,29,4,3,2,9,Loyal Users
94806,81,51,287,4,5,5,14,Champions
94922,536,6,15,2,1,1,4,Lost
95235,772,9,11,2,2,1,5,Lost
95340,77,151,416,4,5,5,14,Champions
95414,366,42,50,3,4,3,10,Loyal Users
95691,3730,7,16,1,2,2,5,Lost
95697,977,17,68,2,3,4,9,Casual Users
96060,417,6,14,3,1,1,5,Casual Users
96381,3577,19,19,1,3,2,6,Casual Users
96968,2071,7,16,1,2,2,5,Lost
97121,87,188,460,4,5,5,14,Champions
97173,822,14,39,2,3,3,8,Casual Users
97317,3720,5,6,1,1,1,3,Lost
97462,215,6,14,3,1,1,5,Casual Users
97593,68,13,72,5,3,4,12,Loyal Users
97598,34,28,92,5,4,4,13,Champions
97697,416,6,7,3,1,1,5,Casual Users
97723,2114,6,7,1,1,1,3,Lost
97955,564,5,8,2,1,1,4,Lost
98284,844,11,12,2,2,1,5,Lost
98318,377,33,64,3,4,4,11,Loyal Users
98639,9,101,666,5,5,5,15,Champions
98848,1553,46,72,1,5,4,10,At Risk
98881,425,32,126,3,4,4,11,Loyal Users
98929,57,12,88,5,3,4,12,Loyal Users
99510,584,5,7,2,1,1,4,Lost
99587,73,48,62,4,5,3,12,Loyal Users
99615,1,14,39,5,3,3,11,Loyal Users
99691,438,98,242,3,5,5,13,Loyal Users
99718,2410,5,56,1,1,3,5,Lost
99728,150,6,10,4,1,1,6,Promising
99731,945,7,24,2,2,2,6,Lost
99827,265,12,13,3,3,1,7,Loyal Users
99897,3,32,55,5,4,3,12,Loyal Users
91366,419,78,394,3,5,5,13,Loyal Users
91435,3604,6,12,1,1,1,3,Lost
91544,133,55,365,4,5,5,14,Champions
91705,1628,5,21,1,1,2,4,Lost
91721,213,24,121,3,4,4,11,Loyal Users
91806,433,14,33,3,3,3,9,Loyal Users
92120,873,13,61,2,3,3,8,Casual Users
92153,113,23,33,4,4,3,11,Loyal Users
92157,43,23,209,5,4,5,14,Champions
92588,44,11,16,5,2,2,9,Promising
92687,2058,10,17,1,2,2,5,Lost
93127,443,7,19,3,2,2,7,Casual Users
93500,557,5,8,2,1,1,4,Lost
93650,3551,7,29,1,2,2,5,Lost
93664,3065,8,11,1,2,1,4,Lost
93776,108,81,303,4,5,5,14,Champions
94024,3608,33,81,1,4,4,9,At Risk
94288,1696,16,51,1,3,3,7,Casual Users
94307,20,42,71,5,4,4,13,Champions
94475,172,30,49,3,4,3,10,Loyal Users
94518,158,12,38,4,3,3,10,Loyal Users
94701,33,19,39,5,3,3,11,Loyal Users
95234,4013,7,9,1,2,1,4,Lost
95727,1,40,166,5,4,5,14,Champions
96341,409,7,23,3,2,2,7,Casual Users
96499,46,49,158,5,5,5,15,Champions
96757,54,141,473,5,5,5,15,Champions
96930,1271,25,37,1,4,3,8,At Risk
96986,1219,17,22,2,3,2,7,Casual Users
97209,910,65,147,2,5,5,12,At Risk
97396,206,5,10,3,1,1,5,Casual Users
97693,437,7,30,3,2,2,7,Casual Users
97968,418,16,31,3,3,2,8,Loyal Users
98144,107,35,103,4,4,4,12,Champions
98317,4,78,107,5,5,4,14,Champions
98320,3864,24,33,1,4,3,8,At Risk
98424,12,84,393,5,5,5,15,Champions
98511,276,25,35,3,4,3,10,Loyal Users
99006,23,25,67,5,4,4,13,Champions
99013,1398,8,11,1,2,1,4,Lost
99323,2932,6,37,1,1,3,5,Lost
99559,161,6,6,4,1,1,6,Promising
99970,58,85,157,5,5,5,15,Champions
91158,1219,5,12,2,1,1,4,Lost
91229,415,29,63,3,4,4,11,Loyal Users
91478,1313,13,46,1,3,3,7,Casual Users
91711,4265,8,34,1,2,3,6,Lost
92284,283,10,70,3,2,4,9,Casual Users
92372,128,10,50,4,2,3,9,Promising
92676,413,32,127,3,4,4,11,Loyal Users
92737,3178,16,19,1,3,2,6,Casual Users
92767,2374,12,19,1,3,2,6,Casual Users
92976,676,10,11,2,2,1,5,Lost
93047,5710,12,54,1,3,3,7,Casual Users
93060,32,70,706,5,5,5,15,Champions
93282,3577,5,10,1,1,1,3,Lost
93688,166,10,26,3,2,2,7,Casual Users
93992,1500,14,23,1,3,2,6,Casual Users
94299,19,32,131,5,4,4,13,Champions
94336,2,35,125,5,4,4,13,Champions
94522,1065,7,11,2,2,1,5,Lost
94550,870,5,15,2,1,1,4,Lost
94653,2954,6,8,1,1,1,3,Lost
94821,2172,18,41,1,3,3,7,Casual Users
94938,77,80,160,4,5,5,14,Champions
94981,445,25,44,3,4,3,10,Loyal Users
95064,4,130,310,5,5,5,15,Champions
95093,107,51,268,4,5,5,14,Champions
95174,2700,7,24,1,2,2,5,Lost
95557,2830,23,105,1,4,4,9,At Risk
95600,672,5,15,2,1,1,4,Lost
95880,46,92,461,5,5,5,15,Champions
96173,158,38,75,4,4,4,12,Champions
96492,3,10,66,5,2,4,11,Promising
96901,79,16,51,4,3,3,10,Loyal Users
97152,1519,15,28,1,3,2,6,Casual Users
97247,1269,5,14,1,1,1,3,Lost
97307,175,12,36,3,3,3,9,Loyal Users
97519,3751,6,10,1,1,1,3,Lost
97544,706,13,59,2,3,3,8,Casual Users
97717,1399,6,13,1,1,1,3,Lost
97962,2005,14,19,1,3,2,6,Casual Users
98653,413,7,15,3,2,1,6,Casual Users
99143,282,39,105,3,4,4,11,Loyal Users
99197,23,73,385,5,5,5,15,Champions
99283,152,25,153,4,4,5,13,Champions
99401,660,22,168,2,4,5,11,At Risk
99734,225,5,9,3,1,1,5,Casual Users
99755,269,13,38,3,3,3,9,Loyal Users
99825,199,22,64,3,4,4,11,Loyal Users
91439,109,17,111,4,3,4,11,Loyal Users
91625,222,5,13,3,1,1,5,Casual Users
91741,492,6,11,2,1,1,4,Lost
91805,12,43,166,5,4,5,14,Champions
91849,432,26,32,3,4,3,10,Loyal Users
91897,1786,8,27,1,2,2,5,Lost
92096,670,23,87,2,4,4,10,At Risk
93242,154,57,106,4,5,4,13,Champions
93264,6036,10,17,1,2,2,5,Lost
93396,570,10,26,2,2,2,6,Lost
93491,7,30,150,5,4,5,14,Champions
93830,319,56,241,3,5,5,13,Loyal Users
93909,424,19,45,3,3,3,9,Loyal Users
93962,37,12,24,5,3,2,10,Loyal Users
94092,2682,5,9,1,1,1,3,Lost
94293,465,32,60,3,4,3,10,Loyal Users
94843,136,10,59,4,2,3,9,Promising
95017,3413,7,12,1,2,1,4,Lost
95065,3974,7,8,1,2,1,4,Lost
95504,6,67,171,5,5,5,15,Champions
95583,427,7,24,3,2,2,7,Casual Users
96170,85,8,27,4,2,2,8,Promising
96403,418,6,7,3,1,1,5,Casual Users
96658,124,36,170,4,4,5,13,Champions
96855,13,109,757,5,5,5,15,Champions
97420,36,60,326,5,5,5,15,Champions
97486,243,5,11,3,1,1,5,Casual Users
97669,159,22,44,4,4,3,11,Loyal Users
97887,182,6,23,3,1,2,6,Casual Users
98553,4435,6,14,1,1,1,3,Lost
98644,101,21,38,4,3,3,10,Loyal Users
98740,144,54,136,4,5,4,13,Champions
98928,3814,5,9,1,1,1,3,Lost
98986,34,12,28,5,3,2,10,Loyal Users
99262,5,127,403,5,5,5,15,Champions
99470,26,43,332,5,4,5,14,Champions
99608,1980,7,8,1,2,1,4,Lost
99794,1181,33,64,2,4,4,10,At Risk
99858,4142,5,37,1,1,3,5,Lost
91115,858,5,15,2,1,1,4,Lost
91557,3085,26,147,1,4,5,10,At Risk
91579,1628,5,25,1,1,2,4,Lost
91714,431,13,32,3,3,3,9,Loyal Users
91783,130,17,45,4,3,3,10,Loyal Users
91877,420,35,84,3,4,4,11,Loyal Users
92074,2673,6,8,1,1,1,3,Lost
92177,72,18,155,4,3,5,12,Loyal Users
92474,1684,8,11,1,2,1,4,Lost
93141,267,28,125,3,4,4,11,Loyal Users
93473,23,15,56,5,3,3,11,Loyal Users
93595,34,41,96,5,4,4,13,Champions
93624,14,30,91,5,4,4,13,Champions
93699,2405,5,6,1,1,1,3,Lost
93786,139,5,14,4,1,1,6,Promising
93787,20,37,52,5,4,3,12,Loyal Users
93889,2985,5,14,1,1,1,3,Lost
94016,22,9,18,5,2,2,9,Promising
94042,834,19,59,2,3,3,8,Casual Users
94315,403,8,23,3,2,2,7,Casual Users
94444,54,57,138,5,5,4,14,Champions
94615,290,23,180,3,4,5,12,Loyal Users
94777,19,96,119,5,5,4,14,Champions
94895,1364,12,54,1,3,3,7,Casual Users
95276,1103,7,40,2,2,3,7,Lost
95335,1936,13,16,1,3,2,6,Casual Users
95603,261,27,50,3,4,3,10,Loyal Users
95682,757,9,10,2,2,1,5,Lost
95752,7,111,394,5,5,5,15,Champions
95873,39,87,128,5,5,4,14,Champions
95986,882,8,23,2,2,2,6,Lost
96032,126,6,7,4,1,1,6,Promising
96034,2018,6,27,1,1,2,4,Lost
96332,355,12,85,3,3,4,10,Loyal Users
96543,4371,6,15,1,1,1,3,Lost
97303,365,55,92,3,5,4,12,Loyal Users
97667,533,8,28,2,2,2,6,Lost
97791,117,27,174,4,4,5,13,Champions
97821,15,106,593,5,5,5,15,Champions
97877,269,18,49,3,3,3,9,Loyal Users
98135,32,79,160,5,5,5,15,Champions
98352,1020,21,94,2,3,4,9,Casual Users
98401,1185,23,68,2,4,4,10,At Risk
98537,53,5,13,5,1,1,7,Promising
99141,137,5,11,4,1,1,6,Promising
99215,4740,40,164,1,4,5,10,At Risk
99657,15,10,36,5,2,3,10,Promising
99767,1289,35,159,1,4,5,10,At Risk
91072,401,20,61,3,3,3,9,Loyal Users
91099,3017,15,28,1,3,2,6,Casual Users
91207,185,58,482,3,5,5,13,Loyal Users
91238,17,76,524,5,5,5,15,Champions
91259,1681,12,30,1,3,2,6,Casual Users
91280,9,16,37,5,3,3,11,Loyal Users
91316,2466,8,11,1,2,1,4,Lost
91351,20,85,200,5,5,5,15,Champions
91428,71,20,55,4,3,3,10,Loyal Users
91929,2,106,272,5,5,5,15,Champions
91964,589,8,13,2,2,1,5,Lost
92087,65,27,130,5,4,4,13,Champions
92345,2425,21,92,1,3,4,8,Casual Users
92578,3934,7,19,1,2,2,5,Lost
92697,88,13,227,4,3,5,12,Loyal Users
92722,462,40,47,3,4,3,10,Loyal Users
92771,11,14,39,5,3,3,11,Loyal Users
92883,325,123,343,3,5,5,13,Loyal Users
93045,11,30,55,5,4,3,12,Loyal Users
93143,0,243,306,5,5,5,15,Champions
93270,2685,12,63,1,3,4,8,Casual Users
93387,277,6,6,3,1,1,5,Casual Users
93972,396,27,31,3,4,2,9,Loyal Users
94166,1665,11,21,1,2,2,5,Lost
94177,244,18,30,3,3,2,8,Loyal Users
94190,4018,5,9,1,1,1,3,Lost
94395,2220,6,54,1,1,3,5,Lost
94414,212,35,70,3,4,4,11,Loyal Users
94432,296,8,24,3,2,2,7,Casual Users
95445,364,25,37,3,4,3,10,Loyal Users
95633,21,142,517,5,5,5,15,Champions
95665,275,24,60,3,4,3,10,Loyal Users
95757,436,9,46,3,2,3,8,Casual Users
96088,268,18,27,3,3,2,8,Loyal Users
96123,36,147,191,5,5,5,15,Champions
96674,2417,10,18,1,2,2,5,Lost
96915,125,42,62,4,4,3,11,Loyal Users
96951,682,14,77,2,3,4,9,Casual Users
97087,2,26,93,5,4,4,13,Champions
97337,1118,44,306,2,4,5,11,At Risk
97437,1625,9,27,1,2,2,5,Lost
97530,234,132,403,3,5,5,13,Loyal Users
97930,395,9,37,3,2,3,8,Casual Users
98047,1789,12,13,1,3,1,5,Casual Users
98224,134,36,47,4,4,3,11,Loyal Users
98420,281,10,21,3,2,2,7,Casual Users
98807,153,25,50,4,4,3,11,Loyal Users
98903,1086,10,16,2,2,2,6,Lost
99132,1284,5,9,1,1,1,3,Lost
99289,230,20,32,3,3,3,9,Loyal Users
99329,120,56,299,4,5,5,14,Champions
99556,4005,7,18,1,2,2,5,Lost
99576,75,76,262,4,5,5,14,Champions
99840,126,31,53,4,4,3,11,Loyal Users
99972,26,40,303,5,4,5,14,Champions
91206,228,21,24,3,3,2,8,Loyal Users
91234,251,48,80,3,5,4,12,Loyal Users
91376,294,7,12,3,2,1,6,Casual Users
91470,1812,10,14,1,2,1,4,Lost
91608,1,72,391,5,5,5,15,Champions
91802,11,80,239,5,5,5,15,Champions
91894,975,45,71,2,4,4,10,At Risk
92053,295,13,30,3,3,2,8,Loyal Users
92103,528,6,6,2,1,1,4,Lost
92370,168,6,21,3,1,2,6,Casual Users
92462,33,66,130,5,5,4,14,Champions
92974,282,6,23,3,1,2,6,Casual Users
92998,668,18,26,2,3,2,7,Casual Users
93140,269,64,350,3,5,5,13,Loyal Users
93857,334,16,21,3,3,2,8,Loyal Users
94091,1436,5,31,1,1,2,4,Lost
94140,720,7,12,2,2,1,5,Lost
94204,143,6,63,4,1,4,9,Promising
94252,126,12,114,4,3,4,11,Loyal Users
94279,35,54,121,5,5,4,14,Champions
94291,477,6,30,2,1,2,5,Lost
94323,145,21,106,4,3,4,11,Loyal Users
94825,1855,9,27,1,2,2,5,Lost
94926,28,60,78,5,5,4,14,Champions
95107,2031,7,28,1,2,2,5,Lost
95185,381,11,14,3,2,1,6,Casual Users
95297,833,23,75,2,4,4,10,At Risk
95316,749,9,14,2,2,1,5,Lost
95438,2088,84,173,1,5,5,11,At Risk
95529,176,8,12,3,2,1,6,Casual Users
95804,1384,5,5,1,1,1,3,Lost
95897,34,78,629,5,5,5,15,Champions
95926,1943,5,7,1,1,1,3,Lost
96517,147,12,44,4,3,3,10,Loyal Users
96634,283,11,16,3,2,2,7,Casual Users
96778,364,33,137,3,4,4,11,Loyal Users
96788,2154,6,88,1,1,4,6,Lost
97227,880,14,17,2,3,2,7,Casual Users
97408,3714,22,28,1,4,2,7,At Risk
97551,1982,6,15,1,1,1,3,Lost
97570,22,35,190,5,4,5,14,Champions
97582,135,14,26,4,3,2,9,Loyal Users
97747,294,20,23,3,3,2,8,Loyal Users
97831,1244,13,25,2,3,2,7,Casual Users
97873,1722,18,23,1,3,2,6,Casual Users
98176,223,25,104,3,4,4,11,Loyal Users
98237,96,9,39,4,2,3,9,Promising
98373,4843,10,10,1,2,1,4,Lost
98735,142,11,55,4,2,3,9,Promising
98794,133,5,34,4,1,3,8,Promising
98892,108,57,456,4,5,5,14,Champions
99075,92,55,104,4,5,4,13,Champions
99264,163,22,87,4,4,4,12,Champions
99301,2575,46,125,1,5,4,10,At Risk
99311,713,10,17,2,2,2,6,Lost
99508,789,6,24,2,1,2,5,Lost
99775,13,39,153,5,4,5,14,Champions
99884,141,19,131,4,3,4,11,Loyal Users
91275,114,22,65,4,4,4,12,Champions
91695,7,12,51,5,3,3,11,Loyal Users
91862,5,35,133,5,4,4,13,Champions
92007,1547,22,27,1,4,2,7,At Risk
92159,1,37,48,5,4,3,12,Loyal Users
92221,436,36,54,3,4,3,10,Loyal Users
92878,155,26,55,4,4,3,11,Loyal Users
93148,1721,5,40,1,1,3,5,Lost
93198,258,12,31,3,3,2,8,Loyal Users
93619,128,15,44,4,3,3,10,Loyal Users
93817,929,6,37,2,1,3,6,Lost
94020,1323,23,61,1,4,3,8,At Risk
94023,543,5,5,2,1,1,4,Lost
94095,259,39,171,3,4,5,12,Loyal Users
94658,5105,5,20,1,1,2,4,Lost
94718,51,83,152,5,5,5,15,Champions
95134,32,143,423,5,5,5,15,Champions
95177,4546,10,30,1,2,2,5,Lost
95368,578,49,124,2,5,4,11,At Risk
95497,129,5,9,4,1,1,6,Promising
95698,276,83,137,3,5,4,12,Loyal Users
95717,3925,20,88,1,3,4,8,Casual Users
95726,2816,10,19,1,2,2,5,Lost
95966,65,37,115,5,4,4,13,Champions
96127,104,14,66,4,3,4,11,Loyal Users
96411,276,11,28,3,2,2,7,Casual Users
96480,149,172,268,4,5,5,14,Champions
96493,22,66,190,5,5,5,15,Champions
96693,675,7,12,2,2,1,5,Lost
96797,24,21,61,5,3,3,11,Loyal Users
96799,1419,16,36,1,3,3,7,Casual Users
97215,420,10,28,3,2,2,7,Casual Users
97418,2723,6,8,1,1,1,3,Lost
97540,259,29,38,3,4,3,10,Loyal Users
97708,461,35,142,3,4,4,11,Loyal Users
97937,303,106,230,3,5,5,13,Loyal Users
98022,182,32,74,3,4,4,11,Loyal Users
98348,101,22,694,4,4,5,13,Champions
98788,5,66,340,5,5,5,15,Champions
98968,117,44,179,4,4,5,13,Champions
99118,263,9,18,3,2,2,7,Casual Users
99161,60,55,339,5,5,5,15,Champions
99274,3957,6,8,1,1,1,3,Lost
99341,3407,8,13,1,2,1,4,Lost
99344,39,35,102,5,4,4,13,Champions
99505,4,33,63,5,4,4,13,Champions
99515,124,9,13,4,2,1,7,Promising
99937,581,6,11,2,1,1,4,Lost
91788,18,129,287,5,5,5,15,Champions
91946,164,71,521,4,5,5,14,Champions
92133,389,9,31,3,2,2,7,Casual Users
92277,954,35,168,2,4,5,11,At Risk
92280,2817,12,16,1,3,2,6,Casual Users
93171,120,23,50,4,4,3,11,Loyal Users
93685,442,15,21,3,3,2,8,Loyal Users
94343,3530,33,45,1,4,3,8,At Risk
94650,1069,7,15,2,2,1,5,Lost
94679,184,27,33,3,4,3,10,Loyal Users
95195,106,13,102,4,3,4,11,Loyal Users
95369,4030,5,5,1,1,1,3,Lost
95513,2002,9,23,1,2,2,5,Lost
95535,1431,9,14,1,2,1,4,Lost
95548,627,22,35,2,4,3,9,At Risk
95931,795,9,24,2,2,2,6,Lost
95998,1613,5,19,1,1,2,4,Lost
96039,394,17,41,3,3,3,9,Loyal Users
96080,420,27,79,3,4,4,11,Loyal Users
96108,139,25,54,4,4,3,11,Loyal Users
96135,837,18,23,2,3,2,7,Casual Users
96639,1464,7,15,1,2,1,4,Lost
96648,156,28,183,4,4,5,13,Champions
96764,3415,5,15,1,1,1,3,Lost
96772,16,43,201,5,4,5,14,Champions
97130,5694,10,37,1,2,3,6,Lost
97276,68,36,114,5,4,4,13,Champions
97852,588,15,20,2,3,2,7,Casual Users
97952,17,99,177,5,5,5,15,Champions
98012,187,47,276,3,5,5,13,Loyal Users
98275,818,11,16,2,2,2,6,Lost
98717,2807,9,78,1,2,4,7,Lost
98980,958,62,150,2,5,5,12,At Risk
99044,19,5,31,5,1,2,8,Promising
99234,689,11,27,2,2,2,6,Lost
99380,587,17,39,2,3,3,8,Casual Users
99610,499,12,15,2,3,1,6,Casual Users
91073,2548,6,22,1,1,2,4,Lost
91222,1960,7,27,1,2,2,5,Lost
91304,373,9,17,3,2,2,7,Casual Users
91948,51,127,446,5,5,5,15,Champions
92032,572,32,182,2,4,5,11,At Risk
92122,140,41,105,4,4,4,12,Champions
92364,579,31,52,2,4,3,9,At Risk
92836,2056,59,257,1,5,5,11,At Risk
92872,1071,5,12,2,1,1,4,Lost
93033,3542,5,33,1,1,3,5,Lost
93221,811,7,20,2,2,2,6,Lost
93538,1800,22,30,1,4,2,7,At Risk
93618,1991,8,35,1,2,3,6,Lost
93627,1321,5,8,1,1,1,3,Lost
93773,213,7,28,3,2,2,7,Casual Users
93782,26,36,72,5,4,4,13,Champions
94311,34,24,133,5,4,4,13,Champions
94330,4677,6,9,1,1,1,3,Lost
94431,63,42,60,5,4,3,12,Loyal Users
95602,308,51,195,3,5,5,13,Loyal Users
95613,114,13,29,4,3,2,9,Loyal Users
96235,593,64,127,2,5,4,11,At Risk
96280,250,59,96,3,5,4,12,Loyal Users
96635,2268,16,39,1,3,3,7,Casual Users
96659,3,69,122,5,5,4,14,Champions
96714,9,54,76,5,5,4,14,Champions
97913,2416,7,14,1,2,1,4,Lost
98069,1031,7,49,2,2,3,7,Lost
98460,864,7,8,2,2,1,5,Lost
98466,134,40,56,4,4,3,11,Loyal Users
98625,1354,9,58,1,2,3,6,Lost
98960,580,5,5,2,1,1,4,Lost
99516,2566,10,24,1,2,2,5,Lost
99568,3244,15,20,1,3,2,6,Casual Users
91537,237,14,85,3,3,4,10,Loyal Users
91770,127,44,88,4,4,4,12,Champions
92075,376,13,19,3,3,2,8,Loyal Users
92338,104,9,17,4,2,2,8,Promising
92468,123,51,95,4,5,4,13,Champions
92715,41,9,13,5,2,1,8,Promising
92816,127,28,43,4,4,3,11,Loyal Users
93636,97,68,205,4,5,5,14,Champions
93660,80,188,323,4,5,5,14,Champions
94018,3399,7,12,1,2,1,4,Lost
94094,63,20,27,5,3,2,10,Loyal Users
94302,34,37,113,5,4,4,13,Champions
94459,41,92,173,5,5,5,15,Champions
94595,567,5,10,2,1,1,4,Lost
94640,1830,6,7,1,1,1,3,Lost
95736,7,20,40,5,3,3,11,Loyal Users
95777,1642,84,283,1,5,5,11,At Risk
95860,123,28,48,4,4,3,11,Loyal Users
95961,232,78,155,3,5,5,13,Loyal Users
96024,1963,7,12,1,2,1,4,Lost
96090,261,26,102,3,4,4,11,Loyal Users
96131,836,9,14,2,2,1,5,Lost
96150,8,97,192,5,5,5,15,Champions
96335,1229,25,127,2,4,4,10,At Risk
96373,223,143,504,3,5,5,13,Loyal Users
96794,2554,6,10,1,1,1,3,Lost
96925,671,19,25,2,3,2,7,Casual Users
97099,1696,5,5,1,1,1,3,Lost
97137,20,59,278,5,5,5,15,Champions
97349,26,27,98,5,4,4,13,Champions
97443,1169,22,67,2,4,4,10,At Risk
97506,424,17,73,3,3,4,10,Loyal Users
97549,171,45,205,3,4,5,12,Loyal Users
97755,945,6,28,2,1,2,5,Lost
98120,4,38,105,5,4,4,13,Champions
98587,761,9,83,2,2,4,8,Lost
98605,137,67,127,4,5,4,13,Champions
98940,1544,6,8,1,1,1,3,Lost
99347,266,12,28,3,3,2,8,Loyal Users
99437,731,5,12,2,1,1,4,Lost
99648,126,16,55,4,3,3,10,Loyal Users
91525,3284,6,15,1,1,1,3,Lost
91672,440,7,9,3,2,1,6,Casual Users
92403,3063,7,23,1,2,2,5,Lost
92575,149,6,12,4,1,1,6,Promising
92753,119,33,103,4,4,4,12,Champions
92951,131,20,152,4,3,5,12,Loyal Users
93433,74,5,10,4,1,1,6,Promising
93462,257,5,13,3,1,1,5,Casual Users
93544,308,37,160,3,4,5,12,Loyal Users
93652,91,35,45,4,4,3,11,Loyal Users
93781,310,8,20,3,2,2,7,Casual Users
93965,52,18,47,5,3,3,11,Loyal Users
94069,721,15,117,2,3,4,9,Casual Users
94538,574,7,10,2,2,1,5,Lost
94557,3906,6,9,1,1,1,3,Lost
94708,313,16,86,3,3,4,10,Loyal Users
94940,25,54,255,5,5,5,15,Champions
95330,1,143,634,5,5,5,15,Champions
95537,4739,7,10,1,2,1,4,Lost
95614,141,57,167,4,5,5,14,Champions
95730,270,21,161,3,3,5,11,Loyal Users
95808,104,5,16,4,1,2,7,Promising
95835,131,32,58,4,4,3,11,Loyal Users
95867,44,71,112,5,5,4,14,Champions
95869,594,13,14,2,3,1,6,Casual Users
96445,364,65,326,3,5,5,13,Loyal Users
96527,4,72,146,5,5,4,14,Champions
96598,1107,5,25,2,1,2,5,Lost
96637,117,20,46,4,3,3,10,Loyal Users
96641,129,97,486,4,5,5,14,Champions
97110,200,32,47,3,4,3,10,Loyal Users
97331,245,38,58,3,4,3,10,Loyal Users
97640,92,9,19,4,2,2,8,Promising
97741,0,61,166,5,5,5,15,Champions
98546,235,23,69,3,4,4,11,Loyal Users
99561,74,46,73,4,5,4,13,Champions
99984,1884,6,6,1,1,1,3,Lost
91118,537,6,35,2,1,3,6,Lost
91493,80,18,111,4,3,4,11,Loyal Users
91702,1829,14,54,1,3,3,7,Casual Users
91951,169,28,80,3,4,4,11,Loyal Users
91966,1756,6,25,1,1,2,4,Lost
91998,364,7,9,3,2,1,6,Casual Users
92023,413,12,15,3,3,1,7,Loyal Users
92136,1146,12,16,2,3,2,7,Casual Users
92279,35,67,226,5,5,5,15,Champions
92597,149,37,110,4,4,4,12,Champions
92688,1144,9,22,2,2,2,6,Lost
92750,1709,9,13,1,2,1,4,Lost
92798,2121,5,9,1,1,1,3,Lost
93167,0,8,51,5,2,3,10,Promising
93638,68,24,148,5,4,5,14,Champions
93828,44,34,124,5,4,4,13,Champions
94032,276,14,43,3,3,3,9,Loyal Users
94830,65,71,241,5,5,5,15,Champions
94975,86,16,123,4,3,4,11,Loyal Users
95382,17,104,247,5,5,5,15,Champions
95562,1823,31,92,1,4,4,9,At Risk
95762,267,25,44,3,4,3,10,Loyal Users
96074,116,12,48,4,3,3,10,Loyal Users
96414,1147,11,20,2,2,2,6,Lost
96881,117,36,132,4,4,4,12,Champions
96948,168,35,70,3,4,4,11,Loyal Users
97150,92,31,135,4,4,4,12,Champions
97169,235,10,35,3,2,3,8,Casual Users
97222,201,22,41,3,4,3,10,Loyal Users
97625,15,137,690,5,5,5,15,Champions
97999,1576,15,100,1,3,4,8,Casual Users
98316,72,130,535,4,5,5,14,Champions
98356,735,44,97,2,4,4,10,At Risk
98609,831,7,7,2,2,1,5,Lost
98984,42,29,43,5,4,3,12,Loyal Users
99059,2862,6,26,1,1,2,4,Lost
99083,663,65,280,2,5,5,12,At Risk
99518,131,67,245,4,5,5,14,Champions
99683,22,202,358,5,5,5,15,Champions
99759,116,73,118,4,5,4,13,Champions
99818,3,38,85,5,4,4,13,Champions
91117,713,7,16,2,2,2,6,Lost
91193,68,70,167,5,5,5,15,Champions
91295,725,6,24,2,1,2,5,Lost
91322,163,45,457,4,4,5,13,Champions
91332,112,75,251,4,5,5,14,Champions
91911,115,9,10,4,2,1,7,Promising
92365,65,69,136,5,5,4,14,Champions
92628,88,6,6,4,1,1,6,Promising
92732,24,78,284,5,5,5,15,Champions
92948,69,7,7,5,2,1,8,Promising
92999,136,8,10,4,2,1,7,Promising
93061,689,5,9,2,1,1,4,Lost
93089,89,111,538,4,5,5,14,Champions
93845,423,6,6,3,1,1,5,Casual Users
93998,1682,7,11,1,2,1,4,Lost
94015,70,39,186,4,4,5,13,Champions
94133,110,103,364,4,5,5,14,Champions
94409,1070,15,29,2,3,2,7,Casual Users
94707,1311,9,28,1,2,2,5,Lost
94861,429,7,11,3,2,1,6,Casual Users
95059,4746,6,33,1,1,3,5,Lost
95201,1990,8,15,1,2,1,4,Lost
95260,585,65,119,2,5,4,11,At Risk
95383,4117,9,16,1,2,2,5,Lost
95483,43,40,77,5,4,4,13,Champions
95908,383,6,19,3,1,2,6,Casual Users
95953,76,12,17,4,3,2,9,Loyal Users
96140,313,16,53,3,3,3,9,Loyal Users
96195,934,37,104,2,4,4,10,At Risk
96645,1376,17,21,1,3,2,6,Casual Users
96715,1637,6,8,1,1,1,3,Lost
96776,712,33,116,2,4,4,10,At Risk
97059,822,19,84,2,3,4,9,Casual Users
97067,124,8,28,4,2,2,8,Promising
97068,853,10,13,2,2,1,5,Lost
97690,9,44,206,5,4,5,14,Champions
97865,90,22,69,4,4,4,12,Champions
97904,1056,12,54,2,3,3,8,Casual Users
98242,0,141,865,5,5,5,15,Champions
98851,981,5,8,2,1,1,4,Lost
98899,1305,11,19,1,2,2,5,Lost
99093,567,54,125,2,5,4,11,At Risk
99230,296,28,50,3,4,3,10,Loyal Users
99529,3126,6,27,1,1,2,4,Lost
99534,102,19,56,4,3,3,10,Loyal Users
99985,48,59,232,5,5,5,15,Champions
91227,16,9,16,5,2,2,9,Promising
91317,21,78,227,5,5,5,15,Champions
91658,143,11,23,4,2,2,8,Promising
91669,124,97,272,4,5,5,14,Champions
92006,3873,26,52,1,4,3,8,At Risk
92226,49,10,23,5,2,2,9,Promising
92320,402,10,12,3,2,1,6,Casual Users
92527,572,8,9,2,2,1,5,Lost
92757,34,46,250,5,5,5,15,Champions
92765,28,170,316,5,5,5,15,Champions
92950,1,6,14,5,1,1,7,Promising
93005,33,41,137,5,4,4,13,Champions
93183,87,13,65,4,3,4,11,Loyal Users
93331,573,13,35,2,3,3,8,Casual Users
93378,518,8,39,2,2,3,7,Lost
93844,4095,9,16,1,2,2,5,Lost
94019,1,72,140,5,5,4,14,Champions
94029,151,58,72,4,5,4,13,Champions
94067,69,66,197,5,5,5,15,Champions
94157,35,8,10,5,2,1,8,Promising
94256,146,15,24,4,3,2,9,Loyal Users
94271,824,6,11,2,1,1,4,Lost
94273,2653,5,5,1,1,1,3,Lost
94419,836,6,9,2,1,1,4,Lost
94498,609,6,11,2,1,1,4,Lost
95170,19,13,17,5,3,2,10,Loyal Users
95301,130,17,22,4,3,2,9,Loyal Users
95323,846,10,22,2,2,2,6,Lost
95673,4008,11,11,1,2,1,4,Lost
95731,1508,40,214,1,4,5,10,At Risk
95849,109,11,29,4,2,2,8,Promising
96494,297,17,48,3,3,3,9,Loyal Users
96685,94,11,56,4,2,3,9,Promising
96810,1366,7,14,1,2,1,4,Lost
97351,427,65,86,3,5,4,12,Loyal Users
97482,70,12,20,4,3,2,9,Loyal Users
97637,22,61,183,5,5,5,15,Champions
97714,363,32,56,3,4,3,10,Loyal Users
97829,130,31,144,4,4,4,12,Champions
98889,277,11,29,3,2,2,7,Casual Users
99256,2105,10,22,1,2,2,5,Lost
99307,969,11,23,2,2,2,6,Lost
99422,119,11,37,4,2,3,9,Promising
99424,325,20,43,3,3,3,9,Loyal Users
99492,3120,5,19,1,1,2,4,Lost
99544,2991,5,6,1,1,1,3,Lost
99604,331,19,81,3,3,4,10,Loyal Users
99716,127,45,95,4,4,4,12,Champions
99860,68,30,35,5,4,3,12,Loyal Users
99889,144,31,110,4,4,4,12,Champions
99962,16,14,38,5,3,3,11,Loyal Users
91800,128,111,302,4,5,5,14,Champions
91943,104,38,69,4,4,4,12,Champions
92115,114,103,262,4,5,5,14,Champions
92254,98,54,123,4,5,4,13,Champions
92384,101,55,82,4,5,4,13,Champions
92389,835,58,333,2,5,5,12,At Risk
92426,12,7,53,5,2,3,10,Promising
92505,12,42,109,5,4,4,13,Champions
92808,3901,16,46,1,3,3,7,Casual Users
92964,2071,9,15,1,2,1,4,Lost
93010,283,18,99,3,3,4,10,Loyal Users
93226,38,12,19,5,3,2,10,Loyal Users
93329,151,7,8,4,2,1,7,Promising
93761,406,17,29,3,3,2,8,Loyal Users
93843,1,10,32,5,2,3,10,Promising
93985,226,11,62,3,2,3,8,Casual Users
95203,27,87,192,5,5,5,15,Champions
95221,12,152,804,5,5,5,15,Champions
95429,424,19,59,3,3,3,9,Loyal Users
95679,19,35,138,5,4,4,13,Champions
95782,12,13,48,5,3,3,11,Loyal Users
95868,694,54,131,2,5,4,11,At Risk
96242,1557,16,134,1,3,4,8,Casual Users
96477,1638,5,6,1,1,1,3,Lost
96522,970,6,11,2,1,1,4,Lost
96560,145,61,221,4,5,5,14,Champions
96692,125,5,9,4,1,1,6,Promising
96878,234,30,111,3,4,4,11,Loyal Users
96970,793,6,13,2,1,1,4,Lost
97244,884,11,37,2,2,3,7,Lost
97565,657,15,101,2,3,4,9,Casual Users
97571,101,13,20,4,3,2,9,Loyal Users
97612,1654,19,37,1,3,3,7,Casual Users
97797,88,14,22,4,3,2,9,Loyal Users
97954,2264,8,50,1,2,3,6,Lost
98050,7,12,31,5,3,2,10,Loyal Users
98249,488,41,189,2,4,5,11,At Risk
98545,115,116,217,4,5,5,14,Champions
98618,26,75,229,5,5,5,15,Champions
99408,1531,5,14,1,1,1,3,Lost
99420,10,94,212,5,5,5,15,Champions
99427,87,11,29,4,2,2,8,Promising
99598,557,6,28,2,1,2,5,Lost
99606,1556,39,96,1,4,4,9,At Risk
99800,1561,16,76,1,3,4,8,Casual Users
91101,270,46,118,3,5,4,12,Loyal Users
91373,4866,10,17,1,2,2,5,Lost
91378,1649,6,32,1,1,3,5,Lost
91433,3379,6,19,1,1,2,4,Lost
91622,159,11,19,4,2,2,8,Promising
91751,1171,7,13,2,2,1,5,Lost
92107,4294,12,33,1,3,3,7,Casual Users
92268,41,130,454,5,5,5,15,Champions
92515,221,32,63,3,4,4,11,Loyal Users
92749,75,14,56,4,3,3,10,Loyal Users
93076,7,79,486,5,5,5,15,Champions
93243,68,7,15,5,2,1,8,Promising
93532,1019,60,91,2,5,4,11,At Risk
93567,238,15,23,3,3,2,8,Loyal Users
93677,23,83,163,5,5,5,15,Champions
93785,446,30,118,3,4,4,11,Loyal Users
93917,156,8,14,4,2,1,7,Promising
94084,2,28,203,5,4,5,14,Champions
94489,3474,5,17,1,1,2,4,Lost
94893,670,10,34,2,2,3,7,Lost
95163,586,22,55,2,4,3,9,At Risk
95644,70,97,572,4,5,5,14,Champions
95845,917,12,21,2,3,2,7,Casual Users
96159,996,8,19,2,2,2,6,Lost
96611,433,38,66,3,4,4,11,Loyal Users
96771,573,5,11,2,1,1,4,Lost
97010,1631,12,14,1,3,1,5,Casual Users
97071,156,24,48,4,4,3,11,Loyal Users
97460,158,37,70,4,4,4,12,Champions
97933,395,15,27,3,3,2,8,Loyal Users
97975,569,11,14,2,2,1,5,Lost
98596,760,9,22,2,2,2,6,Lost
98656,154,19,125,4,3,4,11,Loyal Users
98714,245,31,65,3,4,4,11,Loyal Users
98733,317,20,34,3,3,3,9,Loyal Users
98847,990,17,74,2,3,4,9,Casual Users
98872,1533,15,25,1,3,2,6,Casual Users
98886,545,6,56,2,1,3,6,Lost
98942,301,17,34,3,3,3,9,Loyal Users
98977,87,29,63,4,4,4,12,Champions
99181,13,30,43,5,4,3,12,Loyal Users
99377,1467,10,97,1,2,4,7,Lost
99499,510,5,32,2,1,3,6,Lost
99735,1303,9,12,1,2,1,4,Lost
99994,75,41,102,4,4,4,12,Champions
91139,943,40,300,2,4,5,11,At Risk
91217,1465,20,222,1,3,5,9,Casual Users
91235,257,17,33,3,3,3,9,Loyal Users
91623,1574,21,47,1,3,3,7,Casual Users
91719,120,5,15,4,1,1,6,Promising
92161,1385,10,20,1,2,2,5,Lost
92206,4397,5,38,1,1,3,5,Lost
92263,29,93,163,5,5,5,15,Champions
92347,85,66,158,4,5,5,14,Champions
92604,1561,8,14,1,2,1,4,Lost
92735,33,117,259,5,5,5,15,Champions
92773,16,44,96,5,4,4,13,Champions
92782,163,44,231,4,4,5,13,Champions
92983,215,18,26,3,3,2,8,Loyal Users
93021,3456,6,14,1,1,1,3,Lost
93069,827,13,16,2,3,2,7,Casual Users
93178,3985,12,13,1,3,1,5,Casual Users
93398,294,12,22,3,3,2,8,Loyal Users
93522,505,20,46,2,3,3,8,Casual Users
93594,22,38,112,5,4,4,13,Champions
93858,49,16,49,5,3,3,11,Loyal Users
94351,2364,6,9,1,1,1,3,Lost
94553,1879,5,34,1,1,3,5,Lost
94637,390,11,30,3,2,2,7,Casual Users
94676,53,29,61,5,4,3,12,Loyal Users
94913,133,45,275,4,4,5,13,Champions
95246,144,21,58,4,3,3,10,Loyal Users
95524,0,119,274,5,5,5,15,Champions
95592,293,6,6,3,1,1,5,Casual Users
96406,524,5,7,2,1,1,4,Lost
96422,3007,6,7,1,1,1,3,Lost
96487,214,53,123,3,5,4,12,Loyal Users
96507,4,62,80,5,5,4,14,Champions
96742,3434,27,27,1,4,2,7,At Risk
96854,88,93,317,4,5,5,14,Champions
97165,1590,10,10,1,2,1,4,Lost
97330,13,53,120,5,5,4,14,Champions
97756,210,41,338,3,4,5,12,Loyal Users
97762,569,9,20,2,2,2,6,Lost
98034,1714,5,5,1,1,1,3,Lost
98095,23,61,109,5,5,4,14,Champions
98380,96,32,79,4,4,4,12,Champions
98930,71,47,134,4,5,4,13,Champions
98946,243,36,76,3,4,4,11,Loyal Users
99243,506,14,39,2,3,3,8,Casual Users
99545,2413,7,8,1,2,1,4,Lost
91272,108,9,34,4,2,3,9,Promising
91333,3878,6,8,1,1,1,3,Lost
91447,415,5,30,3,1,2,6,Casual Users
91448,5287,9,9,1,2,1,4,Lost
91736,215,23,120,3,4,4,11,Loyal Users
91836,7,37,286,5,4,5,14,Champions
91920,53,17,24,5,3,2,10,Loyal Users
92241,74,16,40,4,3,3,10,Loyal Users
92327,66,63,394,5,5,5,15,Champions
92558,12,123,363,5,5,5,15,Champions
92825,1015,35,71,2,4,4,10,At Risk
92986,2424,11,22,1,2,2,5,Lost
92987,24,24,54,5,4,3,12,Loyal Users
94532,582,19,67,2,3,4,9,Casual Users
94882,269,58,380,3,5,5,13,Loyal Users
94929,166,13,36,3,3,3,9,Loyal Users
95247,670,6,26,2,1,2,5,Lost
95511,49,70,111,5,5,4,14,Champions
95635,11,98,365,5,5,5,15,Champions
95681,1701,7,7,1,2,1,4,Lost
96046,573,7,21,2,2,2,6,Lost
96177,5,82,544,5,5,5,15,Champions
96213,2,78,110,5,5,4,14,Champions
96218,417,5,7,3,1,1,5,Casual Users
96470,385,12,19,3,3,2,8,Loyal Users
96629,1146,61,213,2,5,5,12,At Risk
96760,3161,12,28,1,3,2,6,Casual Users
96910,24,64,90,5,5,4,14,Champions
96935,265,241,565,3,5,5,13,Loyal Users
96992,1434,8,16,1,2,2,5,Lost
97061,78,46,92,4,5,4,13,Champions
97157,163,6,12,4,1,1,6,Promising
97192,8,179,352,5,5,5,15,Champions
97501,200,74,109,3,5,4,12,Loyal Users
97545,36,23,69,5,4,4,13,Champions
97561,16,9,37,5,2,3,10,Promising
97581,30,27,44,5,4,3,12,Loyal Users
97641,0,119,708,5,5,5,15,Champions
97658,3555,7,19,1,2,2,5,Lost
97692,485,19,167,2,3,5,10,Casual Users
97735,646,31,70,2,4,4,10,At Risk
97785,158,33,42,4,4,3,11,Loyal Users
98055,609,9,46,2,2,3,7,Lost
98288,931,15,19,2,3,2,7,Casual Users
98687,582,6,6,2,1,1,4,Lost
98798,232,26,103,3,4,4,11,Loyal Users
99005,156,10,37,4,2,3,9,Promising
99011,829,17,103,2,3,4,9,Casual Users
99268,292,5,11,3,1,1,5,Casual Users
99367,164,10,26,4,2,2,8,Promising
99844,696,40,44,2,4,3,9,At Risk
99960,2605,6,7,1,1,1,3,Lost
91085,829,6,8,2,1,1,4,Lost
91086,246,110,254,3,5,5,13,Loyal Users
91144,434,5,12,3,1,1,5,Casual Users
91225,4,64,248,5,5,5,15,Champions
91960,688,27,181,2,4,5,11,At Risk
92012,129,35,107,4,4,4,12,Champions
92138,438,22,24,3,4,2,9,Loyal Users
92421,9,42,128,5,4,4,13,Champions
92523,404,58,109,3,5,4,12,Loyal Users
92673,671,7,14,2,2,1,5,Lost
92972,267,6,21,3,1,2,6,Casual Users
92995,128,69,151,4,5,5,14,Champions
93225,2794,5,9,1,1,1,3,Lost
93351,1668,41,69,1,4,4,9,At Risk
93368,23,13,33,5,3,3,11,Loyal Users
93717,10,93,365,5,5,5,15,Champions
93980,539,14,21,2,3,2,7,Casual Users
94357,155,9,11,4,2,1,7,Promising
94791,275,15,41,3,3,3,9,Loyal Users
94879,2193,5,6,1,1,1,3,Lost
94953,338,14,161,3,3,5,11,Loyal Users
95052,25,14,128,5,3,4,12,Loyal Users
95278,130,11,15,4,2,1,7,Promising
95378,80,30,113,4,4,4,12,Champions
95407,824,6,28,2,1,2,5,Lost
95923,211,16,33,3,3,3,9,Loyal Users
96273,2273,9,35,1,2,3,6,Lost
96282,26,75,307,5,5,5,15,Champions
96447,2700,5,8,1,1,1,3,Lost
96651,224,71,136,3,5,4,12,Loyal Users
96656,424,19,34,3,3,3,9,Loyal Users
96905,462,9,26,3,2,2,7,Casual Users
97050,93,113,263,4,5,5,14,Champions
97140,155,44,217,4,4,5,13,Champions
97427,2339,8,21,1,2,2,5,Lost
97674,485,8,10,2,2,1,5,Lost
97678,545,5,8,2,1,1,4,Lost
97917,1072,7,16,2,2,2,6,Lost
98013,6,59,83,5,5,4,14,Champions
98205,2836,7,32,1,2,3,6,Lost
98274,540,10,13,2,2,1,5,Lost
98388,1509,10,10,1,2,1,4,Lost
98485,653,7,19,2,2,2,6,Lost
98540,19,28,95,5,4,4,13,Champions
98638,1221,110,307,2,5,5,12,At Risk
98742,571,11,25,2,2,2,6,Lost
98801,262,18,70,3,3,4,10,Loyal Users
98910,548,30,75,2,4,4,10,At Risk
98948,283,7,16,3,2,2,7,Casual Users
99340,7,113,339,5,5,5,15,Champions
99692,4,100,262,5,5,5,15,Champions
99880,27,38,173,5,4,5,14,Champions
99910,1270,6,11,1,1,1,3,Lost
91245,4021,7,9,1,2,1,4,Lost
91455,119,86,298,4,5,5,14,Champions
91637,136,18,64,4,3,4,11,Loyal Users
92543,1033,18,60,2,3,3,8,Casual Users
92595,7,58,336,5,5,5,15,Champions
92605,313,48,76,3,5,4,12,Loyal Users
92642,2238,15,23,1,3,2,6,Casual Users
92702,946,8,18,2,2,2,6,Lost
93266,130,97,232,4,5,5,14,Champions
93386,1213,5,25,2,1,2,5,Lost
93393,20,19,25,5,3,2,10,Loyal Users
93907,1840,10,19,1,2,2,5,Lost
93952,91,22,39,4,4,3,11,Loyal Users
94648,1101,10,31,2,2,2,6,Lost
96251,2547,10,25,1,2,2,5,Lost
96255,12,97,360,5,5,5,15,Champions
96349,74,41,264,4,4,5,13,Champions
96383,32,110,590,5,5,5,15,Champions
96835,138,7,16,4,2,2,8,Promising
97185,2650,6,25,1,1,2,4,Lost
97240,2167,5,5,1,1,1,3,Lost
97857,179,21,23,3,3,2,8,Loyal Users
98370,2199,5,8,1,1,1,3,Lost
98528,31,10,12,5,2,1,8,Promising
98593,669,9,33,2,2,3,7,Lost
98905,3,82,368,5,5,5,15,Champions
99104,1197,12,68,2,3,4,9,Casual Users
99120,1500,14,27,1,3,2,6,Casual Users
99246,110,24,75,4,4,4,12,Champions
99284,1284,10,32,1,2,3,6,Lost
99469,1744,5,17,1,1,2,4,Lost
91210,57,22,191,5,4,5,14,Champions
91236,33,20,79,5,3,4,12,Loyal Users
91673,1990,9,18,1,2,2,5,Lost
91769,176,23,65,3,4,4,11,Loyal Users
92085,4191,44,336,1,4,5,10,At Risk
92126,2,32,176,5,4,5,14,Champions
92130,890,25,71,2,4,4,10,At Risk
92262,133,17,28,4,3,2,9,Loyal Users
92755,1804,19,21,1,3,2,6,Casual Users
92795,42,121,151,5,5,5,15,Champions
92933,1139,7,29,2,2,2,6,Lost
93164,18,36,123,5,4,4,13,Champions
93283,597,35,61,2,4,3,9,At Risk
93589,84,5,6,4,1,1,6,Promising
93725,405,9,74,3,2,4,9,Casual Users
93744,252,22,45,3,4,3,10,Loyal Users
94218,138,37,63,4,4,4,12,Champions
94761,157,22,33,4,4,3,11,Loyal Users
96022,96,78,229,4,5,5,14,Champions
96093,83,13,19,4,3,2,9,Loyal Users
96260,1,46,171,5,5,5,15,Champions
96485,12,91,193,5,5,5,15,Champions
96963,273,14,123,3,3,4,10,Loyal Users
97022,44,73,119,5,5,4,14,Champions
97205,844,5,12,2,1,1,4,Lost
97217,1156,28,64,2,4,4,10,At Risk
97378,66,52,378,5,5,5,15,Champions
97401,37,29,47,5,4,3,12,Loyal Users
97559,142,24,37,4,4,3,11,Loyal Users
97768,7,253,466,5,5,5,15,Champions
97779,131,35,64,4,4,4,12,Champions
97916,17,203,338,5,5,5,15,Champions
98319,2,98,710,5,5,5,15,Champions
98371,246,14,30,3,3,2,8,Loyal Users
99387,538,34,93,2,4,4,10,At Risk
99893,174,37,87,3,4,4,11,Loyal Users
99941,57,48,153,5,5,5,15,Champions
91106,92,102,269,4,5,5,14,Champions
91908,326,29,117,3,4,4,11,Loyal Users
91909,2766,5,5,1,1,1,3,Lost
92003,322,11,22,3,2,2,7,Casual Users
92018,3294,51,179,1,5,5,11,At Risk
92110,2414,8,13,1,2,1,4,Lost
92881,17,170,288,5,5,5,15,Champions
93255,118,62,302,4,5,5,14,Champions
93683,432,48,187,3,5,5,13,Loyal Users
93703,258,68,184,3,5,5,13,Loyal Users
93803,215,11,47,3,2,3,8,Casual Users
93834,250,8,10,3,2,1,6,Casual Users
94360,612,26,74,2,4,4,10,At Risk
94410,52,42,79,5,4,4,13,Champions
94530,2184,33,77,1,4,4,9,At Risk
95211,5,20,56,5,3,3,11,Loyal Users
95274,2678,8,10,1,2,1,4,Lost
95522,20,39,121,5,4,4,13,Champions
95541,3082,5,15,1,1,1,3,Lost
96602,1702,6,7,1,1,1,3,Lost
96943,16,8,45,5,2,3,10,Promising
97406,405,57,88,3,5,4,12,Loyal Users
97516,1407,5,7,1,1,1,3,Lost
97532,526,11,15,2,2,1,5,Lost
97591,557,10,14,2,2,1,5,Lost
97740,382,6,26,3,1,2,6,Casual Users
97841,232,7,20,3,2,2,7,Casual Users
98162,88,17,18,4,3,2,9,Loyal Users
98175,867,11,22,2,2,2,6,Lost
98429,563,17,24,2,3,2,7,Casual Users
98604,15,165,784,5,5,5,15,Champions
98795,415,9,20,3,2,2,7,Casual Users
99012,532,50,89,2,5,4,11,At Risk
99048,101,42,203,4,4,5,13,Champions
99139,89,64,104,4,5,4,13,Champions
99382,283,22,96,3,4,4,11,Loyal Users
99668,5313,6,17,1,1,2,4,Lost
99934,304,42,318,3,4,5,12,Loyal Users
91436,1412,7,10,1,2,1,4,Lost
91472,9,19,61,5,3,3,11,Loyal Users
91504,3514,11,38,1,2,3,6,Lost
91528,242,13,47,3,3,3,9,Loyal Users
91631,43,37,43,5,4,3,12,Loyal Users
91691,421,26,64,3,4,4,11,Loyal Users
92000,76,66,190,4,5,5,14,Champions
92761,1807,24,156,1,4,5,10,At Risk
92769,1970,6,30,1,1,2,4,Lost
92908,1149,7,24,2,2,2,6,Lost
93071,4587,7,7,1,2,1,4,Lost
93172,890,84,217,2,5,5,12,At Risk
93609,49,48,86,5,5,4,14,Champions
93671,128,44,176,4,4,5,13,Champions
93888,136,33,72,4,4,4,12,Champions
94046,273,21,50,3,3,3,9,Loyal Users
94373,340,9,159,3,2,5,10,Casual Users
94795,844,176,559,2,5,5,12,At Risk
94906,277,37,267,3,4,5,12,Loyal Users
95358,2515,5,21,1,1,2,4,Lost
95373,1708,6,21,1,1,2,4,Lost
95486,3404,7,9,1,2,1,4,Lost
95530,314,9,31,3,2,2,7,Casual Users
95951,270,19,69,3,3,4,10,Loyal Users
96205,2724,13,24,1,3,2,6,Casual Users
96221,419,8,18,3,2,2,7,Casual Users
96409,36,84,300,5,5,5,15,Champions
97000,71,50,134,4,5,4,13,Champions
97241,411,13,47,3,3,3,9,Loyal Users
97248,3111,6,10,1,1,1,3,Lost
97344,37,66,335,5,5,5,15,Champions
97377,92,161,276,4,5,5,14,Champions
97902,103,15,58,4,3,3,10,Loyal Users
97940,497,5,6,2,1,1,4,Lost
97945,122,34,126,4,4,4,12,Champions
98305,315,15,70,3,3,4,10,Loyal Users
98329,265,16,26,3,3,2,8,Loyal Users
98442,103,65,92,4,5,4,13,Champions
98453,10,13,16,5,3,2,10,Loyal Users
98683,818,19,48,2,3,3,8,Casual Users
98694,66,5,9,5,1,1,7,Promising
98842,19,44,100,5,4,4,13,Champions
98869,3889,6,9,1,1,1,3,Lost
98937,334,63,167,3,5,5,13,Loyal Users
98957,36,24,33,5,4,3,12,Loyal Users
99265,2134,27,41,1,4,3,8,At Risk
99337,3421,10,70,1,2,4,7,Lost
99704,25,22,48,5,4,3,12,Loyal Users
99757,129,103,166,4,5,5,14,Champions
99809,1588,9,17,1,2,2,5,Lost
99823,65,136,375,5,5,5,15,Champions
91430,366,149,577,3,5,5,13,Loyal Users
91950,189,7,53,3,2,3,8,Casual Users
92082,94,15,155,4,3,5,12,Loyal Users
92147,227,17,24,3,3,2,8,Loyal Users
92178,2021,8,14,1,2,1,4,Lost
92238,955,30,172,2,4,5,11,At Risk
92464,560,9,57,2,2,3,7,Lost
92766,261,43,144,3,4,4,11,Loyal Users
92860,363,10,21,3,2,2,7,Casual Users
93412,377,11,28,3,2,2,7,Casual Users
93443,1575,16,35,1,3,3,7,Casual Users
93465,2,68,120,5,5,4,14,Champions
94264,417,9,22,3,2,2,7,Casual Users
94536,2293,8,17,1,2,2,5,Lost
94987,132,39,136,4,4,4,12,Champions
95197,424,14,52,3,3,3,9,Loyal Users
95371,286,18,46,3,3,3,9,Loyal Users
95402,245,10,45,3,2,3,8,Casual Users
95597,126,80,128,4,5,4,13,Champions
95866,118,40,186,4,4,5,13,Champions
95973,160,13,19,4,3,2,9,Loyal Users
96068,398,16,32,3,3,3,9,Loyal Users
96268,391,10,35,3,2,3,8,Casual Users
97491,87,37,52,4,4,3,11,Loyal Users
97504,2838,15,18,1,3,2,6,Casual Users
97613,251,27,130,3,4,4,11,Loyal Users
97725,278,16,31,3,3,2,8,Loyal Users
97783,397,131,207,3,5,5,13,Loyal Users
97862,2393,6,10,1,1,1,3,Lost
98033,309,29,45,3,4,3,10,Loyal Users
98063,4790,14,35,1,3,3,7,Casual Users
98086,5,29,45,5,4,3,12,Loyal Users
98286,152,23,28,4,4,2,10,Loyal Users
98342,245,19,99,3,3,4,10,Loyal Users
98493,127,18,41,4,3,3,10,Loyal Users
99020,2434,13,62,1,3,3,7,Casual Users
99111,2540,6,6,1,1,1,3,Lost
99174,285,10,33,3,2,3,8,Casual Users
99462,84,57,118,4,5,4,13,Champions
99521,2437,6,8,1,1,1,3,Lost
99776,113,203,914,4,5,5,14,Champions
99903,116,44,93,4,4,4,12,Champions
91285,288,30,96,3,4,4,11,Loyal Users
91463,18,75,266,5,5,5,15,Champions
91569,406,9,139,3,2,4,9,Casual Users
91874,2,138,364,5,5,5,15,Champions
91892,2256,13,55,1,3,3,7,Casual Users
92044,513,21,77,2,3,4,9,Casual Users
92184,102,56,118,4,5,4,13,Champions
92258,558,6,12,2,1,1,4,Lost
92318,1395,8,21,1,2,2,5,Lost
92433,52,37,154,5,4,5,14,Champions
92504,2417,7,9,1,2,1,4,Lost
92639,987,10,35,2,2,3,7,Lost
92787,101,7,9,4,2,1,7,Promising
92792,103,13,67,4,3,4,11,Loyal Users
92809,292,13,76,3,3,4,10,Loyal Users
92851,23,75,485,5,5,5,15,Champions
92913,21,193,1039,5,5,5,15,Champions
93347,4,51,113,5,5,4,14,Champions
93424,844,6,8,2,1,1,4,Lost
93684,9,37,59,5,4,3,12,Loyal Users
93957,16,138,392,5,5,5,15,Champions
94227,438,14,58,3,3,3,9,Loyal Users
94512,1886,6,11,1,1,1,3,Lost
94868,118,5,24,4,1,2,7,Promising
95265,86,116,732,4,5,5,14,Champions
95451,296,12,101,3,3,4,10,Loyal Users
95773,392,14,55,3,3,3,9,Loyal Users
95805,334,6,40,3,1,3,7,Casual Users
96405,2143,6,56,1,1,3,5,Lost
96579,261,32,88,3,4,4,11,Loyal Users
96862,0,125,220,5,5,5,15,Champions
97177,144,35,150,4,4,5,13,Champions
97256,239,71,112,3,5,4,12,Loyal Users
97326,416,9,14,3,2,1,6,Casual Users
97350,6,137,310,5,5,5,15,Champions
97362,1134,20,168,2,3,5,10,Casual Users
97670,82,78,301,4,5,5,14,Champions
97722,200,8,25,3,2,2,7,Casual Users
97928,412,14,21,3,3,2,8,Loyal Users
98038,650,19,56,2,3,3,8,Casual Users
98262,364,40,111,3,4,4,11,Loyal Users
98315,267,25,41,3,4,3,10,Loyal Users
98399,381,15,50,3,3,3,9,Loyal Users
98434,6125,5,5,1,1,1,3,Lost
98785,1283,11,36,1,2,3,6,Lost
99410,1135,11,15,2,2,1,5,Lost
99990,131,25,236,4,4,5,13,Champions
91444,123,6,10,4,1,1,6,Promising
91584,112,54,223,4,5,5,14,Champions
92187,139,40,204,4,4,5,13,Champions
92309,529,12,39,2,3,3,8,Casual Users
92683,1701,8,9,1,2,1,4,Lost
93050,673,48,197,2,5,5,12,At Risk
93097,1256,24,31,2,4,2,8,At Risk
93620,447,24,77,3,4,4,11,Loyal Users
93807,104,9,13,4,2,1,7,Promising
94053,1094,14,24,2,3,2,7,Casual Users
94054,1962,7,19,1,2,2,5,Lost
94056,865,11,12,2,2,1,5,Lost
94118,2957,8,13,1,2,1,4,Lost
94622,276,75,205,3,5,5,13,Loyal Users
94694,424,7,18,3,2,2,7,Casual Users
95436,326,36,59,3,4,3,10,Loyal Users
95503,280,5,5,3,1,1,5,Casual Users
95885,2042,25,184,1,4,5,10,At Risk
96021,1534,7,10,1,2,1,4,Lost
96279,427,16,18,3,3,2,8,Loyal Users
96314,4608,5,21,1,1,2,4,Lost
97657,3851,15,65,1,3,4,8,Casual Users
98327,213,38,85,3,4,4,11,Loyal Users
98428,1879,5,8,1,1,1,3,Lost
98651,164,129,684,4,5,5,14,Champions
99558,68,10,127,5,2,4,11,Promising
91208,400,11,24,3,2,2,7,Casual Users
91258,625,22,31,2,4,2,8,At Risk
91520,292,33,91,3,4,4,11,Loyal Users
91563,29,41,85,5,4,4,13,Champions
92414,84,104,278,4,5,5,14,Champions
92450,2181,13,37,1,3,3,7,Casual Users
92762,115,43,111,4,4,4,12,Champions
93074,24,55,259,5,5,5,15,Champions
94416,138,8,9,4,2,1,7,Promising
94437,3161,5,7,1,1,1,3,Lost
94746,32,8,28,5,2,2,9,Promising
95120,93,58,177,4,5,5,14,Champions
95228,2671,10,25,1,2,2,5,Lost
95328,123,58,343,4,5,5,14,Champions
95686,2685,13,13,1,3,1,5,Casual Users
96329,21,86,290,5,5,5,15,Champions
96450,3226,7,17,1,2,2,5,Lost
96501,261,17,28,3,3,2,8,Loyal Users
96766,22,100,716,5,5,5,15,Champions
96886,33,40,112,5,4,4,13,Champions
96975,226,5,5,3,1,1,5,Casual Users
97160,283,50,91,3,5,4,12,Loyal Users
97329,96,41,97,4,4,4,12,Champions
97524,1569,11,13,1,2,1,4,Lost
97752,413,7,14,3,2,1,6,Casual Users
98196,804,6,23,2,1,2,5,Lost
98225,854,37,175,2,4,5,11,At Risk
98263,7,110,695,5,5,5,15,Champions
98455,272,18,106,3,3,4,10,Loyal Users
98645,105,21,88,4,3,4,11,Loyal Users
98822,101,6,20,4,1,2,7,Promising
99030,102,69,422,4,5,5,14,Champions
99237,95,48,377,4,5,5,14,Champions
99369,330,77,239,3,5,5,13,Loyal Users
99494,1533,16,110,1,3,4,8,Casual Users
99541,136,23,44,4,4,3,11,Loyal Users
99649,2620,7,16,1,2,2,5,Lost
99726,1127,31,51,2,4,3,9,At Risk
99816,47,19,25,5,3,2,10,Loyal Users
99912,131,24,54,4,4,3,11,Loyal Users
91331,6,48,73,5,5,4,14,Champions
92123,773,12,16,2,3,2,7,Casual Users
92410,5,32,78,5,4,4,13,Champions
92826,56,127,349,5,5,5,15,Champions
92884,382,6,69,3,1,4,8,Casual Users
92926,191,35,66,3,4,4,11,Loyal Users
93195,41,61,381,5,5,5,15,Champions
93267,2228,16,60,1,3,3,7,Casual Users
93372,1129,25,65,2,4,4,10,At Risk
93420,882,5,5,2,1,1,4,Lost
93446,453,7,29,3,2,2,7,Casual Users
93586,267,21,50,3,3,3,9,Loyal Users
93755,23,63,504,5,5,5,15,Champions
93825,189,41,113,3,4,4,11,Loyal Users
93902,2012,9,26,1,2,2,5,Lost
94326,1443,7,28,1,2,2,5,Lost
94354,4458,5,10,1,1,1,3,Lost
94453,9,93,328,5,5,5,15,Champions
94467,28,58,121,5,5,4,14,Champions
94592,111,21,73,4,3,4,11,Loyal Users
94612,14,19,42,5,3,3,11,Loyal Users
94946,409,27,44,3,4,3,10,Loyal Users
95029,294,39,86,3,4,4,11,Loyal Users
95168,15,23,208,5,4,5,14,Champions
95213,276,52,93,3,5,4,12,Loyal Users
95347,10,131,270,5,5,5,15,Champions
95646,818,10,26,2,2,2,6,Lost
95744,1565,7,51,1,2,3,6,Lost
96250,22,129,254,5,5,5,15,Champions
96360,129,33,54,4,4,3,11,Loyal Users
96416,3813,5,45,1,1,3,5,Lost
96687,480,5,14,2,1,1,4,Lost
97014,184,15,27,3,3,2,8,Loyal Users
97677,1138,5,15,2,1,1,4,Lost
97938,1711,5,8,1,1,1,3,Lost
98104,7,19,57,5,3,3,11,Loyal Users
98383,16,26,108,5,4,4,13,Champions
98478,1430,5,8,1,1,1,3,Lost
98682,1591,5,6,1,1,1,3,Lost
98861,1414,6,10,1,1,1,3,Lost
99298,1262,10,36,1,2,3,6,Lost
99312,20,21,39,5,3,3,11,Loyal Users
99540,307,8,15,3,2,1,6,Casual Users
99900,59,18,34,5,3,3,11,Loyal Users
91340,90,90,274,4,5,5,14,Champions
91703,325,7,53,3,2,3,8,Casual Users
91850,1080,14,49,2,3,3,8,Casual Users
91945,106,20,56,4,3,3,10,Loyal Users
92666,926,26,78,2,4,4,10,At Risk
92671,673,15,172,2,3,5,10,Casual Users
93177,141,11,12,4,2,1,7,Promising
93180,3384,38,69,1,4,4,9,At Risk
93259,158,49,296,4,5,5,14,Champions
93281,121,13,36,4,3,3,10,Loyal Users
93679,419,16,26,3,3,2,8,Loyal Users
93971,732,23,48,2,4,3,9,At Risk
94208,87,11,17,4,2,2,8,Promising
94537,1614,6,18,1,1,2,4,Lost
94923,96,26,40,4,4,3,11,Loyal Users
95324,412,53,179,3,5,5,13,Loyal Users
95463,830,22,56,2,4,3,9,At Risk
95628,136,13,18,4,3,2,9,Loyal Users
95949,71,45,347,4,4,5,13,Champions
96053,1577,8,17,1,2,2,5,Lost
96350,0,58,234,5,5,5,15,Champions
96418,1294,9,35,1,2,3,6,Lost
96783,439,126,196,3,5,5,13,Loyal Users
96900,115,6,16,4,1,2,7,Promising
97048,1836,5,5,1,1,1,3,Lost
97090,1864,9,33,1,2,3,6,Lost
97193,134,7,49,4,2,3,9,Promising
97901,109,50,77,4,5,4,13,Champions
98040,26,6,10,5,1,1,7,Promising
98054,4175,6,8,1,1,1,3,Lost
98091,424,41,237,3,4,5,12,Loyal Users
98367,449,7,37,3,2,3,8,Casual Users
98508,554,19,67,2,3,4,9,Casual Users
98526,923,7,22,2,2,2,6,Lost
98705,575,19,28,2,3,2,7,Casual Users
98779,256,25,94,3,4,4,11,Loyal Users
98944,433,11,16,3,2,2,7,Casual Users
99065,38,74,255,5,5,5,15,Champions
99115,297,20,25,3,3,2,8,Loyal Users
99596,1727,9,11,1,2,1,4,Lost
99597,148,14,47,4,3,3,10,Loyal Users
99964,94,41,108,4,4,4,12,Champions
91327,1227,38,109,2,4,4,10,At Risk
91981,572,5,7,2,1,1,4,Lost
92020,133,22,55,4,4,3,11,Loyal Users
92383,2135,21,145,1,3,4,8,Casual Users
92466,471,8,12,2,2,1,5,Lost
92677,22,18,46,5,3,3,11,Loyal Users
92791,1692,13,26,1,3,2,6,Casual Users
92819,118,9,14,4,2,1,7,Promising
92824,427,68,157,3,5,5,13,Loyal Users
92955,777,11,79,2,2,4,8,Lost
92996,354,17,119,3,3,4,10,Loyal Users
93111,69,26,324,5,4,5,14,Champions
93290,232,41,79,3,4,4,11,Loyal Users
93525,125,94,144,4,5,4,13,Champions
94093,1530,19,33,1,3,3,7,Casual Users
94430,193,47,84,3,5,4,12,Loyal Users
94461,161,19,61,4,3,3,10,Loyal Users
94992,1116,10,28,2,2,2,6,Lost
95377,5841,5,5,1,1,1,3,Lost
95408,967,8,14,2,2,1,5,Lost
95564,167,12,37,3,3,3,9,Loyal Users
95571,1,47,109,5,5,4,14,Champions
96069,1085,8,11,2,2,1,5,Lost
96179,124,21,28,4,3,2,9,Loyal Users
96581,575,13,34,2,3,3,8,Casual Users
96743,11,11,63,5,2,4,11,Promising
96827,310,19,107,3,3,4,10,Loyal Users
96903,690,15,26,2,3,2,7,Casual Users
96993,1417,7,36,1,2,3,6,Lost
97053,271,56,97,3,5,4,12,Loyal Users
97183,423,6,11,3,1,1,5,Casual Users
97374,417,8,8,3,2,1,6,Casual Users
97556,414,121,273,3,5,5,13,Loyal Users
97574,545,16,65,2,3,4,9,Casual Users
97603,1407,27,50,1,4,3,8,At Risk
97647,287,68,401,3,5,5,13,Loyal Users
97843,729,13,19,2,3,2,7,Casual Users
97854,245,18,54,3,3,3,9,Loyal Users
97905,79,79,365,4,5,5,14,Champions
97960,5284,6,16,1,1,2,4,Lost
97986,734,12,19,2,3,2,7,Casual Users
98614,712,11,25,2,2,2,6,Lost
98667,111,12,18,4,3,2,9,Loyal Users
98792,434,43,280,3,4,5,12,Loyal Users
98799,1536,9,12,1,2,1,4,Lost
99631,65,22,121,5,4,4,13,Champions
99666,284,31,56,3,4,3,10,Loyal Users
99720,3,52,128,5,5,4,14,Champions
99855,2873,10,17,1,2,2,5,Lost
91120,182,9,16,3,2,2,7,Casual Users
91431,551,17,103,2,3,4,9,Casual Users
91629,537,56,141,2,5,4,11,At Risk
91737,86,44,164,4,4,5,13,Champions
91856,3,12,130,5,3,4,12,Loyal Users
91913,125,126,294,4,5,5,14,Champions
91979,592,20,87,2,3,4,9,Casual Users
92181,1078,29,115,2,4,4,10,At Risk
92243,95,5,19,4,1,2,7,Promising
92303,942,8,17,2,2,2,6,Lost
93122,1410,9,21,1,2,2,5,Lost
93248,931,5,24,2,1,2,5,Lost
93797,423,100,201,3,5,5,13,Loyal Users
94189,145,13,18,4,3,2,9,Loyal Users
94368,140,15,30,4,3,2,9,Loyal Users
94783,316,13,42,3,3,3,9,Loyal Users
95088,115,105,306,4,5,5,14,Champions
95186,154,27,74,4,4,4,12,Champions
95240,6,35,74,5,4,4,13,Champions
95341,145,16,25,4,3,2,9,Loyal Users
95360,1265,25,43,1,4,3,8,At Risk
95787,4,59,214,5,5,5,15,Champions
95879,15,46,120,5,5,4,14,Champions
96043,985,84,114,2,5,4,11,At Risk
96180,30,84,253,5,5,5,15,Champions
96631,3,80,362,5,5,5,15,Champions
96895,370,5,28,3,1,2,6,Casual Users
96988,514,9,18,2,2,2,6,Lost
97429,1901,23,39,1,4,3,8,At Risk
97710,2605,5,8,1,1,1,3,Lost
97896,3614,9,56,1,2,3,6,Lost
97898,24,35,152,5,4,5,14,Champions
97998,44,18,62,5,3,3,11,Loyal Users
98070,580,9,53,2,2,3,7,Lost
98121,416,10,10,3,2,1,6,Casual Users
98183,945,5,12,2,1,1,4,Lost
98285,3753,16,16,1,3,2,6,Casual Users
98301,120,38,81,4,4,4,12,Champions
98339,3210,14,39,1,3,3,7,Casual Users
98492,3554,5,48,1,1,3,5,Lost
98607,1560,11,47,1,2,3,6,Lost
98954,2147,14,52,1,3,3,7,Casual Users
98973,25,128,230,5,5,5,15,Champions
99830,702,14,44,2,3,3,8,Casual Users
91369,16,26,214,5,4,5,14,Champions
91371,16,50,106,5,5,4,14,Champions
91676,5893,5,14,1,1,1,3,Lost
91764,2425,5,6,1,1,1,3,Lost
92340,270,78,260,3,5,5,13,Loyal Users
92395,2477,5,8,1,1,1,3,Lost
92400,119,21,64,4,3,4,11,Loyal Users
92453,14,139,483,5,5,5,15,Champions
92541,1690,8,102,1,2,4,7,Lost
92559,419,6,6,3,1,1,5,Casual Users
92822,44,102,321,5,5,5,15,Champions
92897,2680,16,63,1,3,4,8,Casual Users
92985,3727,6,6,1,1,1,3,Lost
93292,142,50,122,4,5,4,13,Champions
93598,761,7,27,2,2,2,6,Lost
93634,59,43,71,5,4,4,13,Champions
93728,449,40,58,3,4,3,10,Loyal Users
93739,128,24,90,4,4,4,12,Champions
93766,232,41,199,3,4,5,12,Loyal Users
94073,424,28,159,3,4,5,12,Loyal Users
94403,6,17,38,5,3,3,11,Loyal Users
94433,38,28,36,5,4,3,12,Loyal Users
94577,19,31,220,5,4,5,14,Champions
94794,382,20,56,3,3,3,9,Loyal Users
94904,1611,13,18,1,3,2,6,Casual Users
95269,230,9,9,3,2,1,6,Casual Users
95406,245,28,55,3,4,3,10,Loyal Users
95576,131,6,7,4,1,1,6,Promising
95699,934,12,28,2,3,2,7,Casual Users
95864,247,95,174,3,5,5,13,Loyal Users
96237,977,12,106,2,3,4,9,Casual Users
96428,15,91,202,5,5,5,15,Champions
96559,111,19,59,4,3,3,10,Loyal Users
96627,2944,6,7,1,1,1,3,Lost
97206,441,49,294,3,5,5,13,Loyal Users
97239,536,11,15,2,2,1,5,Lost
97738,2250,40,101,1,4,4,9,At Risk
97903,30,66,251,5,5,5,15,Champions
97984,9,39,122,5,4,4,13,Champions
98298,398,5,11,3,1,1,5,Casual Users
99109,641,5,15,2,1,1,4,Lost
99123,294,13,13,3,3,1,7,Loyal Users
99191,28,88,323,5,5,5,15,Champions
99259,494,7,15,2,2,1,5,Lost
99453,7,62,170,5,5,5,15,Champions
99554,573,10,24,2,2,2,6,Lost
99711,543,13,43,2,3,3,8,Casual Users
91532,3131,10,52,1,2,3,6,Lost
91534,984,26,196,2,4,5,11,At Risk
91559,129,22,30,4,4,2,10,Loyal Users
91593,172,128,172,3,5,5,13,Loyal Users
91743,366,7,16,3,2,2,7,Casual Users
91837,5,88,370,5,5,5,15,Champions
91899,15,21,69,5,3,4,12,Loyal Users
92040,30,50,277,5,5,5,15,Champions
92118,15,89,220,5,5,5,15,Champions
92119,4269,10,19,1,2,2,5,Lost
92265,278,74,112,3,5,4,12,Loyal Users
92573,116,129,935,4,5,5,14,Champions
93157,15,56,183,5,5,5,15,Champions
93456,103,15,19,4,3,2,9,Loyal Users
93501,83,134,180,4,5,5,14,Champions
93672,3106,36,36,1,4,3,8,At Risk
94210,671,49,141,2,5,4,11,At Risk
94570,1251,13,48,2,3,3,8,Casual Users
94620,1036,9,30,2,2,2,6,Lost
95272,153,6,9,4,1,1,6,Promising
95506,111,45,115,4,4,4,12,Champions
96148,17,83,220,5,5,5,15,Champions
96380,1,33,101,5,4,4,13,Champions
96444,718,9,35,2,2,3,7,Lost
96466,387,20,69,3,3,4,10,Loyal Users
96864,19,71,228,5,5,5,15,Champions
96982,12,167,464,5,5,5,15,Champions
97312,192,40,157,3,4,5,12,Loyal Users
97459,449,7,15,3,2,1,6,Casual Users
98110,132,80,156,4,5,5,14,Champions
98191,11,130,259,5,5,5,15,Champions
98240,884,7,20,2,2,2,6,Lost
98581,2970,7,44,1,2,3,6,Lost
98660,643,18,121,2,3,4,9,Casual Users
98782,106,39,119,4,4,4,12,Champions
98843,106,92,397,4,5,5,14,Champions
98908,549,38,86,2,4,4,10,At Risk
99004,87,41,57,4,4,3,11,Loyal Users
99032,568,6,33,2,1,3,6,Lost
99278,148,22,25,4,4,2,10,Loyal Users
99395,982,6,8,2,1,1,4,Lost
99416,10,92,382,5,5,5,15,Champions
99548,411,27,67,3,4,4,11,Loyal Users
99580,3892,8,10,1,2,1,4,Lost
99680,275,116,287,3,5,5,13,Loyal Users
91349,119,16,35,4,3,3,10,Loyal Users
91411,1427,13,25,1,3,2,6,Casual Users
91842,1991,7,10,1,2,1,4,Lost
91883,738,12,13,2,3,1,6,Casual Users
91898,421,48,53,3,5,3,11,Loyal Users
92016,12,73,149,5,5,5,15,Champions
92088,10,33,139,5,4,4,13,Champions
92131,5118,6,10,1,1,1,3,Lost
92377,165,11,18,4,2,2,8,Promising
92441,119,106,508,4,5,5,14,Champions
92939,272,6,7,3,1,1,5,Casual Users
94089,535,11,18,2,2,2,6,Lost
94169,5280,9,22,1,2,2,5,Lost
94740,72,109,236,4,5,5,14,Champions
94752,27,199,431,5,5,5,15,Champions
94888,102,122,771,4,5,5,14,Champions
95036,176,18,26,3,3,2,8,Loyal Users
95085,1703,5,18,1,1,2,4,Lost
95188,5041,5,5,1,1,1,3,Lost
95505,4443,5,8,1,1,1,3,Lost
95531,846,29,47,2,4,3,9,At Risk
95572,973,5,14,2,1,1,4,Lost
95821,366,14,23,3,3,2,8,Loyal Users
96077,70,80,524,4,5,5,14,Champions
96278,1640,10,43,1,2,3,6,Lost
96489,117,38,187,4,4,5,13,Champions
96545,182,5,17,3,1,2,6,Casual Users
96741,1143,14,48,2,3,3,8,Casual Users
97138,819,9,43,2,2,3,7,Lost
97277,125,23,117,4,4,4,12,Champions
97376,456,11,26,3,2,2,7,Casual Users
97421,469,7,11,3,2,1,6,Casual Users
97654,156,5,10,4,1,1,6,Promising
97728,87,11,19,4,2,2,8,Promising
98140,35,67,110,5,5,4,14,Champions
98269,418,10,84,3,2,4,9,Casual Users
98483,257,52,154,3,5,5,13,Loyal Users
98488,1706,10,17,1,2,2,5,Lost
98556,37,96,524,5,5,5,15,Champions
98988,125,21,29,4,3,2,9,Loyal Users
99084,119,35,242,4,4,5,13,Champions
99829,250,6,39,3,1,3,7,Casual Users
91564,4,17,63,5,3,4,12,Loyal Users
91582,1,66,394,5,5,5,15,Champions
91598,993,31,49,2,4,3,9,At Risk
91809,231,15,57,3,3,3,9,Loyal Users
91870,1906,7,10,1,2,1,4,Lost
91944,8,52,391,5,5,5,15,Champions
92002,417,38,72,3,4,4,11,Loyal Users
92150,26,36,65,5,4,4,13,Champions
92311,956,29,98,2,4,4,10,At Risk
92360,12,38,223,5,4,5,14,Champions
92777,1092,7,11,2,2,1,5,Lost
92871,1508,25,71,1,4,4,9,At Risk
93316,458,6,13,3,1,1,5,Casual Users
93445,927,24,40,2,4,3,9,At Risk
93489,394,7,21,3,2,2,7,Casual Users
93670,2853,5,25,1,1,2,4,Lost
93832,3324,6,17,1,1,2,4,Lost
94186,1731,5,12,1,1,1,3,Lost
95030,110,52,470,4,5,5,14,Champions
95294,5106,10,10,1,2,1,4,Lost
95460,148,5,13,4,1,1,6,Promising
95605,1131,7,10,2,2,1,5,Lost
95609,307,38,49,3,4,3,10,Loyal Users
95629,45,15,26,5,3,2,10,Loyal Users
95631,143,71,163,4,5,5,14,Champions
95851,427,29,53,3,4,3,10,Loyal Users
96436,986,15,24,2,3,2,7,Casual Users
96643,183,28,34,3,4,3,10,Loyal Users
96859,4998,7,22,1,2,2,5,Lost
97136,580,14,35,2,3,3,8,Casual Users
97610,1098,6,16,2,1,2,5,Lost
97851,629,12,24,2,3,2,7,Casual Users
98185,113,6,12,4,1,1,6,Promising
98195,13,12,41,5,3,3,11,Loyal Users
98214,175,20,40,3,3,3,9,Loyal Users
98412,942,42,147,2,4,5,11,At Risk
98818,835,25,70,2,4,4,10,At Risk
98913,271,68,233,3,5,5,13,Loyal Users
99177,3117,5,6,1,1,1,3,Lost
99335,2979,6,7,1,1,1,3,Lost
99805,593,5,5,2,1,1,4,Lost
91074,3,7,9,5,2,1,8,Promising
91134,371,5,8,3,1,1,5,Casual Users
91480,126,26,68,4,4,4,12,Champions
91572,224,60,98,3,5,4,12,Loyal Users
91939,289,11,52,3,2,3,8,Casual Users
92091,2011,6,12,1,1,1,3,Lost
92269,691,66,179,2,5,5,12,At Risk
92626,2048,6,15,1,1,1,3,Lost
92645,46,112,380,5,5,5,15,Champions
93528,613,43,183,2,4,5,11,At Risk
93911,3,22,23,5,4,2,11,Loyal Users
93935,135,25,62,4,4,3,11,Loyal Users
94214,15,53,236,5,5,5,15,Champions
94392,26,100,149,5,5,5,15,Champions
94958,168,6,6,3,1,1,5,Casual Users
95128,838,37,53,2,4,3,9,At Risk
95138,121,29,50,4,4,3,11,Loyal Users
95317,213,25,68,3,4,4,11,Loyal Users
95452,55,77,244,5,5,5,15,Champions
95464,284,6,12,3,1,1,5,Casual Users
95543,301,38,132,3,4,4,11,Loyal Users
95550,1,93,359,5,5,5,15,Champions
95917,429,15,77,3,3,4,10,Loyal Users
95946,80,16,47,4,3,3,10,Loyal Users
96091,13,71,152,5,5,5,15,Champions
96534,1481,8,9,1,2,1,4,Lost
96938,311,6,18,3,1,2,6,Casual Users
96985,1656,5,7,1,1,1,3,Lost
97234,379,19,42,3,3,3,9,Loyal Users
98008,36,5,6,5,1,1,7,Promising
98127,674,5,13,2,1,1,4,Lost
98187,74,35,106,4,4,4,12,Champions
98499,2715,5,11,1,1,1,3,Lost
98684,119,24,53,4,4,3,11,Loyal Users
98762,52,76,129,5,5,4,14,Champions
98923,48,6,24,5,1,2,8,Promising
99219,3344,6,17,1,1,2,4,Lost
99475,27,5,14,5,1,1,7,Promising
99497,122,49,297,4,5,5,14,Champions
99555,1656,13,23,1,3,2,6,Casual Users
99982,152,76,132,4,5,4,13,Champions
91223,37,70,308,5,5,5,15,Champions
91915,16,73,211,5,5,5,15,Champions
91988,3821,5,8,1,1,1,3,Lost
92391,2174,7,25,1,2,2,5,Lost
92423,3520,8,25,1,2,2,5,Lost
92473,25,183,468,5,5,5,15,Champions
93092,1916,5,5,1,1,1,3,Lost
93188,315,29,60,3,4,3,10,Loyal Users
93397,23,48,273,5,5,5,15,Champions
93655,816,24,73,2,4,4,10,At Risk
93850,232,6,17,3,1,2,6,Casual Users
93887,645,45,199,2,4,5,11,At Risk
94130,149,9,14,4,2,1,7,Promising
94382,65,123,830,5,5,5,15,Champions
94663,81,9,63,4,2,4,10,Promising
95292,22,44,205,5,4,5,14,Champions
95405,1902,24,71,1,4,4,9,At Risk
95434,544,9,16,2,2,2,6,Lost
95507,2415,5,20,1,1,2,4,Lost
95742,205,78,169,3,5,5,13,Loyal Users
96005,4668,6,14,1,1,1,3,Lost
96054,405,18,30,3,3,2,8,Loyal Users
96605,1587,5,8,1,1,1,3,Lost
96613,122,6,24,4,1,2,7,Promising
96615,91,11,92,4,2,4,10,Promising
96628,713,6,8,2,1,1,4,Lost
96919,2,79,158,5,5,5,15,Champions
97267,96,33,143,4,4,4,12,Champions
97441,2994,6,12,1,1,1,3,Lost
97602,561,12,19,2,3,2,7,Casual Users
98201,602,19,87,2,3,4,9,Casual Users
98436,108,41,79,4,4,4,12,Champions
98701,73,7,8,4,2,1,7,Promising
98856,862,16,33,2,3,3,8,Casual Users
98888,108,28,82,4,4,4,12,Champions
99145,812,8,9,2,2,1,5,Lost
99429,2114,5,18,1,1,2,4,Lost
99652,984,12,72,2,3,4,9,Casual Users
91201,155,26,147,4,4,5,13,Champions
91341,274,32,89,3,4,4,11,Loyal Users
91394,1731,11,19,1,2,2,5,Lost
91419,4956,5,11,1,1,1,3,Lost
91801,5,86,200,5,5,5,15,Champions
91829,964,101,607,2,5,5,12,At Risk
92064,4427,5,11,1,1,1,3,Lost
92569,1281,11,22,1,2,2,5,Lost
92997,384,52,248,3,5,5,13,Loyal Users
93149,31,20,77,5,3,4,12,Loyal Users
93218,3095,36,257,1,4,5,10,At Risk
93662,264,30,61,3,4,3,10,Loyal Users
93709,13,12,44,5,3,3,11,Loyal Users
93880,0,104,707,5,5,5,15,Champions
94011,411,55,123,3,5,4,12,Loyal Users
95447,4961,84,206,1,5,5,11,At Risk
96002,69,20,91,5,3,4,12,Loyal Users
96041,206,9,15,3,2,1,6,Casual Users
96174,204,33,91,3,4,4,11,Loyal Users
96509,6,24,45,5,4,3,12,Loyal Users
96718,4800,5,23,1,1,2,4,Lost
96784,171,8,11,3,2,1,6,Casual Users
97046,101,27,131,4,4,4,12,Champions
97716,1414,11,66,1,2,4,7,Lost
97863,125,22,160,4,4,5,13,Champions
97974,2284,18,23,1,3,2,6,Casual Users
98105,1313,7,58,1,2,3,6,Lost
98254,422,24,72,3,4,4,11,Loyal Users
98543,95,93,269,4,5,5,14,Champions
98725,1422,9,26,1,2,2,5,Lost
99196,2517,5,16,1,1,2,4,Lost
99525,1234,7,29,2,2,2,6,Lost
99566,1218,14,55,2,3,3,8,Casual Users
99628,52,37,163,5,4,5,14,Champions
99766,339,27,128,3,4,4,11,Loyal Users
99966,176,119,358,3,5,5,13,Loyal Users
91255,1545,31,62,1,4,3,8,At Risk
91262,567,7,19,2,2,2,6,Lost
91354,1174,12,25,2,3,2,7,Casual Users
91422,3,7,7,5,2,1,8,Promising
91707,1268,9,16,1,2,2,5,Lost
91799,878,54,99,2,5,4,11,At Risk
91980,426,47,93,3,5,4,12,Loyal Users
92068,694,33,100,2,4,4,10,At Risk
92492,876,8,17,2,2,2,6,Lost
92651,265,11,64,3,2,4,9,Casual Users
92944,1985,8,37,1,2,3,6,Lost
93271,1296,11,11,1,2,1,4,Lost
93352,125,52,67,4,5,4,13,Champions
93354,842,8,26,2,2,2,6,Lost
93464,710,6,10,2,1,1,4,Lost
93558,272,37,67,3,4,4,11,Loyal Users
93610,128,53,117,4,5,4,13,Champions
93646,11,14,28,5,3,2,10,Loyal Users
93814,1439,7,15,1,2,1,4,Lost
93916,1266,8,19,1,2,2,5,Lost
93961,665,17,30,2,3,2,7,Casual Users
94162,585,30,66,2,4,4,10,At Risk
94324,474,12,23,2,3,2,7,Casual Users
94428,227,80,198,3,5,5,13,Loyal Users
94466,174,87,518,3,5,5,13,Loyal Users
94500,154,36,104,4,4,4,12,Champions
94528,104,19,68,4,3,4,11,Loyal Users
94632,96,39,70,4,4,4,12,Champions
94710,48,107,302,5,5,5,15,Champions
94873,422,7,9,3,2,1,6,Casual Users
94989,283,29,66,3,4,4,11,Loyal Users
95293,716,6,7,2,1,1,4,Lost
95318,4560,9,10,1,2,1,4,Lost
95359,127,81,128,4,5,4,13,Champions
95776,15,31,65,5,4,4,13,Champions
95822,3226,5,12,1,1,1,3,Lost
96385,894,11,14,2,2,1,5,Lost
96505,261,17,38,3,3,3,9,Loyal Users
97097,67,69,601,5,5,5,15,Champions
97104,278,9,17,3,2,2,7,Casual Users
97681,329,5,8,3,1,1,5,Casual Users
97825,1290,11,42,1,2,3,6,Lost
97846,1615,17,40,1,3,3,7,Casual Users
97909,3608,5,11,1,1,1,3,Lost
97934,185,11,23,3,2,2,7,Casual Users
97996,1232,19,35,2,3,3,8,Casual Users
98547,147,16,21,4,3,2,9,Loyal Users
99087,428,46,116,3,5,4,12,Loyal Users
99363,23,68,292,5,5,5,15,Champions
99391,1368,7,7,1,2,1,4,Lost
99400,140,5,10,4,1,1,6,Promising
99414,710,120,189,2,5,5,12,At Risk
99879,1920,24,39,1,4,3,8,At Risk
99953,134,9,22,4,2,2,8,Promising
91091,422,31,80,3,4,4,11,Loyal Users
91184,272,60,286,3,5,5,13,Loyal Users
91211,440,8,33,3,2,3,8,Casual Users
91305,0,36,82,5,4,4,13,Champions
91424,8,30,121,5,4,4,13,Champions
91640,531,11,17,2,2,2,6,Lost
91779,227,8,23,3,2,2,7,Casual Users
91932,567,8,11,2,2,1,5,Lost
91953,2733,6,11,1,1,1,3,Lost
92190,1429,23,27,1,4,2,7,At Risk
92245,264,6,9,3,1,1,5,Casual Users
92344,416,6,10,3,1,1,5,Casual Users
92566,751,12,22,2,3,2,7,Casual Users
92640,66,47,136,5,5,4,14,Champions
93114,862,5,6,2,1,1,4,Lost
93137,666,12,16,2,3,2,7,Casual Users
93138,2284,10,18,1,2,2,5,Lost
93174,3034,5,6,1,1,1,3,Lost
93510,142,66,294,4,5,5,14,Champions
93714,149,65,544,4,5,5,14,Champions
94280,1201,5,8,2,1,1,4,Lost
94591,79,8,14,4,2,1,7,Promising
95037,654,11,14,2,2,1,5,Lost
95114,1267,11,18,1,2,2,5,Lost
95140,102,15,24,4,3,2,9,Loyal Users
95158,833,24,131,2,4,4,10,At Risk
95279,901,9,22,2,2,2,6,Lost
95552,1265,14,18,1,3,2,6,Casual Users
95565,567,30,44,2,4,3,9,At Risk
96328,670,6,9,2,1,1,4,Lost
96523,104,48,194,4,5,5,14,Champions
97258,30,106,339,5,5,5,15,Champions
97262,3239,5,16,1,1,2,4,Lost
97300,219,8,10,3,2,1,6,Casual Users
97371,393,43,84,3,4,4,11,Loyal Users
97471,1402,6,26,1,1,2,4,Lost
97543,101,96,211,4,5,5,14,Champions
97753,688,22,35,2,4,3,9,At Risk
97936,20,52,491,5,5,5,15,Champions
97969,371,41,62,3,4,3,10,Loyal Users
97995,460,16,49,3,3,3,9,Loyal Users
98108,241,25,39,3,4,3,10,Loyal Users
98451,1262,5,9,1,1,1,3,Lost
98510,2085,14,17,1,3,2,6,Casual Users
98580,590,5,8,2,1,1,4,Lost
98699,695,37,63,2,4,4,10,At Risk
98873,68,34,255,5,4,5,14,Champions
99669,1416,5,12,1,1,1,3,Lost
99696,1705,6,11,1,1,1,3,Lost
99936,509,13,33,2,3,3,8,Casual Users
91264,409,14,16,3,3,2,8,Loyal Users
91268,38,157,497,5,5,5,15,Champions
91523,234,20,31,3,3,2,8,Loyal Users
91533,65,105,342,5,5,5,15,Champions
91547,1135,7,13,2,2,1,5,Lost
91568,145,7,60,4,2,3,9,Promising
91627,168,31,91,3,4,4,11,Loyal Users
91887,80,137,451,4,5,5,14,Champions
92509,274,36,67,3,4,4,11,Loyal Users
92739,128,111,621,4,5,5,14,Champions
93614,544,9,42,2,2,3,7,Lost
94345,171,6,7,3,1,1,5,Casual Users
94634,1712,5,14,1,1,1,3,Lost
94713,586,7,18,2,2,2,6,Lost
94785,5599,7,19,1,2,2,5,Lost
94916,839,41,143,2,4,4,10,At Risk
95314,223,12,17,3,3,2,8,Loyal Users
95333,112,107,287,4,5,5,14,Champions
95364,1428,5,31,1,1,2,4,Lost
95984,152,41,125,4,4,4,12,Champions
96084,1002,5,8,2,1,1,4,Lost
96289,187,26,67,3,4,4,11,Loyal Users
96503,2719,5,7,1,1,1,3,Lost
96608,133,7,22,4,2,2,8,Promising
96632,350,7,14,3,2,1,6,Casual Users
96739,1179,18,83,2,3,4,9,Casual Users
96756,1884,19,59,1,3,3,7,Casual Users
97225,1851,9,35,1,2,3,6,Lost
97282,1122,27,49,2,4,3,9,At Risk
97314,351,20,57,3,3,3,9,Loyal Users
97473,32,43,144,5,4,4,13,Champions
97820,75,102,158,4,5,5,14,Champions
98340,3546,9,20,1,2,2,5,Lost
98406,729,12,43,2,3,3,8,Casual Users
98443,107,9,21,4,2,2,8,Promising
98868,738,15,35,2,3,3,8,Casual Users
99117,3465,5,5,1,1,1,3,Lost
99201,0,143,333,5,5,5,15,Champions
99571,2108,5,11,1,1,1,3,Lost
99601,226,8,13,3,2,1,6,Casual Users
99770,47,7,24,5,2,2,9,Promising
99856,50,20,36,5,3,3,11,Loyal Users
99959,51,17,192,5,3,5,13,Loyal Users
99995,722,21,37,2,3,3,8,Casual Users
91145,3586,6,19,1,1,2,4,Lost
91633,62,49,237,5,5,5,15,Champions
91930,4268,20,88,1,3,4,8,Casual Users
92477,852,6,26,2,1,2,5,Lost
92524,253,6,11,3,1,1,5,Casual Users
92598,133,7,15,4,2,1,7,Promising
92709,2848,5,11,1,1,1,3,Lost
93804,422,43,342,3,4,5,12,Loyal Users
93941,1087,5,7,2,1,1,4,Lost
93964,83,65,195,4,5,5,14,Champions
94181,23,44,296,5,4,5,14,Champions
94364,1430,8,15,1,2,1,4,Lost
94376,63,95,204,5,5,5,15,Champions
94715,585,7,14,2,2,1,5,Lost
94781,171,5,8,3,1,1,5,Casual Users
95015,109,23,246,4,4,5,13,Champions
95215,2012,18,53,1,3,3,7,Casual Users
95893,98,63,430,4,5,5,14,Champions
96040,274,7,40,3,2,3,8,Casual Users
96122,137,58,99,4,5,4,13,Champions
96301,1148,43,129,2,4,4,10,At Risk
96336,876,7,26,2,2,2,6,Lost
96395,1145,15,31,2,3,2,7,Casual Users
96690,1822,8,34,1,2,3,6,Lost
97275,409,49,151,3,5,5,13,Loyal Users
97370,456,16,28,3,3,2,8,Loyal Users
97436,219,22,33,3,4,3,10,Loyal Users
97963,143,9,24,4,2,2,8,Promising
98279,1229,12,20,2,3,2,7,Casual Users
98608,281,6,6,3,1,1,5,Casual Users
98664,1157,13,25,2,3,2,7,Casual Users
99096,129,9,26,4,2,2,8,Promising
99157,1580,14,24,1,3,2,6,Casual Users
99336,23,59,182,5,5,5,15,Champions
99583,408,50,75,3,5,4,12,Loyal Users
99700,120,5,39,4,1,3,8,Promising
99736,66,158,520,5,5,5,15,Champions
99765,33,73,298,5,5,5,15,Champions
99837,128,42,199,4,4,5,13,Champions
99917,316,101,305,3,5,5,13,Loyal Users
99923,280,12,119,3,3,4,10,Loyal Users
91306,2981,6,7,1,1,1,3,Lost
91729,10,55,215,5,5,5,15,Champions
92276,3545,11,17,1,2,2,5,Lost
92422,1961,9,23,1,2,2,5,Lost
92868,1131,218,733,2,5,5,12,At Risk
93066,203,43,71,3,4,4,11,Loyal Users
93232,1797,6,48,1,1,3,5,Lost
93300,0,75,402,5,5,5,15,Champions
93310,27,24,131,5,4,4,13,Champions
93875,311,15,42,3,3,3,9,Loyal Users
93898,1060,14,64,2,3,4,9,Casual Users
94077,267,10,24,3,2,2,7,Casual Users
94129,120,81,401,4,5,5,14,Champions
94269,3513,6,15,1,1,1,3,Lost
94731,114,177,479,4,5,5,14,Champions
94807,943,21,83,2,3,4,9,Casual Users
95152,87,47,92,4,5,4,13,Champions
95214,8,55,160,5,5,5,15,Champions
95252,3409,14,19,1,3,2,6,Casual Users
95396,2482,13,75,1,3,4,8,Casual Users
95410,1932,15,78,1,3,4,8,Casual Users
95570,324,21,25,3,3,2,8,Loyal Users
95716,12,13,24,5,3,2,10,Loyal Users
95746,3587,13,36,1,3,3,7,Casual Users
95775,1591,75,179,1,5,5,11,At Risk
95811,1367,13,31,1,3,2,6,Casual Users
95862,581,8,52,2,2,3,7,Lost
95964,1182,10,17,2,2,2,6,Lost
96206,36,6,8,5,1,1,7,Promising
96340,549,12,23,2,3,2,7,Casual Users
96574,294,7,9,3,2,1,6,Casual Users
96803,424,6,48,3,1,3,7,Casual Users
97095,73,5,14,4,1,1,6,Promising
97391,2316,10,46,1,2,3,6,Lost
97691,15,14,19,5,3,2,10,Loyal Users
97800,1717,8,15,1,2,1,4,Lost
97808,118,86,219,4,5,5,14,Champions
97814,2116,6,11,1,1,1,3,Lost
97864,111,23,63,4,4,4,12,Champions
97897,656,18,27,2,3,2,7,Casual Users
97920,106,5,12,4,1,1,6,Promising
97977,2274,42,73,1,4,4,9,At Risk
98473,1544,6,14,1,1,1,3,Lost
98501,150,52,307,4,5,5,14,Champions
99452,153,7,17,4,2,2,8,Promising
99528,125,42,61,4,4,3,11,Loyal Users
99549,474,8,8,2,2,1,5,Lost
99653,965,5,21,2,1,2,5,Lost
99782,7,107,337,5,5,5,15,Champions
99902,579,15,41,2,3,3,8,Casual Users
99927,957,10,19,2,2,2,6,Lost
91249,440,5,40,3,1,3,7,Casual Users
91553,14,56,532,5,5,5,15,Champions
91742,338,26,32,3,4,3,10,Loyal Users
92281,230,51,187,3,5,5,13,Loyal Users
92584,11,43,69,5,4,4,13,Champions
92833,85,25,64,4,4,4,12,Champions
92867,245,23,79,3,4,4,11,Loyal Users
92904,2298,5,9,1,1,1,3,Lost
93459,203,7,11,3,2,1,6,Casual Users
93524,135,8,24,4,2,2,8,Promising
93534,7,28,110,5,4,4,13,Champions
93690,27,53,87,5,5,4,14,Champions
93885,5,97,629,5,5,5,15,Champions
93936,3133,14,31,1,3,2,6,Casual Users
94153,568,8,26,2,2,2,6,Lost
94492,20,125,545,5,5,5,15,Champions
94516,16,5,18,5,1,2,8,Promising
94689,528,9,55,2,2,3,7,Lost
94909,1756,12,23,1,3,2,6,Casual Users
94969,8,27,148,5,4,5,14,Champions
95680,36,41,139,5,4,4,13,Champions
96152,19,18,48,5,3,3,11,Loyal Users
96183,181,11,33,3,2,3,8,Casual Users
96283,10,183,248,5,5,5,15,Champions
96438,1518,26,30,1,4,2,7,At Risk
96749,966,5,5,2,1,1,4,Lost
96762,1346,13,29,1,3,2,6,Casual Users
96974,22,5,21,5,1,2,8,Promising
97045,1153,15,31,2,3,2,7,Casual Users
97052,114,70,170,4,5,5,14,Champions
97207,1018,14,19,2,3,2,7,Casual Users
97285,3065,8,13,1,2,1,4,Lost
97389,4,62,85,5,5,4,14,Champions
97472,13,43,76,5,4,4,13,Champions
98241,27,18,32,5,3,3,11,Loyal Users
98620,283,138,509,3,5,5,13,Loyal Users
98669,247,40,192,3,4,5,12,Loyal Users
99003,584,18,23,2,3,2,7,Casual Users
99067,3420,8,34,1,2,3,6,Lost
99135,3888,6,30,1,1,2,4,Lost
99456,304,19,67,3,3,4,10,Loyal Users
99640,474,66,212,2,5,5,12,At Risk
99924,125,19,42,4,3,3,10,Loyal Users
99991,4529,10,24,1,2,2,5,Lost
91110,3592,7,30,1,2,2,5,Lost
91182,148,11,16,4,2,2,8,Promising
91356,2,68,158,5,5,5,15,Champions
91527,4591,8,26,1,2,2,5,Lost
91562,15,24,44,5,4,3,12,Loyal Users
91589,1363,8,37,1,2,3,6,Lost
91807,90,180,304,4,5,5,14,Champions
91857,390,8,8,3,2,1,6,Casual Users
92009,978,8,23,2,2,2,6,Lost
92035,0,62,151,5,5,5,15,Champions
92513,119,12,40,4,3,3,10,Loyal Users
92670,81,74,88,4,5,4,13,Champions
92679,430,11,40,3,2,3,8,Casual Users
92978,280,74,321,3,5,5,13,Loyal Users
93035,35,10,27,5,2,2,9,Promising
93209,82,40,241,4,4,5,13,Champions
93373,95,108,152,4,5,5,14,Champions
93481,9,71,279,5,5,5,15,Champions
93692,257,19,75,3,3,4,10,Loyal Users
93846,379,5,5,3,1,1,5,Casual Users
94064,165,40,50,4,4,3,11,Loyal Users
94261,784,29,45,2,4,3,9,At Risk
94346,77,45,126,4,4,4,12,Champions
94543,318,15,18,3,3,2,8,Loyal Users
94680,424,5,10,3,1,1,5,Casual Users
94774,213,5,5,3,1,1,5,Casual Users
94813,2275,5,9,1,1,1,3,Lost
94897,423,7,75,3,2,4,9,Casual Users
94963,115,50,350,4,5,5,14,Champions
94965,228,98,346,3,5,5,13,Loyal Users
95016,167,60,85,3,5,4,12,Loyal Users
95075,104,18,54,4,3,3,10,Loyal Users
95307,165,14,20,4,3,2,9,Loyal Users
95683,165,15,37,4,3,3,10,Loyal Users
95887,611,19,57,2,3,3,8,Casual Users
96308,5705,11,23,1,2,2,5,Lost
96433,952,17,54,2,3,3,8,Casual Users
96479,3105,6,8,1,1,1,3,Lost
96617,286,32,67,3,4,4,11,Loyal Users
96681,723,5,7,2,1,1,4,Lost
96831,30,17,38,5,3,3,11,Loyal Users
96894,152,97,773,4,5,5,14,Champions
97034,2970,8,10,1,2,1,4,Lost
97242,255,5,8,3,1,1,5,Casual Users
97286,111,18,90,4,3,4,11,Loyal Users
97291,22,60,98,5,5,4,14,Champions
97947,132,7,8,4,2,1,7,Promising
97982,268,17,57,3,3,3,9,Loyal Users
98133,15,46,134,5,5,4,14,Champions
98193,26,94,437,5,5,5,15,Champions
98216,2399,10,30,1,2,2,5,Lost
98234,217,13,46,3,3,3,9,Loyal Users
99227,963,5,12,2,1,1,4,Lost
99507,38,54,267,5,5,5,15,Champions
99522,810,7,20,2,2,2,6,Lost
99841,543,39,69,2,4,4,10,At Risk
91151,88,47,282,4,5,5,14,Champions
91375,715,19,27,2,3,2,7,Casual Users
91441,1082,9,25,2,2,2,6,Lost
91492,125,6,20,4,1,2,7,Promising
91814,269,5,14,3,1,1,5,Casual Users
91853,2854,9,11,1,2,1,4,Lost
91861,3807,15,24,1,3,2,6,Casual Users
92312,112,19,31,4,3,2,9,Loyal Users
92348,70,28,74,4,4,4,12,Champions
92500,153,17,46,4,3,3,10,Loyal Users
92567,367,6,13,3,1,1,5,Casual Users
92713,149,118,597,4,5,5,14,Champions
92942,50,145,310,5,5,5,15,Champions
93130,3238,13,27,1,3,2,6,Casual Users
93296,2500,170,371,1,5,5,11,At Risk
93833,412,36,127,3,4,4,11,Loyal Users
94174,97,7,11,4,2,1,7,Promising
94301,25,15,62,5,3,3,11,Loyal Users
94329,421,11,48,3,2,3,8,Casual Users
94732,1554,13,27,1,3,2,6,Casual Users
94815,5390,10,17,1,2,2,5,Lost
95241,23,68,169,5,5,5,15,Champions
95339,122,12,48,4,3,3,10,Loyal Users
95595,25,5,8,5,1,1,7,Promising
95662,393,13,21,3,3,2,8,Loyal Users
95756,733,17,19,2,3,2,7,Casual Users
96219,1126,10,18,2,2,2,6,Lost
96275,880,19,92,2,3,4,9,Casual Users
96356,13,48,214,5,5,5,15,Champions
96484,234,8,32,3,2,3,8,Casual Users
97118,523,6,17,2,1,2,5,Lost
97187,1700,7,7,1,2,1,4,Lost
97477,789,7,14,2,2,1,5,Lost
97912,116,84,464,4,5,5,14,Champions
97929,129,26,87,4,4,4,12,Champions
98431,30,30,79,5,4,4,13,Champions
98433,238,29,58,3,4,3,10,Loyal Users
98549,128,29,45,4,4,3,11,Loyal Users
99022,42,58,143,5,5,4,14,Champions
99409,284,6,6,3,1,1,5,Casual Users
99495,23,42,155,5,4,5,14,Champions
99591,281,5,12,3,1,1,5,Casual Users
99673,259,66,288,3,5,5,13,Loyal Users
99852,1396,26,66,1,4,4,9,At Risk
99968,105,42,58,4,4,3,11,Loyal Users
91226,272,43,318,3,4,5,12,Loyal Users
91374,766,8,10,2,2,1,5,Lost
91781,1028,9,24,2,2,2,6,Lost
91793,2554,16,26,1,3,2,6,Casual Users
91847,129,21,23,4,3,2,9,Loyal Users
91891,3729,11,14,1,2,1,4,Lost
92335,652,18,35,2,3,3,8,Casual Users
92393,270,10,16,3,2,2,7,Casual Users
92970,406,13,19,3,3,2,8,Loyal Users
93055,1426,5,8,1,1,1,3,Lost
93194,2,121,236,5,5,5,15,Champions
93197,1289,21,44,1,3,3,7,Casual Users
93617,414,19,30,3,3,2,8,Loyal Users
93674,143,10,36,4,2,3,9,Promising
93913,1276,6,24,1,1,2,4,Lost
93915,144,15,69,4,3,4,11,Loyal Users
94531,580,8,8,2,2,1,5,Lost
94568,13,121,388,5,5,5,15,Champions
94672,42,29,59,5,4,3,12,Loyal Users
94690,4364,14,27,1,3,2,6,Casual Users
95178,3241,13,21,1,3,2,6,Casual Users
95353,140,11,42,4,2,3,9,Promising
95409,134,61,116,4,5,4,13,Champions
95651,138,39,73,4,4,4,12,Champions
95654,2532,16,95,1,3,4,8,Casual Users
95921,34,32,79,5,4,4,13,Champions
95936,536,70,131,2,5,4,11,At Risk
96295,2082,7,16,1,2,2,5,Lost
97155,128,49,161,4,5,5,14,Champions
97451,1917,17,21,1,3,2,6,Casual Users
97461,91,40,72,4,4,4,12,Champions
97889,6,26,55,5,4,3,12,Loyal Users
98067,36,58,133,5,5,4,14,Champions
98138,943,5,24,2,1,2,5,Lost
98347,160,6,70,4,1,4,9,Promising
98513,272,37,140,3,4,4,11,Loyal Users
98821,79,6,18,4,1,2,7,Promising
98959,1395,8,16,1,2,2,5,Lost
99187,932,11,98,2,2,4,8,Lost
99266,2959,38,186,1,4,5,10,At Risk
99309,317,13,14,3,3,1,7,Loyal Users
99562,2145,22,46,1,4,3,8,At Risk
99751,2474,6,9,1,1,1,3,Lost
99780,2158,5,23,1,1,2,4,Lost
91244,719,6,31,2,1,2,5,Lost
91353,715,33,113,2,4,4,10,At Risk
91566,127,71,114,4,5,4,13,Champions
92298,791,8,13,2,2,1,5,Lost
92525,106,60,299,4,5,5,14,Champions
92583,4043,12,24,1,3,2,6,Casual Users
92723,560,9,9,2,2,1,5,Lost
92847,822,6,103,2,1,4,7,Lost
93046,1269,9,21,1,2,2,5,Lost
93204,157,11,77,4,2,4,10,Promising
93320,119,75,87,4,5,4,13,Champions
93499,252,16,21,3,3,2,8,Loyal Users
94206,179,75,116,3,5,4,12,Loyal Users
94276,104,9,18,4,2,2,8,Promising
94915,43,107,236,5,5,5,15,Champions
94974,60,14,22,5,3,2,10,Loyal Users
95299,583,15,177,2,3,5,10,Casual Users
95413,43,8,24,5,2,2,9,Promising
95796,445,41,68,3,4,4,11,Loyal Users
96229,87,61,141,4,5,4,13,Champions
96451,2522,31,56,1,4,3,8,At Risk
96515,1499,15,26,1,3,2,6,Casual Users
96913,222,22,52,3,4,3,10,Loyal Users
96927,61,21,55,5,3,3,11,Loyal Users
97056,452,11,23,3,2,2,7,Casual Users
97237,43,24,114,5,4,4,13,Champions
97588,1531,7,11,1,2,1,4,Lost
98065,112,6,26,4,1,2,7,Promising
98126,116,48,98,4,5,4,13,Champions
98209,680,27,55,2,4,3,9,At Risk
98568,746,20,75,2,3,4,9,Casual Users
98695,133,14,27,4,3,2,9,Loyal Users
98907,425,17,95,3,3,4,10,Loyal Users
99140,72,40,177,4,4,5,13,Champions
99154,136,17,61,4,3,3,10,Loyal Users
99442,287,25,125,3,4,4,11,Loyal Users
99458,457,13,31,3,3,2,8,Loyal Users
99461,81,21,53,4,3,3,10,Loyal Users
99488,79,18,31,4,3,2,9,Loyal Users
99620,31,155,1323,5,5,5,15,Champions
99694,266,8,26,3,2,2,7,Casual Users
99739,1926,5,9,1,1,1,3,Lost
99853,305,25,73,3,4,4,11,Loyal Users
99981,5,175,706,5,5,5,15,Champions
91336,183,150,440,3,5,5,13,Loyal Users
91651,143,10,24,4,2,2,8,Promising
91827,625,26,39,2,4,3,9,At Risk
91942,8,7,13,5,2,1,8,Promising
92054,5240,5,5,1,1,1,3,Lost
92097,10,133,334,5,5,5,15,Champions
92359,28,56,240,5,5,5,15,Champions
92369,473,14,16,2,3,2,7,Casual Users
92587,149,111,570,4,5,5,14,Champions
92649,102,16,25,4,3,2,9,Loyal Users
92660,30,31,156,5,4,5,14,Champions
92678,858,13,46,2,3,3,8,Casual Users
92742,2634,5,8,1,1,1,3,Lost
92949,216,18,25,3,3,2,8,Loyal Users
93244,454,30,62,3,4,3,10,Loyal Users
93924,16,15,38,5,3,3,11,Loyal Users
94096,1081,13,63,2,3,4,9,Casual Users
94143,16,155,471,5,5,5,15,Champions
94251,51,77,138,5,5,4,14,Champions
94603,1171,7,10,2,2,1,5,Lost
94692,233,16,65,3,3,4,10,Loyal Users
94876,4249,7,7,1,2,1,4,Lost
95076,87,85,367,4,5,5,14,Champions
95827,189,18,42,3,3,3,9,Loyal Users
96118,432,19,37,3,3,3,9,Loyal Users
96467,228,5,15,3,1,1,5,Casual Users
96535,3131,33,78,1,4,4,9,At Risk
96844,705,8,68,2,2,4,8,Lost
97114,885,7,9,2,2,1,5,Lost
97279,12,31,118,5,4,4,13,Champions
97313,210,16,20,3,3,2,8,Loyal Users
97453,3353,11,26,1,2,2,5,Lost
97494,1872,5,15,1,1,1,3,Lost
97539,5,6,14,5,1,1,7,Promising
98723,165,28,52,4,4,3,11,Loyal Users
98802,953,7,17,2,2,2,6,Lost
99302,264,20,150,3,3,5,11,Loyal Users
99315,4583,13,15,1,3,1,5,Casual Users
99445,16,71,629,5,5,5,15,Champions
99593,90,59,109,4,5,4,13,Champions
99682,585,6,12,2,1,1,4,Lost
91659,24,157,283,5,5,5,15,Champions
91821,688,10,49,2,2,3,7,Lost
92086,528,29,87,2,4,4,10,At Risk
92287,266,6,28,3,1,2,6,Casual Users
92376,10,24,56,5,4,3,12,Loyal Users
92435,34,11,22,5,2,2,9,Promising
92446,687,10,13,2,2,1,5,Lost
92490,12,26,43,5,4,3,12,Loyal Users
92494,2240,16,20,1,3,2,6,Casual Users
93322,1578,6,11,1,1,1,3,Lost
93629,688,10,10,2,2,1,5,Lost
93708,11,27,62,5,4,3,12,Loyal Users
93802,5,13,98,5,3,4,12,Loyal Users
93912,25,23,41,5,4,3,12,Loyal Users
94224,416,16,23,3,3,2,8,Loyal Users
94374,725,5,17,2,1,2,5,Lost
94423,7,21,39,5,3,3,11,Loyal Users
94686,78,10,15,4,2,1,7,Promising
94828,723,6,21,2,1,2,5,Lost
95032,247,22,156,3,4,5,12,Loyal Users
95192,429,24,27,3,4,2,9,Loyal Users
95824,2741,10,32,1,2,3,6,Lost
96047,1143,8,9,2,2,1,5,Lost
96459,948,11,23,2,2,2,6,Lost
96575,464,8,42,3,2,3,8,Casual Users
96944,3,30,110,5,4,4,13,Champions
97029,102,159,715,4,5,5,14,Champions
97529,2,78,411,5,5,5,15,Champions
98021,999,21,77,2,3,4,9,Casual Users
98072,216,71,290,3,5,5,13,Loyal Users
98227,418,9,30,3,2,2,7,Casual Users
98486,83,17,38,4,3,3,10,Loyal Users
99308,2295,8,9,1,2,1,4,Lost
99664,332,20,36,3,3,3,9,Loyal Users
99675,12,145,428,5,5,5,15,Champions
91093,5529,6,8,1,1,1,3,Lost
91098,110,28,79,4,4,4,12,Champions
91438,2414,17,32,1,3,3,7,Casual Users
91451,134,52,125,4,5,4,13,Champions
91507,2,51,473,5,5,5,15,Champions
91732,1068,17,62,2,3,3,8,Casual Users
91813,1105,5,14,2,1,1,4,Lost
91961,24,11,77,5,2,4,11,Promising
92354,68,13,27,5,3,2,10,Loyal Users
92416,224,7,53,3,2,3,8,Casual Users
92439,2006,6,18,1,1,2,4,Lost
92690,1150,10,30,2,2,2,6,Lost
92741,126,19,69,4,3,4,11,Loyal Users
93181,18,44,133,5,4,4,13,Champions
93182,2416,62,139,1,5,4,10,At Risk
93216,291,7,16,3,2,2,7,Casual Users
93233,344,6,10,3,1,1,5,Casual Users
93608,11,12,18,5,3,2,10,Loyal Users
93686,2804,12,77,1,3,4,8,Casual Users
93693,183,6,29,3,1,2,6,Casual Users
93758,463,8,9,3,2,1,6,Casual Users
93827,4,70,226,5,5,5,15,Champions
93849,7,35,171,5,4,5,14,Champions
93937,122,65,151,4,5,5,14,Champions
94332,748,14,77,2,3,4,9,Casual Users
94757,4702,12,74,1,3,4,8,Casual Users
94760,2,36,280,5,4,5,14,Champions
94808,40,41,239,5,4,5,14,Champions
94817,113,50,186,4,5,5,14,Champions
95087,429,20,73,3,3,4,10,Loyal Users
95437,556,48,116,2,5,4,11,At Risk
95518,1467,23,42,1,4,3,8,At Risk
95732,21,76,190,5,5,5,15,Champions
95802,1662,13,39,1,3,3,7,Casual Users
96584,101,32,114,4,4,4,12,Champions
97096,7,84,246,5,5,5,15,Champions
97126,1179,11,15,2,2,1,5,Lost
98100,31,31,388,5,4,5,14,Champions
98394,21,110,604,5,5,5,15,Champions
98527,1016,15,18,2,3,2,7,Casual Users
98636,15,36,200,5,4,5,14,Champions
98677,126,29,63,4,4,4,12,Champions
98865,188,8,30,3,2,2,7,Casual Users
99125,52,122,282,5,5,5,15,Champions
99198,1127,8,11,2,2,1,5,Lost
99206,823,6,9,2,1,1,4,Lost
99697,228,7,10,3,2,1,6,Casual Users
99706,24,44,110,5,4,4,13,Champions
99954,32,12,12,5,3,1,9,Loyal Users
91126,500,16,68,2,3,4,9,Casual Users
92116,72,60,91,4,5,4,13,Champions
92180,74,32,176,4,4,5,13,Champions
92736,65,9,37,5,2,3,10,Promising
92921,3356,12,12,1,3,1,5,Casual Users
93048,1,109,557,5,5,5,15,Champions
93324,694,31,63,2,4,4,10,At Risk
93939,428,30,42,3,4,3,10,Loyal Users
94123,876,9,30,2,2,2,6,Lost
94487,497,12,45,2,3,3,8,Casual Users
95031,842,16,20,2,3,2,7,Casual Users
95502,139,29,143,4,4,4,12,Champions
95573,224,48,89,3,5,4,12,Loyal Users
95741,89,15,22,4,3,2,9,Loyal Users
95920,76,7,39,4,2,3,9,Promising
96204,978,15,33,2,3,3,8,Casual Users
96263,940,6,8,2,1,1,4,Lost
96556,2089,11,23,1,2,2,5,Lost
96590,633,10,14,2,2,1,5,Lost
96754,204,20,32,3,3,3,9,Loyal Users
96846,131,52,123,4,5,4,13,Champions
96965,116,9,13,4,2,1,7,Promising
97025,701,15,23,2,3,2,7,Casual Users
97144,89,134,204,4,5,5,14,Champions
97265,571,11,14,2,2,1,5,Lost
97338,112,34,97,4,4,4,12,Champions
97500,1304,10,13,1,2,1,4,Lost
97590,3052,5,47,1,1,3,5,Lost
97730,145,78,418,4,5,5,14,Champions
97769,819,9,44,2,2,3,7,Lost
98020,14,111,204,5,5,5,15,Champions
98355,3903,6,13,1,1,1,3,Lost
98906,106,5,6,4,1,1,6,Promising
98947,276,7,17,3,2,2,7,Casual Users
99242,162,6,14,4,1,1,6,Promising
99342,859,8,9,2,2,1,5,Lost
99412,452,8,13,3,2,1,6,Casual Users
99531,737,11,15,2,2,1,5,Lost
99678,841,28,76,2,4,4,10,At Risk
99778,844,8,14,2,2,1,5,Lost
99833,150,21,54,4,3,3,10,Loyal Users
99888,40,76,318,5,5,5,15,Champions
99989,53,69,263,5,5,5,15,Champions
91329,431,19,47,3,3,3,9,Loyal Users
91421,874,16,34,2,3,3,8,Casual Users
91524,2081,16,20,1,3,2,6,Casual Users
91636,36,32,119,5,4,4,13,Champions
91752,368,31,45,3,4,3,10,Loyal Users
91940,2,20,95,5,3,4,12,Loyal Users
92127,405,12,57,3,3,3,9,Loyal Users
92204,0,19,28,5,3,2,10,Loyal Users
92321,520,11,16,2,2,2,6,Lost
92415,568,6,8,2,1,1,4,Lost
92419,208,17,158,3,3,5,11,Loyal Users
92497,125,110,603,4,5,5,14,Champions
92806,128,40,139,4,4,4,12,Champions
92830,133,38,113,4,4,4,12,Champions
92940,91,31,64,4,4,4,12,Champions
93062,47,44,179,5,4,5,14,Champions
93238,4762,10,27,1,2,2,5,Lost
93406,628,14,120,2,3,4,9,Casual Users
93526,122,40,127,4,4,4,12,Champions
93729,987,10,40,2,2,3,7,Lost
93774,268,13,24,3,3,2,8,Loyal Users
93820,17,68,567,5,5,5,15,Champions
94155,174,10,29,3,2,2,7,Casual Users
94497,518,12,49,2,3,3,8,Casual Users
94585,896,20,74,2,3,4,9,Casual Users
94649,840,19,30,2,3,2,7,Casual Users
94957,592,6,12,2,1,1,4,Lost
94983,1128,69,85,2,5,4,11,At Risk
95098,516,22,31,2,4,2,8,At Risk
95387,170,5,8,3,1,1,5,Casual Users
95806,180,21,42,3,3,3,9,Loyal Users
95861,3401,7,27,1,2,2,5,Lost
96029,235,34,123,3,4,4,11,Loyal Users
96168,1800,5,12,1,1,1,3,Lost
96192,2183,5,20,1,1,2,4,Lost
96366,2574,9,24,1,2,2,5,Lost
96404,7,60,103,5,5,4,14,Champions
96471,1,113,322,5,5,5,15,Champions
96475,969,7,14,2,2,1,5,Lost
96618,626,12,16,2,3,2,7,Casual Users
96997,33,46,279,5,5,5,15,Champions
97336,174,24,34,3,4,3,10,Loyal Users
97366,17,8,9,5,2,1,8,Promising
97474,42,69,315,5,5,5,15,Champions
97568,4680,6,37,1,1,3,5,Lost
97653,843,7,12,2,2,1,5,Lost
97867,724,9,9,2,2,1,5,Lost
98080,77,11,29,4,2,2,8,Promising
98266,263,12,60,3,3,3,9,Loyal Users
98282,134,72,177,4,5,5,14,Champions
98435,1725,6,6,1,1,1,3,Lost
98637,2418,6,9,1,1,1,3,Lost
98666,525,5,5,2,1,1,4,Lost
98952,375,7,14,3,2,1,6,Casual Users
98991,305,5,5,3,1,1,5,Casual Users
99396,23,59,81,5,5,4,14,Champions
99533,131,35,77,4,4,4,12,Champions
99655,813,58,102,2,5,4,11,At Risk
91077,262,16,41,3,3,3,9,Loyal Users
91129,4227,5,5,1,1,1,3,Lost
91237,30,23,69,5,4,4,13,Champions
91364,434,18,105,3,3,4,10,Loyal Users
91776,424,37,91,3,4,4,11,Loyal Users
92366,543,9,42,2,2,3,7,Lost
92499,1149,5,6,2,1,1,4,Lost
92552,14,117,343,5,5,5,15,Champions
92633,15,190,592,5,5,5,15,Champions
92962,1097,5,31,2,1,2,5,Lost
93080,3307,5,6,1,1,1,3,Lost
93359,88,21,111,4,3,4,11,Loyal Users
93377,1719,5,6,1,1,1,3,Lost
93436,441,28,93,3,4,4,11,Loyal Users
93448,6,67,101,5,5,4,14,Champions
93483,531,37,92,2,4,4,10,At Risk
93497,136,20,30,4,3,2,9,Loyal Users
93593,1375,17,45,1,3,3,7,Casual Users
93632,611,16,64,2,3,4,9,Casual Users
93819,8,86,651,5,5,5,15,Champions
94036,112,50,296,4,5,5,14,Champions
94300,129,30,120,4,4,4,12,Champions
94362,3,156,602,5,5,5,15,Champions
94551,6,62,100,5,5,4,14,Champions
95150,917,16,84,2,3,4,9,Casual Users
95381,1992,12,36,1,3,3,7,Casual Users
95444,804,18,57,2,3,3,8,Casual Users
95676,3,75,234,5,5,5,15,Champions
96155,229,13,17,3,3,2,8,Loyal Users
96293,1997,13,88,1,3,4,8,Casual Users
96716,25,17,32,5,3,3,11,Loyal Users
96745,1513,5,8,1,1,1,3,Lost
96987,441,6,21,3,1,2,6,Casual Users
97465,985,40,64,2,4,4,10,At Risk
97994,2380,7,13,1,2,1,4,Lost
98018,591,7,10,2,2,1,5,Lost
98265,408,33,77,3,4,4,11,Loyal Users
98926,1650,12,46,1,3,3,7,Casual Users
99273,272,28,130,3,4,4,11,Loyal Users
99372,5,73,306,5,5,5,15,Champions
99681,114,55,194,4,5,5,14,Champions
91481,569,25,181,2,4,5,11,At Risk
91681,1847,13,18,1,3,2,6,Casual Users
91797,16,102,190,5,5,5,15,Champions
91888,645,13,25,2,3,2,7,Casual Users
92246,836,5,6,2,1,1,4,Lost
92417,265,13,29,3,3,2,8,Loyal Users
92437,411,28,154,3,4,5,12,Loyal Users
92665,153,27,51,4,4,3,11,Loyal Users
93008,4648,38,160,1,4,5,10,At Risk
93276,28,11,61,5,2,3,10,Promising
93605,372,11,14,3,2,1,6,Casual Users
93719,907,14,15,2,3,1,6,Casual Users
93732,3106,15,18,1,3,2,6,Casual Users
93793,14,180,669,5,5,5,15,Champions
93798,126,51,92,4,5,4,13,Champions
94359,1,152,396,5,5,5,15,Champions
94384,436,9,11,3,2,1,6,Casual Users
94448,318,5,5,3,1,1,5,Casual Users
94533,654,62,116,2,5,4,11,At Risk
94556,1563,13,24,1,3,2,6,Casual Users
94599,404,15,27,3,3,2,8,Loyal Users
94826,839,31,135,2,4,4,10,At Risk
94871,43,85,178,5,5,5,15,Champions
95346,231,31,45,3,4,3,10,Loyal Users
95470,270,43,174,3,4,5,12,Loyal Users
95519,1915,9,39,1,2,3,6,Lost
95689,1519,9,11,1,2,1,4,Lost
95831,115,10,22,4,2,2,8,Promising
95914,281,16,37,3,3,3,9,Loyal Users
96049,3399,9,23,1,2,2,5,Lost
96153,2728,11,29,1,2,2,5,Lost
96684,4,20,106,5,3,4,12,Loyal Users
96774,1297,5,7,1,1,1,3,Lost
96939,3603,5,13,1,1,1,3,Lost
97269,2505,7,9,1,2,1,4,Lost
97298,104,17,32,4,3,3,10,Loyal Users
97576,981,6,9,2,1,1,4,Lost
97767,117,5,7,4,1,1,6,Promising
98030,28,5,19,5,1,2,8,Promising
98192,434,11,28,3,2,2,7,Casual Users
98407,248,5,8,3,1,1,5,Casual Users
98583,132,56,87,4,5,4,13,Champions
98812,726,6,12,2,1,1,4,Lost
98931,1022,6,10,2,1,1,4,Lost
98987,170,22,53,3,4,3,10,Loyal Users
99144,741,6,7,2,1,1,4,Lost
99511,4869,16,20,1,3,2,6,Casual Users
99815,19,50,71,5,5,4,14,Champions
99913,477,5,11,2,1,1,4,Lost
99955,3632,8,36,1,2,3,6,Lost
91664,2058,17,43,1,3,3,7,Casual Users
91825,1221,12,18,2,3,2,7,Casual Users
92225,300,13,65,3,3,4,10,Loyal Users
92299,143,49,63,4,5,4,13,Champions
92546,64,35,96,5,4,4,13,Champions
93068,44,5,8,5,1,1,7,Promising
94119,71,38,54,4,4,3,11,Loyal Users
94187,138,29,71,4,4,4,12,Champions
94375,392,5,6,3,1,1,5,Casual Users
94490,516,18,35,2,3,3,8,Casual Users
94517,44,53,251,5,5,5,15,Champions
94521,30,46,114,5,5,4,14,Champions
94804,39,18,39,5,3,3,11,Loyal Users
94902,110,49,116,4,5,4,13,Champions
95121,577,5,11,2,1,1,4,Lost
95232,84,47,63,4,5,4,13,Champions
95344,50,30,47,5,4,3,12,Loyal Users
95426,734,6,16,2,1,2,5,Lost
96067,20,22,46,5,4,3,12,Loyal Users
96095,160,25,52,4,4,3,11,Loyal Users
96238,96,91,379,4,5,5,14,Champions
96292,697,16,25,2,3,2,7,Casual Users
96325,271,14,75,3,3,4,10,Loyal Users
96379,5381,5,5,1,1,1,3,Lost
96746,568,32,81,2,4,4,10,At Risk
97100,327,30,44,3,4,3,10,Loyal Users
97259,541,6,55,2,1,3,6,Lost
97535,49,61,347,5,5,5,15,Champions
97592,83,37,46,4,4,3,11,Loyal Users
97972,975,7,16,2,2,2,6,Lost
98417,408,20,33,3,3,3,9,Loyal Users
99079,230,129,313,3,5,5,13,Loyal Users
99286,388,7,7,3,2,1,6,Casual Users
99465,1413,5,6,1,1,1,3,Lost
99564,279,15,28,3,3,2,8,Loyal Users
99632,95,53,225,4,5,5,14,Champions
